,Time,Amount,Balance,Opening Balance,Change From Opening Balance
0,2022-01-01 08:00:00,1260.05,1260.05,0.0,1260.05
1,2022-01-01 08:05:00,1283.72,2543.77,0.0,2543.77
2,2022-01-01 08:10:00,-926.12,1617.65,0.0,1617.65
3,2022-01-01 08:15:00,-597.09,1020.5600000000001,0.0,1020.5600000000001
4,2022-01-01 08:20:00,-307.39,713.1700000000001,0.0,713.1700000000001
5,2022-01-01 08:25:00,204.41,917.58,0.0,917.58
6,2022-01-01 08:30:00,-868.14,49.440000000000055,0.0,49.440000000000055
7,2022-01-01 08:35:00,1093.28,1142.72,0.0,1142.72
8,2022-01-01 08:40:00,105.78,1248.5,0.0,1248.5
9,2022-01-01 08:45:00,290.46,1538.96,0.0,1538.96
10,2022-01-01 08:50:00,1066.08,2605.04,0.0,2605.04
11,2022-01-01 08:55:00,-735.29,1869.75,0.0,1869.75
12,2022-01-01 09:00:00,431.3,2301.05,0.0,2301.05
13,2022-01-01 09:05:00,91.43,2392.48,0.0,2392.48
14,2022-01-01 09:10:00,-1298.86,1093.6200000000001,0.0,1093.6200000000001
15,2022-01-01 09:15:00,-28.53,1065.0900000000001,0.0,1065.0900000000001
16,2022-01-01 09:20:00,110.1,1175.19,0.0,1175.19
17,2022-01-01 09:25:00,-37.14,1138.05,0.0,1138.05
18,2022-01-01 09:30:00,-528.53,609.52,0.0,609.52
19,2022-01-01 09:35:00,1596.19,2205.71,0.0,2205.71
20,2022-01-01 09:40:00,-1992.73,212.98000000000002,0.0,212.98000000000002
21,2022-01-01 09:45:00,1581.21,1794.19,0.0,1794.19
22,2022-01-01 09:50:00,-692.02,1102.17,0.0,1102.17
23,2022-01-01 09:55:00,-76.75,1025.42,0.0,1025.42
24,2022-01-01 10:00:00,423.83,1449.25,0.0,1449.25
25,2022-01-01 10:05:00,-848.97,600.28,0.0,600.28
26,2022-01-01 10:10:00,-231.38,368.9,0.0,368.9
27,2022-01-01 10:15:00,1793.65,2162.55,0.0,2162.55
28,2022-01-01 10:20:00,-1308.12,854.4300000000003,0.0,854.4300000000003
29,2022-01-01 10:25:00,1052.62,1907.0500000000002,0.0,1907.0500000000002
30,2022-01-01 10:30:00,-1267.52,639.5300000000002,0.0,639.5300000000002
31,2022-01-01 10:35:00,1191.02,1830.5500000000002,0.0,1830.5500000000002
32,2022-01-01 10:40:00,1031.45,2862.0,0.0,2862.0
33,2022-01-01 10:45:00,-669.07,2192.93,0.0,2192.93
34,2022-01-01 10:50:00,39.61,2232.54,0.0,2232.54
35,2022-01-01 10:55:00,757.91,2990.45,0.0,2990.45
36,2022-01-01 11:00:00,-1382.27,1608.1799999999998,0.0,1608.1799999999998
37,2022-01-01 11:05:00,-237.34,1370.84,0.0,1370.84
38,2022-01-01 11:10:00,-846.16,524.68,0.0,524.68
39,2022-01-01 11:15:00,655.67,1180.35,0.0,1180.35
40,2022-01-01 11:20:00,-1030.89,149.4599999999998,0.0,149.4599999999998
41,2022-01-01 11:25:00,1977.66,2127.12,0.0,2127.12
42,2022-01-01 11:30:00,-313.13,1813.9899999999998,0.0,1813.9899999999998
43,2022-01-01 11:35:00,1363.79,3177.7799999999997,0.0,3177.7799999999997
44,2022-01-01 11:40:00,35.25,3213.0299999999997,0.0,3213.0299999999997
45,2022-01-01 11:45:00,-1347.11,1865.9199999999998,0.0,1865.9199999999998
46,2022-01-01 11:50:00,-142.67,1723.2499999999998,0.0,1723.2499999999998
47,2022-01-01 11:55:00,67.29,1790.5399999999997,0.0,1790.5399999999997
48,2022-01-01 12:00:00,348.28,2138.8199999999997,0.0,2138.8199999999997
49,2022-01-01 12:05:00,462.29,2601.1099999999997,0.0,2601.1099999999997
50,2022-01-01 12:10:00,-296.8,2304.3099999999995,0.0,2304.3099999999995
51,2022-01-01 12:15:00,-237.02,2067.2899999999995,0.0,2067.2899999999995
52,2022-01-01 12:20:00,-383.11,1684.1799999999994,0.0,1684.1799999999994
53,2022-01-01 12:25:00,-1655.33,28.849999999999454,0.0,28.849999999999454
54,2022-01-01 12:30:00,1799.3,1828.1499999999994,0.0,1828.1499999999994
55,2022-01-01 12:35:00,-71.89,1756.2599999999993,0.0,1756.2599999999993
56,2022-01-01 12:40:00,-1685.77,70.48999999999933,0.0,70.48999999999933
57,2022-01-01 12:45:00,1812.55,1883.0399999999993,0.0,1883.0399999999993
58,2022-01-01 12:50:00,-84.03,1799.0099999999993,0.0,1799.0099999999993
59,2022-01-01 12:55:00,1572.76,3371.7699999999995,0.0,3371.7699999999995
60,2022-01-01 13:00:00,1859.41,5231.179999999999,0.0,5231.179999999999
61,2022-01-01 13:05:00,1089.84,6321.0199999999995,0.0,6321.0199999999995
62,2022-01-01 13:10:00,305.67,6626.69,0.0,6626.69
63,2022-01-01 13:15:00,-98.34,6528.349999999999,0.0,6528.349999999999
64,2022-01-01 13:20:00,-872.18,5656.169999999999,0.0,5656.169999999999
65,2022-01-01 13:25:00,-1274.95,4381.219999999999,0.0,4381.219999999999
66,2022-01-01 13:30:00,586.93,4968.15,0.0,4968.15
67,2022-01-01 13:35:00,1391.34,6359.49,0.0,6359.49
68,2022-01-01 13:40:00,1290.34,7649.83,0.0,7649.83
69,2022-01-01 13:45:00,-727.49,6922.34,0.0,6922.34
70,2022-01-01 13:50:00,-1748.16,5174.18,0.0,5174.18
71,2022-01-01 13:55:00,1267.34,6441.52,0.0,6441.52
72,2022-01-01 14:00:00,39.34,6480.860000000001,0.0,6480.860000000001
73,2022-01-01 14:05:00,-288.17,6192.6900000000005,0.0,6192.6900000000005
74,2022-01-01 14:10:00,-129.75,6062.9400000000005,0.0,6062.9400000000005
75,2022-01-01 14:15:00,-832.32,5230.620000000001,0.0,5230.620000000001
76,2022-01-01 14:20:00,181.3,5411.920000000001,0.0,5411.920000000001
77,2022-01-01 14:25:00,1532.86,6944.780000000001,0.0,6944.780000000001
78,2022-01-01 14:30:00,404.0,7348.780000000001,0.0,7348.780000000001
79,2022-01-01 14:35:00,142.88,7491.660000000001,0.0,7491.660000000001
80,2022-01-01 14:40:00,1299.14,8790.800000000001,0.0,8790.800000000001
81,2022-01-01 14:45:00,-978.27,7812.530000000001,0.0,7812.530000000001
82,2022-01-01 14:50:00,1087.01,8899.54,0.0,8899.54
83,2022-01-01 14:55:00,1548.8,10448.34,0.0,10448.34
84,2022-01-01 15:00:00,-1493.78,8954.56,0.0,8954.56
85,2022-01-01 15:05:00,1616.48,10571.039999999999,0.0,10571.039999999999
86,2022-01-01 15:10:00,1137.24,11708.279999999999,0.0,11708.279999999999
87,2022-01-01 15:15:00,409.95,12118.23,0.0,12118.23
88,2022-01-01 15:20:00,33.51,12151.74,0.0,12151.74
89,2022-01-01 15:25:00,155.59,12307.33,0.0,12307.33
90,2022-01-01 15:30:00,1116.69,13424.02,0.0,13424.02
91,2022-01-01 15:35:00,-1601.78,11822.24,0.0,11822.24
92,2022-01-01 15:40:00,-136.76,11685.48,0.0,11685.48
93,2022-01-01 15:45:00,-1651.27,10034.21,0.0,10034.21
94,2022-01-01 15:50:00,1033.45,11067.66,0.0,11067.66
95,2022-01-01 15:55:00,-1300.79,9766.869999999999,0.0,9766.869999999999
96,2022-01-01 16:00:00,622.91,10389.779999999999,0.0,10389.779999999999
97,2022-01-01 16:05:00,-1514.03,8875.749999999998,0.0,8875.749999999998
98,2022-01-01 16:10:00,-660.58,8215.169999999998,0.0,8215.169999999998
99,2022-01-01 16:15:00,-615.42,7599.749999999998,0.0,7599.749999999998
100,2022-01-01 16:20:00,-53.59,7546.159999999998,0.0,7546.159999999998
101,2022-01-01 16:25:00,84.86,7631.019999999998,0.0,7631.019999999998
102,2022-01-01 16:30:00,-1168.84,6462.179999999998,0.0,6462.179999999998
103,2022-01-01 16:35:00,-1333.81,5128.369999999997,0.0,5128.369999999997
104,2022-01-01 16:40:00,232.32,5360.689999999997,0.0,5360.689999999997
105,2022-01-01 16:45:00,-1051.75,4308.939999999997,0.0,4308.939999999997
106,2022-01-01 16:50:00,434.21,4743.149999999997,0.0,4743.149999999997
107,2022-01-01 16:55:00,1545.57,6288.719999999997,0.0,6288.719999999997
108,2022-01-02 08:00:00,37.35,6326.069999999997,6288.719999999997,37.350000000000364
109,2022-01-02 08:05:00,175.93,6501.999999999997,6288.719999999997,213.28000000000065
110,2022-01-02 08:10:00,-910.61,5591.389999999998,6288.719999999997,-697.329999999999
111,2022-01-02 08:15:00,-290.37,5301.019999999998,6288.719999999997,-987.6999999999989
112,2022-01-02 08:20:00,786.13,6087.149999999998,6288.719999999997,-201.5699999999988
113,2022-01-02 08:25:00,-1924.75,4162.399999999998,6288.719999999997,-2126.319999999999
114,2022-01-02 08:30:00,-618.74,3543.659999999998,6288.719999999997,-2745.0599999999986
115,2022-01-02 08:35:00,685.78,4229.439999999998,6288.719999999997,-2059.279999999999
116,2022-01-02 08:40:00,1146.71,5376.149999999998,6288.719999999997,-912.5699999999988
117,2022-01-02 08:45:00,-819.47,4556.679999999998,6288.719999999997,-1732.039999999999
118,2022-01-02 08:50:00,44.07,4600.749999999997,6288.719999999997,-1687.9699999999993
119,2022-01-02 08:55:00,828.05,5428.799999999997,6288.719999999997,-859.9199999999992
120,2022-01-02 09:00:00,863.01,6291.809999999998,6288.719999999997,3.090000000001055
121,2022-01-02 09:05:00,5.98,6297.789999999997,6288.719999999997,9.070000000000618
122,2022-01-02 09:10:00,-579.46,5718.329999999997,6288.719999999997,-570.3899999999994
123,2022-01-02 09:15:00,-807.36,4910.9699999999975,6288.719999999997,-1377.749999999999
124,2022-01-02 09:20:00,-1902.39,3008.579999999997,6288.719999999997,-3280.1399999999994
125,2022-01-02 09:25:00,-704.09,2304.489999999997,6288.719999999997,-3984.2299999999996
126,2022-01-02 09:30:00,668.36,2972.849999999997,6288.719999999997,-3315.8699999999994
127,2022-01-02 09:35:00,711.0,3683.849999999997,6288.719999999997,-2604.8699999999994
128,2022-01-02 09:40:00,-1550.45,2133.399999999997,6288.719999999997,-4155.32
129,2022-01-02 09:45:00,1923.35,4056.749999999997,6288.719999999997,-2231.97
130,2022-01-02 09:50:00,1397.77,5454.519999999997,6288.719999999997,-834.1999999999998
131,2022-01-02 09:55:00,-1752.7,3701.819999999997,6288.719999999997,-2586.8999999999996
132,2022-01-02 10:00:00,-169.26,3532.5599999999968,6288.719999999997,-2756.16
133,2022-01-02 10:05:00,-1172.71,2359.8499999999967,6288.719999999997,-3928.87
134,2022-01-02 10:10:00,-1420.57,939.2799999999968,6288.719999999997,-5349.44
135,2022-01-02 10:15:00,1750.21,2689.489999999997,6288.719999999997,-3599.2299999999996
136,2022-01-02 10:20:00,-1322.13,1367.359999999997,6288.719999999997,-4921.36
137,2022-01-02 10:25:00,1899.21,3266.569999999997,6288.719999999997,-3022.1499999999996
138,2022-01-02 10:30:00,-1604.5,1662.069999999997,6288.719999999997,-4626.65
139,2022-01-02 10:35:00,-43.89,1618.1799999999969,6288.719999999997,-4670.54
140,2022-01-02 10:40:00,-1560.66,57.5199999999968,6288.719999999997,-6231.2
141,2022-01-02 10:45:00,1125.35,1182.8699999999967,6288.719999999997,-5105.85
142,2022-01-02 10:50:00,-592.25,590.6199999999967,6288.719999999997,-5698.1
143,2022-01-02 10:55:00,813.85,1404.4699999999966,6288.719999999997,-4884.25
144,2022-01-02 11:00:00,-894.64,509.82999999999663,6288.719999999997,-5778.89
145,2022-01-02 11:05:00,287.44,797.2699999999966,6288.719999999997,-5491.45
146,2022-01-02 11:10:00,-248.97,548.2999999999965,6288.719999999997,-5740.42
147,2022-01-02 11:15:00,1358.97,1907.2699999999966,6288.719999999997,-4381.45
148,2022-01-02 11:20:00,1868.91,3776.1799999999967,6288.719999999997,-2512.54
149,2022-01-02 11:25:00,-1264.4,2511.7799999999966,6288.719999999997,-3776.94
150,2022-01-02 11:30:00,1514.24,4026.019999999997,6288.719999999997,-2262.7
151,2022-01-02 11:35:00,-40.0,3986.019999999997,6288.719999999997,-2302.7
152,2022-01-02 11:40:00,-104.63,3881.3899999999967,6288.719999999997,-2407.33
153,2022-01-02 11:45:00,1117.11,4998.499999999996,6288.719999999997,-1290.2200000000003
154,2022-01-02 11:50:00,1415.78,6414.279999999996,6288.719999999997,125.55999999999949
155,2022-01-02 11:55:00,-1902.77,4511.509999999997,6288.719999999997,-1777.21
156,2022-01-02 12:00:00,-629.52,3881.9899999999966,6288.719999999997,-2406.73
157,2022-01-02 12:05:00,1941.1,5823.0899999999965,6288.719999999997,-465.6300000000001
158,2022-01-02 12:10:00,-1261.14,4561.949999999996,6288.719999999997,-1726.7700000000004
159,2022-01-02 12:15:00,-1150.1,3411.8499999999963,6288.719999999997,-2876.8700000000003
160,2022-01-02 12:20:00,-47.8,3364.049999999996,6288.719999999997,-2924.6700000000005
161,2022-01-02 12:25:00,-674.51,2689.5399999999963,6288.719999999997,-3599.1800000000003
162,2022-01-02 12:30:00,1934.68,4624.219999999997,6288.719999999997,-1664.5
163,2022-01-02 12:35:00,-1037.38,3586.8399999999965,6288.719999999997,-2701.88
164,2022-01-02 12:40:00,483.56,4070.3999999999965,6288.719999999997,-2218.32
165,2022-01-02 12:45:00,1947.88,6018.279999999997,6288.719999999997,-270.4399999999996
166,2022-01-02 12:50:00,1878.44,7896.7199999999975,6288.719999999997,1608.000000000001
167,2022-01-02 12:55:00,757.55,8654.269999999997,6288.719999999997,2365.55
168,2022-01-02 13:00:00,-1379.76,7274.509999999997,6288.719999999997,985.79
169,2022-01-02 13:05:00,708.39,7982.899999999997,6288.719999999997,1694.1800000000003
170,2022-01-02 13:10:00,523.58,8506.479999999998,6288.719999999997,2217.760000000001
171,2022-01-02 13:15:00,-1767.09,6739.389999999998,6288.719999999997,450.670000000001
172,2022-01-02 13:20:00,-1348.9,5390.489999999998,6288.719999999997,-898.2299999999987
173,2022-01-02 13:25:00,-16.32,5374.169999999998,6288.719999999997,-914.5499999999984
174,2022-01-02 13:30:00,-1969.7,3404.4699999999984,6288.719999999997,-2884.249999999998
175,2022-01-02 13:35:00,890.91,4295.379999999998,6288.719999999997,-1993.3399999999983
176,2022-01-02 13:40:00,1823.97,6119.3499999999985,6288.719999999997,-169.36999999999807
177,2022-01-02 13:45:00,-635.57,5483.779999999999,6288.719999999997,-804.9399999999978
178,2022-01-02 13:50:00,536.67,6020.449999999999,6288.719999999997,-268.2699999999977
179,2022-01-02 13:55:00,-724.85,5295.5999999999985,6288.719999999997,-993.1199999999981
180,2022-01-02 14:00:00,428.37,5723.969999999998,6288.719999999997,-564.7499999999982
181,2022-01-02 14:05:00,1219.12,6943.089999999998,6288.719999999997,654.3700000000017
182,2022-01-02 14:10:00,1413.96,8357.05,6288.719999999997,2068.3300000000027
183,2022-01-02 14:15:00,-338.51,8018.539999999999,6288.719999999997,1729.8200000000024
184,2022-01-02 14:20:00,-186.13,7832.409999999999,6288.719999999997,1543.6900000000023
185,2022-01-02 14:25:00,1713.5,9545.91,6288.719999999997,3257.1900000000032
186,2022-01-02 14:30:00,-670.64,8875.27,6288.719999999997,2586.550000000004
187,2022-01-02 14:35:00,1514.44,10389.710000000001,6288.719999999997,4100.990000000004
188,2022-01-02 14:40:00,1168.43,11558.140000000001,6288.719999999997,5269.420000000005
189,2022-01-02 14:45:00,-1878.26,9679.880000000001,6288.719999999997,3391.1600000000044
190,2022-01-02 14:50:00,-111.21,9568.670000000002,6288.719999999997,3279.9500000000053
191,2022-01-02 14:55:00,-351.45,9217.220000000001,6288.719999999997,2928.5000000000045
192,2022-01-02 15:00:00,347.59,9564.810000000001,6288.719999999997,3276.0900000000047
193,2022-01-02 15:05:00,-1671.68,7893.130000000001,6288.719999999997,1604.4100000000044
194,2022-01-02 15:10:00,-718.69,7174.4400000000005,6288.719999999997,885.7200000000039
195,2022-01-02 15:15:00,236.86,7411.3,6288.719999999997,1122.5800000000036
196,2022-01-02 15:20:00,1156.15,8567.45,6288.719999999997,2278.730000000004
197,2022-01-02 15:25:00,1823.67,10391.12,6288.719999999997,4102.400000000004
198,2022-01-02 15:30:00,-38.46,10352.660000000002,6288.719999999997,4063.940000000005
199,2022-01-02 15:35:00,93.37,10446.030000000002,6288.719999999997,4157.310000000006
200,2022-01-02 15:40:00,1353.42,11799.450000000003,6288.719999999997,5510.730000000006
201,2022-01-02 15:45:00,-1463.93,10335.520000000002,6288.719999999997,4046.8000000000056
202,2022-01-02 15:50:00,-770.1,9565.420000000002,6288.719999999997,3276.7000000000053
203,2022-01-02 15:55:00,-1632.76,7932.660000000002,6288.719999999997,1643.940000000005
204,2022-01-02 16:00:00,-758.28,7174.380000000002,6288.719999999997,885.6600000000053
205,2022-01-02 16:05:00,-898.54,6275.840000000002,6288.719999999997,-12.879999999994652
206,2022-01-02 16:10:00,-1939.65,4336.190000000002,6288.719999999997,-1952.5299999999943
207,2022-01-02 16:15:00,413.4,4749.590000000002,6288.719999999997,-1539.1299999999947
208,2022-01-02 16:20:00,1771.95,6521.540000000002,6288.719999999997,232.82000000000517
209,2022-01-02 16:25:00,572.19,7093.730000000001,6288.719999999997,805.0100000000048
210,2022-01-02 16:30:00,551.14,7644.870000000002,6288.719999999997,1356.150000000005
211,2022-01-02 16:35:00,-366.95,7277.920000000002,6288.719999999997,989.2000000000053
212,2022-01-02 16:40:00,61.56,7339.480000000002,6288.719999999997,1050.7600000000057
213,2022-01-02 16:45:00,599.05,7938.5300000000025,6288.719999999997,1649.8100000000059
214,2022-01-02 16:50:00,165.62,8104.150000000002,6288.719999999997,1815.4300000000057
215,2022-01-02 16:55:00,1694.35,9798.500000000002,6288.719999999997,3509.780000000005
216,2022-01-03 08:00:00,-1662.61,8135.890000000002,9798.500000000002,-1662.6099999999997
217,2022-01-03 08:05:00,-841.42,7294.470000000002,9798.500000000002,-2504.0299999999997
218,2022-01-03 08:10:00,1132.66,8427.130000000003,9798.500000000002,-1371.369999999999
219,2022-01-03 08:15:00,783.29,9210.420000000002,9798.500000000002,-588.0799999999999
220,2022-01-03 08:20:00,538.86,9749.280000000002,9798.500000000002,-49.219999999999345
221,2022-01-03 08:25:00,807.17,10556.450000000003,9798.500000000002,757.9500000000007
222,2022-01-03 08:30:00,-1127.26,9429.190000000002,9798.500000000002,-369.3099999999995
223,2022-01-03 08:35:00,1410.27,10839.460000000003,9798.500000000002,1040.960000000001
224,2022-01-03 08:40:00,-1562.78,9276.680000000002,9798.500000000002,-521.8199999999997
225,2022-01-03 08:45:00,-1536.72,7739.960000000002,9798.500000000002,-2058.54
226,2022-01-03 08:50:00,-1144.64,6595.3200000000015,9798.500000000002,-3203.1800000000003
227,2022-01-03 08:55:00,-1691.24,4904.080000000002,9798.500000000002,-4894.42
228,2022-01-03 09:00:00,601.06,5505.140000000001,9798.500000000002,-4293.360000000001
229,2022-01-03 09:05:00,-1405.31,4099.830000000002,9798.500000000002,-5698.67
230,2022-01-03 09:10:00,1939.03,6038.8600000000015,9798.500000000002,-3759.6400000000003
231,2022-01-03 09:15:00,947.99,6986.850000000001,9798.500000000002,-2811.6500000000005
232,2022-01-03 09:20:00,-389.66,6597.190000000001,9798.500000000002,-3201.3100000000004
233,2022-01-03 09:25:00,-1584.02,5013.170000000002,9798.500000000002,-4785.33
234,2022-01-03 09:30:00,1780.27,6793.440000000002,9798.500000000002,-3005.0599999999995
235,2022-01-03 09:35:00,-179.48,6613.960000000003,9798.500000000002,-3184.539999999999
236,2022-01-03 09:40:00,735.41,7349.370000000003,9798.500000000002,-2449.129999999999
237,2022-01-03 09:45:00,1496.4,8845.770000000002,9798.500000000002,-952.7299999999996
238,2022-01-03 09:50:00,-1555.31,7290.460000000003,9798.500000000002,-2508.039999999999
239,2022-01-03 09:55:00,1898.11,9188.570000000003,9798.500000000002,-609.9299999999985
240,2022-01-03 10:00:00,1377.77,10566.340000000004,9798.500000000002,767.840000000002
241,2022-01-03 10:05:00,-34.71,10531.630000000005,9798.500000000002,733.1300000000028
242,2022-01-03 10:10:00,-109.09,10422.540000000005,9798.500000000002,624.0400000000027
243,2022-01-03 10:15:00,472.44,10894.980000000005,9798.500000000002,1096.4800000000032
244,2022-01-03 10:20:00,-1058.18,9836.800000000005,9798.500000000002,38.30000000000291
245,2022-01-03 10:25:00,1671.06,11507.860000000004,9798.500000000002,1709.3600000000024
246,2022-01-03 10:30:00,1372.21,12880.070000000003,9798.500000000002,3081.5700000000015
247,2022-01-03 10:35:00,1353.85,14233.920000000004,9798.500000000002,4435.420000000002
248,2022-01-03 10:40:00,189.37,14423.290000000005,9798.500000000002,4624.790000000003
249,2022-01-03 10:45:00,-1441.31,12981.980000000005,9798.500000000002,3183.480000000003
250,2022-01-03 10:50:00,-170.45,12811.530000000004,9798.500000000002,3013.0300000000025
251,2022-01-03 10:55:00,-1806.26,11005.270000000004,9798.500000000002,1206.7700000000023
252,2022-01-03 11:00:00,1251.71,12256.980000000003,9798.500000000002,2458.4800000000014
253,2022-01-03 11:05:00,1059.64,13316.620000000003,9798.500000000002,3518.120000000001
254,2022-01-03 11:10:00,-540.15,12776.470000000003,9798.500000000002,2977.970000000001
255,2022-01-03 11:15:00,1343.25,14119.720000000003,9798.500000000002,4321.220000000001
256,2022-01-03 11:20:00,-1427.32,12692.400000000003,9798.500000000002,2893.9000000000015
257,2022-01-03 11:25:00,-1194.31,11498.090000000004,9798.500000000002,1699.590000000002
258,2022-01-03 11:30:00,642.41,12140.500000000004,9798.500000000002,2342.000000000002
259,2022-01-03 11:35:00,-1806.64,10333.860000000004,9798.500000000002,535.3600000000024
260,2022-01-03 11:40:00,12.56,10346.420000000004,9798.500000000002,547.9200000000019
261,2022-01-03 11:45:00,-105.58,10240.840000000004,9798.500000000002,442.34000000000196
262,2022-01-03 11:50:00,812.07,11052.910000000003,9798.500000000002,1254.4100000000017
263,2022-01-03 11:55:00,-1363.67,9689.240000000003,9798.500000000002,-109.2599999999984
264,2022-01-03 12:00:00,-1287.29,8401.950000000004,9798.500000000002,-1396.5499999999975
265,2022-01-03 12:05:00,-1399.71,7002.240000000004,9798.500000000002,-2796.2599999999975
266,2022-01-03 12:10:00,-1520.04,5482.200000000004,9798.500000000002,-4316.299999999997
267,2022-01-03 12:15:00,-571.6,4910.600000000004,9798.500000000002,-4887.899999999998
268,2022-01-03 12:20:00,-1914.54,2996.060000000004,9798.500000000002,-6802.439999999998
269,2022-01-03 12:25:00,1473.33,4469.390000000004,9798.500000000002,-5329.109999999998
270,2022-01-03 12:30:00,-959.16,3510.230000000004,9798.500000000002,-6288.269999999998
271,2022-01-03 12:35:00,-822.19,2688.040000000004,9798.500000000002,-7110.459999999997
272,2022-01-03 12:40:00,-313.6,2374.440000000004,9798.500000000002,-7424.059999999998
273,2022-01-03 12:45:00,1747.31,4121.750000000004,9798.500000000002,-5676.749999999998
274,2022-01-03 12:50:00,1433.43,5555.180000000004,9798.500000000002,-4243.319999999998
275,2022-01-03 12:55:00,-1108.26,4446.920000000004,9798.500000000002,-5351.579999999998
276,2022-01-03 13:00:00,1631.03,6077.9500000000035,9798.500000000002,-3720.5499999999984
277,2022-01-03 13:05:00,-83.0,5994.9500000000035,9798.500000000002,-3803.5499999999984
278,2022-01-03 13:10:00,408.29,6403.240000000003,9798.500000000002,-3395.2599999999984
279,2022-01-03 13:15:00,750.8,7154.040000000004,9798.500000000002,-2644.459999999998
280,2022-01-03 13:20:00,-1362.41,5791.630000000004,9798.500000000002,-4006.869999999998
281,2022-01-03 13:25:00,1025.49,6817.1200000000035,9798.500000000002,-2981.3799999999983
282,2022-01-03 13:30:00,-218.43,6598.690000000003,9798.500000000002,-3199.8099999999986
283,2022-01-03 13:35:00,1589.84,8188.530000000003,9798.500000000002,-1609.9699999999984
284,2022-01-03 13:40:00,-1849.46,6339.070000000003,9798.500000000002,-3459.4299999999985
285,2022-01-03 13:45:00,-1418.06,4921.010000000004,9798.500000000002,-4877.489999999998
286,2022-01-03 13:50:00,-722.2,4198.810000000004,9798.500000000002,-5599.689999999998
287,2022-01-03 13:55:00,1148.52,5347.330000000004,9798.500000000002,-4451.169999999998
288,2022-01-03 14:00:00,1495.29,6842.6200000000035,9798.500000000002,-2955.8799999999983
289,2022-01-03 14:05:00,1161.32,8003.940000000003,9798.500000000002,-1794.5599999999986
290,2022-01-03 14:10:00,1638.47,9642.410000000003,9798.500000000002,-156.08999999999833
291,2022-01-03 14:15:00,897.9,10540.310000000003,9798.500000000002,741.8100000000013
292,2022-01-03 14:20:00,-1802.83,8737.480000000003,9798.500000000002,-1061.0199999999986
293,2022-01-03 14:25:00,1519.82,10257.300000000003,9798.500000000002,458.8000000000011
294,2022-01-03 14:30:00,-677.19,9580.110000000002,9798.500000000002,-218.38999999999942
295,2022-01-03 14:35:00,1125.68,10705.790000000003,9798.500000000002,907.2900000000009
296,2022-01-03 14:40:00,-1688.44,9017.350000000002,9798.500000000002,-781.1499999999996
297,2022-01-03 14:45:00,297.31,9314.660000000002,9798.500000000002,-483.84000000000015
298,2022-01-03 14:50:00,1298.54,10613.2,9798.500000000002,814.6999999999989
299,2022-01-03 14:55:00,-1787.27,8825.93,9798.500000000002,-972.5700000000015
300,2022-01-03 15:00:00,-1996.78,6829.150000000001,9798.500000000002,-2969.3500000000013
301,2022-01-03 15:05:00,-160.38,6668.77,9798.500000000002,-3129.7300000000014
302,2022-01-03 15:10:00,46.51,6715.280000000001,9798.500000000002,-3083.220000000001
303,2022-01-03 15:15:00,841.0,7556.280000000001,9798.500000000002,-2242.220000000001
304,2022-01-03 15:20:00,-206.91,7349.370000000001,9798.500000000002,-2449.130000000001
305,2022-01-03 15:25:00,-470.98,6878.390000000001,9798.500000000002,-2920.1100000000006
306,2022-01-03 15:30:00,314.09,7192.480000000001,9798.500000000002,-2606.0200000000004
307,2022-01-03 15:35:00,-1193.83,5998.6500000000015,9798.500000000002,-3799.8500000000004
308,2022-01-03 15:40:00,122.92,6121.5700000000015,9798.500000000002,-3676.9300000000003
309,2022-01-03 15:45:00,263.75,6385.3200000000015,9798.500000000002,-3413.1800000000003
310,2022-01-03 15:50:00,-1093.43,5291.890000000001,9798.500000000002,-4506.610000000001
311,2022-01-03 15:55:00,-1426.83,3865.0600000000013,9798.500000000002,-5933.4400000000005
312,2022-01-03 16:00:00,-892.68,2972.3800000000015,9798.500000000002,-6826.120000000001
313,2022-01-03 16:05:00,933.69,3906.0700000000015,9798.500000000002,-5892.43
314,2022-01-03 16:10:00,1299.25,5205.3200000000015,9798.500000000002,-4593.18
315,2022-01-03 16:15:00,-951.48,4253.840000000002,9798.500000000002,-5544.66
316,2022-01-03 16:20:00,733.17,4987.010000000002,9798.500000000002,-4811.49
317,2022-01-03 16:25:00,-1711.67,3275.340000000002,9798.500000000002,-6523.16
318,2022-01-03 16:30:00,-819.05,2456.290000000002,9798.500000000002,-7342.21
319,2022-01-03 16:35:00,195.41,2651.7000000000016,9798.500000000002,-7146.8
320,2022-01-03 16:40:00,1810.92,4462.620000000002,9798.500000000002,-5335.88
321,2022-01-03 16:45:00,-884.53,3578.090000000002,9798.500000000002,-6220.41
322,2022-01-03 16:50:00,59.73,3637.820000000002,9798.500000000002,-6160.68
323,2022-01-03 16:55:00,-887.28,2750.540000000002,9798.500000000002,-7047.96
324,2022-01-04 08:00:00,-1669.12,1081.420000000002,2750.540000000002,-1669.12
325,2022-01-04 08:05:00,1083.02,2164.440000000002,2750.540000000002,-586.0999999999999
326,2022-01-04 08:10:00,-1076.31,1088.130000000002,2750.540000000002,-1662.4099999999999
327,2022-01-04 08:15:00,483.17,1571.300000000002,2750.540000000002,-1179.2399999999998
328,2022-01-04 08:20:00,1782.83,3354.130000000002,2750.540000000002,603.5900000000001
329,2022-01-04 08:25:00,1554.52,4908.6500000000015,2750.540000000002,2158.1099999999997
330,2022-01-04 08:30:00,1006.03,5914.680000000001,2750.540000000002,3164.1399999999994
331,2022-01-04 08:35:00,747.26,6661.940000000001,2750.540000000002,3911.3999999999996
332,2022-01-04 08:40:00,620.13,7282.0700000000015,2750.540000000002,4531.53
333,2022-01-04 08:45:00,1508.04,8790.11,2750.540000000002,6039.569999999999
334,2022-01-04 08:50:00,227.23,9017.34,2750.540000000002,6266.799999999998
335,2022-01-04 08:55:00,449.63,9466.97,2750.540000000002,6716.429999999998
336,2022-01-04 09:00:00,1342.27,10809.24,2750.540000000002,8058.699999999998
337,2022-01-04 09:05:00,1979.47,12788.71,2750.540000000002,10038.169999999998
338,2022-01-04 09:10:00,1748.37,14537.079999999998,2750.540000000002,11786.539999999997
339,2022-01-04 09:15:00,-908.34,13628.739999999998,2750.540000000002,10878.199999999997
340,2022-01-04 09:20:00,792.61,14421.349999999999,2750.540000000002,11670.809999999998
341,2022-01-04 09:25:00,1083.66,15505.009999999998,2750.540000000002,12754.469999999998
342,2022-01-04 09:30:00,-1390.8,14114.21,2750.540000000002,11363.669999999998
343,2022-01-04 09:35:00,515.09,14629.3,2750.540000000002,11878.759999999998
344,2022-01-04 09:40:00,-1253.81,13375.49,2750.540000000002,10624.949999999997
345,2022-01-04 09:45:00,-1477.65,11897.84,2750.540000000002,9147.3
346,2022-01-04 09:50:00,1072.38,12970.220000000001,2750.540000000002,10219.68
347,2022-01-04 09:55:00,1580.09,14550.310000000001,2750.540000000002,11799.77
348,2022-01-04 10:00:00,-1195.37,13354.940000000002,2750.540000000002,10604.400000000001
349,2022-01-04 10:05:00,1787.0,15141.940000000002,2750.540000000002,12391.400000000001
350,2022-01-04 10:10:00,1042.53,16184.470000000003,2750.540000000002,13433.93
351,2022-01-04 10:15:00,-543.11,15641.360000000002,2750.540000000002,12890.82
352,2022-01-04 10:20:00,1935.41,17576.770000000004,2750.540000000002,14826.230000000003
353,2022-01-04 10:25:00,1474.34,19051.110000000004,2750.540000000002,16300.570000000003
354,2022-01-04 10:30:00,-1754.67,17296.440000000002,2750.540000000002,14545.900000000001
355,2022-01-04 10:35:00,1543.38,18839.820000000003,2750.540000000002,16089.280000000002
356,2022-01-04 10:40:00,1251.98,20091.800000000003,2750.540000000002,17341.260000000002
357,2022-01-04 10:45:00,334.11,20425.910000000003,2750.540000000002,17675.370000000003
358,2022-01-04 10:50:00,-1691.84,18734.070000000003,2750.540000000002,15983.530000000002
359,2022-01-04 10:55:00,1294.43,20028.500000000004,2750.540000000002,17277.960000000003
360,2022-01-04 11:00:00,1137.82,21166.320000000003,2750.540000000002,18415.780000000002
361,2022-01-04 11:05:00,-293.79,20872.530000000002,2750.540000000002,18121.99
362,2022-01-04 11:10:00,1885.34,22757.870000000003,2750.540000000002,20007.33
363,2022-01-04 11:15:00,-1839.53,20918.340000000004,2750.540000000002,18167.800000000003
364,2022-01-04 11:20:00,943.8,21862.140000000003,2750.540000000002,19111.600000000002
365,2022-01-04 11:25:00,-741.9,21120.24,2750.540000000002,18369.7
366,2022-01-04 11:30:00,-863.45,20256.79,2750.540000000002,17506.25
367,2022-01-04 11:35:00,1645.5,21902.29,2750.540000000002,19151.75
368,2022-01-04 11:40:00,1890.23,23792.52,2750.540000000002,21041.98
369,2022-01-04 11:45:00,-292.1,23500.420000000002,2750.540000000002,20749.88
370,2022-01-04 11:50:00,1448.58,24949.0,2750.540000000002,22198.46
371,2022-01-04 11:55:00,1484.76,26433.76,2750.540000000002,23683.219999999998
372,2022-01-04 12:00:00,712.43,27146.19,2750.540000000002,24395.649999999998
373,2022-01-04 12:05:00,1190.49,28336.68,2750.540000000002,25586.14
374,2022-01-04 12:10:00,1330.07,29666.75,2750.540000000002,26916.21
375,2022-01-04 12:15:00,-643.94,29022.81,2750.540000000002,26272.27
376,2022-01-04 12:20:00,1286.79,30309.600000000002,2750.540000000002,27559.06
377,2022-01-04 12:25:00,1285.62,31595.22,2750.540000000002,28844.68
378,2022-01-04 12:30:00,-1521.47,30073.75,2750.540000000002,27323.21
379,2022-01-04 12:35:00,1343.13,31416.88,2750.540000000002,28666.34
380,2022-01-04 12:40:00,992.33,32409.210000000003,2750.540000000002,29658.670000000002
381,2022-01-04 12:45:00,-756.83,31652.38,2750.540000000002,28901.84
382,2022-01-04 12:50:00,1162.17,32814.55,2750.540000000002,30064.010000000002
383,2022-01-04 12:55:00,310.77,33125.32,2750.540000000002,30374.78
384,2022-01-04 13:00:00,1748.42,34873.74,2750.540000000002,32123.199999999997
385,2022-01-04 13:05:00,-1377.86,33495.88,2750.540000000002,30745.339999999997
386,2022-01-04 13:10:00,1247.61,34743.49,2750.540000000002,31992.949999999997
387,2022-01-04 13:15:00,-124.81,34618.68,2750.540000000002,31868.14
388,2022-01-04 13:20:00,131.17,34749.85,2750.540000000002,31999.309999999998
389,2022-01-04 13:25:00,-1879.31,32870.54,2750.540000000002,30120.0
390,2022-01-04 13:30:00,908.17,33778.71,2750.540000000002,31028.17
391,2022-01-04 13:35:00,488.23,34266.94,2750.540000000002,31516.4
392,2022-01-04 13:40:00,1132.48,35399.420000000006,2750.540000000002,32648.880000000005
393,2022-01-04 13:45:00,1480.75,36880.170000000006,2750.540000000002,34129.630000000005
394,2022-01-04 13:50:00,-801.47,36078.700000000004,2750.540000000002,33328.16
395,2022-01-04 13:55:00,1656.29,37734.990000000005,2750.540000000002,34984.450000000004
396,2022-01-04 14:00:00,-1932.12,35802.87,2750.540000000002,33052.33
397,2022-01-04 14:05:00,123.39,35926.26,2750.540000000002,33175.72
398,2022-01-04 14:10:00,1570.48,37496.740000000005,2750.540000000002,34746.200000000004
399,2022-01-04 14:15:00,1961.38,39458.12,2750.540000000002,36707.58
400,2022-01-04 14:20:00,480.33,39938.450000000004,2750.540000000002,37187.91
401,2022-01-04 14:25:00,1578.01,41516.46000000001,2750.540000000002,38765.920000000006
402,2022-01-04 14:30:00,-1854.84,39661.62000000001,2750.540000000002,36911.08000000001
403,2022-01-04 14:35:00,-401.76,39259.86000000001,2750.540000000002,36509.32000000001
404,2022-01-04 14:40:00,-500.16,38759.700000000004,2750.540000000002,36009.16
405,2022-01-04 14:45:00,-928.44,37831.26,2750.540000000002,35080.72
406,2022-01-04 14:50:00,1859.06,39690.32,2750.540000000002,36939.78
407,2022-01-04 14:55:00,-781.54,38908.78,2750.540000000002,36158.24
408,2022-01-04 15:00:00,1957.29,40866.07,2750.540000000002,38115.53
409,2022-01-04 15:05:00,1550.24,42416.31,2750.540000000002,39665.77
410,2022-01-04 15:10:00,-1607.63,40808.68,2750.540000000002,38058.14
411,2022-01-04 15:15:00,-669.14,40139.54,2750.540000000002,37389.0
412,2022-01-04 15:20:00,-913.09,39226.450000000004,2750.540000000002,36475.91
413,2022-01-04 15:25:00,-1958.38,37268.07000000001,2750.540000000002,34517.530000000006
414,2022-01-04 15:30:00,-1281.65,35986.420000000006,2750.540000000002,33235.880000000005
415,2022-01-04 15:35:00,-1171.4,34815.020000000004,2750.540000000002,32064.480000000003
416,2022-01-04 15:40:00,1914.9,36729.920000000006,2750.540000000002,33979.380000000005
417,2022-01-04 15:45:00,-183.29,36546.630000000005,2750.540000000002,33796.090000000004
418,2022-01-04 15:50:00,-1726.71,34819.920000000006,2750.540000000002,32069.380000000005
419,2022-01-04 15:55:00,671.88,35491.8,2750.540000000002,32741.260000000002
420,2022-01-04 16:00:00,-455.38,35036.420000000006,2750.540000000002,32285.880000000005
421,2022-01-04 16:05:00,-343.88,34692.54000000001,2750.540000000002,31942.000000000007
422,2022-01-04 16:10:00,1057.43,35749.97000000001,2750.540000000002,32999.43000000001
423,2022-01-04 16:15:00,-1533.33,34216.64000000001,2750.540000000002,31466.100000000006
424,2022-01-04 16:20:00,660.25,34876.89000000001,2750.540000000002,32126.350000000006
425,2022-01-04 16:25:00,1034.2,35911.090000000004,2750.540000000002,33160.55
426,2022-01-04 16:30:00,-1866.54,34044.55,2750.540000000002,31294.010000000002
427,2022-01-04 16:35:00,-79.24,33965.310000000005,2750.540000000002,31214.770000000004
428,2022-01-04 16:40:00,863.88,34829.19,2750.540000000002,32078.65
429,2022-01-04 16:45:00,997.62,35826.810000000005,2750.540000000002,33076.270000000004
430,2022-01-04 16:50:00,1555.8,37382.61000000001,2750.540000000002,34632.07000000001
431,2022-01-04 16:55:00,-1265.91,36116.700000000004,2750.540000000002,33366.16
432,2022-01-05 08:00:00,-651.27,35465.43000000001,36116.700000000004,-651.2699999999968
433,2022-01-05 08:05:00,106.88,35572.310000000005,36116.700000000004,-544.3899999999994
434,2022-01-05 08:10:00,-803.12,34769.19,36116.700000000004,-1347.510000000002
435,2022-01-05 08:15:00,-1152.81,33616.380000000005,36116.700000000004,-2500.3199999999997
436,2022-01-05 08:20:00,1651.79,35268.170000000006,36116.700000000004,-848.5299999999988
437,2022-01-05 08:25:00,-1852.49,33415.68000000001,36116.700000000004,-2701.019999999997
438,2022-01-05 08:30:00,1031.64,34447.32000000001,36116.700000000004,-1669.3799999999974
439,2022-01-05 08:35:00,331.22,34778.54000000001,36116.700000000004,-1338.1599999999962
440,2022-01-05 08:40:00,1758.31,36536.850000000006,36116.700000000004,420.15000000000146
441,2022-01-05 08:45:00,-214.16,36322.69,36116.700000000004,205.98999999999796
442,2022-01-05 08:50:00,-446.24,35876.450000000004,36116.700000000004,-240.25
443,2022-01-05 08:55:00,-1780.23,34096.22,36116.700000000004,-2020.4800000000032
444,2022-01-05 09:00:00,950.78,35047.0,36116.700000000004,-1069.7000000000044
445,2022-01-05 09:05:00,-1507.84,33539.16,36116.700000000004,-2577.540000000001
446,2022-01-05 09:10:00,197.42,33736.58,36116.700000000004,-2380.1200000000026
447,2022-01-05 09:15:00,-1172.88,32563.7,36116.700000000004,-3553.0000000000036
448,2022-01-05 09:20:00,-1589.74,30973.96,36116.700000000004,-5142.740000000005
449,2022-01-05 09:25:00,-1005.22,29968.739999999998,36116.700000000004,-6147.960000000006
450,2022-01-05 09:30:00,101.48,30070.219999999998,36116.700000000004,-6046.480000000007
451,2022-01-05 09:35:00,-613.58,29456.639999999996,36116.700000000004,-6660.060000000009
452,2022-01-05 09:40:00,1255.13,30711.769999999997,36116.700000000004,-5404.930000000008
453,2022-01-05 09:45:00,-520.73,30191.039999999997,36116.700000000004,-5925.660000000007
454,2022-01-05 09:50:00,861.08,31052.12,36116.700000000004,-5064.580000000005
455,2022-01-05 09:55:00,218.25,31270.37,36116.700000000004,-4846.330000000005
456,2022-01-05 10:00:00,-1829.59,29440.78,36116.700000000004,-6675.9200000000055
457,2022-01-05 10:05:00,823.92,30264.699999999997,36116.700000000004,-5852.000000000007
458,2022-01-05 10:10:00,-160.57,30104.129999999997,36116.700000000004,-6012.570000000007
459,2022-01-05 10:15:00,-1164.41,28939.719999999998,36116.700000000004,-7176.980000000007
460,2022-01-05 10:20:00,-1810.06,27129.659999999996,36116.700000000004,-8987.040000000008
461,2022-01-05 10:25:00,-577.52,26552.139999999996,36116.700000000004,-9564.560000000009
462,2022-01-05 10:30:00,1062.08,27614.219999999994,36116.700000000004,-8502.48000000001
463,2022-01-05 10:35:00,-1247.16,26367.059999999994,36116.700000000004,-9749.64000000001
464,2022-01-05 10:40:00,795.25,27162.309999999994,36116.700000000004,-8954.39000000001
465,2022-01-05 10:45:00,378.76,27541.069999999992,36116.700000000004,-8575.630000000012
466,2022-01-05 10:50:00,-1627.4,25913.66999999999,36116.700000000004,-10203.030000000013
467,2022-01-05 10:55:00,1129.53,27043.19999999999,36116.700000000004,-9073.500000000015
468,2022-01-05 11:00:00,-1665.75,25377.44999999999,36116.700000000004,-10739.250000000015
469,2022-01-05 11:05:00,1072.47,26449.91999999999,36116.700000000004,-9666.780000000013
470,2022-01-05 11:10:00,-24.36,26425.55999999999,36116.700000000004,-9691.140000000014
471,2022-01-05 11:15:00,-1240.69,25184.86999999999,36116.700000000004,-10931.830000000013
472,2022-01-05 11:20:00,-829.8,24355.069999999992,36116.700000000004,-11761.630000000012
473,2022-01-05 11:25:00,1164.59,25519.659999999993,36116.700000000004,-10597.040000000012
474,2022-01-05 11:30:00,366.29,25885.949999999993,36116.700000000004,-10230.750000000011
475,2022-01-05 11:35:00,1626.9,27512.849999999995,36116.700000000004,-8603.85000000001
476,2022-01-05 11:40:00,1080.18,28593.029999999995,36116.700000000004,-7523.670000000009
477,2022-01-05 11:45:00,-1265.57,27327.459999999995,36116.700000000004,-8789.240000000009
478,2022-01-05 11:50:00,233.02,27560.479999999996,36116.700000000004,-8556.220000000008
479,2022-01-05 11:55:00,1957.19,29517.669999999995,36116.700000000004,-6599.03000000001
480,2022-01-05 12:00:00,1203.13,30720.799999999996,36116.700000000004,-5395.900000000009
481,2022-01-05 12:05:00,271.11,30991.909999999996,36116.700000000004,-5124.790000000008
482,2022-01-05 12:10:00,1599.44,32591.349999999995,36116.700000000004,-3525.3500000000095
483,2022-01-05 12:15:00,-749.78,31841.569999999996,36116.700000000004,-4275.130000000008
484,2022-01-05 12:20:00,-119.56,31722.009999999995,36116.700000000004,-4394.69000000001
485,2022-01-05 12:25:00,217.91,31939.919999999995,36116.700000000004,-4176.78000000001
486,2022-01-05 12:30:00,-1307.6,30632.319999999996,36116.700000000004,-5484.380000000008
487,2022-01-05 12:35:00,-692.25,29940.069999999996,36116.700000000004,-6176.630000000008
488,2022-01-05 12:40:00,-841.22,29098.849999999995,36116.700000000004,-7017.8500000000095
489,2022-01-05 12:45:00,-1958.33,27140.519999999997,36116.700000000004,-8976.180000000008
490,2022-01-05 12:50:00,228.44,27368.959999999995,36116.700000000004,-8747.740000000009
491,2022-01-05 12:55:00,726.59,28095.549999999996,36116.700000000004,-8021.150000000009
492,2022-01-05 13:00:00,1352.36,29447.909999999996,36116.700000000004,-6668.790000000008
493,2022-01-05 13:05:00,-1826.3,27621.609999999997,36116.700000000004,-8495.090000000007
494,2022-01-05 13:10:00,-1766.17,25855.439999999995,36116.700000000004,-10261.26000000001
495,2022-01-05 13:15:00,1818.79,27674.229999999996,36116.700000000004,-8442.470000000008
496,2022-01-05 13:20:00,-865.63,26808.599999999995,36116.700000000004,-9308.10000000001
497,2022-01-05 13:25:00,-908.82,25899.779999999995,36116.700000000004,-10216.92000000001
498,2022-01-05 13:30:00,169.03,26068.809999999994,36116.700000000004,-10047.89000000001
499,2022-01-05 13:35:00,-1100.27,24968.539999999994,36116.700000000004,-11148.16000000001
500,2022-01-05 13:40:00,-1131.35,23837.189999999995,36116.700000000004,-12279.51000000001
501,2022-01-05 13:45:00,-54.1,23783.089999999997,36116.700000000004,-12333.610000000008
502,2022-01-05 13:50:00,1567.06,25350.149999999998,36116.700000000004,-10766.550000000007
503,2022-01-05 13:55:00,864.88,26215.03,36116.700000000004,-9901.670000000006
504,2022-01-05 14:00:00,1906.77,28121.8,36116.700000000004,-7994.900000000005
505,2022-01-05 14:05:00,1925.05,30046.85,36116.700000000004,-6069.850000000006
506,2022-01-05 14:10:00,1474.82,31521.67,36116.700000000004,-4595.030000000006
507,2022-01-05 14:15:00,1808.15,33329.82,36116.700000000004,-2786.8800000000047
508,2022-01-05 14:20:00,-1071.42,32258.4,36116.700000000004,-3858.300000000003
509,2022-01-05 14:25:00,-1960.76,30297.640000000003,36116.700000000004,-5819.060000000001
510,2022-01-05 14:30:00,49.05,30346.690000000002,36116.700000000004,-5770.010000000002
511,2022-01-05 14:35:00,-560.17,29786.520000000004,36116.700000000004,-6330.18
512,2022-01-05 14:40:00,474.94,30261.460000000003,36116.700000000004,-5855.240000000002
513,2022-01-05 14:45:00,962.3,31223.760000000002,36116.700000000004,-4892.940000000002
514,2022-01-05 14:50:00,-662.83,30560.93,36116.700000000004,-5555.770000000004
515,2022-01-05 14:55:00,706.81,31267.74,36116.700000000004,-4848.960000000003
516,2022-01-05 15:00:00,-189.91,31077.83,36116.700000000004,-5038.870000000003
517,2022-01-05 15:05:00,1376.03,32453.86,36116.700000000004,-3662.840000000004
518,2022-01-05 15:10:00,-1864.15,30589.71,36116.700000000004,-5526.990000000005
519,2022-01-05 15:15:00,675.49,31265.2,36116.700000000004,-4851.500000000004
520,2022-01-05 15:20:00,100.7,31365.9,36116.700000000004,-4750.800000000003
521,2022-01-05 15:25:00,1117.51,32483.41,36116.700000000004,-3633.2900000000045
522,2022-01-05 15:30:00,-850.31,31633.1,36116.700000000004,-4483.600000000006
523,2022-01-05 15:35:00,1675.28,33308.38,36116.700000000004,-2808.320000000007
524,2022-01-05 15:40:00,804.34,34112.719999999994,36116.700000000004,-2003.9800000000105
525,2022-01-05 15:45:00,-1102.1,33010.619999999995,36116.700000000004,-3106.080000000009
526,2022-01-05 15:50:00,1107.2,34117.81999999999,36116.700000000004,-1998.880000000012
527,2022-01-05 15:55:00,345.67,34463.48999999999,36116.700000000004,-1653.2100000000137
528,2022-01-05 16:00:00,1724.15,36187.63999999999,36116.700000000004,70.93999999998778
529,2022-01-05 16:05:00,-1934.15,34253.48999999999,36116.700000000004,-1863.2100000000137
530,2022-01-05 16:10:00,-1562.89,32690.59999999999,36116.700000000004,-3426.100000000013
531,2022-01-05 16:15:00,-790.64,31899.959999999992,36116.700000000004,-4216.7400000000125
532,2022-01-05 16:20:00,1218.16,33118.119999999995,36116.700000000004,-2998.580000000009
533,2022-01-05 16:25:00,-331.89,32786.229999999996,36116.700000000004,-3330.4700000000084
534,2022-01-05 16:30:00,-258.44,32527.789999999997,36116.700000000004,-3588.910000000007
535,2022-01-05 16:35:00,4.84,32532.629999999997,36116.700000000004,-3584.070000000007
536,2022-01-05 16:40:00,501.02,33033.649999999994,36116.700000000004,-3083.05000000001
537,2022-01-05 16:45:00,-1170.34,31863.309999999994,36116.700000000004,-4253.39000000001
538,2022-01-05 16:50:00,-1305.53,30557.779999999995,36116.700000000004,-5558.920000000009
539,2022-01-05 16:55:00,1985.51,32543.289999999994,36116.700000000004,-3573.4100000000108
540,2022-01-06 08:00:00,430.44,32973.729999999996,32543.289999999994,430.4400000000023
541,2022-01-06 08:05:00,-1928.6,31045.129999999997,32543.289999999994,-1498.1599999999962
542,2022-01-06 08:10:00,922.88,31968.01,32543.289999999994,-575.2799999999952
543,2022-01-06 08:15:00,1707.01,33675.02,32543.289999999994,1131.7300000000032
544,2022-01-06 08:20:00,-443.19,33231.829999999994,32543.289999999994,688.5400000000009
545,2022-01-06 08:25:00,1360.41,34592.24,32543.289999999994,2048.9500000000044
546,2022-01-06 08:30:00,-1000.95,33591.29,32543.289999999994,1048.0000000000073
547,2022-01-06 08:35:00,-1614.02,31977.27,32543.289999999994,-566.0199999999932
548,2022-01-06 08:40:00,-530.32,31446.95,32543.289999999994,-1096.3399999999929
549,2022-01-06 08:45:00,-1566.23,29880.72,32543.289999999994,-2662.5699999999924
550,2022-01-06 08:50:00,-34.64,29846.08,32543.289999999994,-2697.209999999992
551,2022-01-06 08:55:00,1520.02,31366.100000000002,32543.289999999994,-1177.1899999999914
552,2022-01-06 09:00:00,675.99,32042.090000000004,32543.289999999994,-501.1999999999898
553,2022-01-06 09:05:00,984.9,33026.990000000005,32543.289999999994,483.70000000001164
554,2022-01-06 09:10:00,-19.07,33007.920000000006,32543.289999999994,464.63000000001193
555,2022-01-06 09:15:00,-1155.89,31852.030000000006,32543.289999999994,-691.2599999999875
556,2022-01-06 09:20:00,-1902.86,29949.170000000006,32543.289999999994,-2594.119999999988
557,2022-01-06 09:25:00,-694.57,29254.600000000006,32543.289999999994,-3288.689999999988
558,2022-01-06 09:30:00,1272.87,30527.470000000005,32543.289999999994,-2015.8199999999888
559,2022-01-06 09:35:00,-1033.53,29493.940000000006,32543.289999999994,-3049.3499999999876
560,2022-01-06 09:40:00,107.14,29601.080000000005,32543.289999999994,-2942.209999999988
561,2022-01-06 09:45:00,664.19,30265.270000000004,32543.289999999994,-2278.0199999999895
562,2022-01-06 09:50:00,1886.49,32151.760000000006,32543.289999999994,-391.5299999999879
563,2022-01-06 09:55:00,1186.87,33338.630000000005,32543.289999999994,795.3400000000111
564,2022-01-06 10:00:00,310.41,33649.04000000001,32543.289999999994,1105.7500000000146
565,2022-01-06 10:05:00,427.25,34076.29000000001,32543.289999999994,1533.0000000000146
566,2022-01-06 10:10:00,-1261.14,32815.15000000001,32543.289999999994,271.86000000001513
567,2022-01-06 10:15:00,587.84,33402.990000000005,32543.289999999994,859.7000000000116
568,2022-01-06 10:20:00,-346.77,33056.22000000001,32543.289999999994,512.9300000000148
569,2022-01-06 10:25:00,1995.81,35052.030000000006,32543.289999999994,2508.7400000000125
570,2022-01-06 10:30:00,1699.07,36751.100000000006,32543.289999999994,4207.810000000012
571,2022-01-06 10:35:00,913.09,37664.19,32543.289999999994,5120.900000000009
572,2022-01-06 10:40:00,-451.93,37212.26,32543.289999999994,4668.970000000008
573,2022-01-06 10:45:00,-1777.32,35434.94,32543.289999999994,2891.6500000000087
574,2022-01-06 10:50:00,1679.52,37114.46,32543.289999999994,4571.1700000000055
575,2022-01-06 10:55:00,634.97,37749.43,32543.289999999994,5206.140000000007
576,2022-01-06 11:00:00,-1934.52,35814.91,32543.289999999994,3271.62000000001
577,2022-01-06 11:05:00,-1241.26,34573.65,32543.289999999994,2030.3600000000079
578,2022-01-06 11:10:00,1854.24,36427.89,32543.289999999994,3884.600000000006
579,2022-01-06 11:15:00,-589.75,35838.14,32543.289999999994,3294.850000000006
580,2022-01-06 11:20:00,1792.15,37630.29,32543.289999999994,5087.000000000007
581,2022-01-06 11:25:00,131.08,37761.37,32543.289999999994,5218.080000000009
582,2022-01-06 11:30:00,1538.47,39299.840000000004,32543.289999999994,6756.55000000001
583,2022-01-06 11:35:00,4.19,39304.030000000006,32543.289999999994,6760.7400000000125
584,2022-01-06 11:40:00,-1436.02,37868.01000000001,32543.289999999994,5324.720000000016
585,2022-01-06 11:45:00,1875.05,39743.06000000001,32543.289999999994,7199.770000000019
586,2022-01-06 11:50:00,-1406.9,38336.16000000001,32543.289999999994,5792.870000000017
587,2022-01-06 11:55:00,-895.01,37441.15000000001,32543.289999999994,4897.860000000015
588,2022-01-06 12:00:00,-1941.24,35499.91000000001,32543.289999999994,2956.620000000017
589,2022-01-06 12:05:00,1256.78,36756.69000000001,32543.289999999994,4213.400000000016
590,2022-01-06 12:10:00,-1065.4,35691.29000000001,32543.289999999994,3148.0000000000146
591,2022-01-06 12:15:00,-97.15,35594.14000000001,32543.289999999994,3050.850000000013
592,2022-01-06 12:20:00,138.38,35732.520000000004,32543.289999999994,3189.2300000000105
593,2022-01-06 12:25:00,-1254.31,34478.21000000001,32543.289999999994,1934.9200000000128
594,2022-01-06 12:30:00,-1516.22,32961.990000000005,32543.289999999994,418.70000000001164
595,2022-01-06 12:35:00,-825.7,32136.290000000005,32543.289999999994,-406.9999999999891
596,2022-01-06 12:40:00,1601.52,33737.810000000005,32543.289999999994,1194.5200000000114
597,2022-01-06 12:45:00,1063.37,34801.18000000001,32543.289999999994,2257.890000000014
598,2022-01-06 12:50:00,32.55,34833.73000000001,32543.289999999994,2290.440000000017
599,2022-01-06 12:55:00,381.33,35215.06000000001,32543.289999999994,2671.7700000000186
600,2022-01-06 13:00:00,-744.64,34470.42000000001,32543.289999999994,1927.1300000000192
601,2022-01-06 13:05:00,-1717.12,32753.300000000014,32543.289999999994,210.01000000002023
602,2022-01-06 13:10:00,936.09,33689.390000000014,32543.289999999994,1146.1000000000204
603,2022-01-06 13:15:00,51.43,33740.820000000014,32543.289999999994,1197.5300000000207
604,2022-01-06 13:20:00,-8.34,33732.48000000002,32543.289999999994,1189.1900000000242
605,2022-01-06 13:25:00,-290.39,33442.09000000002,32543.289999999994,898.8000000000247
606,2022-01-06 13:30:00,1768.75,35210.84000000002,32543.289999999994,2667.5500000000247
607,2022-01-06 13:35:00,-357.52,34853.32000000002,32543.289999999994,2310.030000000028
608,2022-01-06 13:40:00,1153.73,36007.050000000025,32543.289999999994,3463.760000000031
609,2022-01-06 13:45:00,1959.93,37966.980000000025,32543.289999999994,5423.690000000031
610,2022-01-06 13:50:00,-1651.43,36315.550000000025,32543.289999999994,3772.260000000031
611,2022-01-06 13:55:00,841.22,37156.770000000026,32543.289999999994,4613.480000000032
612,2022-01-06 14:00:00,-659.7,36497.07000000003,32543.289999999994,3953.780000000035
613,2022-01-06 14:05:00,-326.96,36170.11000000003,32543.289999999994,3626.820000000036
614,2022-01-06 14:10:00,-935.91,35234.200000000026,32543.289999999994,2690.9100000000326
615,2022-01-06 14:15:00,700.69,35934.89000000003,32543.289999999994,3391.600000000035
616,2022-01-06 14:20:00,1579.29,37514.18000000003,32543.289999999994,4970.890000000036
617,2022-01-06 14:25:00,-707.0,36807.18000000003,32543.289999999994,4263.890000000036
618,2022-01-06 14:30:00,1823.86,38631.04000000003,32543.289999999994,6087.750000000036
619,2022-01-06 14:35:00,941.95,39572.99000000003,32543.289999999994,7029.7000000000335
620,2022-01-06 14:40:00,-144.02,39428.97000000003,32543.289999999994,6885.680000000037
621,2022-01-06 14:45:00,-1102.13,38326.84000000003,32543.289999999994,5783.550000000039
622,2022-01-06 14:50:00,-1947.85,36378.990000000034,32543.289999999994,3835.7000000000407
623,2022-01-06 14:55:00,-869.14,35509.850000000035,32543.289999999994,2966.5600000000413
624,2022-01-06 15:00:00,-940.5,34569.350000000035,32543.289999999994,2026.0600000000413
625,2022-01-06 15:05:00,229.1,34798.45000000003,32543.289999999994,2255.16000000004
626,2022-01-06 15:10:00,-212.86,34585.59000000003,32543.289999999994,2042.3000000000393
627,2022-01-06 15:15:00,1390.26,35975.850000000035,32543.289999999994,3432.5600000000413
628,2022-01-06 15:20:00,398.86,36374.710000000036,32543.289999999994,3831.420000000042
629,2022-01-06 15:25:00,1812.41,38187.12000000004,32543.289999999994,5643.830000000045
630,2022-01-06 15:30:00,701.07,38888.19000000004,32543.289999999994,6344.900000000045
631,2022-01-06 15:35:00,120.39,39008.58000000004,32543.289999999994,6465.2900000000445
632,2022-01-06 15:40:00,-318.25,38690.33000000004,32543.289999999994,6147.0400000000445
633,2022-01-06 15:45:00,-207.47,38482.86000000004,32543.289999999994,5939.570000000043
634,2022-01-06 15:50:00,-1561.6,36921.26000000004,32543.289999999994,4377.970000000045
635,2022-01-06 15:55:00,941.93,37863.19000000004,32543.289999999994,5319.900000000045
636,2022-01-06 16:00:00,904.88,38768.070000000036,32543.289999999994,6224.7800000000425
637,2022-01-06 16:05:00,-1517.6,37250.47000000004,32543.289999999994,4707.180000000044
638,2022-01-06 16:10:00,-909.1,36341.37000000004,32543.289999999994,3798.0800000000454
639,2022-01-06 16:15:00,709.88,37051.25000000004,32543.289999999994,4507.960000000043
640,2022-01-06 16:20:00,963.69,38014.94000000004,32543.289999999994,5471.650000000045
641,2022-01-06 16:25:00,-149.56,37865.38000000004,32543.289999999994,5322.090000000047
642,2022-01-06 16:30:00,-475.75,37389.63000000004,32543.289999999994,4846.340000000047
643,2022-01-06 16:35:00,1253.68,38643.31000000004,32543.289999999994,6100.020000000048
644,2022-01-06 16:40:00,-996.59,37646.720000000045,32543.289999999994,5103.430000000051
645,2022-01-06 16:45:00,-1991.73,35654.99000000004,32543.289999999994,3111.700000000048
646,2022-01-06 16:50:00,1279.38,36934.37000000004,32543.289999999994,4391.080000000045
647,2022-01-06 16:55:00,98.48,37032.85000000004,32543.289999999994,4489.560000000049
648,2022-01-07 08:00:00,-238.97,36793.88000000004,37032.85000000004,-238.97000000000116
649,2022-01-07 08:05:00,856.63,37650.51000000004,37032.85000000004,617.6599999999962
650,2022-01-07 08:10:00,470.8,38121.31000000004,37032.85000000004,1088.4599999999991
651,2022-01-07 08:15:00,-1107.4,37013.91000000004,37032.85000000004,-18.94000000000233
652,2022-01-07 08:20:00,-1448.82,35565.09000000004,37032.85000000004,-1467.760000000002
653,2022-01-07 08:25:00,-1466.08,34099.01000000004,37032.85000000004,-2933.840000000004
654,2022-01-07 08:30:00,-160.9,33938.11000000004,37032.85000000004,-3094.7400000000052
655,2022-01-07 08:35:00,123.71,34061.820000000036,37032.85000000004,-2971.030000000006
656,2022-01-07 08:40:00,1153.55,35215.37000000004,37032.85000000004,-1817.4800000000032
657,2022-01-07 08:45:00,1104.62,36319.99000000004,37032.85000000004,-712.8600000000006
658,2022-01-07 08:50:00,1141.81,37461.80000000004,37032.85000000004,428.9499999999971
659,2022-01-07 08:55:00,-1690.07,35771.73000000004,37032.85000000004,-1261.1200000000026
660,2022-01-07 09:00:00,127.22,35898.95000000004,37032.85000000004,-1133.9000000000015
661,2022-01-07 09:05:00,1527.17,37426.12000000004,37032.85000000004,393.2699999999968
662,2022-01-07 09:10:00,-1277.25,36148.87000000004,37032.85000000004,-883.9800000000032
663,2022-01-07 09:15:00,-57.3,36091.570000000036,37032.85000000004,-941.2800000000061
664,2022-01-07 09:20:00,-1018.09,35073.48000000004,37032.85000000004,-1959.3700000000026
665,2022-01-07 09:25:00,-764.27,34309.21000000004,37032.85000000004,-2723.6399999999994
666,2022-01-07 09:30:00,1974.84,36284.05000000004,37032.85000000004,-748.8000000000029
667,2022-01-07 09:35:00,-1826.3,34457.75000000004,37032.85000000004,-2575.100000000006
668,2022-01-07 09:40:00,1505.66,35963.41000000004,37032.85000000004,-1069.4400000000023
669,2022-01-07 09:45:00,1966.46,37929.87000000004,37032.85000000004,897.0199999999968
670,2022-01-07 09:50:00,-1112.07,36817.80000000004,37032.85000000004,-215.0500000000029
671,2022-01-07 09:55:00,-588.61,36229.19000000004,37032.85000000004,-803.6600000000035
672,2022-01-07 10:00:00,-1278.75,34950.44000000004,37032.85000000004,-2082.4100000000035
673,2022-01-07 10:05:00,-882.04,34068.40000000004,37032.85000000004,-2964.4500000000044
674,2022-01-07 10:10:00,1776.67,35845.070000000036,37032.85000000004,-1187.780000000006
675,2022-01-07 10:15:00,1058.31,36903.380000000034,37032.85000000004,-129.47000000000844
676,2022-01-07 10:20:00,-1059.25,35844.130000000034,37032.85000000004,-1188.7200000000084
677,2022-01-07 10:25:00,416.3,36260.43000000004,37032.85000000004,-772.4200000000055
678,2022-01-07 10:30:00,-896.02,35364.41000000004,37032.85000000004,-1668.4400000000023
679,2022-01-07 10:35:00,-1557.51,33806.90000000004,37032.85000000004,-3225.9500000000044
680,2022-01-07 10:40:00,-1023.48,32783.420000000035,37032.85000000004,-4249.430000000008
681,2022-01-07 10:45:00,1747.04,34530.460000000036,37032.85000000004,-2502.3900000000067
682,2022-01-07 10:50:00,-1641.16,32889.30000000003,37032.85000000004,-4143.55000000001
683,2022-01-07 10:55:00,-1859.91,31029.390000000032,37032.85000000004,-6003.46000000001
684,2022-01-07 11:00:00,286.57,31315.960000000032,37032.85000000004,-5716.89000000001
685,2022-01-07 11:05:00,1430.11,32746.070000000032,37032.85000000004,-4286.78000000001
686,2022-01-07 11:10:00,-913.44,31832.630000000034,37032.85000000004,-5200.220000000008
687,2022-01-07 11:15:00,-727.28,31105.350000000035,37032.85000000004,-5927.500000000007
688,2022-01-07 11:20:00,1324.28,32429.630000000034,37032.85000000004,-4603.220000000008
689,2022-01-07 11:25:00,-966.94,31462.690000000035,37032.85000000004,-5570.160000000007
690,2022-01-07 11:30:00,-1542.62,29920.070000000036,37032.85000000004,-7112.780000000006
691,2022-01-07 11:35:00,968.78,30888.850000000035,37032.85000000004,-6144.000000000007
692,2022-01-07 11:40:00,-1309.7,29579.150000000034,37032.85000000004,-7453.700000000008
693,2022-01-07 11:45:00,1599.9,31179.050000000036,37032.85000000004,-5853.800000000007
694,2022-01-07 11:50:00,1079.32,32258.370000000035,37032.85000000004,-4774.480000000007
695,2022-01-07 11:55:00,-1949.3,30309.070000000036,37032.85000000004,-6723.780000000006
696,2022-01-07 12:00:00,-567.62,29741.450000000037,37032.85000000004,-7291.400000000005
697,2022-01-07 12:05:00,1938.42,31679.87000000004,37032.85000000004,-5352.980000000003
698,2022-01-07 12:10:00,1051.66,32731.53000000004,37032.85000000004,-4301.320000000003
699,2022-01-07 12:15:00,-948.09,31783.44000000004,37032.85000000004,-5249.4100000000035
700,2022-01-07 12:20:00,58.49,31841.93000000004,37032.85000000004,-5190.920000000002
701,2022-01-07 12:25:00,-1067.44,30774.49000000004,37032.85000000004,-6258.360000000001
702,2022-01-07 12:30:00,1727.53,32502.02000000004,37032.85000000004,-4530.830000000002
703,2022-01-07 12:35:00,1258.76,33760.78000000004,37032.85000000004,-3272.0699999999997
704,2022-01-07 12:40:00,1883.61,35644.39000000004,37032.85000000004,-1388.4599999999991
705,2022-01-07 12:45:00,581.3,36225.690000000046,37032.85000000004,-807.1599999999962
706,2022-01-07 12:50:00,-809.31,35416.38000000005,37032.85000000004,-1616.469999999994
707,2022-01-07 12:55:00,1976.44,37392.82000000005,37032.85000000004,359.97000000000844
708,2022-01-07 13:00:00,1422.61,38815.43000000005,37032.85000000004,1782.580000000009
709,2022-01-07 13:05:00,-1834.89,36980.54000000005,37032.85000000004,-52.309999999990396
710,2022-01-07 13:10:00,1653.09,38633.63000000005,37032.85000000004,1600.780000000006
711,2022-01-07 13:15:00,565.7,39199.330000000045,37032.85000000004,2166.480000000003
712,2022-01-07 13:20:00,-961.44,38237.89000000004,37032.85000000004,1205.0400000000009
713,2022-01-07 13:25:00,1532.12,39770.010000000046,37032.85000000004,2737.1600000000035
714,2022-01-07 13:30:00,-1149.49,38620.52000000005,37032.85000000004,1587.6700000000055
715,2022-01-07 13:35:00,-1670.98,36949.540000000045,37032.85000000004,-83.30999999999767
716,2022-01-07 13:40:00,-1098.01,35851.53000000004,37032.85000000004,-1181.3199999999997
717,2022-01-07 13:45:00,-1388.9,34462.63000000004,37032.85000000004,-2570.220000000001
718,2022-01-07 13:50:00,1315.17,35777.80000000004,37032.85000000004,-1255.050000000003
719,2022-01-07 13:55:00,-1342.95,34434.85000000004,37032.85000000004,-2598.0
720,2022-01-07 14:00:00,-937.75,33497.10000000004,37032.85000000004,-3535.75
721,2022-01-07 14:05:00,727.56,34224.66000000004,37032.85000000004,-2808.1900000000023
722,2022-01-07 14:10:00,244.87,34469.53000000004,37032.85000000004,-2563.3199999999997
723,2022-01-07 14:15:00,170.47,34640.000000000044,37032.85000000004,-2392.8499999999985
724,2022-01-07 14:20:00,1278.91,35918.91000000005,37032.85000000004,-1113.939999999995
725,2022-01-07 14:25:00,-1370.19,34548.720000000045,37032.85000000004,-2484.1299999999974
726,2022-01-07 14:30:00,561.2,35109.92000000004,37032.85000000004,-1922.9300000000003
727,2022-01-07 14:35:00,1996.96,37106.88000000004,37032.85000000004,74.02999999999884
728,2022-01-07 14:40:00,-404.95,36701.930000000044,37032.85000000004,-330.91999999999825
729,2022-01-07 14:45:00,1345.93,38047.860000000044,37032.85000000004,1015.010000000002
730,2022-01-07 14:50:00,469.91,38517.77000000005,37032.85000000004,1484.9200000000055
731,2022-01-07 14:55:00,1560.84,40078.610000000044,37032.85000000004,3045.760000000002
732,2022-01-07 15:00:00,-630.64,39447.970000000045,37032.85000000004,2415.1200000000026
733,2022-01-07 15:05:00,1316.97,40764.940000000046,37032.85000000004,3732.090000000004
734,2022-01-07 15:10:00,-502.86,40262.080000000045,37032.85000000004,3229.230000000003
735,2022-01-07 15:15:00,244.19,40506.27000000005,37032.85000000004,3473.4200000000055
736,2022-01-07 15:20:00,-636.31,39869.96000000005,37032.85000000004,2837.110000000008
737,2022-01-07 15:25:00,-1681.93,38188.03000000005,37032.85000000004,1155.1800000000076
738,2022-01-07 15:30:00,-1882.82,36305.21000000005,37032.85000000004,-727.6399999999921
739,2022-01-07 15:35:00,-1797.87,34507.34000000005,37032.85000000004,-2525.5099999999948
740,2022-01-07 15:40:00,73.39,34580.73000000005,37032.85000000004,-2452.1199999999953
741,2022-01-07 15:45:00,1563.34,36144.07000000004,37032.85000000004,-888.7799999999988
742,2022-01-07 15:50:00,1803.82,37947.89000000004,37032.85000000004,915.0400000000009
743,2022-01-07 15:55:00,-1550.0,36397.89000000004,37032.85000000004,-634.9599999999991
744,2022-01-07 16:00:00,-1260.13,35137.760000000046,37032.85000000004,-1895.0899999999965
745,2022-01-07 16:05:00,-890.73,34247.03000000004,37032.85000000004,-2785.8199999999997
746,2022-01-07 16:10:00,-241.22,34005.81000000004,37032.85000000004,-3027.040000000001
747,2022-01-07 16:15:00,-807.79,33198.02000000004,37032.85000000004,-3834.8300000000017
748,2022-01-07 16:20:00,805.19,34003.21000000004,37032.85000000004,-3029.6399999999994
749,2022-01-07 16:25:00,-782.33,33220.88000000004,37032.85000000004,-3811.970000000001
750,2022-01-07 16:30:00,1108.55,34329.430000000044,37032.85000000004,-2703.4199999999983
751,2022-01-07 16:35:00,498.83,34828.260000000046,37032.85000000004,-2204.5899999999965
752,2022-01-07 16:40:00,-1888.1,32940.16000000005,37032.85000000004,-4092.689999999995
753,2022-01-07 16:45:00,1161.76,34101.92000000005,37032.85000000004,-2930.929999999993
754,2022-01-07 16:50:00,85.31,34187.23000000005,37032.85000000004,-2845.6199999999953
755,2022-01-07 16:55:00,814.56,35001.790000000045,37032.85000000004,-2031.0599999999977
756,2022-01-08 08:00:00,-1507.85,33493.940000000046,35001.790000000045,-1507.8499999999985
757,2022-01-08 08:05:00,-410.82,33083.120000000046,35001.790000000045,-1918.6699999999983
758,2022-01-08 08:10:00,1329.21,34412.330000000045,35001.790000000045,-589.4599999999991
759,2022-01-08 08:15:00,1212.13,35624.46000000004,35001.790000000045,622.6699999999983
760,2022-01-08 08:20:00,-1147.52,34476.940000000046,35001.790000000045,-524.8499999999985
761,2022-01-08 08:25:00,279.66,34756.60000000005,35001.790000000045,-245.18999999999505
762,2022-01-08 08:30:00,-1995.92,32760.68000000005,35001.790000000045,-2241.1099999999933
763,2022-01-08 08:35:00,-47.39,32713.29000000005,35001.790000000045,-2288.4999999999927
764,2022-01-08 08:40:00,1340.23,34053.520000000055,35001.790000000045,-948.2699999999895
765,2022-01-08 08:45:00,-712.26,33341.26000000005,35001.790000000045,-1660.5299999999916
766,2022-01-08 08:50:00,-1704.44,31636.820000000054,35001.790000000045,-3364.9699999999903
767,2022-01-08 08:55:00,-910.46,30726.360000000055,35001.790000000045,-4275.429999999989
768,2022-01-08 09:00:00,303.83,31030.190000000057,35001.790000000045,-3971.5999999999876
769,2022-01-08 09:05:00,-1923.61,29106.580000000056,35001.790000000045,-5895.209999999988
770,2022-01-08 09:10:00,209.0,29315.580000000056,35001.790000000045,-5686.209999999988
771,2022-01-08 09:15:00,-1894.95,27420.630000000056,35001.790000000045,-7581.159999999989
772,2022-01-08 09:20:00,-641.08,26779.550000000054,35001.790000000045,-8222.23999999999
773,2022-01-08 09:25:00,-1540.39,25239.160000000054,35001.790000000045,-9762.62999999999
774,2022-01-08 09:30:00,-163.17,25075.990000000056,35001.790000000045,-9925.799999999988
775,2022-01-08 09:35:00,-831.93,24244.060000000056,35001.790000000045,-10757.729999999989
776,2022-01-08 09:40:00,-696.21,23547.850000000057,35001.790000000045,-11453.939999999988
777,2022-01-08 09:45:00,-1101.85,22446.00000000006,35001.790000000045,-12555.789999999986
778,2022-01-08 09:50:00,-1191.61,21254.390000000058,35001.790000000045,-13747.399999999987
779,2022-01-08 09:55:00,1660.7,22915.09000000006,35001.790000000045,-12086.699999999986
780,2022-01-08 10:00:00,-1292.68,21622.410000000058,35001.790000000045,-13379.379999999986
781,2022-01-08 10:05:00,-1583.27,20039.140000000058,35001.790000000045,-14962.649999999987
782,2022-01-08 10:10:00,819.63,20858.77000000006,35001.790000000045,-14143.019999999986
783,2022-01-08 10:15:00,1210.0,22068.77000000006,35001.790000000045,-12933.019999999986
784,2022-01-08 10:20:00,368.72,22437.49000000006,35001.790000000045,-12564.299999999985
785,2022-01-08 10:25:00,-721.4,21716.09000000006,35001.790000000045,-13285.699999999986
786,2022-01-08 10:30:00,-858.84,20857.25000000006,35001.790000000045,-14144.539999999986
787,2022-01-08 10:35:00,-1192.21,19665.04000000006,35001.790000000045,-15336.749999999985
788,2022-01-08 10:40:00,-1909.73,17755.31000000006,35001.790000000045,-17246.479999999985
789,2022-01-08 10:45:00,293.22,18048.53000000006,35001.790000000045,-16953.259999999984
790,2022-01-08 10:50:00,452.3,18500.83000000006,35001.790000000045,-16500.959999999985
791,2022-01-08 10:55:00,-385.73,18115.10000000006,35001.790000000045,-16886.689999999984
792,2022-01-08 11:00:00,1286.81,19401.91000000006,35001.790000000045,-15599.879999999983
793,2022-01-08 11:05:00,-320.73,19081.180000000062,35001.790000000045,-15920.609999999982
794,2022-01-08 11:10:00,-1981.61,17099.57000000006,35001.790000000045,-17902.219999999983
795,2022-01-08 11:15:00,-1583.13,15516.44000000006,35001.790000000045,-19485.349999999984
796,2022-01-08 11:20:00,-541.99,14974.45000000006,35001.790000000045,-20027.339999999982
797,2022-01-08 11:25:00,611.63,15586.08000000006,35001.790000000045,-19415.709999999985
798,2022-01-08 11:30:00,-1679.78,13906.30000000006,35001.790000000045,-21095.489999999983
799,2022-01-08 11:35:00,1800.21,15706.51000000006,35001.790000000045,-19295.279999999984
800,2022-01-08 11:40:00,1723.72,17430.23000000006,35001.790000000045,-17571.559999999983
801,2022-01-08 11:45:00,-1039.52,16390.71000000006,35001.790000000045,-18611.079999999984
802,2022-01-08 11:50:00,864.19,17254.90000000006,35001.790000000045,-17746.889999999985
803,2022-01-08 11:55:00,-1418.94,15835.96000000006,35001.790000000045,-19165.829999999987
804,2022-01-08 12:00:00,1830.75,17666.710000000057,35001.790000000045,-17335.079999999987
805,2022-01-08 12:05:00,-785.28,16881.43000000006,35001.790000000045,-18120.359999999986
806,2022-01-08 12:10:00,1624.73,18506.160000000058,35001.790000000045,-16495.629999999986
807,2022-01-08 12:15:00,-648.49,17857.670000000056,35001.790000000045,-17144.119999999988
808,2022-01-08 12:20:00,-1606.78,16250.890000000056,35001.790000000045,-18750.899999999987
809,2022-01-08 12:25:00,401.16,16652.050000000057,35001.790000000045,-18349.739999999987
810,2022-01-08 12:30:00,1073.61,17725.660000000058,35001.790000000045,-17276.129999999986
811,2022-01-08 12:35:00,9.32,17734.980000000058,35001.790000000045,-17266.809999999987
812,2022-01-08 12:40:00,-448.84,17286.140000000058,35001.790000000045,-17715.649999999987
813,2022-01-08 12:45:00,-1468.92,15817.220000000058,35001.790000000045,-19184.569999999985
814,2022-01-08 12:50:00,-1735.24,14081.980000000058,35001.790000000045,-20919.809999999987
815,2022-01-08 12:55:00,366.57,14448.550000000057,35001.790000000045,-20553.239999999987
816,2022-01-08 13:00:00,1629.66,16078.210000000057,35001.790000000045,-18923.579999999987
817,2022-01-08 13:05:00,-324.21,15754.000000000058,35001.790000000045,-19247.789999999986
818,2022-01-08 13:10:00,-1505.35,14248.650000000058,35001.790000000045,-20753.139999999985
819,2022-01-08 13:15:00,-1095.67,13152.980000000058,35001.790000000045,-21848.809999999987
820,2022-01-08 13:20:00,-1242.26,11910.720000000058,35001.790000000045,-23091.069999999985
821,2022-01-08 13:25:00,-1382.17,10528.550000000057,35001.790000000045,-24473.239999999987
822,2022-01-08 13:30:00,-1186.77,9341.780000000057,35001.790000000045,-25660.009999999987
823,2022-01-08 13:35:00,484.91,9826.690000000057,35001.790000000045,-25175.099999999988
824,2022-01-08 13:40:00,449.86,10276.550000000057,35001.790000000045,-24725.239999999987
825,2022-01-08 13:45:00,-592.74,9683.810000000058,35001.790000000045,-25317.97999999999
826,2022-01-08 13:50:00,-1622.6,8061.210000000057,35001.790000000045,-26940.579999999987
827,2022-01-08 13:55:00,-1603.21,6458.000000000057,35001.790000000045,-28543.789999999986
828,2022-01-08 14:00:00,883.71,7341.710000000057,35001.790000000045,-27660.079999999987
829,2022-01-08 14:05:00,1738.03,9079.740000000058,35001.790000000045,-25922.04999999999
830,2022-01-08 14:10:00,-379.03,8700.710000000057,35001.790000000045,-26301.079999999987
831,2022-01-08 14:15:00,-1177.36,7523.350000000058,35001.790000000045,-27478.439999999988
832,2022-01-08 14:20:00,1301.72,8825.070000000058,35001.790000000045,-26176.719999999987
833,2022-01-08 14:25:00,408.77,9233.840000000058,35001.790000000045,-25767.949999999986
834,2022-01-08 14:30:00,199.12,9432.96000000006,35001.790000000045,-25568.829999999987
835,2022-01-08 14:35:00,1201.13,10634.090000000058,35001.790000000045,-24367.699999999986
836,2022-01-08 14:40:00,-630.44,10003.650000000058,35001.790000000045,-24998.139999999985
837,2022-01-08 14:45:00,534.41,10538.060000000058,35001.790000000045,-24463.72999999999
838,2022-01-08 14:50:00,1475.6,12013.660000000058,35001.790000000045,-22988.129999999986
839,2022-01-08 14:55:00,-1176.52,10837.140000000058,35001.790000000045,-24164.649999999987
840,2022-01-08 15:00:00,-1098.51,9738.630000000057,35001.790000000045,-25263.15999999999
841,2022-01-08 15:05:00,1079.26,10817.890000000058,35001.790000000045,-24183.899999999987
842,2022-01-08 15:10:00,539.4,11357.290000000057,35001.790000000045,-23644.499999999985
843,2022-01-08 15:15:00,-1757.89,9599.400000000058,35001.790000000045,-25402.389999999985
844,2022-01-08 15:20:00,-641.35,8958.050000000057,35001.790000000045,-26043.739999999987
845,2022-01-08 15:25:00,1111.48,10069.530000000057,35001.790000000045,-24932.259999999987
846,2022-01-08 15:30:00,557.18,10626.710000000057,35001.790000000045,-24375.079999999987
847,2022-01-08 15:35:00,-1629.99,8996.720000000058,35001.790000000045,-26005.069999999985
848,2022-01-08 15:40:00,402.39,9399.110000000057,35001.790000000045,-25602.679999999986
849,2022-01-08 15:45:00,992.15,10391.260000000057,35001.790000000045,-24610.529999999988
850,2022-01-08 15:50:00,534.48,10925.740000000056,35001.790000000045,-24076.04999999999
851,2022-01-08 15:55:00,325.68,11251.420000000056,35001.790000000045,-23750.369999999988
852,2022-01-08 16:00:00,-1976.48,9274.940000000057,35001.790000000045,-25726.849999999988
853,2022-01-08 16:05:00,1036.47,10311.410000000056,35001.790000000045,-24690.37999999999
854,2022-01-08 16:10:00,-544.54,9766.870000000057,35001.790000000045,-25234.919999999987
855,2022-01-08 16:15:00,-1791.66,7975.210000000057,35001.790000000045,-27026.579999999987
856,2022-01-08 16:20:00,189.26,8164.470000000058,35001.790000000045,-26837.319999999985
857,2022-01-08 16:25:00,1185.57,9350.040000000057,35001.790000000045,-25651.749999999985
858,2022-01-08 16:30:00,1487.74,10837.780000000057,35001.790000000045,-24164.009999999987
859,2022-01-08 16:35:00,-1976.84,8860.940000000057,35001.790000000045,-26140.849999999988
860,2022-01-08 16:40:00,1255.31,10116.250000000056,35001.790000000045,-24885.539999999986
861,2022-01-08 16:45:00,782.52,10898.770000000057,35001.790000000045,-24103.01999999999
862,2022-01-08 16:50:00,-286.56,10612.210000000057,35001.790000000045,-24389.579999999987
863,2022-01-08 16:55:00,523.88,11136.090000000057,35001.790000000045,-23865.69999999999
864,2022-01-09 08:00:00,-1105.23,10030.860000000057,11136.090000000057,-1105.2299999999996
865,2022-01-09 08:05:00,98.8,10129.660000000056,11136.090000000057,-1006.4300000000003
866,2022-01-09 08:10:00,-262.43,9867.230000000056,11136.090000000057,-1268.8600000000006
867,2022-01-09 08:15:00,1610.48,11477.710000000056,11136.090000000057,341.619999999999
868,2022-01-09 08:20:00,-629.39,10848.320000000056,11136.090000000057,-287.77000000000044
869,2022-01-09 08:25:00,-6.36,10841.960000000056,11136.090000000057,-294.130000000001
870,2022-01-09 08:30:00,-75.99,10765.970000000056,11136.090000000057,-370.1200000000008
871,2022-01-09 08:35:00,-312.45,10453.520000000055,11136.090000000057,-682.5700000000015
872,2022-01-09 08:40:00,-1701.47,8752.050000000056,11136.090000000057,-2384.040000000001
873,2022-01-09 08:45:00,-1294.62,7457.430000000056,11136.090000000057,-3678.6600000000008
874,2022-01-09 08:50:00,-1318.35,6139.080000000056,11136.090000000057,-4997.01
875,2022-01-09 08:55:00,-812.93,5326.150000000056,11136.090000000057,-5809.9400000000005
876,2022-01-09 09:00:00,1762.68,7088.830000000056,11136.090000000057,-4047.26
877,2022-01-09 09:05:00,466.11,7554.940000000056,11136.090000000057,-3581.1500000000005
878,2022-01-09 09:10:00,-1191.03,6363.910000000056,11136.090000000057,-4772.18
879,2022-01-09 09:15:00,-1846.31,4517.600000000057,11136.090000000057,-6618.49
880,2022-01-09 09:20:00,-160.95,4356.650000000057,11136.090000000057,-6779.44
881,2022-01-09 09:25:00,-1388.85,2967.800000000057,11136.090000000057,-8168.289999999999
882,2022-01-09 09:30:00,-622.15,2345.650000000057,11136.090000000057,-8790.439999999999
883,2022-01-09 09:35:00,256.55,2602.200000000057,11136.090000000057,-8533.89
884,2022-01-09 09:40:00,-121.34,2480.860000000057,11136.090000000057,-8655.23
885,2022-01-09 09:45:00,1717.36,4198.220000000057,11136.090000000057,-6937.87
886,2022-01-09 09:50:00,1845.78,6044.000000000056,11136.090000000057,-5092.09
887,2022-01-09 09:55:00,-527.2,5516.800000000057,11136.090000000057,-5619.29
888,2022-01-09 10:00:00,-988.64,4528.160000000056,11136.090000000057,-6607.93
889,2022-01-09 10:05:00,-1147.02,3381.1400000000563,11136.090000000057,-7754.950000000001
890,2022-01-09 10:10:00,830.61,4211.750000000056,11136.090000000057,-6924.34
891,2022-01-09 10:15:00,1136.87,5348.620000000056,11136.090000000057,-5787.47
892,2022-01-09 10:20:00,-564.51,4784.110000000056,11136.090000000057,-6351.9800000000005
893,2022-01-09 10:25:00,216.62,5000.730000000056,11136.090000000057,-6135.360000000001
894,2022-01-09 10:30:00,-596.6,4404.130000000056,11136.090000000057,-6731.960000000001
895,2022-01-09 10:35:00,1292.89,5697.020000000056,11136.090000000057,-5439.070000000001
896,2022-01-09 10:40:00,-223.38,5473.640000000056,11136.090000000057,-5662.450000000001
897,2022-01-09 10:45:00,-342.63,5131.010000000056,11136.090000000057,-6005.080000000001
898,2022-01-09 10:50:00,794.94,5925.950000000055,11136.090000000057,-5210.140000000001
899,2022-01-09 10:55:00,-1327.97,4597.980000000055,11136.090000000057,-6538.1100000000015
900,2022-01-09 11:00:00,-616.39,3981.590000000055,11136.090000000057,-7154.500000000002
901,2022-01-09 11:05:00,-1043.83,2937.7600000000552,11136.090000000057,-8198.330000000002
902,2022-01-09 11:10:00,919.22,3856.980000000055,11136.090000000057,-7279.1100000000015
903,2022-01-09 11:15:00,1294.16,5151.140000000055,11136.090000000057,-5984.950000000002
904,2022-01-09 11:20:00,1846.53,6997.670000000055,11136.090000000057,-4138.420000000002
905,2022-01-09 11:25:00,-598.02,6399.650000000054,11136.090000000057,-4736.440000000002
906,2022-01-09 11:30:00,-1895.07,4504.5800000000545,11136.090000000057,-6631.510000000002
907,2022-01-09 11:35:00,-1732.29,2772.2900000000545,11136.090000000057,-8363.800000000003
908,2022-01-09 11:40:00,-817.34,1954.9500000000544,11136.090000000057,-9181.140000000003
909,2022-01-09 11:45:00,-980.86,974.0900000000544,11136.090000000057,-10162.000000000002
910,2022-01-09 11:50:00,1192.93,2167.0200000000546,11136.090000000057,-8969.070000000002
911,2022-01-09 11:55:00,1107.6,3274.6200000000545,11136.090000000057,-7861.470000000002
912,2022-01-09 12:00:00,-422.81,2851.8100000000545,11136.090000000057,-8284.280000000002
913,2022-01-09 12:05:00,1878.2,4730.010000000055,11136.090000000057,-6406.080000000002
914,2022-01-09 12:10:00,456.46,5186.470000000055,11136.090000000057,-5949.620000000002
915,2022-01-09 12:15:00,289.59,5476.060000000055,11136.090000000057,-5660.030000000002
916,2022-01-09 12:20:00,372.74,5848.800000000055,11136.090000000057,-5287.290000000002
917,2022-01-09 12:25:00,-1725.39,4123.410000000054,11136.090000000057,-7012.680000000002
918,2022-01-09 12:30:00,1839.84,5963.250000000055,11136.090000000057,-5172.840000000002
919,2022-01-09 12:35:00,-578.45,5384.800000000055,11136.090000000057,-5751.290000000002
920,2022-01-09 12:40:00,520.17,5904.970000000055,11136.090000000057,-5231.120000000002
921,2022-01-09 12:45:00,-1838.59,4066.3800000000547,11136.090000000057,-7069.710000000002
922,2022-01-09 12:50:00,1786.23,5852.610000000055,11136.090000000057,-5283.480000000001
923,2022-01-09 12:55:00,-391.38,5461.230000000055,11136.090000000057,-5674.8600000000015
924,2022-01-09 13:00:00,-1601.12,3860.110000000055,11136.090000000057,-7275.980000000001
925,2022-01-09 13:05:00,-1893.95,1966.160000000055,11136.090000000057,-9169.930000000002
926,2022-01-09 13:10:00,-1282.73,683.4300000000551,11136.090000000057,-10452.660000000002
927,2022-01-09 13:15:00,-266.99,416.4400000000551,11136.090000000057,-10719.650000000001
928,2022-01-09 13:20:00,24.25,440.6900000000551,11136.090000000057,-10695.400000000001
929,2022-01-09 13:25:00,1439.0,1879.690000000055,11136.090000000057,-9256.400000000001
930,2022-01-09 13:30:00,-394.48,1485.210000000055,11136.090000000057,-9650.880000000001
931,2022-01-09 13:35:00,1906.4,3391.610000000055,11136.090000000057,-7744.480000000001
932,2022-01-09 13:40:00,1163.08,4554.690000000055,11136.090000000057,-6581.4000000000015
933,2022-01-09 13:45:00,976.13,5530.820000000055,11136.090000000057,-5605.270000000001
934,2022-01-09 13:50:00,-732.6,4798.220000000055,11136.090000000057,-6337.870000000002
935,2022-01-09 13:55:00,-1675.08,3123.140000000055,11136.090000000057,-8012.950000000002
936,2022-01-09 14:00:00,-800.35,2322.790000000055,11136.090000000057,-8813.300000000001
937,2022-01-09 14:05:00,1617.35,3940.140000000055,11136.090000000057,-7195.950000000002
938,2022-01-09 14:10:00,-632.82,3307.3200000000547,11136.090000000057,-7828.770000000002
939,2022-01-09 14:15:00,8.11,3315.430000000055,11136.090000000057,-7820.660000000002
940,2022-01-09 14:20:00,-1182.25,2133.180000000055,11136.090000000057,-9002.910000000002
941,2022-01-09 14:25:00,-1659.98,473.20000000005484,11136.090000000057,-10662.890000000001
942,2022-01-09 14:30:00,1587.12,2060.3200000000547,11136.090000000057,-9075.770000000002
943,2022-01-09 14:35:00,33.57,2093.890000000055,11136.090000000057,-9042.2
944,2022-01-09 14:40:00,1518.16,3612.0500000000548,11136.090000000057,-7524.040000000002
945,2022-01-09 14:45:00,1143.88,4755.930000000055,11136.090000000057,-6380.160000000002
946,2022-01-09 14:50:00,244.64,5000.570000000055,11136.090000000057,-6135.520000000001
947,2022-01-09 14:55:00,-629.56,4371.010000000055,11136.090000000057,-6765.080000000002
948,2022-01-09 15:00:00,238.36,4609.3700000000545,11136.090000000057,-6526.720000000002
949,2022-01-09 15:05:00,-565.71,4043.6600000000544,11136.090000000057,-7092.430000000002
950,2022-01-09 15:10:00,-274.18,3769.4800000000546,11136.090000000057,-7366.610000000002
951,2022-01-09 15:15:00,1855.76,5625.240000000054,11136.090000000057,-5510.850000000002
952,2022-01-09 15:20:00,-666.45,4958.7900000000545,11136.090000000057,-6177.300000000002
953,2022-01-09 15:25:00,-520.33,4438.460000000055,11136.090000000057,-6697.630000000002
954,2022-01-09 15:30:00,1726.62,6165.0800000000545,11136.090000000057,-4971.010000000002
955,2022-01-09 15:35:00,-1618.44,4546.640000000054,11136.090000000057,-6589.450000000003
956,2022-01-09 15:40:00,535.58,5082.220000000054,11136.090000000057,-6053.870000000003
957,2022-01-09 15:45:00,-1691.74,3390.480000000054,11136.090000000057,-7745.610000000002
958,2022-01-09 15:50:00,1194.93,4585.410000000054,11136.090000000057,-6550.680000000002
959,2022-01-09 15:55:00,-1521.16,3064.2500000000546,11136.090000000057,-8071.840000000002
960,2022-01-09 16:00:00,399.21,3463.4600000000546,11136.090000000057,-7672.630000000002
961,2022-01-09 16:05:00,266.83,3730.2900000000545,11136.090000000057,-7405.800000000002
962,2022-01-09 16:10:00,388.94,4119.230000000054,11136.090000000057,-7016.860000000002
963,2022-01-09 16:15:00,1455.39,5574.6200000000545,11136.090000000057,-5561.470000000002
964,2022-01-09 16:20:00,-1433.52,4141.100000000055,11136.090000000057,-6994.990000000002
965,2022-01-09 16:25:00,-937.76,3203.3400000000547,11136.090000000057,-7932.750000000002
966,2022-01-09 16:30:00,538.73,3742.0700000000547,11136.090000000057,-7394.020000000002
967,2022-01-09 16:35:00,866.88,4608.950000000054,11136.090000000057,-6527.140000000002
968,2022-01-09 16:40:00,1243.83,5852.780000000054,11136.090000000057,-5283.310000000002
969,2022-01-09 16:45:00,797.95,6650.730000000054,11136.090000000057,-4485.360000000002
970,2022-01-09 16:50:00,-453.56,6197.170000000054,11136.090000000057,-4938.920000000003
971,2022-01-09 16:55:00,545.88,6743.050000000054,11136.090000000057,-4393.040000000003
972,2022-01-10 08:00:00,1151.9,7894.9500000000535,6743.050000000054,1151.8999999999996
973,2022-01-10 08:05:00,-815.18,7079.770000000053,6743.050000000054,336.71999999999935
974,2022-01-10 08:10:00,458.17,7537.940000000053,6743.050000000054,794.8899999999994
975,2022-01-10 08:15:00,335.01,7872.9500000000535,6743.050000000054,1129.8999999999996
976,2022-01-10 08:20:00,453.12,8326.070000000054,6743.050000000054,1583.0200000000004
977,2022-01-10 08:25:00,1328.58,9654.650000000054,6743.050000000054,2911.6000000000004
978,2022-01-10 08:30:00,166.17,9820.820000000054,6743.050000000054,3077.7700000000004
979,2022-01-10 08:35:00,-303.06,9517.760000000055,6743.050000000054,2774.710000000001
980,2022-01-10 08:40:00,43.44,9561.200000000055,6743.050000000054,2818.1500000000015
981,2022-01-10 08:45:00,-533.61,9027.590000000055,6743.050000000054,2284.540000000001
982,2022-01-10 08:50:00,-313.37,8714.220000000054,6743.050000000054,1971.17
983,2022-01-10 08:55:00,-1213.91,7500.310000000054,6743.050000000054,757.2600000000002
984,2022-01-10 09:00:00,-1947.37,5552.940000000054,6743.050000000054,-1190.1099999999997
985,2022-01-10 09:05:00,1841.91,7394.850000000054,6743.050000000054,651.8000000000002
986,2022-01-10 09:10:00,311.33,7706.180000000054,6743.050000000054,963.1300000000001
987,2022-01-10 09:15:00,-775.44,6930.740000000054,6743.050000000054,187.6900000000005
988,2022-01-10 09:20:00,-1203.29,5727.450000000054,6743.050000000054,-1015.5999999999995
989,2022-01-10 09:25:00,617.3,6344.750000000055,6743.050000000054,-398.2999999999993
990,2022-01-10 09:30:00,505.67,6850.420000000055,6743.050000000054,107.3700000000008
991,2022-01-10 09:35:00,480.93,7331.350000000055,6743.050000000054,588.3000000000011
992,2022-01-10 09:40:00,918.32,8249.670000000055,6743.050000000054,1506.6200000000008
993,2022-01-10 09:45:00,1640.9,9890.570000000054,6743.050000000054,3147.5200000000004
994,2022-01-10 09:50:00,-1952.39,7938.180000000054,6743.050000000054,1195.13
995,2022-01-10 09:55:00,-1341.16,6597.020000000054,6743.050000000054,-146.02999999999975
996,2022-01-10 10:00:00,1270.83,7867.850000000054,6743.050000000054,1124.8000000000002
997,2022-01-10 10:05:00,1271.39,9139.240000000054,6743.050000000054,2396.1900000000005
998,2022-01-10 10:10:00,-1220.64,7918.600000000054,6743.050000000054,1175.5500000000002
999,2022-01-10 10:15:00,1904.72,9823.320000000054,6743.050000000054,3080.2700000000004
1000,2022-01-10 10:20:00,-1583.59,8239.730000000054,6743.050000000054,1496.6800000000003
1001,2022-01-10 10:25:00,-1824.53,6415.200000000054,6743.050000000054,-327.84999999999945
1002,2022-01-10 10:30:00,-1447.48,4967.720000000054,6743.050000000054,-1775.33
1003,2022-01-10 10:35:00,-1354.46,3613.260000000054,6743.050000000054,-3129.79
1004,2022-01-10 10:40:00,1087.25,4700.510000000054,6743.050000000054,-2042.54
1005,2022-01-10 10:45:00,-397.68,4302.830000000054,6743.050000000054,-2440.2200000000003
1006,2022-01-10 10:50:00,-335.78,3967.050000000054,6743.050000000054,-2776.0
1007,2022-01-10 10:55:00,-986.63,2980.4200000000537,6743.050000000054,-3762.63
1008,2022-01-10 11:00:00,-468.12,2512.300000000054,6743.050000000054,-4230.75
1009,2022-01-10 11:05:00,-1449.03,1063.2700000000539,6743.050000000054,-5679.78
1010,2022-01-10 11:10:00,1024.02,2087.2900000000536,6743.050000000054,-4655.76
1011,2022-01-10 11:15:00,-752.28,1335.0100000000537,6743.050000000054,-5408.04
1012,2022-01-10 11:20:00,529.38,1864.3900000000535,6743.050000000054,-4878.66
1013,2022-01-10 11:25:00,1927.79,3792.1800000000535,6743.050000000054,-2950.8700000000003
1014,2022-01-10 11:30:00,-1322.17,2470.0100000000534,6743.050000000054,-4273.040000000001
1015,2022-01-10 11:35:00,60.18,2530.1900000000533,6743.050000000054,-4212.860000000001
1016,2022-01-10 11:40:00,339.23,2869.4200000000533,6743.050000000054,-3873.6300000000006
1017,2022-01-10 11:45:00,850.66,3720.080000000053,6743.050000000054,-3022.9700000000007
1018,2022-01-10 11:50:00,-916.05,2804.0300000000534,6743.050000000054,-3939.0200000000004
1019,2022-01-10 11:55:00,848.75,3652.7800000000534,6743.050000000054,-3090.2700000000004
1020,2022-01-10 12:00:00,-1667.11,1985.6700000000535,6743.050000000054,-4757.38
1021,2022-01-10 12:05:00,-583.48,1402.1900000000535,6743.050000000054,-5340.860000000001
1022,2022-01-10 12:10:00,-535.7,866.4900000000534,6743.050000000054,-5876.56
1023,2022-01-10 12:15:00,-421.98,444.5100000000534,6743.050000000054,-6298.540000000001
1024,2022-01-10 12:20:00,438.41,882.9200000000535,6743.050000000054,-5860.13
1025,2022-01-10 12:25:00,1146.64,2029.5600000000536,6743.050000000054,-4713.49
1026,2022-01-10 12:30:00,606.64,2636.2000000000535,6743.050000000054,-4106.85
1027,2022-01-10 12:35:00,-1083.74,1552.4600000000535,6743.050000000054,-5190.59
1028,2022-01-10 12:40:00,730.89,2283.3500000000536,6743.050000000054,-4459.700000000001
1029,2022-01-10 12:45:00,82.37,2365.7200000000535,6743.050000000054,-4377.33
1030,2022-01-10 12:50:00,-665.99,1699.7300000000535,6743.050000000054,-5043.320000000001
1031,2022-01-10 12:55:00,884.68,2584.4100000000535,6743.050000000054,-4158.64
1032,2022-01-10 13:00:00,-242.44,2341.9700000000535,6743.050000000054,-4401.08
1033,2022-01-10 13:05:00,-1265.0,1076.9700000000535,6743.050000000054,-5666.08
1034,2022-01-10 13:10:00,893.72,1970.6900000000535,6743.050000000054,-4772.360000000001
1035,2022-01-10 13:15:00,-1909.05,61.64000000005353,6743.050000000054,-6681.41
1036,2022-01-10 13:20:00,155.2,216.84000000005352,6743.050000000054,-6526.21
1037,2022-01-10 13:25:00,226.72,443.5600000000535,6743.050000000054,-6299.490000000001
1038,2022-01-10 13:30:00,1998.12,2441.6800000000535,6743.050000000054,-4301.370000000001
1039,2022-01-10 13:35:00,-1581.23,860.4500000000535,6743.050000000054,-5882.6
1040,2022-01-10 13:40:00,1982.81,2843.2600000000534,6743.050000000054,-3899.7900000000004
1041,2022-01-10 13:45:00,-617.74,2225.520000000053,6743.050000000054,-4517.530000000001
1042,2022-01-10 13:50:00,-791.77,1433.7500000000532,6743.050000000054,-5309.300000000001
1043,2022-01-10 13:55:00,1145.95,2579.7000000000535,6743.050000000054,-4163.35
1044,2022-01-10 14:00:00,1963.87,4543.570000000053,6743.050000000054,-2199.4800000000005
1045,2022-01-10 14:05:00,1346.79,5890.360000000053,6743.050000000054,-852.6900000000005
1046,2022-01-10 14:10:00,-539.95,5350.4100000000535,6743.050000000054,-1392.6400000000003
1047,2022-01-10 14:15:00,-1185.88,4164.530000000053,6743.050000000054,-2578.5200000000004
1048,2022-01-10 14:20:00,-262.99,3901.5400000000536,6743.050000000054,-2841.51
1049,2022-01-10 14:25:00,-289.73,3611.8100000000536,6743.050000000054,-3131.2400000000002
1050,2022-01-10 14:30:00,532.94,4144.750000000054,6743.050000000054,-2598.3
1051,2022-01-10 14:35:00,-1454.31,2690.4400000000537,6743.050000000054,-4052.61
1052,2022-01-10 14:40:00,-15.43,2675.010000000054,6743.050000000054,-4068.04
1053,2022-01-10 14:45:00,510.02,3185.030000000054,6743.050000000054,-3558.02
1054,2022-01-10 14:50:00,258.2,3443.2300000000537,6743.050000000054,-3299.82
1055,2022-01-10 14:55:00,-1695.21,1748.0200000000536,6743.050000000054,-4995.030000000001
1056,2022-01-10 15:00:00,1215.63,2963.6500000000538,6743.050000000054,-3779.4
1057,2022-01-10 15:05:00,-261.42,2702.2300000000537,6743.050000000054,-4040.82
1058,2022-01-10 15:10:00,433.66,3135.8900000000535,6743.050000000054,-3607.1600000000003
1059,2022-01-10 15:15:00,-601.43,2534.4600000000537,6743.050000000054,-4208.59
1060,2022-01-10 15:20:00,-91.62,2442.840000000054,6743.050000000054,-4300.21
1061,2022-01-10 15:25:00,1677.32,4120.1600000000535,6743.050000000054,-2622.8900000000003
1062,2022-01-10 15:30:00,1800.24,5920.400000000053,6743.050000000054,-822.6500000000005
1063,2022-01-10 15:35:00,-1511.56,4408.840000000053,6743.050000000054,-2334.210000000001
1064,2022-01-10 15:40:00,-802.83,3606.010000000053,6743.050000000054,-3137.040000000001
1065,2022-01-10 15:45:00,-1324.88,2281.130000000053,6743.050000000054,-4461.920000000001
1066,2022-01-10 15:50:00,853.48,3134.610000000053,6743.050000000054,-3608.440000000001
1067,2022-01-10 15:55:00,-1619.97,1514.6400000000529,6743.050000000054,-5228.410000000001
1068,2022-01-10 16:00:00,965.68,2480.320000000053,6743.050000000054,-4262.730000000001
1069,2022-01-10 16:05:00,-555.73,1924.590000000053,6743.050000000054,-4818.460000000001
1070,2022-01-10 16:10:00,1545.09,3469.680000000053,6743.050000000054,-3273.370000000001
1071,2022-01-10 16:15:00,1348.22,4817.900000000053,6743.050000000054,-1925.1500000000005
1072,2022-01-10 16:20:00,-1503.83,3314.0700000000534,6743.050000000054,-3428.9800000000005
1073,2022-01-10 16:25:00,-766.26,2547.810000000053,6743.050000000054,-4195.240000000001
1074,2022-01-10 16:30:00,-149.88,2397.930000000053,6743.050000000054,-4345.120000000001
1075,2022-01-10 16:35:00,739.62,3137.550000000053,6743.050000000054,-3605.500000000001
1076,2022-01-10 16:40:00,-962.21,2175.340000000053,6743.050000000054,-4567.710000000001
1077,2022-01-10 16:45:00,1849.3,4024.640000000053,6743.050000000054,-2718.4100000000008
1078,2022-01-10 16:50:00,903.39,4928.030000000053,6743.050000000054,-1815.0200000000004
1079,2022-01-10 16:55:00,115.73,5043.760000000053,6743.050000000054,-1699.2900000000009
1080,2022-01-11 08:00:00,1097.58,6141.340000000053,5043.760000000053,1097.58
1081,2022-01-11 08:05:00,1402.8,7544.140000000053,5043.760000000053,2500.38
1082,2022-01-11 08:10:00,1393.51,8937.650000000052,5043.760000000053,3893.8899999999994
1083,2022-01-11 08:15:00,-1277.53,7660.120000000053,5043.760000000053,2616.3599999999997
1084,2022-01-11 08:20:00,-183.16,7476.960000000053,5043.760000000053,2433.2
1085,2022-01-11 08:25:00,-704.61,6772.350000000053,5043.760000000053,1728.5900000000001
1086,2022-01-11 08:30:00,-1399.78,5372.570000000053,5043.760000000053,328.8100000000004
1087,2022-01-11 08:35:00,1582.37,6954.940000000053,5043.760000000053,1911.1800000000003
1088,2022-01-11 08:40:00,-921.0,6033.940000000053,5043.760000000053,990.1800000000003
1089,2022-01-11 08:45:00,1365.94,7399.880000000054,5043.760000000053,2356.120000000001
1090,2022-01-11 08:50:00,1082.12,8482.000000000055,5043.760000000053,3438.2400000000016
1091,2022-01-11 08:55:00,-460.85,8021.150000000054,5043.760000000053,2977.3900000000012
1092,2022-01-11 09:00:00,-1940.32,6080.8300000000545,5043.760000000053,1037.0700000000015
1093,2022-01-11 09:05:00,1959.82,8040.650000000054,5043.760000000053,2996.8900000000012
1094,2022-01-11 09:10:00,376.43,8417.080000000054,5043.760000000053,3373.3200000000015
1095,2022-01-11 09:15:00,752.51,9169.590000000055,5043.760000000053,4125.830000000002
1096,2022-01-11 09:20:00,1693.9,10863.490000000054,5043.760000000053,5819.730000000001
1097,2022-01-11 09:25:00,-1955.3,8908.190000000055,5043.760000000053,3864.430000000002
1098,2022-01-11 09:30:00,54.37,8962.560000000056,5043.760000000053,3918.800000000003
1099,2022-01-11 09:35:00,1519.31,10481.870000000055,5043.760000000053,5438.110000000002
1100,2022-01-11 09:40:00,1277.48,11759.350000000055,5043.760000000053,6715.590000000002
1101,2022-01-11 09:45:00,-1057.86,10701.490000000054,5043.760000000053,5657.730000000001
1102,2022-01-11 09:50:00,-871.76,9829.730000000054,5043.760000000053,4785.970000000001
1103,2022-01-11 09:55:00,-1830.39,7999.340000000054,5043.760000000053,2955.580000000001
1104,2022-01-11 10:00:00,-1544.15,6455.190000000053,5043.760000000053,1411.4300000000003
1105,2022-01-11 10:05:00,-304.45,6150.740000000053,5043.760000000053,1106.9800000000005
1106,2022-01-11 10:10:00,669.02,6819.760000000053,5043.760000000053,1776.0
1107,2022-01-11 10:15:00,1124.69,7944.4500000000535,5043.760000000053,2900.6900000000005
1108,2022-01-11 10:20:00,1322.61,9267.060000000054,5043.760000000053,4223.300000000001
1109,2022-01-11 10:25:00,-1814.3,7452.760000000054,5043.760000000053,2409.000000000001
1110,2022-01-11 10:30:00,-1895.81,5556.9500000000535,5043.760000000053,513.1900000000005
1111,2022-01-11 10:35:00,-486.0,5070.9500000000535,5043.760000000053,27.19000000000051
1112,2022-01-11 10:40:00,762.55,5833.500000000054,5043.760000000053,789.7400000000007
1113,2022-01-11 10:45:00,-1334.13,4499.370000000054,5043.760000000053,-544.3899999999994
1114,2022-01-11 10:50:00,570.74,5070.110000000053,5043.760000000053,26.350000000000364
1115,2022-01-11 10:55:00,1646.85,6716.960000000054,5043.760000000053,1673.2000000000007
1116,2022-01-11 11:00:00,-1037.51,5679.4500000000535,5043.760000000053,635.6900000000005
1117,2022-01-11 11:05:00,-702.14,4977.310000000053,5043.760000000053,-66.44999999999982
1118,2022-01-11 11:10:00,180.69,5158.000000000053,5043.760000000053,114.23999999999978
1119,2022-01-11 11:15:00,-1623.6,3534.400000000053,5043.760000000053,-1509.3600000000001
1120,2022-01-11 11:20:00,699.08,4233.480000000053,5043.760000000053,-810.2799999999997
1121,2022-01-11 11:25:00,-1676.88,2556.600000000053,5043.760000000053,-2487.16
1122,2022-01-11 11:30:00,1722.34,4278.940000000053,5043.760000000053,-764.8199999999997
1123,2022-01-11 11:35:00,1197.92,5476.860000000053,5043.760000000053,433.10000000000036
1124,2022-01-11 11:40:00,1187.32,6664.180000000053,5043.760000000053,1620.42
1125,2022-01-11 11:45:00,-315.29,6348.890000000053,5043.760000000053,1305.13
1126,2022-01-11 11:50:00,-1198.32,5150.570000000053,5043.760000000053,106.8100000000004
1127,2022-01-11 11:55:00,1227.39,6377.960000000054,5043.760000000053,1334.2000000000007
1128,2022-01-11 12:00:00,612.45,6990.4100000000535,5043.760000000053,1946.6500000000005
1129,2022-01-11 12:05:00,535.7,7526.110000000053,5043.760000000053,2482.3500000000004
1130,2022-01-11 12:10:00,-68.51,7457.600000000053,5043.760000000053,2413.84
1131,2022-01-11 12:15:00,638.88,8096.480000000053,5043.760000000053,3052.7200000000003
1132,2022-01-11 12:20:00,306.36,8402.840000000053,5043.760000000053,3359.08
1133,2022-01-11 12:25:00,-869.37,7533.470000000053,5043.760000000053,2489.71
1134,2022-01-11 12:30:00,-764.59,6768.880000000053,5043.760000000053,1725.12
1135,2022-01-11 12:35:00,-1635.74,5133.140000000053,5043.760000000053,89.38000000000011
1136,2022-01-11 12:40:00,-319.78,4813.360000000053,5043.760000000053,-230.39999999999964
1137,2022-01-11 12:45:00,1972.58,6785.940000000053,5043.760000000053,1742.1800000000003
1138,2022-01-11 12:50:00,1226.46,8012.400000000053,5043.760000000053,2968.6400000000003
1139,2022-01-11 12:55:00,106.58,8118.980000000053,5043.760000000053,3075.2200000000003
1140,2022-01-11 13:00:00,12.4,8131.380000000053,5043.760000000053,3087.62
1141,2022-01-11 13:05:00,-1317.14,6814.2400000000525,5043.760000000053,1770.4799999999996
1142,2022-01-11 13:10:00,-591.23,6223.010000000053,5043.760000000053,1179.25
1143,2022-01-11 13:15:00,-579.92,5643.090000000053,5043.760000000053,599.3299999999999
1144,2022-01-11 13:20:00,-61.73,5581.360000000053,5043.760000000053,537.6000000000004
1145,2022-01-11 13:25:00,-923.14,4658.220000000053,5043.760000000053,-385.53999999999996
1146,2022-01-11 13:30:00,1814.04,6472.260000000053,5043.760000000053,1428.5
1147,2022-01-11 13:35:00,1999.65,8471.910000000053,5043.760000000053,3428.1499999999996
1148,2022-01-11 13:40:00,-1354.56,7117.350000000053,5043.760000000053,2073.59
1149,2022-01-11 13:45:00,1206.5,8323.850000000053,5043.760000000053,3280.09
1150,2022-01-11 13:50:00,-1555.1,6768.750000000053,5043.760000000053,1724.9899999999998
1151,2022-01-11 13:55:00,-574.82,6193.930000000053,5043.760000000053,1150.17
1152,2022-01-11 14:00:00,-452.52,5741.410000000053,5043.760000000053,697.6499999999996
1153,2022-01-11 14:05:00,-906.15,4835.260000000053,5043.760000000053,-208.5
1154,2022-01-11 14:10:00,-1866.35,2968.910000000053,5043.760000000053,-2074.85
1155,2022-01-11 14:15:00,-507.12,2461.790000000053,5043.760000000053,-2581.97
1156,2022-01-11 14:20:00,-91.39,2370.4000000000533,5043.760000000053,-2673.3599999999997
1157,2022-01-11 14:25:00,1075.39,3445.7900000000536,5043.760000000053,-1597.9699999999993
1158,2022-01-11 14:30:00,-194.54,3251.2500000000537,5043.760000000053,-1792.5099999999993
1159,2022-01-11 14:35:00,-1567.62,1683.6300000000538,5043.760000000053,-3360.129999999999
1160,2022-01-11 14:40:00,-1302.07,381.56000000005383,5043.760000000053,-4662.199999999999
1161,2022-01-11 14:45:00,1991.81,2373.3700000000536,5043.760000000053,-2670.3899999999994
1162,2022-01-11 14:50:00,-1576.92,796.4500000000535,5043.760000000053,-4247.3099999999995
1163,2022-01-11 14:55:00,1318.28,2114.730000000053,5043.760000000053,-2929.0299999999997
1164,2022-01-11 15:00:00,-1919.79,194.94000000005326,5043.760000000053,-4848.82
1165,2022-01-11 15:05:00,21.19,216.13000000005326,5043.760000000053,-4827.63
1166,2022-01-11 15:10:00,1208.48,1424.6100000000533,5043.760000000053,-3619.1499999999996
1167,2022-01-11 15:15:00,1412.74,2837.350000000053,5043.760000000053,-2206.41
1168,2022-01-11 15:20:00,768.61,3605.9600000000532,5043.760000000053,-1437.7999999999997
1169,2022-01-11 15:25:00,-808.99,2796.970000000053,5043.760000000053,-2246.79
1170,2022-01-11 15:30:00,-348.25,2448.720000000053,5043.760000000053,-2595.04
1171,2022-01-11 15:35:00,1512.56,3961.280000000053,5043.760000000053,-1082.48
1172,2022-01-11 15:40:00,-1047.98,2913.300000000053,5043.760000000053,-2130.46
1173,2022-01-11 15:45:00,-730.85,2182.450000000053,5043.760000000053,-2861.31
1174,2022-01-11 15:50:00,-1007.19,1175.260000000053,5043.760000000053,-3868.5
1175,2022-01-11 15:55:00,1001.67,2176.930000000053,5043.760000000053,-2866.83
1176,2022-01-11 16:00:00,-1510.79,666.1400000000531,5043.760000000053,-4377.62
1177,2022-01-11 16:05:00,1750.81,2416.950000000053,5043.760000000053,-2626.81
1178,2022-01-11 16:10:00,-1280.92,1136.030000000053,5043.760000000053,-3907.73
1179,2022-01-11 16:15:00,-306.15,829.880000000053,5043.760000000053,-4213.88
1180,2022-01-11 16:20:00,-188.99,640.890000000053,5043.760000000053,-4402.87
1181,2022-01-11 16:25:00,673.71,1314.6000000000531,5043.760000000053,-3729.16
1182,2022-01-11 16:30:00,1511.78,2826.380000000053,5043.760000000053,-2217.38
1183,2022-01-11 16:35:00,835.07,3661.450000000053,5043.760000000053,-1382.31
1184,2022-01-11 16:40:00,1738.43,5399.880000000053,5043.760000000053,356.1199999999999
1185,2022-01-11 16:45:00,993.05,6392.930000000053,5043.760000000053,1349.17
1186,2022-01-11 16:50:00,-1821.59,4571.340000000053,5043.760000000053,-472.4200000000001
1187,2022-01-11 16:55:00,-1532.78,3038.560000000053,5043.760000000053,-2005.1999999999998
1188,2022-01-12 08:00:00,294.1,3332.660000000053,3038.560000000053,294.0999999999999
1189,2022-01-12 08:05:00,-473.48,2859.180000000053,3038.560000000053,-179.3800000000001
1190,2022-01-12 08:10:00,969.94,3829.120000000053,3038.560000000053,790.56
1191,2022-01-12 08:15:00,-802.56,3026.560000000053,3038.560000000053,-12.0
1192,2022-01-12 08:20:00,362.89,3389.450000000053,3038.560000000053,350.8899999999999
1193,2022-01-12 08:25:00,-1364.11,2025.3400000000531,3038.560000000053,-1013.22
1194,2022-01-12 08:30:00,-697.5,1327.8400000000531,3038.560000000053,-1710.72
1195,2022-01-12 08:35:00,-572.81,755.0300000000532,3038.560000000053,-2283.5299999999997
1196,2022-01-12 08:40:00,-109.18,645.8500000000531,3038.560000000053,-2392.71
1197,2022-01-12 08:45:00,147.21,793.0600000000532,3038.560000000053,-2245.5
1198,2022-01-12 08:50:00,-522.38,270.68000000005316,3038.560000000053,-2767.88
1199,2022-01-12 08:55:00,1616.74,1887.4200000000533,3038.560000000053,-1151.1399999999999
1200,2022-01-12 09:00:00,704.29,2591.7100000000532,3038.560000000053,-446.8499999999999
1201,2022-01-12 09:05:00,230.19,2821.9000000000533,3038.560000000053,-216.65999999999985
1202,2022-01-12 09:10:00,-564.07,2257.830000000053,3038.560000000053,-780.73
1203,2022-01-12 09:15:00,1171.92,3429.750000000053,3038.560000000053,391.19000000000005
1204,2022-01-12 09:20:00,-1965.35,1464.4000000000533,3038.560000000053,-1574.1599999999999
1205,2022-01-12 09:25:00,-71.67,1392.7300000000532,3038.560000000053,-1645.83
1206,2022-01-12 09:30:00,456.8,1849.5300000000532,3038.560000000053,-1189.03
1207,2022-01-12 09:35:00,1885.24,3734.770000000053,3038.560000000053,696.21
1208,2022-01-12 09:40:00,296.11,4030.8800000000533,3038.560000000053,992.3200000000002
1209,2022-01-12 09:45:00,691.57,4722.4500000000535,3038.560000000053,1683.8900000000003
1210,2022-01-12 09:50:00,-1912.67,2809.7800000000534,3038.560000000053,-228.77999999999975
1211,2022-01-12 09:55:00,865.32,3675.1000000000536,3038.560000000053,636.5400000000004
1212,2022-01-12 10:00:00,154.26,3829.3600000000533,3038.560000000053,790.8000000000002
1213,2022-01-12 10:05:00,-1744.06,2085.3000000000534,3038.560000000053,-953.2599999999998
1214,2022-01-12 10:10:00,1152.83,3238.1300000000533,3038.560000000053,199.57000000000016
1215,2022-01-12 10:15:00,674.2,3912.3300000000536,3038.560000000053,873.7700000000004
1216,2022-01-12 10:20:00,1115.79,5028.120000000054,3038.560000000053,1989.5600000000004
1217,2022-01-12 10:25:00,1302.21,6330.330000000054,3038.560000000053,3291.7700000000004
1218,2022-01-12 10:30:00,-822.54,5507.790000000054,3038.560000000053,2469.2300000000005
1219,2022-01-12 10:35:00,1514.51,7022.300000000054,3038.560000000053,3983.7400000000007
1220,2022-01-12 10:40:00,-1064.21,5958.090000000054,3038.560000000053,2919.5300000000007
1221,2022-01-12 10:45:00,-33.11,5924.980000000054,3038.560000000053,2886.420000000001
1222,2022-01-12 10:50:00,-330.68,5594.300000000054,3038.560000000053,2555.7400000000007
1223,2022-01-12 10:55:00,603.95,6198.250000000054,3038.560000000053,3159.6900000000005
1224,2022-01-12 11:00:00,-1881.58,4316.670000000054,3038.560000000053,1278.1100000000006
1225,2022-01-12 11:05:00,1971.16,6287.830000000054,3038.560000000053,3249.2700000000004
1226,2022-01-12 11:10:00,875.92,7163.750000000054,3038.560000000053,4125.1900000000005
1227,2022-01-12 11:15:00,-1872.51,5291.240000000053,3038.560000000053,2252.6800000000003
1228,2022-01-12 11:20:00,1129.4,6420.640000000054,3038.560000000053,3382.080000000001
1229,2022-01-12 11:25:00,1031.08,7451.720000000054,3038.560000000053,4413.160000000001
1230,2022-01-12 11:30:00,1608.71,9060.430000000055,3038.560000000053,6021.870000000002
1231,2022-01-12 11:35:00,1152.17,10212.600000000055,3038.560000000053,7174.040000000002
1232,2022-01-12 11:40:00,3.16,10215.760000000055,3038.560000000053,7177.200000000002
1233,2022-01-12 11:45:00,1539.79,11755.550000000054,3038.560000000053,8716.990000000002
1234,2022-01-12 11:50:00,-285.31,11470.240000000054,3038.560000000053,8431.68
1235,2022-01-12 11:55:00,-736.81,10733.430000000055,3038.560000000053,7694.870000000002
1236,2022-01-12 12:00:00,77.83,10811.260000000055,3038.560000000053,7772.700000000002
1237,2022-01-12 12:05:00,247.96,11059.220000000054,3038.560000000053,8020.660000000001
1238,2022-01-12 12:10:00,-38.58,11020.640000000054,3038.560000000053,7982.080000000001
1239,2022-01-12 12:15:00,1054.12,12074.760000000053,3038.560000000053,9036.2
1240,2022-01-12 12:20:00,-42.17,12032.590000000053,3038.560000000053,8994.029999999999
1241,2022-01-12 12:25:00,-855.02,11177.570000000052,3038.560000000053,8139.009999999999
1242,2022-01-12 12:30:00,-579.01,10598.560000000052,3038.560000000053,7559.999999999999
1243,2022-01-12 12:35:00,1785.43,12383.990000000053,3038.560000000053,9345.43
1244,2022-01-12 12:40:00,1805.79,14189.780000000053,3038.560000000053,11151.220000000001
1245,2022-01-12 12:45:00,1556.96,15746.740000000053,3038.560000000053,12708.18
1246,2022-01-12 12:50:00,1389.67,17136.410000000054,3038.560000000053,14097.850000000002
1247,2022-01-12 12:55:00,-952.58,16183.830000000054,3038.560000000053,13145.27
1248,2022-01-12 13:00:00,680.53,16864.360000000055,3038.560000000053,13825.800000000003
1249,2022-01-12 13:05:00,264.54,17128.900000000056,3038.560000000053,14090.340000000004
1250,2022-01-12 13:10:00,924.48,18053.380000000056,3038.560000000053,15014.820000000003
1251,2022-01-12 13:15:00,1182.38,19235.760000000057,3038.560000000053,16197.200000000004
1252,2022-01-12 13:20:00,-428.38,18807.380000000056,3038.560000000053,15768.820000000003
1253,2022-01-12 13:25:00,1313.4,20120.780000000057,3038.560000000053,17082.220000000005
1254,2022-01-12 13:30:00,-1172.97,18947.810000000056,3038.560000000053,15909.250000000004
1255,2022-01-12 13:35:00,-1252.12,17695.690000000057,3038.560000000053,14657.130000000005
1256,2022-01-12 13:40:00,1115.1,18810.790000000055,3038.560000000053,15772.230000000003
1257,2022-01-12 13:45:00,-378.01,18432.780000000057,3038.560000000053,15394.220000000005
1258,2022-01-12 13:50:00,-32.44,18400.34000000006,3038.560000000053,15361.780000000006
1259,2022-01-12 13:55:00,-181.88,18218.460000000057,3038.560000000053,15179.900000000005
1260,2022-01-12 14:00:00,-1348.5,16869.960000000057,3038.560000000053,13831.400000000005
1261,2022-01-12 14:05:00,-706.72,16163.240000000058,3038.560000000053,13124.680000000004
1262,2022-01-12 14:10:00,-999.44,15163.800000000057,3038.560000000053,12125.240000000005
1263,2022-01-12 14:15:00,-1145.48,14018.320000000058,3038.560000000053,10979.760000000006
1264,2022-01-12 14:20:00,-148.59,13869.730000000058,3038.560000000053,10831.170000000006
1265,2022-01-12 14:25:00,416.03,14285.760000000058,3038.560000000053,11247.200000000004
1266,2022-01-12 14:30:00,1095.42,15381.180000000058,3038.560000000053,12342.620000000006
1267,2022-01-12 14:35:00,-868.06,14513.120000000059,3038.560000000053,11474.560000000005
1268,2022-01-12 14:40:00,-701.23,13811.89000000006,3038.560000000053,10773.330000000005
1269,2022-01-12 14:45:00,1058.85,14870.74000000006,3038.560000000053,11832.180000000008
1270,2022-01-12 14:50:00,1761.97,16632.71000000006,3038.560000000053,13594.150000000009
1271,2022-01-12 14:55:00,137.78,16770.49000000006,3038.560000000053,13731.930000000008
1272,2022-01-12 15:00:00,1283.71,18054.20000000006,3038.560000000053,15015.640000000007
1273,2022-01-12 15:05:00,1289.66,19343.86000000006,3038.560000000053,16305.300000000007
1274,2022-01-12 15:10:00,425.03,19768.890000000058,3038.560000000053,16730.330000000005
1275,2022-01-12 15:15:00,-517.88,19251.010000000057,3038.560000000053,16212.450000000004
1276,2022-01-12 15:20:00,-1377.91,17873.100000000057,3038.560000000053,14834.540000000005
1277,2022-01-12 15:25:00,1728.62,19601.720000000056,3038.560000000053,16563.160000000003
1278,2022-01-12 15:30:00,-649.83,18951.890000000054,3038.560000000053,15913.330000000002
1279,2022-01-12 15:35:00,1925.3,20877.190000000053,3038.560000000053,17838.63
1280,2022-01-12 15:40:00,802.7,21679.890000000054,3038.560000000053,18641.33
1281,2022-01-12 15:45:00,577.7,22257.590000000055,3038.560000000053,19219.030000000002
1282,2022-01-12 15:50:00,598.48,22856.070000000054,3038.560000000053,19817.510000000002
1283,2022-01-12 15:55:00,1855.28,24711.350000000053,3038.560000000053,21672.79
1284,2022-01-12 16:00:00,-784.78,23926.570000000054,3038.560000000053,20888.010000000002
1285,2022-01-12 16:05:00,26.08,23952.650000000056,3038.560000000053,20914.090000000004
1286,2022-01-12 16:10:00,-1334.64,22618.010000000057,3038.560000000053,19579.450000000004
1287,2022-01-12 16:15:00,306.45,22924.460000000057,3038.560000000053,19885.900000000005
1288,2022-01-12 16:20:00,-847.26,22077.20000000006,3038.560000000053,19038.640000000007
1289,2022-01-12 16:25:00,-210.72,21866.480000000058,3038.560000000053,18827.920000000006
1290,2022-01-12 16:30:00,957.71,22824.190000000057,3038.560000000053,19785.630000000005
1291,2022-01-12 16:35:00,-93.9,22730.290000000055,3038.560000000053,19691.730000000003
1292,2022-01-12 16:40:00,1439.52,24169.810000000056,3038.560000000053,21131.250000000004
1293,2022-01-12 16:45:00,929.34,25099.150000000056,3038.560000000053,22060.590000000004
1294,2022-01-12 16:50:00,-765.15,24334.000000000055,3038.560000000053,21295.440000000002
1295,2022-01-12 16:55:00,649.03,24983.030000000053,3038.560000000053,21944.47
1296,2022-01-13 08:00:00,515.05,25498.080000000053,24983.030000000053,515.0499999999993
1297,2022-01-13 08:05:00,-1281.02,24217.060000000052,24983.030000000053,-765.9700000000012
1298,2022-01-13 08:10:00,-1702.82,22514.240000000053,24983.030000000053,-2468.790000000001
1299,2022-01-13 08:15:00,-1117.84,21396.400000000052,24983.030000000053,-3586.630000000001
1300,2022-01-13 08:20:00,1129.31,22525.710000000054,24983.030000000053,-2457.3199999999997
1301,2022-01-13 08:25:00,-1284.16,21241.550000000054,24983.030000000053,-3741.4799999999996
1302,2022-01-13 08:30:00,634.26,21875.810000000052,24983.030000000053,-3107.220000000001
1303,2022-01-13 08:35:00,-1712.7,20163.11000000005,24983.030000000053,-4819.920000000002
1304,2022-01-13 08:40:00,1969.85,22132.96000000005,24983.030000000053,-2850.0700000000033
1305,2022-01-13 08:45:00,1905.25,24038.21000000005,24983.030000000053,-944.8200000000033
1306,2022-01-13 08:50:00,1144.03,25182.24000000005,24983.030000000053,199.2099999999955
1307,2022-01-13 08:55:00,1919.69,27101.930000000048,24983.030000000053,2118.899999999994
1308,2022-01-13 09:00:00,1945.08,29047.010000000046,24983.030000000053,4063.9799999999923
1309,2022-01-13 09:05:00,1785.86,30832.870000000046,24983.030000000053,5849.839999999993
1310,2022-01-13 09:10:00,739.57,31572.440000000046,24983.030000000053,6589.409999999993
1311,2022-01-13 09:15:00,-1809.27,29763.170000000046,24983.030000000053,4780.139999999992
1312,2022-01-13 09:20:00,-223.39,29539.780000000046,24983.030000000053,4556.749999999993
1313,2022-01-13 09:25:00,1843.15,31382.930000000048,24983.030000000053,6399.899999999994
1314,2022-01-13 09:30:00,-93.44,31289.49000000005,24983.030000000053,6306.4599999999955
1315,2022-01-13 09:35:00,-120.19,31169.30000000005,24983.030000000053,6186.269999999997
1316,2022-01-13 09:40:00,-1523.76,29645.54000000005,24983.030000000053,4662.509999999998
1317,2022-01-13 09:45:00,452.64,30098.18000000005,24983.030000000053,5115.149999999998
1318,2022-01-13 09:50:00,-1567.81,28530.37000000005,24983.030000000053,3547.3399999999965
1319,2022-01-13 09:55:00,597.8,29128.17000000005,24983.030000000053,4145.139999999996
1320,2022-01-13 10:00:00,1470.78,30598.950000000048,24983.030000000053,5615.919999999995
1321,2022-01-13 10:05:00,-912.07,29686.88000000005,24983.030000000053,4703.849999999995
1322,2022-01-13 10:10:00,1172.67,30859.550000000047,24983.030000000053,5876.519999999993
1323,2022-01-13 10:15:00,551.29,31410.840000000047,24983.030000000053,6427.809999999994
1324,2022-01-13 10:20:00,-948.94,30461.90000000005,24983.030000000053,5478.869999999995
1325,2022-01-13 10:25:00,-293.06,30168.840000000047,24983.030000000053,5185.809999999994
1326,2022-01-13 10:30:00,-366.5,29802.340000000047,24983.030000000053,4819.309999999994
1327,2022-01-13 10:35:00,-976.85,28825.49000000005,24983.030000000053,3842.4599999999955
1328,2022-01-13 10:40:00,75.61,28901.10000000005,24983.030000000053,3918.069999999996
1329,2022-01-13 10:45:00,-717.76,28183.34000000005,24983.030000000053,3200.3099999999977
1330,2022-01-13 10:50:00,632.72,28816.060000000052,24983.030000000053,3833.029999999999
1331,2022-01-13 10:55:00,-928.81,27887.25000000005,24983.030000000053,2904.2199999999975
1332,2022-01-13 11:00:00,-246.26,27640.990000000053,24983.030000000053,2657.959999999999
1333,2022-01-13 11:05:00,1917.82,29558.810000000052,24983.030000000053,4575.779999999999
1334,2022-01-13 11:10:00,-1638.92,27919.89000000005,24983.030000000053,2936.859999999997
1335,2022-01-13 11:15:00,470.25,28390.14000000005,24983.030000000053,3407.109999999997
1336,2022-01-13 11:20:00,985.92,29376.06000000005,24983.030000000053,4393.029999999995
1337,2022-01-13 11:25:00,-975.34,28400.72000000005,24983.030000000053,3417.689999999995
1338,2022-01-13 11:30:00,-1472.15,26928.570000000047,24983.030000000053,1945.5399999999936
1339,2022-01-13 11:35:00,1203.71,28132.280000000046,24983.030000000053,3149.2499999999927
1340,2022-01-13 11:40:00,-741.6,27390.680000000048,24983.030000000053,2407.649999999994
1341,2022-01-13 11:45:00,-718.69,26671.99000000005,24983.030000000053,1688.9599999999955
1342,2022-01-13 11:50:00,1507.15,28179.14000000005,24983.030000000053,3196.109999999997
1343,2022-01-13 11:55:00,-24.55,28154.59000000005,24983.030000000053,3171.5599999999977
1344,2022-01-13 12:00:00,-1660.42,26494.17000000005,24983.030000000053,1511.1399999999958
1345,2022-01-13 12:05:00,1258.16,27752.33000000005,24983.030000000053,2769.2999999999956
1346,2022-01-13 12:10:00,1274.7,29027.03000000005,24983.030000000053,4043.9999999999964
1347,2022-01-13 12:15:00,1260.67,30287.700000000048,24983.030000000053,5304.669999999995
1348,2022-01-13 12:20:00,1696.7,31984.40000000005,24983.030000000053,7001.369999999995
1349,2022-01-13 12:25:00,-1390.38,30594.020000000048,24983.030000000053,5610.989999999994
1350,2022-01-13 12:30:00,-103.01,30491.01000000005,24983.030000000053,5507.979999999996
1351,2022-01-13 12:35:00,-435.57,30055.44000000005,24983.030000000053,5072.409999999996
1352,2022-01-13 12:40:00,969.67,31025.110000000048,24983.030000000053,6042.0799999999945
1353,2022-01-13 12:45:00,1017.81,32042.92000000005,24983.030000000053,7059.889999999996
1354,2022-01-13 12:50:00,789.82,32832.74000000005,24983.030000000053,7849.7099999999955
1355,2022-01-13 12:55:00,882.68,33715.42000000005,24983.030000000053,8732.389999999996
1356,2022-01-13 13:00:00,-1122.89,32592.53000000005,24983.030000000053,7609.499999999996
1357,2022-01-13 13:05:00,-1422.92,31169.61000000005,24983.030000000053,6186.579999999998
1358,2022-01-13 13:10:00,1383.26,32552.87000000005,24983.030000000053,7569.8399999999965
1359,2022-01-13 13:15:00,-1997.49,30555.38000000005,24983.030000000053,5572.349999999995
1360,2022-01-13 13:20:00,-1153.93,29401.450000000048,24983.030000000053,4418.419999999995
1361,2022-01-13 13:25:00,918.24,30319.69000000005,24983.030000000053,5336.659999999996
1362,2022-01-13 13:30:00,739.42,31059.110000000048,24983.030000000053,6076.0799999999945
1363,2022-01-13 13:35:00,301.94,31361.050000000047,24983.030000000053,6378.019999999993
1364,2022-01-13 13:40:00,-1239.42,30121.63000000005,24983.030000000053,5138.599999999995
1365,2022-01-13 13:45:00,-732.46,29389.17000000005,24983.030000000053,4406.139999999996
1366,2022-01-13 13:50:00,1139.75,30528.92000000005,24983.030000000053,5545.889999999996
1367,2022-01-13 13:55:00,-1305.61,29223.31000000005,24983.030000000053,4240.279999999995
1368,2022-01-13 14:00:00,503.21,29726.520000000048,24983.030000000053,4743.489999999994
1369,2022-01-13 14:05:00,1014.01,30740.530000000046,24983.030000000053,5757.499999999993
1370,2022-01-13 14:10:00,697.48,31438.010000000046,24983.030000000053,6454.979999999992
1371,2022-01-13 14:15:00,1277.13,32715.140000000047,24983.030000000053,7732.109999999993
1372,2022-01-13 14:20:00,-1665.03,31050.110000000048,24983.030000000053,6067.0799999999945
1373,2022-01-13 14:25:00,1826.42,32876.53000000005,24983.030000000053,7893.499999999996
1374,2022-01-13 14:30:00,-1861.59,31014.94000000005,24983.030000000053,6031.909999999996
1375,2022-01-13 14:35:00,857.65,31872.59000000005,24983.030000000053,6889.559999999998
1376,2022-01-13 14:40:00,314.04,32186.630000000052,24983.030000000053,7203.5999999999985
1377,2022-01-13 14:45:00,-758.92,31427.710000000054,24983.030000000053,6444.68
1378,2022-01-13 14:50:00,-1301.96,30125.750000000055,24983.030000000053,5142.720000000001
1379,2022-01-13 14:55:00,-1479.75,28646.000000000055,24983.030000000053,3662.970000000001
1380,2022-01-13 15:00:00,-358.32,28287.680000000055,24983.030000000053,3304.6500000000015
1381,2022-01-13 15:05:00,911.61,29199.290000000055,24983.030000000053,4216.260000000002
1382,2022-01-13 15:10:00,-1269.25,27930.040000000055,24983.030000000053,2947.010000000002
1383,2022-01-13 15:15:00,-930.37,26999.670000000056,24983.030000000053,2016.640000000003
1384,2022-01-13 15:20:00,-352.45,26647.220000000056,24983.030000000053,1664.1900000000023
1385,2022-01-13 15:25:00,862.27,27509.490000000056,24983.030000000053,2526.4600000000028
1386,2022-01-13 15:30:00,-63.08,27446.410000000054,24983.030000000053,2463.380000000001
1387,2022-01-13 15:35:00,-506.1,26940.310000000056,24983.030000000053,1957.2800000000025
1388,2022-01-13 15:40:00,-1714.21,25226.100000000057,24983.030000000053,243.07000000000335
1389,2022-01-13 15:45:00,-1566.72,23659.380000000056,24983.030000000053,-1323.6499999999978
1390,2022-01-13 15:50:00,-1164.83,22494.550000000054,24983.030000000053,-2488.4799999999996
1391,2022-01-13 15:55:00,1283.04,23777.590000000055,24983.030000000053,-1205.4399999999987
1392,2022-01-13 16:00:00,-1430.74,22346.850000000053,24983.030000000053,-2636.1800000000003
1393,2022-01-13 16:05:00,-1351.33,20995.520000000055,24983.030000000053,-3987.5099999999984
1394,2022-01-13 16:10:00,1388.68,22384.200000000055,24983.030000000053,-2598.829999999998
1395,2022-01-13 16:15:00,1188.29,23572.490000000056,24983.030000000053,-1410.5399999999972
1396,2022-01-13 16:20:00,702.71,24275.200000000055,24983.030000000053,-707.8299999999981
1397,2022-01-13 16:25:00,531.81,24807.010000000057,24983.030000000053,-176.0199999999968
1398,2022-01-13 16:30:00,1249.65,26056.660000000058,24983.030000000053,1073.6300000000047
1399,2022-01-13 16:35:00,-1144.13,24912.530000000057,24983.030000000053,-70.49999999999636
1400,2022-01-13 16:40:00,-1396.25,23516.280000000057,24983.030000000053,-1466.7499999999964
1401,2022-01-13 16:45:00,-716.56,22799.720000000056,24983.030000000053,-2183.3099999999977
1402,2022-01-13 16:50:00,5.23,22804.950000000055,24983.030000000053,-2178.079999999998
1403,2022-01-13 16:55:00,667.84,23472.790000000055,24983.030000000053,-1510.239999999998
1404,2022-01-14 08:00:00,727.29,24200.080000000056,23472.790000000055,727.2900000000009
1405,2022-01-14 08:05:00,49.96,24250.040000000055,23472.790000000055,777.25
1406,2022-01-14 08:10:00,-350.47,23899.570000000054,23472.790000000055,426.77999999999884
1407,2022-01-14 08:15:00,215.54,24115.110000000055,23472.790000000055,642.3199999999997
1408,2022-01-14 08:20:00,878.06,24993.170000000056,23472.790000000055,1520.380000000001
1409,2022-01-14 08:25:00,-1221.69,23771.480000000058,23472.790000000055,298.6900000000023
1410,2022-01-14 08:30:00,-1377.43,22394.050000000057,23472.790000000055,-1078.739999999998
1411,2022-01-14 08:35:00,-540.55,21853.50000000006,23472.790000000055,-1619.2899999999972
1412,2022-01-14 08:40:00,1928.56,23782.06000000006,23472.790000000055,309.2700000000041
1413,2022-01-14 08:45:00,1471.88,25253.94000000006,23472.790000000055,1781.150000000005
1414,2022-01-14 08:50:00,-225.82,25028.12000000006,23472.790000000055,1555.3300000000054
1415,2022-01-14 08:55:00,1323.3,26351.42000000006,23472.790000000055,2878.6300000000047
1416,2022-01-14 09:00:00,1239.08,27590.50000000006,23472.790000000055,4117.710000000003
1417,2022-01-14 09:05:00,716.02,28306.52000000006,23472.790000000055,4833.730000000003
1418,2022-01-14 09:10:00,-1107.58,27198.94000000006,23472.790000000055,3726.150000000005
1419,2022-01-14 09:15:00,818.86,28017.80000000006,23472.790000000055,4545.010000000006
1420,2022-01-14 09:20:00,-1715.47,26302.33000000006,23472.790000000055,2829.5400000000045
1421,2022-01-14 09:25:00,655.92,26958.25000000006,23472.790000000055,3485.4600000000028
1422,2022-01-14 09:30:00,-1593.9,25364.350000000057,23472.790000000055,1891.5600000000013
1423,2022-01-14 09:35:00,-895.64,24468.710000000057,23472.790000000055,995.9200000000019
1424,2022-01-14 09:40:00,-1104.21,23364.50000000006,23472.790000000055,-108.28999999999724
1425,2022-01-14 09:45:00,1836.76,25201.260000000057,23472.790000000055,1728.4700000000012
1426,2022-01-14 09:50:00,740.21,25941.470000000056,23472.790000000055,2468.6800000000003
1427,2022-01-14 09:55:00,-1196.35,24745.120000000057,23472.790000000055,1272.3300000000017
1428,2022-01-14 10:00:00,416.77,25161.890000000058,23472.790000000055,1689.1000000000022
1429,2022-01-14 10:05:00,993.85,26155.740000000056,23472.790000000055,2682.9500000000007
1430,2022-01-14 10:10:00,367.25,26522.990000000056,23472.790000000055,3050.2000000000007
1431,2022-01-14 10:15:00,788.33,27311.320000000058,23472.790000000055,3838.5300000000025
1432,2022-01-14 10:20:00,935.86,28247.18000000006,23472.790000000055,4774.390000000003
1433,2022-01-14 10:25:00,-943.68,27303.50000000006,23472.790000000055,3830.7100000000028
1434,2022-01-14 10:30:00,-1256.82,26046.68000000006,23472.790000000055,2573.890000000003
1435,2022-01-14 10:35:00,-916.1,25130.58000000006,23472.790000000055,1657.7900000000045
1436,2022-01-14 10:40:00,-1143.66,23986.92000000006,23472.790000000055,514.1300000000047
1437,2022-01-14 10:45:00,-1458.2,22528.72000000006,23472.790000000055,-944.0699999999961
1438,2022-01-14 10:50:00,-1948.13,20580.59000000006,23472.790000000055,-2892.199999999997
1439,2022-01-14 10:55:00,-1272.95,19307.640000000058,23472.790000000055,-4165.149999999998
1440,2022-01-14 11:00:00,-1015.21,18292.43000000006,23472.790000000055,-5180.359999999997
1441,2022-01-14 11:05:00,-1346.62,16945.81000000006,23472.790000000055,-6526.979999999996
1442,2022-01-14 11:10:00,-355.31,16590.50000000006,23472.790000000055,-6882.289999999997
1443,2022-01-14 11:15:00,1862.74,18453.24000000006,23472.790000000055,-5019.549999999996
1444,2022-01-14 11:20:00,436.51,18889.75000000006,23472.790000000055,-4583.039999999997
1445,2022-01-14 11:25:00,-834.19,18055.56000000006,23472.790000000055,-5417.229999999996
1446,2022-01-14 11:30:00,1230.15,19285.71000000006,23472.790000000055,-4187.0799999999945
1447,2022-01-14 11:35:00,-866.73,18418.98000000006,23472.790000000055,-5053.809999999994
1448,2022-01-14 11:40:00,-1109.38,17309.60000000006,23472.790000000055,-6163.189999999995
1449,2022-01-14 11:45:00,-1047.19,16262.41000000006,23472.790000000055,-7210.379999999996
1450,2022-01-14 11:50:00,223.82,16486.23000000006,23472.790000000055,-6986.559999999994
1451,2022-01-14 11:55:00,-827.69,15658.54000000006,23472.790000000055,-7814.2499999999945
1452,2022-01-14 12:00:00,1989.56,17648.10000000006,23472.790000000055,-5824.689999999995
1453,2022-01-14 12:05:00,-469.86,17178.24000000006,23472.790000000055,-6294.549999999996
1454,2022-01-14 12:10:00,1534.13,18712.37000000006,23472.790000000055,-4760.419999999995
1455,2022-01-14 12:15:00,1815.91,20528.28000000006,23472.790000000055,-2944.5099999999948
1456,2022-01-14 12:20:00,-1978.02,18550.26000000006,23472.790000000055,-4922.529999999995
1457,2022-01-14 12:25:00,-569.41,17980.85000000006,23472.790000000055,-5491.939999999995
1458,2022-01-14 12:30:00,-594.68,17386.17000000006,23472.790000000055,-6086.619999999995
1459,2022-01-14 12:35:00,-260.08,17126.09000000006,23472.790000000055,-6346.699999999997
1460,2022-01-14 12:40:00,1083.18,18209.27000000006,23472.790000000055,-5263.519999999997
1461,2022-01-14 12:45:00,-1156.87,17052.40000000006,23472.790000000055,-6420.389999999996
1462,2022-01-14 12:50:00,-1881.58,15170.82000000006,23472.790000000055,-8301.969999999996
1463,2022-01-14 12:55:00,518.43,15689.25000000006,23472.790000000055,-7783.539999999995
1464,2022-01-14 13:00:00,1250.65,16939.90000000006,23472.790000000055,-6532.889999999996
1465,2022-01-14 13:05:00,1803.19,18743.09000000006,23472.790000000055,-4729.699999999997
1466,2022-01-14 13:10:00,-1504.84,17238.25000000006,23472.790000000055,-6234.539999999997
1467,2022-01-14 13:15:00,-1159.78,16078.470000000058,23472.790000000055,-7394.319999999998
1468,2022-01-14 13:20:00,-697.55,15380.920000000058,23472.790000000055,-8091.869999999997
1469,2022-01-14 13:25:00,549.89,15930.810000000058,23472.790000000055,-7541.979999999998
1470,2022-01-14 13:30:00,-152.61,15778.200000000057,23472.790000000055,-7694.589999999998
1471,2022-01-14 13:35:00,303.83,16082.030000000057,23472.790000000055,-7390.759999999998
1472,2022-01-14 13:40:00,1791.19,17873.220000000056,23472.790000000055,-5599.57
1473,2022-01-14 13:45:00,1544.75,19417.970000000056,23472.790000000055,-4054.8199999999997
1474,2022-01-14 13:50:00,-1261.52,18156.450000000055,23472.790000000055,-5316.34
1475,2022-01-14 13:55:00,-1721.16,16435.290000000055,23472.790000000055,-7037.5
1476,2022-01-14 14:00:00,-1333.85,15101.440000000055,23472.790000000055,-8371.35
1477,2022-01-14 14:05:00,112.04,15213.480000000056,23472.790000000055,-8259.31
1478,2022-01-14 14:10:00,908.09,16121.570000000056,23472.790000000055,-7351.219999999999
1479,2022-01-14 14:15:00,241.29,16362.860000000057,23472.790000000055,-7109.9299999999985
1480,2022-01-14 14:20:00,-376.66,15986.200000000057,23472.790000000055,-7486.589999999998
1481,2022-01-14 14:25:00,1286.7,17272.900000000056,23472.790000000055,-6199.889999999999
1482,2022-01-14 14:30:00,-770.76,16502.140000000058,23472.790000000055,-6970.649999999998
1483,2022-01-14 14:35:00,-1575.37,14926.770000000059,23472.790000000055,-8546.019999999997
1484,2022-01-14 14:40:00,1486.07,16412.84000000006,23472.790000000055,-7059.949999999997
1485,2022-01-14 14:45:00,845.82,17258.660000000058,23472.790000000055,-6214.129999999997
1486,2022-01-14 14:50:00,-262.91,16995.75000000006,23472.790000000055,-6477.039999999997
1487,2022-01-14 14:55:00,732.89,17728.640000000058,23472.790000000055,-5744.149999999998
1488,2022-01-14 15:00:00,1505.25,19233.890000000058,23472.790000000055,-4238.899999999998
1489,2022-01-14 15:05:00,1585.85,20819.740000000056,23472.790000000055,-2653.0499999999993
1490,2022-01-14 15:10:00,-1475.73,19344.010000000057,23472.790000000055,-4128.779999999999
1491,2022-01-14 15:15:00,-1474.33,17869.68000000006,23472.790000000055,-5603.109999999997
1492,2022-01-14 15:20:00,-171.37,17698.31000000006,23472.790000000055,-5774.479999999996
1493,2022-01-14 15:25:00,76.76,17775.070000000058,23472.790000000055,-5697.7199999999975
1494,2022-01-14 15:30:00,-278.83,17496.240000000056,23472.790000000055,-5976.549999999999
1495,2022-01-14 15:35:00,-244.72,17251.520000000055,23472.790000000055,-6221.27
1496,2022-01-14 15:40:00,1636.77,18888.290000000055,23472.790000000055,-4584.5
1497,2022-01-14 15:45:00,-1137.22,17751.070000000054,23472.790000000055,-5721.720000000001
1498,2022-01-14 15:50:00,-954.5,16796.570000000054,23472.790000000055,-6676.220000000001
1499,2022-01-14 15:55:00,140.56,16937.130000000056,23472.790000000055,-6535.66
1500,2022-01-14 16:00:00,417.99,17355.120000000057,23472.790000000055,-6117.669999999998
1501,2022-01-14 16:05:00,197.65,17552.77000000006,23472.790000000055,-5920.019999999997
1502,2022-01-14 16:10:00,-693.41,16859.36000000006,23472.790000000055,-6613.429999999997
1503,2022-01-14 16:15:00,-195.6,16663.76000000006,23472.790000000055,-6809.029999999995
1504,2022-01-14 16:20:00,-1344.87,15318.890000000061,23472.790000000055,-8153.899999999994
1505,2022-01-14 16:25:00,1350.56,16669.450000000063,23472.790000000055,-6803.339999999993
1506,2022-01-14 16:30:00,1998.9,18668.350000000064,23472.790000000055,-4804.439999999991
1507,2022-01-14 16:35:00,784.56,19452.910000000065,23472.790000000055,-4019.87999999999
1508,2022-01-14 16:40:00,-654.09,18798.820000000065,23472.790000000055,-4673.96999999999
1509,2022-01-14 16:45:00,226.62,19025.440000000064,23472.790000000055,-4447.349999999991
1510,2022-01-14 16:50:00,1992.0,21017.440000000064,23472.790000000055,-2455.3499999999913
1511,2022-01-14 16:55:00,-57.9,20959.540000000063,23472.790000000055,-2513.2499999999927
1512,2022-01-15 08:00:00,1697.69,22657.23000000006,20959.540000000063,1697.6899999999987
1513,2022-01-15 08:05:00,123.42,22780.65000000006,20959.540000000063,1821.109999999997
1514,2022-01-15 08:10:00,-1254.2,21526.45000000006,20959.540000000063,566.9099999999962
1515,2022-01-15 08:15:00,-1523.92,20002.530000000057,20959.540000000063,-957.0100000000057
1516,2022-01-15 08:20:00,-689.07,19313.460000000057,20959.540000000063,-1646.0800000000054
1517,2022-01-15 08:25:00,505.79,19819.25000000006,20959.540000000063,-1140.2900000000045
1518,2022-01-15 08:30:00,-1778.67,18040.58000000006,20959.540000000063,-2918.9600000000028
1519,2022-01-15 08:35:00,778.91,18819.49000000006,20959.540000000063,-2140.050000000003
1520,2022-01-15 08:40:00,-503.47,18316.02000000006,20959.540000000063,-2643.520000000004
1521,2022-01-15 08:45:00,1326.13,19642.15000000006,20959.540000000063,-1317.390000000003
1522,2022-01-15 08:50:00,1847.72,21489.87000000006,20959.540000000063,530.3299999999981
1523,2022-01-15 08:55:00,1893.26,23383.13000000006,20959.540000000063,2423.5899999999965
1524,2022-01-15 09:00:00,-1921.1,21462.03000000006,20959.540000000063,502.48999999999796
1525,2022-01-15 09:05:00,-1080.25,20381.78000000006,20959.540000000063,-577.760000000002
1526,2022-01-15 09:10:00,-1154.09,19227.69000000006,20959.540000000063,-1731.8500000000022
1527,2022-01-15 09:15:00,-788.1,18439.590000000062,20959.540000000063,-2519.9500000000007
1528,2022-01-15 09:20:00,482.25,18921.840000000062,20959.540000000063,-2037.7000000000007
1529,2022-01-15 09:25:00,-1528.05,17393.790000000063,20959.540000000063,-3565.75
1530,2022-01-15 09:30:00,-1805.68,15588.110000000062,20959.540000000063,-5371.43
1531,2022-01-15 09:35:00,-952.92,14635.190000000062,20959.540000000063,-6324.35
1532,2022-01-15 09:40:00,-1559.08,13076.110000000062,20959.540000000063,-7883.43
1533,2022-01-15 09:45:00,-653.51,12422.600000000062,20959.540000000063,-8536.94
1534,2022-01-15 09:50:00,1337.85,13760.450000000063,20959.540000000063,-7199.09
1535,2022-01-15 09:55:00,-1036.86,12723.590000000062,20959.540000000063,-8235.95
1536,2022-01-15 10:00:00,875.64,13599.230000000061,20959.540000000063,-7360.310000000001
1537,2022-01-15 10:05:00,382.13,13981.36000000006,20959.540000000063,-6978.180000000002
1538,2022-01-15 10:10:00,979.64,14961.00000000006,20959.540000000063,-5998.540000000003
1539,2022-01-15 10:15:00,-1813.15,13147.85000000006,20959.540000000063,-7811.690000000002
1540,2022-01-15 10:20:00,-1577.91,11569.94000000006,20959.540000000063,-9389.600000000002
1541,2022-01-15 10:25:00,-1026.22,10543.720000000061,20959.540000000063,-10415.820000000002
1542,2022-01-15 10:30:00,-7.49,10536.230000000061,20959.540000000063,-10423.310000000001
1543,2022-01-15 10:35:00,701.21,11237.44000000006,20959.540000000063,-9722.100000000002
1544,2022-01-15 10:40:00,1436.7,12674.140000000061,20959.540000000063,-8285.400000000001
1545,2022-01-15 10:45:00,223.9,12898.04000000006,20959.540000000063,-8061.500000000002
1546,2022-01-15 10:50:00,1491.11,14389.150000000061,20959.540000000063,-6570.390000000001
1547,2022-01-15 10:55:00,-419.09,13970.060000000061,20959.540000000063,-6989.480000000001
1548,2022-01-15 11:00:00,1714.03,15684.090000000062,20959.540000000063,-5275.450000000001
1549,2022-01-15 11:05:00,1759.94,17444.03000000006,20959.540000000063,-3515.510000000002
1550,2022-01-15 11:10:00,432.1,17876.13000000006,20959.540000000063,-3083.4100000000035
1551,2022-01-15 11:15:00,397.92,18274.050000000057,20959.540000000063,-2685.4900000000052
1552,2022-01-15 11:20:00,-466.51,17807.54000000006,20959.540000000063,-3152.0000000000036
1553,2022-01-15 11:25:00,-1389.34,16418.20000000006,20959.540000000063,-4541.340000000004
1554,2022-01-15 11:30:00,-84.52,16333.680000000058,20959.540000000063,-4625.860000000004
1555,2022-01-15 11:35:00,5.52,16339.200000000059,20959.540000000063,-4620.340000000004
1556,2022-01-15 11:40:00,890.6,17229.800000000057,20959.540000000063,-3729.7400000000052
1557,2022-01-15 11:45:00,34.73,17264.530000000057,20959.540000000063,-3695.0100000000057
1558,2022-01-15 11:50:00,-621.55,16642.980000000058,20959.540000000063,-4316.560000000005
1559,2022-01-15 11:55:00,-1531.1,15111.880000000057,20959.540000000063,-5847.660000000005
1560,2022-01-15 12:00:00,1788.04,16899.920000000056,20959.540000000063,-4059.6200000000063
1561,2022-01-15 12:05:00,247.41,17147.330000000056,20959.540000000063,-3812.2100000000064
1562,2022-01-15 12:10:00,253.25,17400.580000000056,20959.540000000063,-3558.9600000000064
1563,2022-01-15 12:15:00,1319.65,18720.230000000058,20959.540000000063,-2239.310000000005
1564,2022-01-15 12:20:00,1520.79,20241.02000000006,20959.540000000063,-718.5200000000041
1565,2022-01-15 12:25:00,-1778.01,18463.01000000006,20959.540000000063,-2496.5300000000025
1566,2022-01-15 12:30:00,905.03,19368.04000000006,20959.540000000063,-1591.5000000000036
1567,2022-01-15 12:35:00,-396.66,18971.38000000006,20959.540000000063,-1988.1600000000035
1568,2022-01-15 12:40:00,882.13,19853.51000000006,20959.540000000063,-1106.0300000000025
1569,2022-01-15 12:45:00,-1772.41,18081.10000000006,20959.540000000063,-2878.4400000000023
1570,2022-01-15 12:50:00,-1688.71,16392.39000000006,20959.540000000063,-4567.1500000000015
1571,2022-01-15 12:55:00,959.8,17352.19000000006,20959.540000000063,-3607.350000000002
1572,2022-01-15 13:00:00,1264.44,18616.63000000006,20959.540000000063,-2342.9100000000035
1573,2022-01-15 13:05:00,1838.4,20455.03000000006,20959.540000000063,-504.51000000000204
1574,2022-01-15 13:10:00,526.75,20981.78000000006,20959.540000000063,22.239999999997963
1575,2022-01-15 13:15:00,-1994.19,18987.590000000062,20959.540000000063,-1971.9500000000007
1576,2022-01-15 13:20:00,-1955.32,17032.270000000062,20959.540000000063,-3927.2700000000004
1577,2022-01-15 13:25:00,1808.03,18840.30000000006,20959.540000000063,-2119.2400000000016
1578,2022-01-15 13:30:00,-1016.62,17823.680000000062,20959.540000000063,-3135.8600000000006
1579,2022-01-15 13:35:00,863.81,18687.490000000063,20959.540000000063,-2272.0499999999993
1580,2022-01-15 13:40:00,1239.47,19926.960000000065,20959.540000000063,-1032.579999999998
1581,2022-01-15 13:45:00,-741.79,19185.170000000064,20959.540000000063,-1774.369999999999
1582,2022-01-15 13:50:00,283.99,19469.160000000065,20959.540000000063,-1490.3799999999974
1583,2022-01-15 13:55:00,1875.1,21344.260000000064,20959.540000000063,384.72000000000116
1584,2022-01-15 14:00:00,1447.67,22791.930000000066,20959.540000000063,1832.390000000003
1585,2022-01-15 14:05:00,-1686.22,21105.710000000065,20959.540000000063,146.1700000000019
1586,2022-01-15 14:10:00,1709.56,22815.270000000066,20959.540000000063,1855.7300000000032
1587,2022-01-15 14:15:00,-1419.06,21396.210000000065,20959.540000000063,436.6700000000019
1588,2022-01-15 14:20:00,-425.4,20970.810000000063,20959.540000000063,11.270000000000437
1589,2022-01-15 14:25:00,331.44,21302.250000000062,20959.540000000063,342.7099999999991
1590,2022-01-15 14:30:00,1342.04,22644.290000000063,20959.540000000063,1684.75
1591,2022-01-15 14:35:00,-1323.63,21320.66000000006,20959.540000000063,361.119999999999
1592,2022-01-15 14:40:00,1537.5,22858.16000000006,20959.540000000063,1898.619999999999
1593,2022-01-15 14:45:00,773.56,23631.720000000063,20959.540000000063,2672.1800000000003
1594,2022-01-15 14:50:00,-1973.64,21658.080000000064,20959.540000000063,698.5400000000009
1595,2022-01-15 14:55:00,1744.98,23403.060000000063,20959.540000000063,2443.5200000000004
1596,2022-01-15 15:00:00,117.45,23520.510000000064,20959.540000000063,2560.970000000001
1597,2022-01-15 15:05:00,-1518.59,22001.920000000064,20959.540000000063,1042.380000000001
1598,2022-01-15 15:10:00,-618.25,21383.670000000064,20959.540000000063,424.130000000001
1599,2022-01-15 15:15:00,-395.51,20988.160000000065,20959.540000000063,28.62000000000262
1600,2022-01-15 15:20:00,-1485.77,19502.390000000065,20959.540000000063,-1457.1499999999978
1601,2022-01-15 15:25:00,1779.68,21282.070000000065,20959.540000000063,322.5300000000025
1602,2022-01-15 15:30:00,1933.39,23215.460000000065,20959.540000000063,2255.920000000002
1603,2022-01-15 15:35:00,1835.5,25050.960000000065,20959.540000000063,4091.420000000002
1604,2022-01-15 15:40:00,-68.69,24982.270000000066,20959.540000000063,4022.730000000003
1605,2022-01-15 15:45:00,733.4,25715.670000000067,20959.540000000063,4756.130000000005
1606,2022-01-15 15:50:00,-1679.6,24036.07000000007,20959.540000000063,3076.530000000006
1607,2022-01-15 15:55:00,-482.13,23553.940000000068,20959.540000000063,2594.400000000005
1608,2022-01-15 16:00:00,278.23,23832.170000000067,20959.540000000063,2872.6300000000047
1609,2022-01-15 16:05:00,-1751.7,22080.470000000067,20959.540000000063,1120.930000000004
1610,2022-01-15 16:10:00,1207.78,23288.250000000065,20959.540000000063,2328.7100000000028
1611,2022-01-15 16:15:00,1980.09,25268.340000000066,20959.540000000063,4308.800000000003
1612,2022-01-15 16:20:00,-1234.82,24033.520000000066,20959.540000000063,3073.980000000003
1613,2022-01-15 16:25:00,61.65,24095.170000000067,20959.540000000063,3135.6300000000047
1614,2022-01-15 16:30:00,1914.02,26009.190000000068,20959.540000000063,5049.650000000005
1615,2022-01-15 16:35:00,-65.99,25943.200000000066,20959.540000000063,4983.6600000000035
1616,2022-01-15 16:40:00,-659.14,25284.060000000067,20959.540000000063,4324.520000000004
1617,2022-01-15 16:45:00,-435.49,24848.570000000065,20959.540000000063,3889.0300000000025
1618,2022-01-15 16:50:00,-162.89,24685.680000000066,20959.540000000063,3726.140000000003
1619,2022-01-15 16:55:00,-137.25,24548.430000000066,20959.540000000063,3588.890000000003
1620,2022-01-16 08:00:00,-1680.19,22868.240000000067,24548.430000000066,-1680.1899999999987
1621,2022-01-16 08:05:00,964.26,23832.500000000065,24548.430000000066,-715.9300000000003
1622,2022-01-16 08:10:00,-1236.36,22596.140000000065,24548.430000000066,-1952.2900000000009
1623,2022-01-16 08:15:00,-984.06,21612.080000000064,24548.430000000066,-2936.350000000002
1624,2022-01-16 08:20:00,-95.87,21516.210000000065,24548.430000000066,-3032.220000000001
1625,2022-01-16 08:25:00,-1161.0,20355.210000000065,24548.430000000066,-4193.220000000001
1626,2022-01-16 08:30:00,-1518.16,18837.050000000065,24548.430000000066,-5711.380000000001
1627,2022-01-16 08:35:00,-1448.45,17388.600000000064,24548.430000000066,-7159.830000000002
1628,2022-01-16 08:40:00,-515.62,16872.980000000065,24548.430000000066,-7675.450000000001
1629,2022-01-16 08:45:00,-324.41,16548.570000000065,24548.430000000066,-7999.860000000001
1630,2022-01-16 08:50:00,788.53,17337.100000000064,24548.430000000066,-7211.330000000002
1631,2022-01-16 08:55:00,-1246.37,16090.730000000065,24548.430000000066,-8457.7
1632,2022-01-16 09:00:00,-566.49,15524.240000000065,24548.430000000066,-9024.19
1633,2022-01-16 09:05:00,1138.27,16662.510000000064,24548.430000000066,-7885.920000000002
1634,2022-01-16 09:10:00,-1098.13,15564.380000000063,24548.430000000066,-8984.050000000003
1635,2022-01-16 09:15:00,-386.18,15178.200000000063,24548.430000000066,-9370.230000000003
1636,2022-01-16 09:20:00,1437.34,16615.540000000063,24548.430000000066,-7932.890000000003
1637,2022-01-16 09:25:00,-275.28,16340.260000000062,24548.430000000066,-8208.170000000004
1638,2022-01-16 09:30:00,1557.7,17897.96000000006,24548.430000000066,-6650.470000000005
1639,2022-01-16 09:35:00,-787.84,17110.12000000006,24548.430000000066,-7438.310000000005
1640,2022-01-16 09:40:00,-1070.26,16039.86000000006,24548.430000000066,-8508.570000000005
1641,2022-01-16 09:45:00,-1084.16,14955.70000000006,24548.430000000066,-9592.730000000005
1642,2022-01-16 09:50:00,-717.97,14237.730000000061,24548.430000000066,-10310.700000000004
1643,2022-01-16 09:55:00,958.04,15195.770000000062,24548.430000000066,-9352.660000000003
1644,2022-01-16 10:00:00,1125.1,16320.870000000063,24548.430000000066,-8227.560000000003
1645,2022-01-16 10:05:00,1059.17,17380.040000000063,24548.430000000066,-7168.390000000003
1646,2022-01-16 10:10:00,-781.02,16599.020000000062,24548.430000000066,-7949.4100000000035
1647,2022-01-16 10:15:00,-721.41,15877.610000000062,24548.430000000066,-8670.820000000003
1648,2022-01-16 10:20:00,-1447.66,14429.950000000063,24548.430000000066,-10118.480000000003
1649,2022-01-16 10:25:00,-604.73,13825.220000000063,24548.430000000066,-10723.210000000003
1650,2022-01-16 10:30:00,-1660.8,12164.420000000064,24548.430000000066,-12384.010000000002
1651,2022-01-16 10:35:00,483.29,12647.710000000065,24548.430000000066,-11900.720000000001
1652,2022-01-16 10:40:00,-1181.89,11465.820000000065,24548.430000000066,-13082.61
1653,2022-01-16 10:45:00,1647.63,13113.450000000066,24548.430000000066,-11434.98
1654,2022-01-16 10:50:00,505.94,13619.390000000067,24548.430000000066,-10929.039999999999
1655,2022-01-16 10:55:00,502.83,14122.220000000067,24548.430000000066,-10426.21
1656,2022-01-16 11:00:00,-901.73,13220.490000000067,24548.430000000066,-11327.939999999999
1657,2022-01-16 11:05:00,1000.92,14221.410000000067,24548.430000000066,-10327.019999999999
1658,2022-01-16 11:10:00,-1200.58,13020.830000000067,24548.430000000066,-11527.599999999999
1659,2022-01-16 11:15:00,1397.49,14418.320000000067,24548.430000000066,-10130.109999999999
1660,2022-01-16 11:20:00,-442.74,13975.580000000067,24548.430000000066,-10572.849999999999
1661,2022-01-16 11:25:00,-1474.79,12500.790000000066,24548.430000000066,-12047.64
1662,2022-01-16 11:30:00,1985.93,14486.720000000067,24548.430000000066,-10061.71
1663,2022-01-16 11:35:00,449.73,14936.450000000066,24548.430000000066,-9611.98
1664,2022-01-16 11:40:00,-382.02,14554.430000000066,24548.430000000066,-9994.0
1665,2022-01-16 11:45:00,-399.69,14154.740000000065,24548.430000000066,-10393.69
1666,2022-01-16 11:50:00,-493.34,13661.400000000065,24548.430000000066,-10887.03
1667,2022-01-16 11:55:00,1134.54,14795.940000000064,24548.430000000066,-9752.490000000002
1668,2022-01-16 12:00:00,-1636.76,13159.180000000064,24548.430000000066,-11389.250000000002
1669,2022-01-16 12:05:00,-1225.8,11933.380000000065,24548.430000000066,-12615.050000000001
1670,2022-01-16 12:10:00,338.38,12271.760000000064,24548.430000000066,-12276.670000000002
1671,2022-01-16 12:15:00,-1788.35,10483.410000000064,24548.430000000066,-14065.020000000002
1672,2022-01-16 12:20:00,1448.01,11931.420000000064,24548.430000000066,-12617.010000000002
1673,2022-01-16 12:25:00,1866.96,13798.380000000063,24548.430000000066,-10750.050000000003
1674,2022-01-16 12:30:00,1141.84,14940.220000000063,24548.430000000066,-9608.210000000003
1675,2022-01-16 12:35:00,1310.41,16250.630000000063,24548.430000000066,-8297.800000000003
1676,2022-01-16 12:40:00,-1365.65,14884.980000000063,24548.430000000066,-9663.450000000003
1677,2022-01-16 12:45:00,-728.33,14156.650000000063,24548.430000000066,-10391.780000000002
1678,2022-01-16 12:50:00,1737.51,15894.160000000064,24548.430000000066,-8654.270000000002
1679,2022-01-16 12:55:00,964.47,16858.630000000063,24548.430000000066,-7689.800000000003
1680,2022-01-16 13:00:00,1343.14,18201.770000000062,24548.430000000066,-6346.6600000000035
1681,2022-01-16 13:05:00,1866.37,20068.14000000006,24548.430000000066,-4480.2900000000045
1682,2022-01-16 13:10:00,292.64,20360.78000000006,24548.430000000066,-4187.650000000005
1683,2022-01-16 13:15:00,-30.6,20330.180000000062,24548.430000000066,-4218.250000000004
1684,2022-01-16 13:20:00,1806.08,22136.26000000006,24548.430000000066,-2412.1700000000055
1685,2022-01-16 13:25:00,943.52,23079.78000000006,24548.430000000066,-1468.650000000005
1686,2022-01-16 13:30:00,836.5,23916.28000000006,24548.430000000066,-632.1500000000051
1687,2022-01-16 13:35:00,-1970.51,21945.770000000062,24548.430000000066,-2602.6600000000035
1688,2022-01-16 13:40:00,-1327.14,20618.630000000063,24548.430000000066,-3929.800000000003
1689,2022-01-16 13:45:00,-1825.25,18793.380000000063,24548.430000000066,-5755.050000000003
1690,2022-01-16 13:50:00,-1793.79,16999.590000000062,24548.430000000066,-7548.840000000004
1691,2022-01-16 13:55:00,761.89,17761.48000000006,24548.430000000066,-6786.950000000004
1692,2022-01-16 14:00:00,752.8,18514.28000000006,24548.430000000066,-6034.150000000005
1693,2022-01-16 14:05:00,718.8,19233.08000000006,24548.430000000066,-5315.350000000006
1694,2022-01-16 14:10:00,-415.32,18817.76000000006,24548.430000000066,-5730.6700000000055
1695,2022-01-16 14:15:00,-453.38,18364.38000000006,24548.430000000066,-6184.050000000007
1696,2022-01-16 14:20:00,-258.36,18106.02000000006,24548.430000000066,-6442.410000000007
1697,2022-01-16 14:25:00,-528.93,17577.09000000006,24548.430000000066,-6971.340000000007
1698,2022-01-16 14:30:00,858.76,18435.850000000057,24548.430000000066,-6112.580000000009
1699,2022-01-16 14:35:00,650.86,19086.710000000057,24548.430000000066,-5461.720000000008
1700,2022-01-16 14:40:00,-1439.0,17647.710000000057,24548.430000000066,-6900.720000000008
1701,2022-01-16 14:45:00,684.39,18332.100000000057,24548.430000000066,-6216.330000000009
1702,2022-01-16 14:50:00,1738.65,20070.75000000006,24548.430000000066,-4477.680000000008
1703,2022-01-16 14:55:00,-1247.61,18823.140000000058,24548.430000000066,-5725.290000000008
1704,2022-01-16 15:00:00,-28.77,18794.370000000057,24548.430000000066,-5754.060000000009
1705,2022-01-16 15:05:00,344.82,19139.190000000057,24548.430000000066,-5409.240000000009
1706,2022-01-16 15:10:00,1421.68,20560.870000000057,24548.430000000066,-3987.5600000000086
1707,2022-01-16 15:15:00,-88.14,20472.730000000058,24548.430000000066,-4075.700000000008
1708,2022-01-16 15:20:00,1419.29,21892.02000000006,24548.430000000066,-2656.410000000007
1709,2022-01-16 15:25:00,-594.31,21297.710000000057,24548.430000000066,-3250.7200000000084
1710,2022-01-16 15:30:00,880.31,22178.02000000006,24548.430000000066,-2370.410000000007
1711,2022-01-16 15:35:00,94.32,22272.34000000006,24548.430000000066,-2276.0900000000074
1712,2022-01-16 15:40:00,-1034.91,21237.43000000006,24548.430000000066,-3311.0000000000073
1713,2022-01-16 15:45:00,1026.7,22264.13000000006,24548.430000000066,-2284.3000000000065
1714,2022-01-16 15:50:00,-817.68,21446.45000000006,24548.430000000066,-3101.980000000007
1715,2022-01-16 15:55:00,422.09,21868.54000000006,24548.430000000066,-2679.8900000000067
1716,2022-01-16 16:00:00,-475.36,21393.18000000006,24548.430000000066,-3155.2500000000073
1717,2022-01-16 16:05:00,1411.46,22804.640000000058,24548.430000000066,-1743.7900000000081
1718,2022-01-16 16:10:00,-305.26,22499.38000000006,24548.430000000066,-2049.0500000000065
1719,2022-01-16 16:15:00,1071.2,23570.58000000006,24548.430000000066,-977.8500000000058
1720,2022-01-16 16:20:00,710.08,24280.66000000006,24548.430000000066,-267.7700000000041
1721,2022-01-16 16:25:00,-1964.68,22315.98000000006,24548.430000000066,-2232.4500000000044
1722,2022-01-16 16:30:00,-1306.73,21009.250000000062,24548.430000000066,-3539.180000000004
1723,2022-01-16 16:35:00,261.19,21270.44000000006,24548.430000000066,-3277.9900000000052
1724,2022-01-16 16:40:00,-827.01,20443.430000000062,24548.430000000066,-4105.000000000004
1725,2022-01-16 16:45:00,-1210.7,19232.73000000006,24548.430000000066,-5315.700000000004
1726,2022-01-16 16:50:00,-1297.63,17935.10000000006,24548.430000000066,-6613.330000000005
1727,2022-01-16 16:55:00,-838.44,17096.66000000006,24548.430000000066,-7451.770000000004
1728,2022-01-17 08:00:00,-837.37,16259.29000000006,17096.66000000006,-837.3700000000008
1729,2022-01-17 08:05:00,391.81,16651.10000000006,17096.66000000006,-445.5600000000013
1730,2022-01-17 08:10:00,-695.18,15955.92000000006,17096.66000000006,-1140.7400000000016
1731,2022-01-17 08:15:00,816.94,16772.86000000006,17096.66000000006,-323.8000000000029
1732,2022-01-17 08:20:00,1071.24,17844.10000000006,17096.66000000006,747.4399999999987
1733,2022-01-17 08:25:00,1053.28,18897.38000000006,17096.66000000006,1800.7199999999975
1734,2022-01-17 08:30:00,126.52,19023.90000000006,17096.66000000006,1927.239999999998
1735,2022-01-17 08:35:00,1211.57,20235.47000000006,17096.66000000006,3138.8099999999977
1736,2022-01-17 08:40:00,1315.07,21550.54000000006,17096.66000000006,4453.879999999997
1737,2022-01-17 08:45:00,-941.93,20608.61000000006,17096.66000000006,3511.949999999997
1738,2022-01-17 08:50:00,1729.78,22338.390000000058,17096.66000000006,5241.729999999996
1739,2022-01-17 08:55:00,180.47,22518.86000000006,17096.66000000006,5422.199999999997
1740,2022-01-17 09:00:00,20.72,22539.58000000006,17096.66000000006,5442.919999999998
1741,2022-01-17 09:05:00,-908.25,21631.33000000006,17096.66000000006,4534.669999999998
1742,2022-01-17 09:10:00,631.25,22262.58000000006,17096.66000000006,5165.919999999998
1743,2022-01-17 09:15:00,1399.32,23661.90000000006,17096.66000000006,6565.239999999998
1744,2022-01-17 09:20:00,-1151.04,22510.86000000006,17096.66000000006,5414.199999999997
1745,2022-01-17 09:25:00,848.54,23359.40000000006,17096.66000000006,6262.739999999998
1746,2022-01-17 09:30:00,-713.13,22646.27000000006,17096.66000000006,5549.609999999997
1747,2022-01-17 09:35:00,-1057.4,21588.870000000057,17096.66000000006,4492.2099999999955
1748,2022-01-17 09:40:00,-903.54,20685.330000000056,17096.66000000006,3588.6699999999946
1749,2022-01-17 09:45:00,-229.69,20455.640000000058,17096.66000000006,3358.979999999996
1750,2022-01-17 09:50:00,-865.1,19590.54000000006,17096.66000000006,2493.8799999999974
1751,2022-01-17 09:55:00,1622.06,21212.60000000006,17096.66000000006,4115.939999999999
1752,2022-01-17 10:00:00,-883.39,20329.21000000006,17096.66000000006,3232.5499999999993
1753,2022-01-17 10:05:00,-1317.67,19011.54000000006,17096.66000000006,1914.8799999999974
1754,2022-01-17 10:10:00,-1407.75,17603.79000000006,17096.66000000006,507.1299999999974
1755,2022-01-17 10:15:00,1784.15,19387.94000000006,17096.66000000006,2291.279999999999
1756,2022-01-17 10:20:00,789.46,20177.40000000006,17096.66000000006,3080.739999999998
1757,2022-01-17 10:25:00,1013.62,21191.02000000006,17096.66000000006,4094.359999999997
1758,2022-01-17 10:30:00,-125.1,21065.92000000006,17096.66000000006,3969.2599999999984
1759,2022-01-17 10:35:00,361.66,21427.58000000006,17096.66000000006,4330.919999999998
1760,2022-01-17 10:40:00,1791.83,23219.41000000006,17096.66000000006,6122.75
1761,2022-01-17 10:45:00,1261.58,24480.990000000063,17096.66000000006,7384.330000000002
1762,2022-01-17 10:50:00,-950.72,23530.270000000062,17096.66000000006,6433.610000000001
1763,2022-01-17 10:55:00,1648.21,25178.48000000006,17096.66000000006,8081.82
1764,2022-01-17 11:00:00,1531.72,26710.200000000063,17096.66000000006,9613.54
1765,2022-01-17 11:05:00,1362.31,28072.510000000064,17096.66000000006,10975.850000000002
1766,2022-01-17 11:10:00,-1712.63,26359.880000000063,17096.66000000006,9263.220000000001
1767,2022-01-17 11:15:00,997.17,27357.05000000006,17096.66000000006,10260.39
1768,2022-01-17 11:20:00,491.49,27848.540000000063,17096.66000000006,10751.880000000001
1769,2022-01-17 11:25:00,-1820.99,26027.55000000006,17096.66000000006,8930.89
1770,2022-01-17 11:30:00,-186.25,25841.30000000006,17096.66000000006,8744.64
1771,2022-01-17 11:35:00,399.5,26240.80000000006,17096.66000000006,9144.14
1772,2022-01-17 11:40:00,-1183.6,25057.200000000063,17096.66000000006,7960.540000000001
1773,2022-01-17 11:45:00,-39.44,25017.760000000064,17096.66000000006,7921.100000000002
1774,2022-01-17 11:50:00,1628.08,26645.840000000062,17096.66000000006,9549.18
1775,2022-01-17 11:55:00,-1140.1,25505.740000000063,17096.66000000006,8409.080000000002
1776,2022-01-17 12:00:00,1617.6,27123.340000000062,17096.66000000006,10026.68
1777,2022-01-17 12:05:00,1160.96,28284.30000000006,17096.66000000006,11187.64
1778,2022-01-17 12:10:00,-902.21,27382.090000000062,17096.66000000006,10285.43
1779,2022-01-17 12:15:00,927.04,28309.130000000063,17096.66000000006,11212.470000000001
1780,2022-01-17 12:20:00,1778.81,30087.940000000064,17096.66000000006,12991.280000000002
1781,2022-01-17 12:25:00,458.04,30545.980000000065,17096.66000000006,13449.320000000003
1782,2022-01-17 12:30:00,-1478.41,29067.570000000065,17096.66000000006,11970.910000000003
1783,2022-01-17 12:35:00,1329.01,30396.580000000064,17096.66000000006,13299.920000000002
1784,2022-01-17 12:40:00,-1377.62,29018.960000000065,17096.66000000006,11922.300000000003
1785,2022-01-17 12:45:00,-775.08,28243.880000000063,17096.66000000006,11147.220000000001
1786,2022-01-17 12:50:00,59.54,28303.420000000064,17096.66000000006,11206.760000000002
1787,2022-01-17 12:55:00,825.58,29129.000000000065,17096.66000000006,12032.340000000004
1788,2022-01-17 13:00:00,351.25,29480.250000000065,17096.66000000006,12383.590000000004
1789,2022-01-17 13:05:00,-666.54,28813.710000000065,17096.66000000006,11717.050000000003
1790,2022-01-17 13:10:00,1690.15,30503.860000000066,17096.66000000006,13407.200000000004
1791,2022-01-17 13:15:00,368.59,30872.450000000066,17096.66000000006,13775.790000000005
1792,2022-01-17 13:20:00,1054.3,31926.750000000065,17096.66000000006,14830.090000000004
1793,2022-01-17 13:25:00,-277.76,31648.990000000067,17096.66000000006,14552.330000000005
1794,2022-01-17 13:30:00,657.7,32306.690000000068,17096.66000000006,15210.030000000006
1795,2022-01-17 13:35:00,1635.42,33942.110000000066,17096.66000000006,16845.450000000004
1796,2022-01-17 13:40:00,-660.58,33281.530000000064,17096.66000000006,16184.870000000003
1797,2022-01-17 13:45:00,-472.35,32809.180000000066,17096.66000000006,15712.520000000004
1798,2022-01-17 13:50:00,112.75,32921.930000000066,17096.66000000006,15825.270000000004
1799,2022-01-17 13:55:00,-928.15,31993.780000000064,17096.66000000006,14897.120000000003
1800,2022-01-17 14:00:00,-279.79,31713.990000000063,17096.66000000006,14617.330000000002
1801,2022-01-17 14:05:00,1550.36,33264.350000000064,17096.66000000006,16167.690000000002
1802,2022-01-17 14:10:00,-930.98,32333.370000000064,17096.66000000006,15236.710000000003
1803,2022-01-17 14:15:00,-913.43,31419.940000000064,17096.66000000006,14323.280000000002
1804,2022-01-17 14:20:00,87.14,31507.080000000064,17096.66000000006,14410.420000000002
1805,2022-01-17 14:25:00,-1311.01,30196.070000000065,17096.66000000006,13099.410000000003
1806,2022-01-17 14:30:00,1524.08,31720.150000000067,17096.66000000006,14623.490000000005
1807,2022-01-17 14:35:00,47.13,31767.280000000068,17096.66000000006,14670.620000000006
1808,2022-01-17 14:40:00,-1007.15,30760.130000000067,17096.66000000006,13663.470000000005
1809,2022-01-17 14:45:00,1987.83,32747.960000000065,17096.66000000006,15651.300000000003
1810,2022-01-17 14:50:00,-587.67,32160.290000000066,17096.66000000006,15063.630000000005
1811,2022-01-17 14:55:00,368.84,32529.130000000067,17096.66000000006,15432.470000000005
1812,2022-01-17 15:00:00,585.01,33114.140000000065,17096.66000000006,16017.480000000003
1813,2022-01-17 15:05:00,1450.33,34564.47000000007,17096.66000000006,17467.810000000005
1814,2022-01-17 15:10:00,500.61,35065.08000000007,17096.66000000006,17968.420000000006
1815,2022-01-17 15:15:00,-769.3,34295.780000000064,17096.66000000006,17199.120000000003
1816,2022-01-17 15:20:00,-1877.98,32417.800000000065,17096.66000000006,15321.140000000003
1817,2022-01-17 15:25:00,-155.53,32262.270000000066,17096.66000000006,15165.610000000004
1818,2022-01-17 15:30:00,-871.48,31390.790000000066,17096.66000000006,14294.130000000005
1819,2022-01-17 15:35:00,-596.66,30794.130000000067,17096.66000000006,13697.470000000005
1820,2022-01-17 15:40:00,-1926.27,28867.860000000066,17096.66000000006,11771.200000000004
1821,2022-01-17 15:45:00,-1262.78,27605.080000000067,17096.66000000006,10508.420000000006
1822,2022-01-17 15:50:00,-551.36,27053.720000000067,17096.66000000006,9957.060000000005
1823,2022-01-17 15:55:00,-1862.04,25191.680000000066,17096.66000000006,8095.020000000004
1824,2022-01-17 16:00:00,-551.69,24639.990000000067,17096.66000000006,7543.330000000005
1825,2022-01-17 16:05:00,939.72,25579.71000000007,17096.66000000006,8483.050000000007
1826,2022-01-17 16:10:00,-1223.65,24356.060000000067,17096.66000000006,7259.400000000005
1827,2022-01-17 16:15:00,-593.76,23762.30000000007,17096.66000000006,6665.640000000007
1828,2022-01-17 16:20:00,-968.85,22793.45000000007,17096.66000000006,5696.790000000008
1829,2022-01-17 16:25:00,1520.42,24313.870000000068,17096.66000000006,7217.210000000006
1830,2022-01-17 16:30:00,-766.47,23547.400000000067,17096.66000000006,6450.740000000005
1831,2022-01-17 16:35:00,1692.45,25239.850000000068,17096.66000000006,8143.190000000006
1832,2022-01-17 16:40:00,-1409.12,23830.73000000007,17096.66000000006,6734.070000000007
1833,2022-01-17 16:45:00,-71.55,23759.18000000007,17096.66000000006,6662.520000000008
1834,2022-01-17 16:50:00,1614.98,25374.16000000007,17096.66000000006,8277.500000000007
1835,2022-01-17 16:55:00,-1542.33,23831.830000000067,17096.66000000006,6735.1700000000055
1836,2022-01-18 08:00:00,-1109.5,22722.330000000067,23831.830000000067,-1109.5
1837,2022-01-18 08:05:00,961.25,23683.580000000067,23831.830000000067,-148.25
1838,2022-01-18 08:10:00,1103.67,24787.250000000065,23831.830000000067,955.4199999999983
1839,2022-01-18 08:15:00,-559.3,24227.950000000066,23831.830000000067,396.119999999999
1840,2022-01-18 08:20:00,880.02,25107.970000000067,23831.830000000067,1276.1399999999994
1841,2022-01-18 08:25:00,-134.89,24973.080000000067,23831.830000000067,1141.25
1842,2022-01-18 08:30:00,1442.54,26415.620000000068,23831.830000000067,2583.790000000001
1843,2022-01-18 08:35:00,1811.11,28226.73000000007,23831.830000000067,4394.9000000000015
1844,2022-01-18 08:40:00,-1890.0,26336.73000000007,23831.830000000067,2504.9000000000015
1845,2022-01-18 08:45:00,123.99,26460.72000000007,23831.830000000067,2628.890000000003
1846,2022-01-18 08:50:00,-1254.7,25206.02000000007,23831.830000000067,1374.1900000000023
1847,2022-01-18 08:55:00,1408.16,26614.18000000007,23831.830000000067,2782.350000000002
1848,2022-01-18 09:00:00,110.29,26724.47000000007,23831.830000000067,2892.640000000003
1849,2022-01-18 09:05:00,-1751.21,24973.26000000007,23831.830000000067,1141.430000000004
1850,2022-01-18 09:10:00,1244.86,26218.12000000007,23831.830000000067,2386.2900000000045
1851,2022-01-18 09:15:00,-69.81,26148.31000000007,23831.830000000067,2316.480000000003
1852,2022-01-18 09:20:00,1621.79,27770.10000000007,23831.830000000067,3938.270000000004
1853,2022-01-18 09:25:00,-98.09,27672.01000000007,23831.830000000067,3840.180000000004
1854,2022-01-18 09:30:00,1969.23,29641.24000000007,23831.830000000067,5809.4100000000035
1855,2022-01-18 09:35:00,269.06,29910.300000000072,23831.830000000067,6078.470000000005
1856,2022-01-18 09:40:00,1096.17,31006.470000000074,23831.830000000067,7174.640000000007
1857,2022-01-18 09:45:00,1168.44,32174.910000000073,23831.830000000067,8343.080000000005
1858,2022-01-18 09:50:00,-1780.38,30394.53000000007,23831.830000000067,6562.700000000004
1859,2022-01-18 09:55:00,1471.45,31865.980000000072,23831.830000000067,8034.150000000005
1860,2022-01-18 10:00:00,1620.02,33486.00000000007,23831.830000000067,9654.170000000006
1861,2022-01-18 10:05:00,368.7,33854.70000000007,23831.830000000067,10022.870000000003
1862,2022-01-18 10:10:00,-576.87,33277.83000000007,23831.830000000067,9446.0
1863,2022-01-18 10:15:00,1118.36,34396.19000000007,23831.830000000067,10564.36
1864,2022-01-18 10:20:00,-1691.1,32705.09000000007,23831.830000000067,8873.260000000002
1865,2022-01-18 10:25:00,-1676.52,31028.57000000007,23831.830000000067,7196.740000000002
1866,2022-01-18 10:30:00,-1525.47,29503.100000000068,23831.830000000067,5671.27
1867,2022-01-18 10:35:00,327.57,29830.670000000067,23831.830000000067,5998.84
1868,2022-01-18 10:40:00,1645.2,31475.870000000068,23831.830000000067,7644.040000000001
1869,2022-01-18 10:45:00,1630.0,33105.87000000007,23831.830000000067,9274.04
1870,2022-01-18 10:50:00,-1106.94,31998.93000000007,23831.830000000067,8167.100000000002
1871,2022-01-18 10:55:00,-1864.12,30134.81000000007,23831.830000000067,6302.980000000003
1872,2022-01-18 11:00:00,1507.97,31642.78000000007,23831.830000000067,7810.950000000004
1873,2022-01-18 11:05:00,-616.2,31026.58000000007,23831.830000000067,7194.750000000004
1874,2022-01-18 11:10:00,-443.68,30582.90000000007,23831.830000000067,6751.070000000003
1875,2022-01-18 11:15:00,-1417.27,29165.63000000007,23831.830000000067,5333.800000000003
1876,2022-01-18 11:20:00,1687.91,30853.54000000007,23831.830000000067,7021.710000000003
1877,2022-01-18 11:25:00,732.84,31586.38000000007,23831.830000000067,7754.550000000003
1878,2022-01-18 11:30:00,-1302.1,30284.28000000007,23831.830000000067,6452.450000000004
1879,2022-01-18 11:35:00,139.6,30423.88000000007,23831.830000000067,6592.050000000003
1880,2022-01-18 11:40:00,1606.34,32030.22000000007,23831.830000000067,8198.390000000003
1881,2022-01-18 11:45:00,399.02,32429.24000000007,23831.830000000067,8597.410000000003
1882,2022-01-18 11:50:00,893.44,33322.68000000007,23831.830000000067,9490.850000000006
1883,2022-01-18 11:55:00,792.04,34114.720000000074,23831.830000000067,10282.890000000007
1884,2022-01-18 12:00:00,294.09,34408.81000000007,23831.830000000067,10576.980000000003
1885,2022-01-18 12:05:00,256.35,34665.16000000007,23831.830000000067,10833.330000000002
1886,2022-01-18 12:10:00,1115.18,35780.34000000007,23831.830000000067,11948.510000000002
1887,2022-01-18 12:15:00,-779.36,35000.98000000007,23831.830000000067,11169.150000000001
1888,2022-01-18 12:20:00,-216.75,34784.23000000007,23831.830000000067,10952.400000000001
1889,2022-01-18 12:25:00,1549.06,36333.290000000066,23831.830000000067,12501.46
1890,2022-01-18 12:30:00,-1987.5,34345.790000000066,23831.830000000067,10513.96
1891,2022-01-18 12:35:00,1070.19,35415.98000000007,23831.830000000067,11584.150000000001
1892,2022-01-18 12:40:00,1176.27,36592.250000000065,23831.830000000067,12760.419999999998
1893,2022-01-18 12:45:00,110.72,36702.97000000007,23831.830000000067,12871.14
1894,2022-01-18 12:50:00,440.21,37143.180000000066,23831.830000000067,13311.349999999999
1895,2022-01-18 12:55:00,-1305.82,35837.360000000066,23831.830000000067,12005.529999999999
1896,2022-01-18 13:00:00,-807.44,35029.920000000064,23831.830000000067,11198.089999999997
1897,2022-01-18 13:05:00,-1302.7,33727.22000000007,23831.830000000067,9895.39
1898,2022-01-18 13:10:00,-75.86,33651.360000000066,23831.830000000067,9819.529999999999
1899,2022-01-18 13:15:00,1471.87,35123.23000000007,23831.830000000067,11291.400000000001
1900,2022-01-18 13:20:00,-617.22,34506.01000000007,23831.830000000067,10674.18
1901,2022-01-18 13:25:00,1866.91,36372.92000000007,23831.830000000067,12541.090000000004
1902,2022-01-18 13:30:00,1198.3,37571.220000000074,23831.830000000067,13739.390000000007
1903,2022-01-18 13:35:00,1369.26,38940.480000000076,23831.830000000067,15108.650000000009
1904,2022-01-18 13:40:00,1574.73,40515.21000000008,23831.830000000067,16683.380000000012
1905,2022-01-18 13:45:00,-1672.03,38843.18000000008,23831.830000000067,15011.350000000013
1906,2022-01-18 13:50:00,-1072.06,37771.12000000008,23831.830000000067,13939.290000000015
1907,2022-01-18 13:55:00,1550.74,39321.86000000008,23831.830000000067,15490.030000000013
1908,2022-01-18 14:00:00,44.24,39366.10000000008,23831.830000000067,15534.270000000011
1909,2022-01-18 14:05:00,1105.29,40471.39000000008,23831.830000000067,16639.560000000012
1910,2022-01-18 14:10:00,1249.13,41720.52000000008,23831.830000000067,17888.69000000001
1911,2022-01-18 14:15:00,119.11,41839.63000000008,23831.830000000067,18007.80000000001
1912,2022-01-18 14:20:00,1013.45,42853.080000000075,23831.830000000067,19021.250000000007
1913,2022-01-18 14:25:00,-400.13,42452.95000000008,23831.830000000067,18621.12000000001
1914,2022-01-18 14:30:00,1112.61,43565.56000000008,23831.830000000067,19733.73000000001
1915,2022-01-18 14:35:00,1032.62,44598.18000000008,23831.830000000067,20766.350000000013
1916,2022-01-18 14:40:00,-1745.35,42852.83000000008,23831.830000000067,19021.000000000015
1917,2022-01-18 14:45:00,355.01,43207.840000000084,23831.830000000067,19376.010000000017
1918,2022-01-18 14:50:00,-1541.24,41666.600000000086,23831.830000000067,17834.77000000002
1919,2022-01-18 14:55:00,-868.88,40797.72000000009,23831.830000000067,16965.89000000002
1920,2022-01-18 15:00:00,933.72,41731.44000000009,23831.830000000067,17899.610000000022
1921,2022-01-18 15:05:00,-954.49,40776.95000000009,23831.830000000067,16945.120000000024
1922,2022-01-18 15:10:00,-1390.21,39386.74000000009,23831.830000000067,15554.910000000025
1923,2022-01-18 15:15:00,-996.95,38389.790000000095,23831.830000000067,14557.960000000028
1924,2022-01-18 15:20:00,-1971.26,36418.53000000009,23831.830000000067,12586.700000000026
1925,2022-01-18 15:25:00,-1474.39,34944.140000000094,23831.830000000067,11112.310000000027
1926,2022-01-18 15:30:00,-490.5,34453.640000000094,23831.830000000067,10621.810000000027
1927,2022-01-18 15:35:00,-603.13,33850.5100000001,23831.830000000067,10018.68000000003
1928,2022-01-18 15:40:00,1363.79,35214.3000000001,23831.830000000067,11382.47000000003
1929,2022-01-18 15:45:00,-394.46,34819.8400000001,23831.830000000067,10988.010000000031
1930,2022-01-18 15:50:00,-856.74,33963.1000000001,23831.830000000067,10131.270000000033
1931,2022-01-18 15:55:00,-1857.26,32105.840000000102,23831.830000000067,8274.010000000035
1932,2022-01-18 16:00:00,309.86,32415.700000000103,23831.830000000067,8583.870000000035
1933,2022-01-18 16:05:00,-1784.01,30631.690000000104,23831.830000000067,6799.860000000037
1934,2022-01-18 16:10:00,-598.8,30032.890000000105,23831.830000000067,6201.060000000038
1935,2022-01-18 16:15:00,709.03,30741.920000000104,23831.830000000067,6910.0900000000365
1936,2022-01-18 16:20:00,1767.84,32509.760000000104,23831.830000000067,8677.930000000037
1937,2022-01-18 16:25:00,1125.22,33634.980000000105,23831.830000000067,9803.150000000038
1938,2022-01-18 16:30:00,-1022.21,32612.770000000106,23831.830000000067,8780.940000000039
1939,2022-01-18 16:35:00,-1222.48,31390.290000000106,23831.830000000067,7558.460000000039
1940,2022-01-18 16:40:00,1078.63,32468.920000000107,23831.830000000067,8637.09000000004
1941,2022-01-18 16:45:00,-25.87,32443.05000000011,23831.830000000067,8611.220000000041
1942,2022-01-18 16:50:00,1073.22,33516.270000000106,23831.830000000067,9684.440000000039
1943,2022-01-18 16:55:00,-317.25,33199.020000000106,23831.830000000067,9367.190000000039
1944,2022-01-19 08:00:00,-1274.31,31924.710000000105,33199.020000000106,-1274.3100000000013
1945,2022-01-19 08:05:00,1642.51,33567.2200000001,33199.020000000106,368.1999999999971
1946,2022-01-19 08:10:00,150.5,33717.7200000001,33199.020000000106,518.6999999999971
1947,2022-01-19 08:15:00,-167.7,33550.020000000106,33199.020000000106,351.0
1948,2022-01-19 08:20:00,172.53,33722.550000000105,33199.020000000106,523.5299999999988
1949,2022-01-19 08:25:00,-1358.47,32364.080000000104,33199.020000000106,-834.9400000000023
1950,2022-01-19 08:30:00,-812.19,31551.890000000105,33199.020000000106,-1647.130000000001
1951,2022-01-19 08:35:00,-1996.85,29555.040000000106,33199.020000000106,-3643.9799999999996
1952,2022-01-19 08:40:00,1175.31,30730.350000000108,33199.020000000106,-2468.6699999999983
1953,2022-01-19 08:45:00,-268.3,30462.05000000011,33199.020000000106,-2736.9699999999975
1954,2022-01-19 08:50:00,-653.32,29808.73000000011,33199.020000000106,-3390.2899999999972
1955,2022-01-19 08:55:00,845.53,30654.260000000108,33199.020000000106,-2544.7599999999984
1956,2022-01-19 09:00:00,-1836.32,28817.940000000108,33199.020000000106,-4381.079999999998
1957,2022-01-19 09:05:00,929.26,29747.200000000106,33199.020000000106,-3451.8199999999997
1958,2022-01-19 09:10:00,-112.66,29634.540000000106,33199.020000000106,-3564.4799999999996
1959,2022-01-19 09:15:00,393.41,30027.950000000106,33199.020000000106,-3171.0699999999997
1960,2022-01-19 09:20:00,1269.17,31297.120000000104,33199.020000000106,-1901.9000000000015
1961,2022-01-19 09:25:00,586.83,31883.950000000106,33199.020000000106,-1315.0699999999997
1962,2022-01-19 09:30:00,-1367.82,30516.130000000107,33199.020000000106,-2682.8899999999994
1963,2022-01-19 09:35:00,764.18,31280.310000000107,33199.020000000106,-1918.7099999999991
1964,2022-01-19 09:40:00,204.77,31485.080000000107,33199.020000000106,-1713.9399999999987
1965,2022-01-19 09:45:00,211.74,31696.82000000011,33199.020000000106,-1502.199999999997
1966,2022-01-19 09:50:00,1569.56,33266.38000000011,33199.020000000106,67.36000000000058
1967,2022-01-19 09:55:00,210.72,33477.10000000011,33199.020000000106,278.08000000000175
1968,2022-01-19 10:00:00,584.68,34061.78000000011,33199.020000000106,862.760000000002
1969,2022-01-19 10:05:00,936.91,34998.69000000011,33199.020000000106,1799.6700000000055
1970,2022-01-19 10:10:00,1870.15,36868.84000000011,33199.020000000106,3669.820000000007
1971,2022-01-19 10:15:00,1278.69,38147.530000000115,33199.020000000106,4948.510000000009
1972,2022-01-19 10:20:00,-258.43,37889.100000000115,33199.020000000106,4690.080000000009
1973,2022-01-19 10:25:00,1443.59,39332.69000000011,33199.020000000106,6133.6700000000055
1974,2022-01-19 10:30:00,-65.51,39267.18000000011,33199.020000000106,6068.1600000000035
1975,2022-01-19 10:35:00,649.99,39917.17000000011,33199.020000000106,6718.1500000000015
1976,2022-01-19 10:40:00,-415.28,39501.89000000011,33199.020000000106,6302.870000000003
1977,2022-01-19 10:45:00,-1538.63,37963.26000000011,33199.020000000106,4764.240000000005
1978,2022-01-19 10:50:00,114.74,38078.00000000011,33199.020000000106,4878.980000000003
1979,2022-01-19 10:55:00,1061.46,39139.46000000011,33199.020000000106,5940.440000000002
1980,2022-01-19 11:00:00,-1600.1,37539.36000000011,33199.020000000106,4340.340000000004
1981,2022-01-19 11:05:00,769.09,38308.450000000106,33199.020000000106,5109.43
1982,2022-01-19 11:10:00,-496.03,37812.42000000011,33199.020000000106,4613.4000000000015
1983,2022-01-19 11:15:00,1539.15,39351.57000000011,33199.020000000106,6152.550000000003
1984,2022-01-19 11:20:00,133.67,39485.24000000011,33199.020000000106,6286.220000000001
1985,2022-01-19 11:25:00,-1834.7,37650.54000000011,33199.020000000106,4451.520000000004
1986,2022-01-19 11:30:00,-1963.94,35686.60000000011,33199.020000000106,2487.5800000000017
1987,2022-01-19 11:35:00,421.42,36108.020000000106,33199.020000000106,2909.0
1988,2022-01-19 11:40:00,1583.9,37691.92000000011,33199.020000000106,4492.9000000000015
1989,2022-01-19 11:45:00,-1282.04,36409.88000000011,33199.020000000106,3210.8600000000006
1990,2022-01-19 11:50:00,961.17,37371.050000000105,33199.020000000106,4172.029999999999
1991,2022-01-19 11:55:00,-1039.25,36331.800000000105,33199.020000000106,3132.779999999999
1992,2022-01-19 12:00:00,755.3,37087.10000000011,33199.020000000106,3888.0800000000017
1993,2022-01-19 12:05:00,1081.37,38168.47000000011,33199.020000000106,4969.450000000004
1994,2022-01-19 12:10:00,-570.33,37598.14000000011,33199.020000000106,4399.120000000003
1995,2022-01-19 12:15:00,-207.9,37390.24000000011,33199.020000000106,4191.220000000001
1996,2022-01-19 12:20:00,-103.4,37286.840000000106,33199.020000000106,4087.8199999999997
1997,2022-01-19 12:25:00,1812.92,39099.760000000104,33199.020000000106,5900.739999999998
1998,2022-01-19 12:30:00,1960.93,41060.690000000104,33199.020000000106,7861.669999999998
1999,2022-01-19 12:35:00,-1985.37,39075.3200000001,33199.020000000106,5876.299999999996
2000,2022-01-19 12:40:00,7.48,39082.800000000105,33199.020000000106,5883.779999999999
2001,2022-01-19 12:45:00,-140.56,38942.24000000011,33199.020000000106,5743.220000000001
2002,2022-01-19 12:50:00,-1870.54,37071.700000000106,33199.020000000106,3872.6800000000003
2003,2022-01-19 12:55:00,-196.71,36874.99000000011,33199.020000000106,3675.970000000001
2004,2022-01-19 13:00:00,-426.48,36448.510000000104,33199.020000000106,3249.489999999998
2005,2022-01-19 13:05:00,-523.66,35924.8500000001,33199.020000000106,2725.8299999999945
2006,2022-01-19 13:10:00,-120.63,35804.2200000001,33199.020000000106,2605.199999999997
2007,2022-01-19 13:15:00,7.73,35811.950000000106,33199.020000000106,2612.9300000000003
2008,2022-01-19 13:20:00,1007.01,36818.96000000011,33199.020000000106,3619.9400000000023
2009,2022-01-19 13:25:00,-1604.94,35214.020000000106,33199.020000000106,2015.0
2010,2022-01-19 13:30:00,171.32,35385.340000000106,33199.020000000106,2186.3199999999997
2011,2022-01-19 13:35:00,342.94,35728.28000000011,33199.020000000106,2529.260000000002
2012,2022-01-19 13:40:00,1205.83,36934.11000000011,33199.020000000106,3735.090000000004
2013,2022-01-19 13:45:00,-1939.71,34994.40000000011,33199.020000000106,1795.3800000000047
2014,2022-01-19 13:50:00,-434.26,34560.14000000011,33199.020000000106,1361.1200000000026
2015,2022-01-19 13:55:00,282.9,34843.04000000011,33199.020000000106,1644.020000000004
2016,2022-01-19 14:00:00,1888.15,36731.19000000011,33199.020000000106,3532.1700000000055
2017,2022-01-19 14:05:00,1938.79,38669.98000000011,33199.020000000106,5470.960000000006
2018,2022-01-19 14:10:00,935.26,39605.240000000114,33199.020000000106,6406.220000000008
2019,2022-01-19 14:15:00,-1159.01,38446.23000000011,33199.020000000106,5247.210000000006
2020,2022-01-19 14:20:00,-1709.03,36737.20000000011,33199.020000000106,3538.1800000000076
2021,2022-01-19 14:25:00,575.03,37312.23000000011,33199.020000000106,4113.210000000006
2022,2022-01-19 14:30:00,-510.7,36801.530000000115,33199.020000000106,3602.5100000000093
2023,2022-01-19 14:35:00,-745.86,36055.670000000115,33199.020000000106,2856.6500000000087
2024,2022-01-19 14:40:00,-731.87,35323.80000000011,33199.020000000106,2124.780000000006
2025,2022-01-19 14:45:00,111.24,35435.04000000011,33199.020000000106,2236.020000000004
2026,2022-01-19 14:50:00,1019.93,36454.97000000011,33199.020000000106,3255.9500000000044
2027,2022-01-19 14:55:00,125.84,36580.81000000011,33199.020000000106,3381.790000000001
2028,2022-01-19 15:00:00,1267.88,37848.690000000104,33199.020000000106,4649.669999999998
2029,2022-01-19 15:05:00,-1244.53,36604.160000000105,33199.020000000106,3405.1399999999994
2030,2022-01-19 15:10:00,79.3,36683.46000000011,33199.020000000106,3484.4400000000023
2031,2022-01-19 15:15:00,-1272.32,35411.14000000011,33199.020000000106,2212.1200000000026
2032,2022-01-19 15:20:00,474.3,35885.44000000011,33199.020000000106,2686.4200000000055
2033,2022-01-19 15:25:00,-1095.75,34789.69000000011,33199.020000000106,1590.6700000000055
2034,2022-01-19 15:30:00,647.45,35437.14000000011,33199.020000000106,2238.1200000000026
2035,2022-01-19 15:35:00,983.15,36420.29000000011,33199.020000000106,3221.270000000004
2036,2022-01-19 15:40:00,-1746.18,34674.11000000011,33199.020000000106,1475.0900000000038
2037,2022-01-19 15:45:00,-1002.04,33672.07000000011,33199.020000000106,473.0500000000029
2038,2022-01-19 15:50:00,198.23,33870.30000000011,33199.020000000106,671.2800000000061
2039,2022-01-19 15:55:00,526.86,34397.16000000011,33199.020000000106,1198.1400000000067
2040,2022-01-19 16:00:00,1461.27,35858.43000000011,33199.020000000106,2659.4100000000035
2041,2022-01-19 16:05:00,967.92,36826.35000000011,33199.020000000106,3627.3300000000017
2042,2022-01-19 16:10:00,-1730.03,35096.32000000011,33199.020000000106,1897.300000000003
2043,2022-01-19 16:15:00,-1473.9,33622.42000000011,33199.020000000106,423.40000000000146
2044,2022-01-19 16:20:00,-1011.55,32610.870000000108,33199.020000000106,-588.1499999999978
2045,2022-01-19 16:25:00,728.11,33338.980000000105,33199.020000000106,139.95999999999913
2046,2022-01-19 16:30:00,1599.19,34938.17000000011,33199.020000000106,1739.1500000000015
2047,2022-01-19 16:35:00,-465.93,34472.24000000011,33199.020000000106,1273.2200000000012
2048,2022-01-19 16:40:00,1520.43,35992.67000000011,33199.020000000106,2793.6500000000015
2049,2022-01-19 16:45:00,664.61,36657.28000000011,33199.020000000106,3458.260000000002
2050,2022-01-19 16:50:00,-111.79,36545.49000000011,33199.020000000106,3346.470000000001
2051,2022-01-19 16:55:00,1203.29,37748.78000000011,33199.020000000106,4549.760000000002
2052,2022-01-20 08:00:00,1002.23,38751.01000000011,37748.78000000011,1002.2300000000032
2053,2022-01-20 08:05:00,500.43,39251.44000000011,37748.78000000011,1502.6600000000035
2054,2022-01-20 08:10:00,-1923.91,37327.53000000011,37748.78000000011,-421.25
2055,2022-01-20 08:15:00,33.01,37360.54000000011,37748.78000000011,-388.23999999999796
2056,2022-01-20 08:20:00,-1604.14,35756.40000000011,37748.78000000011,-1992.3799999999974
2057,2022-01-20 08:25:00,1002.32,36758.72000000011,37748.78000000011,-990.0599999999977
2058,2022-01-20 08:30:00,1507.85,38266.57000000011,37748.78000000011,517.7900000000009
2059,2022-01-20 08:35:00,1139.4,39405.97000000011,37748.78000000011,1657.1900000000023
2060,2022-01-20 08:40:00,-846.35,38559.62000000011,37748.78000000011,810.8400000000038
2061,2022-01-20 08:45:00,796.82,39356.44000000011,37748.78000000011,1607.6600000000035
2062,2022-01-20 08:50:00,1161.71,40518.15000000011,37748.78000000011,2769.3700000000026
2063,2022-01-20 08:55:00,-298.42,40219.73000000011,37748.78000000011,2470.9500000000044
2064,2022-01-20 09:00:00,1220.51,41440.240000000114,37748.78000000011,3691.4600000000064
2065,2022-01-20 09:05:00,-1389.32,40050.920000000115,37748.78000000011,2302.1400000000067
2066,2022-01-20 09:10:00,973.38,41024.30000000011,37748.78000000011,3275.520000000004
2067,2022-01-20 09:15:00,1932.52,42956.82000000011,37748.78000000011,5208.040000000001
2068,2022-01-20 09:20:00,1683.43,44640.25000000011,37748.78000000011,6891.470000000001
2069,2022-01-20 09:25:00,-792.85,43847.40000000011,37748.78000000011,6098.620000000003
2070,2022-01-20 09:30:00,118.62,43966.02000000011,37748.78000000011,6217.240000000005
2071,2022-01-20 09:35:00,956.68,44922.70000000011,37748.78000000011,7173.9200000000055
2072,2022-01-20 09:40:00,-1931.7,42991.00000000012,37748.78000000011,5242.220000000008
2073,2022-01-20 09:45:00,-971.28,42019.72000000012,37748.78000000011,4270.94000000001
2074,2022-01-20 09:50:00,-1877.56,40142.16000000012,37748.78000000011,2393.380000000012
2075,2022-01-20 09:55:00,-1502.02,38640.14000000012,37748.78000000011,891.3600000000151
2076,2022-01-20 10:00:00,504.27,39144.41000000012,37748.78000000011,1395.630000000012
2077,2022-01-20 10:05:00,939.91,40084.32000000012,37748.78000000011,2335.5400000000154
2078,2022-01-20 10:10:00,-1391.48,38692.84000000012,37748.78000000011,944.0600000000122
2079,2022-01-20 10:15:00,-1811.28,36881.56000000012,37748.78000000011,-867.2199999999866
2080,2022-01-20 10:20:00,-137.8,36743.76000000012,37748.78000000011,-1005.0199999999895
2081,2022-01-20 10:25:00,490.85,37234.61000000012,37748.78000000011,-514.169999999991
2082,2022-01-20 10:30:00,-1218.08,36016.530000000115,37748.78000000011,-1732.2499999999927
2083,2022-01-20 10:35:00,1797.11,37813.640000000116,37748.78000000011,64.86000000000786
2084,2022-01-20 10:40:00,-287.61,37526.030000000115,37748.78000000011,-222.74999999999272
2085,2022-01-20 10:45:00,-1441.1,36084.93000000012,37748.78000000011,-1663.8499999999913
2086,2022-01-20 10:50:00,-1136.77,34948.16000000012,37748.78000000011,-2800.619999999988
2087,2022-01-20 10:55:00,1510.12,36458.28000000012,37748.78000000011,-1290.4999999999854
2088,2022-01-20 11:00:00,505.85,36964.13000000012,37748.78000000011,-784.6499999999869
2089,2022-01-20 11:05:00,1447.38,38411.51000000012,37748.78000000011,662.7300000000105
2090,2022-01-20 11:10:00,1640.1,40051.61000000012,37748.78000000011,2302.830000000009
2091,2022-01-20 11:15:00,574.3,40625.91000000012,37748.78000000011,2877.130000000012
2092,2022-01-20 11:20:00,-422.02,40203.89000000012,37748.78000000011,2455.110000000015
2093,2022-01-20 11:25:00,-1560.21,38643.680000000124,37748.78000000011,894.900000000016
2094,2022-01-20 11:30:00,-951.84,37691.84000000013,37748.78000000011,-56.9399999999805
2095,2022-01-20 11:35:00,-28.48,37663.360000000124,37748.78000000011,-85.4199999999837
2096,2022-01-20 11:40:00,767.34,38430.70000000012,37748.78000000011,681.9200000000128
2097,2022-01-20 11:45:00,1938.86,40369.56000000012,37748.78000000011,2620.7800000000134
2098,2022-01-20 11:50:00,-870.72,39498.84000000012,37748.78000000011,1750.0600000000122
2099,2022-01-20 11:55:00,-416.22,39082.62000000012,37748.78000000011,1333.840000000011
2100,2022-01-20 12:00:00,-771.49,38311.13000000012,37748.78000000011,562.3500000000131
2101,2022-01-20 12:05:00,-774.13,37537.000000000124,37748.78000000011,-211.77999999998428
2102,2022-01-20 12:10:00,-35.05,37501.95000000012,37748.78000000011,-246.8299999999872
2103,2022-01-20 12:15:00,-211.71,37290.24000000012,37748.78000000011,-458.5399999999863
2104,2022-01-20 12:20:00,-1132.8,36157.44000000012,37748.78000000011,-1591.3399999999892
2105,2022-01-20 12:25:00,54.69,36212.13000000012,37748.78000000011,-1536.649999999987
2106,2022-01-20 12:30:00,-89.42,36122.71000000012,37748.78000000011,-1626.0699999999852
2107,2022-01-20 12:35:00,1960.59,38083.30000000012,37748.78000000011,334.52000000001135
2108,2022-01-20 12:40:00,-1157.66,36925.640000000116,37748.78000000011,-823.1399999999921
2109,2022-01-20 12:45:00,-713.9,36211.740000000114,37748.78000000011,-1537.0399999999936
2110,2022-01-20 12:50:00,-52.88,36158.86000000012,37748.78000000011,-1589.919999999991
2111,2022-01-20 12:55:00,816.3,36975.16000000012,37748.78000000011,-773.6199999999881
2112,2022-01-20 13:00:00,-211.4,36763.76000000012,37748.78000000011,-985.0199999999895
2113,2022-01-20 13:05:00,1695.48,38459.24000000012,37748.78000000011,710.4600000000137
2114,2022-01-20 13:10:00,19.4,38478.64000000012,37748.78000000011,729.8600000000151
2115,2022-01-20 13:15:00,571.59,39050.23000000012,37748.78000000011,1301.4500000000116
2116,2022-01-20 13:20:00,-56.03,38994.20000000012,37748.78000000011,1245.4200000000128
2117,2022-01-20 13:25:00,-1291.31,37702.89000000012,37748.78000000011,-45.889999999984866
2118,2022-01-20 13:30:00,1204.73,38907.620000000126,37748.78000000011,1158.8400000000183
2119,2022-01-20 13:35:00,1457.53,40365.150000000125,37748.78000000011,2616.370000000017
2120,2022-01-20 13:40:00,1810.56,42175.71000000012,37748.78000000011,4426.930000000015
2121,2022-01-20 13:45:00,-1944.81,40230.900000000125,37748.78000000011,2482.120000000017
2122,2022-01-20 13:50:00,-1118.19,39112.71000000012,37748.78000000011,1363.9300000000148
2123,2022-01-20 13:55:00,650.15,39762.860000000124,37748.78000000011,2014.0800000000163
2124,2022-01-20 14:00:00,-161.87,39600.99000000012,37748.78000000011,1852.2100000000137
2125,2022-01-20 14:05:00,316.2,39917.19000000012,37748.78000000011,2168.4100000000108
2126,2022-01-20 14:10:00,396.96,40314.15000000012,37748.78000000011,2565.37000000001
2127,2022-01-20 14:15:00,741.62,41055.77000000012,37748.78000000011,3306.9900000000125
2128,2022-01-20 14:20:00,-926.03,40129.74000000012,37748.78000000011,2380.9600000000137
2129,2022-01-20 14:25:00,-479.38,39650.360000000124,37748.78000000011,1901.5800000000163
2130,2022-01-20 14:30:00,-626.57,39023.790000000125,37748.78000000011,1275.0100000000166
2131,2022-01-20 14:35:00,-944.86,38078.930000000124,37748.78000000011,330.150000000016
2132,2022-01-20 14:40:00,39.87,38118.80000000013,37748.78000000011,370.0200000000186
2133,2022-01-20 14:45:00,841.33,38960.13000000013,37748.78000000011,1211.3500000000204
2134,2022-01-20 14:50:00,-1131.43,37828.70000000013,37748.78000000011,79.92000000002008
2135,2022-01-20 14:55:00,-256.35,37572.35000000013,37748.78000000011,-176.42999999997846
2136,2022-01-20 15:00:00,1794.82,39367.17000000013,37748.78000000011,1618.3900000000212
2137,2022-01-20 15:05:00,-758.02,38609.15000000013,37748.78000000011,860.3700000000244
2138,2022-01-20 15:10:00,-35.47,38573.68000000013,37748.78000000011,824.9000000000233
2139,2022-01-20 15:15:00,207.07,38780.75000000013,37748.78000000011,1031.970000000023
2140,2022-01-20 15:20:00,1943.34,40724.09000000013,37748.78000000011,2975.3100000000195
2141,2022-01-20 15:25:00,-1604.71,39119.38000000013,37748.78000000011,1370.6000000000204
2142,2022-01-20 15:30:00,-1840.65,37278.73000000013,37748.78000000011,-470.0499999999811
2143,2022-01-20 15:35:00,1068.72,38347.45000000013,37748.78000000011,598.6700000000201
2144,2022-01-20 15:40:00,-1667.7,36679.75000000013,37748.78000000011,-1069.029999999977
2145,2022-01-20 15:45:00,-1969.16,34710.59000000013,37748.78000000011,-3038.1899999999805
2146,2022-01-20 15:50:00,1532.28,36242.870000000126,37748.78000000011,-1505.9099999999817
2147,2022-01-20 15:55:00,-1926.41,34316.46000000012,37748.78000000011,-3432.319999999985
2148,2022-01-20 16:00:00,997.1,35313.56000000012,37748.78000000011,-2435.2199999999866
2149,2022-01-20 16:05:00,-1619.22,33694.34000000012,37748.78000000011,-4054.439999999988
2150,2022-01-20 16:10:00,1075.0,34769.34000000012,37748.78000000011,-2979.439999999988
2151,2022-01-20 16:15:00,1646.96,36416.30000000012,37748.78000000011,-1332.4799999999886
2152,2022-01-20 16:20:00,-14.33,36401.97000000012,37748.78000000011,-1346.8099999999904
2153,2022-01-20 16:25:00,689.36,37091.33000000012,37748.78000000011,-657.4499999999898
2154,2022-01-20 16:30:00,-1061.35,36029.98000000012,37748.78000000011,-1718.7999999999884
2155,2022-01-20 16:35:00,-1519.85,34510.13000000012,37748.78000000011,-3238.649999999987
2156,2022-01-20 16:40:00,-558.05,33952.08000000012,37748.78000000011,-3796.69999999999
2157,2022-01-20 16:45:00,-1432.88,32519.200000000117,37748.78000000011,-5229.579999999991
2158,2022-01-20 16:50:00,1674.1,34193.30000000012,37748.78000000011,-3555.4799999999886
2159,2022-01-20 16:55:00,1859.42,36052.72000000012,37748.78000000011,-1696.0599999999904
2160,2022-01-21 08:00:00,-1620.11,34432.61000000012,36052.72000000012,-1620.1100000000006
2161,2022-01-21 08:05:00,146.45,34579.060000000114,36052.72000000012,-1473.6600000000035
2162,2022-01-21 08:10:00,-455.42,34123.640000000116,36052.72000000012,-1929.0800000000017
2163,2022-01-21 08:15:00,1115.53,35239.170000000115,36052.72000000012,-813.5500000000029
2164,2022-01-21 08:20:00,-903.5,34335.670000000115,36052.72000000012,-1717.050000000003
2165,2022-01-21 08:25:00,748.0,35083.670000000115,36052.72000000012,-969.0500000000029
2166,2022-01-21 08:30:00,-1905.92,33177.75000000012,36052.72000000012,-2874.970000000001
2167,2022-01-21 08:35:00,1548.12,34725.87000000012,36052.72000000012,-1326.8499999999985
2168,2022-01-21 08:40:00,-1344.39,33381.48000000012,36052.72000000012,-2671.239999999998
2169,2022-01-21 08:45:00,1693.85,35075.33000000012,36052.72000000012,-977.3899999999994
2170,2022-01-21 08:50:00,348.81,35424.140000000116,36052.72000000012,-628.5800000000017
2171,2022-01-21 08:55:00,1859.41,37283.55000000012,36052.72000000012,1230.8300000000017
2172,2022-01-21 09:00:00,1287.72,38571.27000000012,36052.72000000012,2518.550000000003
2173,2022-01-21 09:05:00,908.12,39479.39000000012,36052.72000000012,3426.6700000000055
2174,2022-01-21 09:10:00,1470.88,40950.27000000012,36052.72000000012,4897.550000000003
2175,2022-01-21 09:15:00,-1034.59,39915.680000000124,36052.72000000012,3862.9600000000064
2176,2022-01-21 09:20:00,862.05,40777.73000000013,36052.72000000012,4725.010000000009
2177,2022-01-21 09:25:00,1.67,40779.400000000125,36052.72000000012,4726.680000000008
2178,2022-01-21 09:30:00,618.39,41397.790000000125,36052.72000000012,5345.070000000007
2179,2022-01-21 09:35:00,-1807.55,39590.24000000012,36052.72000000012,3537.520000000004
2180,2022-01-21 09:40:00,1018.63,40608.87000000012,36052.72000000012,4556.1500000000015
2181,2022-01-21 09:45:00,1096.02,41704.890000000116,36052.72000000012,5652.169999999998
2182,2022-01-21 09:50:00,267.31,41972.20000000011,36052.72000000012,5919.479999999996
2183,2022-01-21 09:55:00,-1521.9,40450.30000000011,36052.72000000012,4397.5799999999945
2184,2022-01-21 10:00:00,-1101.67,39348.630000000114,36052.72000000012,3295.909999999996
2185,2022-01-21 10:05:00,1053.37,40402.00000000012,36052.72000000012,4349.279999999999
2186,2022-01-21 10:10:00,1735.61,42137.61000000012,36052.72000000012,6084.889999999999
2187,2022-01-21 10:15:00,-249.83,41887.780000000115,36052.72000000012,5835.059999999998
2188,2022-01-21 10:20:00,349.61,42237.390000000116,36052.72000000012,6184.669999999998
2189,2022-01-21 10:25:00,1763.54,44000.93000000012,36052.72000000012,7948.209999999999
2190,2022-01-21 10:30:00,-116.24,43884.69000000012,36052.72000000012,7831.970000000001
2191,2022-01-21 10:35:00,1848.02,45732.710000000116,36052.72000000012,9679.989999999998
2192,2022-01-21 10:40:00,180.68,45913.390000000116,36052.72000000012,9860.669999999998
2193,2022-01-21 10:45:00,-632.58,45280.810000000114,36052.72000000012,9228.089999999997
2194,2022-01-21 10:50:00,561.26,45842.070000000116,36052.72000000012,9789.349999999999
2195,2022-01-21 10:55:00,-1905.52,43936.55000000012,36052.72000000012,7883.830000000002
2196,2022-01-21 11:00:00,-1147.17,42789.38000000012,36052.72000000012,6736.6600000000035
2197,2022-01-21 11:05:00,-1290.83,41498.55000000012,36052.72000000012,5445.830000000002
2198,2022-01-21 11:10:00,1780.85,43279.40000000012,36052.72000000012,7226.68
2199,2022-01-21 11:15:00,612.23,43891.63000000012,36052.72000000012,7838.9100000000035
2200,2022-01-21 11:20:00,1496.36,45387.99000000012,36052.72000000012,9335.270000000004
2201,2022-01-21 11:25:00,-1983.98,43404.01000000012,36052.72000000012,7351.290000000001
2202,2022-01-21 11:30:00,-979.64,42424.37000000012,36052.72000000012,6371.6500000000015
2203,2022-01-21 11:35:00,-1855.37,40569.00000000012,36052.72000000012,4516.279999999999
2204,2022-01-21 11:40:00,-1435.79,39133.210000000116,36052.72000000012,3080.489999999998
2205,2022-01-21 11:45:00,-1854.14,37279.070000000116,36052.72000000012,1226.3499999999985
2206,2022-01-21 11:50:00,19.64,37298.710000000116,36052.72000000012,1245.989999999998
2207,2022-01-21 11:55:00,1541.45,38840.16000000011,36052.72000000012,2787.439999999995
2208,2022-01-21 12:00:00,-1712.18,37127.98000000011,36052.72000000012,1075.2599999999948
2209,2022-01-21 12:05:00,-1187.68,35940.30000000011,36052.72000000012,-112.42000000000553
2210,2022-01-21 12:10:00,-732.27,35208.030000000115,36052.72000000012,-844.6900000000023
2211,2022-01-21 12:15:00,1230.77,36438.80000000011,36052.72000000012,386.07999999999447
2212,2022-01-21 12:20:00,340.42,36779.22000000011,36052.72000000012,726.4999999999927
2213,2022-01-21 12:25:00,912.36,37691.58000000011,36052.72000000012,1638.8599999999933
2214,2022-01-21 12:30:00,105.04,37796.62000000011,36052.72000000012,1743.8999999999942
2215,2022-01-21 12:35:00,1364.26,39160.880000000114,36052.72000000012,3108.159999999996
2216,2022-01-21 12:40:00,-104.76,39056.12000000011,36052.72000000012,3003.399999999994
2217,2022-01-21 12:45:00,288.94,39345.060000000114,36052.72000000012,3292.3399999999965
2218,2022-01-21 12:50:00,1454.5,40799.560000000114,36052.72000000012,4746.8399999999965
2219,2022-01-21 12:55:00,953.12,41752.68000000012,36052.72000000012,5699.959999999999
2220,2022-01-21 13:00:00,-1944.54,39808.140000000116,36052.72000000012,3755.4199999999983
2221,2022-01-21 13:05:00,1698.85,41506.990000000114,36052.72000000012,5454.269999999997
2222,2022-01-21 13:10:00,349.06,41856.05000000011,36052.72000000012,5803.3299999999945
2223,2022-01-21 13:15:00,-805.91,41050.14000000011,36052.72000000012,4997.419999999991
2224,2022-01-21 13:20:00,-1189.63,39860.51000000011,36052.72000000012,3807.7899999999936
2225,2022-01-21 13:25:00,-1476.44,38384.07000000011,36052.72000000012,2331.3499999999913
2226,2022-01-21 13:30:00,-694.69,37689.38000000011,36052.72000000012,1636.659999999989
2227,2022-01-21 13:35:00,786.56,38475.940000000104,36052.72000000012,2423.2199999999866
2228,2022-01-21 13:40:00,-1819.12,36656.8200000001,36052.72000000012,604.099999999984
2229,2022-01-21 13:45:00,1736.81,38393.6300000001,36052.72000000012,2340.9099999999817
2230,2022-01-21 13:50:00,1387.6,39781.2300000001,36052.72000000012,3728.50999999998
2231,2022-01-21 13:55:00,298.18,40079.4100000001,36052.72000000012,4026.6899999999805
2232,2022-01-21 14:00:00,1622.5,41701.9100000001,36052.72000000012,5649.1899999999805
2233,2022-01-21 14:05:00,1932.17,43634.080000000096,36052.72000000012,7581.359999999979
2234,2022-01-21 14:10:00,42.76,43676.8400000001,36052.72000000012,7624.119999999981
2235,2022-01-21 14:15:00,-1018.4,42658.4400000001,36052.72000000012,6605.719999999979
2236,2022-01-21 14:20:00,1375.03,44033.470000000096,36052.72000000012,7980.749999999978
2237,2022-01-21 14:25:00,525.02,44558.49000000009,36052.72000000012,8505.769999999975
2238,2022-01-21 14:30:00,563.06,45121.55000000009,36052.72000000012,9068.829999999973
2239,2022-01-21 14:35:00,-536.9,44584.65000000009,36052.72000000012,8531.929999999971
2240,2022-01-21 14:40:00,-115.39,44469.26000000009,36052.72000000012,8416.539999999972
2241,2022-01-21 14:45:00,-518.36,43950.90000000009,36052.72000000012,7898.179999999971
2242,2022-01-21 14:50:00,265.09,44215.990000000085,36052.72000000012,8163.269999999968
2243,2022-01-21 14:55:00,1184.6,45400.590000000084,36052.72000000012,9347.869999999966
2244,2022-01-21 15:00:00,-1605.45,43795.14000000009,36052.72000000012,7742.419999999969
2245,2022-01-21 15:05:00,420.41,44215.55000000009,36052.72000000012,8162.829999999973
2246,2022-01-21 15:10:00,1581.8,45797.35000000009,36052.72000000012,9744.629999999976
2247,2022-01-21 15:15:00,806.91,46604.2600000001,36052.72000000012,10551.539999999979
2248,2022-01-21 15:20:00,-1318.22,45286.040000000095,36052.72000000012,9233.319999999978
2249,2022-01-21 15:25:00,-57.6,45228.4400000001,36052.72000000012,9175.71999999998
2250,2022-01-21 15:30:00,45.33,45273.7700000001,36052.72000000012,9221.049999999981
2251,2022-01-21 15:35:00,1391.96,46665.7300000001,36052.72000000012,10613.00999999998
2252,2022-01-21 15:40:00,589.17,47254.900000000096,36052.72000000012,11202.179999999978
2253,2022-01-21 15:45:00,-513.77,46741.1300000001,36052.72000000012,10688.409999999982
2254,2022-01-21 15:50:00,-1644.62,45096.5100000001,36052.72000000012,9043.789999999979
2255,2022-01-21 15:55:00,518.94,45615.4500000001,36052.72000000012,9562.729999999981
2256,2022-01-21 16:00:00,-540.64,45074.8100000001,36052.72000000012,9022.089999999982
2257,2022-01-21 16:05:00,851.93,45926.7400000001,36052.72000000012,9874.019999999982
2258,2022-01-21 16:10:00,-110.85,45815.8900000001,36052.72000000012,9763.169999999984
2259,2022-01-21 16:15:00,-475.37,45340.5200000001,36052.72000000012,9287.799999999981
2260,2022-01-21 16:20:00,-1986.52,43354.0000000001,36052.72000000012,7301.279999999984
2261,2022-01-21 16:25:00,1851.05,45205.050000000105,36052.72000000012,9152.329999999987
2262,2022-01-21 16:30:00,-680.24,44524.81000000011,36052.72000000012,8472.08999999999
2263,2022-01-21 16:35:00,-538.58,43986.230000000105,36052.72000000012,7933.5099999999875
2264,2022-01-21 16:40:00,-847.02,43139.21000000011,36052.72000000012,7086.489999999991
2265,2022-01-21 16:45:00,1526.41,44665.62000000011,36052.72000000012,8612.899999999994
2266,2022-01-21 16:50:00,-156.52,44509.100000000115,36052.72000000012,8456.379999999997
2267,2022-01-21 16:55:00,-1274.67,43234.43000000012,36052.72000000012,7181.709999999999
2268,2022-01-22 08:00:00,-960.73,42273.70000000011,43234.43000000012,-960.7300000000032
2269,2022-01-22 08:05:00,141.07,42414.77000000011,43234.43000000012,-819.6600000000035
2270,2022-01-22 08:10:00,320.04,42734.810000000114,43234.43000000012,-499.6200000000026
2271,2022-01-22 08:15:00,-448.56,42286.25000000012,43234.43000000012,-948.1800000000003
2272,2022-01-22 08:20:00,1440.76,43727.01000000012,43234.43000000012,492.58000000000175
2273,2022-01-22 08:25:00,-649.45,43077.56000000012,43234.43000000012,-156.86999999999534
2274,2022-01-22 08:30:00,881.75,43959.31000000012,43234.43000000012,724.8800000000047
2275,2022-01-22 08:35:00,1830.61,45789.92000000012,43234.43000000012,2555.4900000000052
2276,2022-01-22 08:40:00,-508.17,45281.750000000124,43234.43000000012,2047.320000000007
2277,2022-01-22 08:45:00,-1237.67,44044.080000000125,43234.43000000012,809.6500000000087
2278,2022-01-22 08:50:00,-1456.91,42587.17000000012,43234.43000000012,-647.2599999999948
2279,2022-01-22 08:55:00,-1226.34,41360.830000000125,43234.43000000012,-1873.5999999999913
2280,2022-01-22 09:00:00,933.04,42293.870000000126,43234.43000000012,-940.5599999999904
2281,2022-01-22 09:05:00,1783.82,44077.690000000126,43234.43000000012,843.2600000000093
2282,2022-01-22 09:10:00,1977.96,46055.650000000125,43234.43000000012,2821.2200000000084
2283,2022-01-22 09:15:00,-1349.46,44706.190000000126,43234.43000000012,1471.7600000000093
2284,2022-01-22 09:20:00,859.13,45565.32000000012,43234.43000000012,2330.8900000000067
2285,2022-01-22 09:25:00,-22.49,45542.830000000125,43234.43000000012,2308.4000000000087
2286,2022-01-22 09:30:00,247.43,45790.260000000126,43234.43000000012,2555.830000000009
2287,2022-01-22 09:35:00,-1609.55,44180.71000000012,43234.43000000012,946.2800000000061
2288,2022-01-22 09:40:00,966.13,45146.84000000012,43234.43000000012,1912.4100000000035
2289,2022-01-22 09:45:00,-1583.06,43563.78000000012,43234.43000000012,329.3500000000058
2290,2022-01-22 09:50:00,-1991.24,41572.540000000125,43234.43000000012,-1661.8899999999921
2291,2022-01-22 09:55:00,-1775.06,39797.48000000013,43234.43000000012,-3436.94999999999
2292,2022-01-22 10:00:00,1317.75,41115.23000000013,43234.43000000012,-2119.19999999999
2293,2022-01-22 10:05:00,-588.66,40526.57000000012,43234.43000000012,-2707.8599999999933
2294,2022-01-22 10:10:00,47.15,40573.720000000125,43234.43000000012,-2660.709999999992
2295,2022-01-22 10:15:00,-602.3,39971.42000000012,43234.43000000012,-3263.0099999999948
2296,2022-01-22 10:20:00,-1496.42,38475.000000000124,43234.43000000012,-4759.429999999993
2297,2022-01-22 10:25:00,1689.47,40164.470000000125,43234.43000000012,-3069.959999999992
2298,2022-01-22 10:30:00,921.01,41085.48000000013,43234.43000000012,-2148.94999999999
2299,2022-01-22 10:35:00,338.86,41424.34000000013,43234.43000000012,-1810.0899999999892
2300,2022-01-22 10:40:00,91.21,41515.55000000013,43234.43000000012,-1718.87999999999
2301,2022-01-22 10:45:00,-629.46,40886.09000000013,43234.43000000012,-2348.3399999999892
2302,2022-01-22 10:50:00,-175.3,40710.790000000125,43234.43000000012,-2523.639999999992
2303,2022-01-22 10:55:00,-1349.9,39360.89000000012,43234.43000000012,-3873.5399999999936
2304,2022-01-22 11:00:00,1505.46,40866.35000000012,43234.43000000012,-2368.0799999999945
2305,2022-01-22 11:05:00,1234.36,42100.71000000012,43234.43000000012,-1133.719999999994
2306,2022-01-22 11:10:00,584.53,42685.24000000012,43234.43000000012,-549.189999999995
2307,2022-01-22 11:15:00,1732.12,44417.360000000124,43234.43000000012,1182.9300000000076
2308,2022-01-22 11:20:00,-288.87,44128.49000000012,43234.43000000012,894.060000000005
2309,2022-01-22 11:25:00,154.1,44282.59000000012,43234.43000000012,1048.1600000000035
2310,2022-01-22 11:30:00,-1912.13,42370.46000000012,43234.43000000012,-863.9699999999939
2311,2022-01-22 11:35:00,103.28,42473.74000000012,43234.43000000012,-760.689999999995
2312,2022-01-22 11:40:00,1264.51,43738.250000000124,43234.43000000012,503.820000000007
2313,2022-01-22 11:45:00,617.8,44356.05000000013,43234.43000000012,1121.62000000001
2314,2022-01-22 11:50:00,-291.34,44064.71000000013,43234.43000000012,830.2800000000134
2315,2022-01-22 11:55:00,463.01,44527.72000000013,43234.43000000012,1293.2900000000154
2316,2022-01-22 12:00:00,-1533.65,42994.07000000013,43234.43000000012,-240.35999999998603
2317,2022-01-22 12:05:00,-101.16,42892.91000000013,43234.43000000012,-341.5199999999895
2318,2022-01-22 12:10:00,-821.81,42071.10000000013,43234.43000000012,-1163.3299999999872
2319,2022-01-22 12:15:00,1128.69,43199.79000000013,43234.43000000012,-34.639999999984866
2320,2022-01-22 12:20:00,208.57,43408.36000000013,43234.43000000012,173.93000000001484
2321,2022-01-22 12:25:00,-1563.09,41845.270000000135,43234.43000000012,-1389.1599999999817
2322,2022-01-22 12:30:00,1840.22,43685.490000000136,43234.43000000012,451.0600000000195
2323,2022-01-22 12:35:00,65.12,43750.61000000014,43234.43000000012,516.1800000000221
2324,2022-01-22 12:40:00,1725.48,45476.09000000014,43234.43000000012,2241.6600000000253
2325,2022-01-22 12:45:00,-1393.71,44082.38000000014,43234.43000000012,847.9500000000262
2326,2022-01-22 12:50:00,1804.18,45886.56000000014,43234.43000000012,2652.1300000000265
2327,2022-01-22 12:55:00,-1371.21,44515.350000000144,43234.43000000012,1280.9200000000274
2328,2022-01-22 13:00:00,-184.97,44330.38000000014,43234.43000000012,1095.9500000000262
2329,2022-01-22 13:05:00,-590.75,43739.63000000014,43234.43000000012,505.2000000000262
2330,2022-01-22 13:10:00,-891.99,42847.640000000145,43234.43000000012,-386.78999999997177
2331,2022-01-22 13:15:00,-1636.58,41211.06000000014,43234.43000000012,-2023.3699999999735
2332,2022-01-22 13:20:00,1075.63,42286.69000000014,43234.43000000012,-947.7399999999761
2333,2022-01-22 13:25:00,1329.5,43616.19000000014,43234.43000000012,381.76000000002387
2334,2022-01-22 13:30:00,-1450.08,42166.11000000014,43234.43000000012,-1068.3199999999779
2335,2022-01-22 13:35:00,-1248.55,40917.560000000136,43234.43000000012,-2316.869999999981
2336,2022-01-22 13:40:00,1716.09,42633.65000000013,43234.43000000012,-600.7799999999843
2337,2022-01-22 13:45:00,-389.29,42244.36000000013,43234.43000000012,-990.0699999999852
2338,2022-01-22 13:50:00,-31.16,42213.20000000013,43234.43000000012,-1021.2299999999886
2339,2022-01-22 13:55:00,1405.83,43619.03000000013,43234.43000000012,384.6000000000131
2340,2022-01-22 14:00:00,-1338.02,42281.01000000013,43234.43000000012,-953.4199999999837
2341,2022-01-22 14:05:00,-1116.6,41164.410000000134,43234.43000000012,-2070.0199999999822
2342,2022-01-22 14:10:00,21.96,41186.37000000013,43234.43000000012,-2048.059999999983
2343,2022-01-22 14:15:00,-685.42,40500.950000000135,43234.43000000012,-2733.4799999999814
2344,2022-01-22 14:20:00,1646.17,42147.12000000013,43234.43000000012,-1087.3099999999831
2345,2022-01-22 14:25:00,-1080.06,41067.060000000136,43234.43000000012,-2167.369999999981
2346,2022-01-22 14:30:00,-771.93,40295.130000000136,43234.43000000012,-2939.299999999981
2347,2022-01-22 14:35:00,-71.12,40224.01000000013,43234.43000000012,-3010.4199999999837
2348,2022-01-22 14:40:00,86.76,40310.770000000135,43234.43000000012,-2923.6599999999817
2349,2022-01-22 14:45:00,228.34,40539.11000000013,43234.43000000012,-2695.319999999985
2350,2022-01-22 14:50:00,430.11,40969.22000000013,43234.43000000012,-2265.2099999999846
2351,2022-01-22 14:55:00,-1165.99,39803.230000000134,43234.43000000012,-3431.1999999999825
2352,2022-01-22 15:00:00,-1893.45,37909.78000000014,43234.43000000012,-5324.64999999998
2353,2022-01-22 15:05:00,-1654.13,36255.65000000014,43234.43000000012,-6978.779999999977
2354,2022-01-22 15:10:00,-638.08,35617.57000000014,43234.43000000012,-7616.859999999979
2355,2022-01-22 15:15:00,842.15,36459.72000000014,43234.43000000012,-6774.709999999977
2356,2022-01-22 15:20:00,489.33,36949.05000000014,43234.43000000012,-6285.379999999976
2357,2022-01-22 15:25:00,1261.11,38210.16000000014,43234.43000000012,-5024.269999999975
2358,2022-01-22 15:30:00,384.65,38594.81000000014,43234.43000000012,-4639.6199999999735
2359,2022-01-22 15:35:00,640.75,39235.56000000014,43234.43000000012,-3998.8699999999735
2360,2022-01-22 15:40:00,458.27,39693.83000000014,43234.43000000012,-3540.5999999999767
2361,2022-01-22 15:45:00,-1169.55,38524.28000000014,43234.43000000012,-4710.14999999998
2362,2022-01-22 15:50:00,322.05,38846.33000000014,43234.43000000012,-4388.099999999977
2363,2022-01-22 15:55:00,1221.82,40068.15000000014,43234.43000000012,-3166.279999999977
2364,2022-01-22 16:00:00,122.97,40191.12000000014,43234.43000000012,-3043.309999999976
2365,2022-01-22 16:05:00,551.63,40742.75000000014,43234.43000000012,-2491.6799999999785
2366,2022-01-22 16:10:00,-1393.61,39349.14000000014,43234.43000000012,-3885.289999999979
2367,2022-01-22 16:15:00,241.95,39591.090000000135,43234.43000000012,-3643.339999999982
2368,2022-01-22 16:20:00,-576.12,39014.97000000013,43234.43000000012,-4219.459999999985
2369,2022-01-22 16:25:00,-310.43,38704.54000000013,43234.43000000012,-4529.889999999985
2370,2022-01-22 16:30:00,-1895.97,36808.57000000013,43234.43000000012,-6425.859999999986
2371,2022-01-22 16:35:00,-1380.08,35428.49000000013,43234.43000000012,-7805.939999999988
2372,2022-01-22 16:40:00,-52.62,35375.870000000126,43234.43000000012,-7858.55999999999
2373,2022-01-22 16:45:00,97.01,35472.88000000013,43234.43000000012,-7761.549999999988
2374,2022-01-22 16:50:00,-624.53,34848.35000000013,43234.43000000012,-8386.079999999987
2375,2022-01-22 16:55:00,-233.4,34614.95000000013,43234.43000000012,-8619.479999999989
2376,2022-01-23 08:00:00,498.7,35113.650000000125,34614.95000000013,498.6999999999971
2377,2022-01-23 08:05:00,25.1,35138.750000000124,34614.95000000013,523.7999999999956
2378,2022-01-23 08:10:00,1154.79,36293.540000000125,34614.95000000013,1678.5899999999965
2379,2022-01-23 08:15:00,-410.68,35882.860000000124,34614.95000000013,1267.9099999999962
2380,2022-01-23 08:20:00,448.11,36330.970000000125,34614.95000000013,1716.0199999999968
2381,2022-01-23 08:25:00,1008.2,37339.17000000012,34614.95000000013,2724.219999999994
2382,2022-01-23 08:30:00,-831.24,36507.930000000124,34614.95000000013,1892.979999999996
2383,2022-01-23 08:35:00,1177.93,37685.860000000124,34614.95000000013,3070.909999999996
2384,2022-01-23 08:40:00,507.32,38193.180000000124,34614.95000000013,3578.229999999996
2385,2022-01-23 08:45:00,-1133.27,37059.91000000013,34614.95000000013,2444.959999999999
2386,2022-01-23 08:50:00,503.37,37563.28000000013,34614.95000000013,2948.3300000000017
2387,2022-01-23 08:55:00,-180.39,37382.89000000013,34614.95000000013,2767.9400000000023
2388,2022-01-23 09:00:00,-531.15,36851.74000000013,34614.95000000013,2236.790000000001
2389,2022-01-23 09:05:00,-1207.5,35644.24000000013,34614.95000000013,1029.2900000000009
2390,2022-01-23 09:10:00,-1876.08,33768.16000000013,34614.95000000013,-846.7900000000009
2391,2022-01-23 09:15:00,1649.48,35417.64000000013,34614.95000000013,802.6900000000023
2392,2022-01-23 09:20:00,-1721.75,33695.89000000013,34614.95000000013,-919.0599999999977
2393,2022-01-23 09:25:00,1110.37,34806.26000000013,34614.95000000013,191.31000000000495
2394,2022-01-23 09:30:00,-1770.11,33036.15000000013,34614.95000000013,-1578.7999999999956
2395,2022-01-23 09:35:00,1322.13,34358.28000000013,34614.95000000013,-256.66999999999825
2396,2022-01-23 09:40:00,-493.58,33864.70000000013,34614.95000000013,-750.25
2397,2022-01-23 09:45:00,83.75,33948.45000000013,34614.95000000013,-666.5
2398,2022-01-23 09:50:00,1769.37,35717.82000000013,34614.95000000013,1102.8700000000026
2399,2022-01-23 09:55:00,-1986.35,33731.47000000013,34614.95000000013,-883.4799999999959
2400,2022-01-23 10:00:00,302.69,34034.160000000134,34614.95000000013,-580.7899999999936
2401,2022-01-23 10:05:00,1354.04,35388.200000000135,34614.95000000013,773.2500000000073
2402,2022-01-23 10:10:00,-892.96,34495.240000000136,34614.95000000013,-119.70999999999185
2403,2022-01-23 10:15:00,-870.65,33624.590000000135,34614.95000000013,-990.3599999999933
2404,2022-01-23 10:20:00,656.72,34281.310000000136,34614.95000000013,-333.63999999999214
2405,2022-01-23 10:25:00,-569.35,33711.96000000014,34614.95000000013,-902.9899999999907
2406,2022-01-23 10:30:00,1225.77,34937.730000000134,34614.95000000013,322.7800000000061
2407,2022-01-23 10:35:00,932.54,35870.270000000135,34614.95000000013,1255.320000000007
2408,2022-01-23 10:40:00,-219.04,35651.230000000134,34614.95000000013,1036.280000000006
2409,2022-01-23 10:45:00,15.76,35666.990000000136,34614.95000000013,1052.0400000000081
2410,2022-01-23 10:50:00,360.5,36027.490000000136,34614.95000000013,1412.5400000000081
2411,2022-01-23 10:55:00,-1996.35,34031.14000000014,34614.95000000013,-583.8099999999904
2412,2022-01-23 11:00:00,930.56,34961.700000000135,34614.95000000013,346.7500000000073
2413,2022-01-23 11:05:00,1357.83,36319.53000000014,34614.95000000013,1704.580000000009
2414,2022-01-23 11:10:00,-1892.79,34426.740000000136,34614.95000000013,-188.20999999999185
2415,2022-01-23 11:15:00,1390.58,35817.32000000014,34614.95000000013,1202.37000000001
2416,2022-01-23 11:20:00,-94.6,35722.72000000014,34614.95000000013,1107.7700000000114
2417,2022-01-23 11:25:00,-1778.99,33943.73000000014,34614.95000000013,-671.2199999999866
2418,2022-01-23 11:30:00,-1012.24,32931.49000000014,34614.95000000013,-1683.4599999999846
2419,2022-01-23 11:35:00,1693.05,34624.54000000015,34614.95000000013,9.590000000018335
2420,2022-01-23 11:40:00,218.11,34842.65000000015,34614.95000000013,227.70000000001892
2421,2022-01-23 11:45:00,1146.97,35989.62000000015,34614.95000000013,1374.67000000002
2422,2022-01-23 11:50:00,356.53,36346.15000000015,34614.95000000013,1731.200000000019
2423,2022-01-23 11:55:00,-814.33,35531.820000000145,34614.95000000013,916.8700000000172
2424,2022-01-23 12:00:00,622.31,36154.13000000014,34614.95000000013,1539.1800000000148
2425,2022-01-23 12:05:00,-989.33,35164.80000000014,34614.95000000013,549.8500000000131
2426,2022-01-23 12:10:00,-296.04,34868.76000000014,34614.95000000013,253.81000000001222
2427,2022-01-23 12:15:00,327.0,35195.76000000014,34614.95000000013,580.8100000000122
2428,2022-01-23 12:20:00,-1554.79,33640.97000000014,34614.95000000013,-973.9799999999886
2429,2022-01-23 12:25:00,1976.55,35617.52000000014,34614.95000000013,1002.5700000000143
2430,2022-01-23 12:30:00,-1167.15,34450.37000000014,34614.95000000013,-164.5799999999872
2431,2022-01-23 12:35:00,1133.04,35583.41000000014,34614.95000000013,968.4600000000137
2432,2022-01-23 12:40:00,-1778.25,33805.16000000014,34614.95000000013,-809.7899999999863
2433,2022-01-23 12:45:00,-586.98,33218.18000000014,34614.95000000013,-1396.7699999999895
2434,2022-01-23 12:50:00,676.96,33895.14000000014,34614.95000000013,-719.8099999999904
2435,2022-01-23 12:55:00,1609.35,35504.490000000136,34614.95000000013,889.5400000000081
2436,2022-01-23 13:00:00,476.72,35981.21000000014,34614.95000000013,1366.2600000000093
2437,2022-01-23 13:05:00,385.8,36367.01000000014,34614.95000000013,1752.0600000000122
2438,2022-01-23 13:10:00,900.73,37267.74000000014,34614.95000000013,2652.7900000000154
2439,2022-01-23 13:15:00,-1405.03,35862.710000000145,34614.95000000013,1247.7600000000166
2440,2022-01-23 13:20:00,-1326.47,34536.24000000014,34614.95000000013,-78.70999999998457
2441,2022-01-23 13:25:00,-934.28,33601.960000000145,34614.95000000013,-1012.9899999999834
2442,2022-01-23 13:30:00,1122.09,34724.05000000014,34614.95000000013,109.1000000000131
2443,2022-01-23 13:35:00,-1214.74,33509.31000000014,34614.95000000013,-1105.6399999999849
2444,2022-01-23 13:40:00,-1569.21,31940.100000000144,34614.95000000013,-2674.849999999984
2445,2022-01-23 13:45:00,-1516.67,30423.430000000146,34614.95000000013,-4191.519999999982
2446,2022-01-23 13:50:00,-276.84,30146.590000000146,34614.95000000013,-4468.359999999982
2447,2022-01-23 13:55:00,-1017.45,29129.140000000145,34614.95000000013,-5485.809999999983
2448,2022-01-23 14:00:00,488.05,29617.190000000144,34614.95000000013,-4997.759999999984
2449,2022-01-23 14:05:00,1040.12,30657.310000000143,34614.95000000013,-3957.639999999985
2450,2022-01-23 14:10:00,1122.87,31780.180000000142,34614.95000000013,-2834.769999999986
2451,2022-01-23 14:15:00,1116.86,32897.04000000014,34614.95000000013,-1717.909999999989
2452,2022-01-23 14:20:00,-324.68,32572.36000000014,34614.95000000013,-2042.5899999999892
2453,2022-01-23 14:25:00,1693.55,34265.91000000014,34614.95000000013,-349.0399999999863
2454,2022-01-23 14:30:00,1346.7,35612.61000000014,34614.95000000013,997.6600000000108
2455,2022-01-23 14:35:00,556.08,36168.69000000014,34614.95000000013,1553.7400000000125
2456,2022-01-23 14:40:00,-765.31,35403.38000000014,34614.95000000013,788.4300000000148
2457,2022-01-23 14:45:00,-377.1,35026.280000000144,34614.95000000013,411.3300000000163
2458,2022-01-23 14:50:00,-524.76,34501.52000000014,34614.95000000013,-113.42999999998574
2459,2022-01-23 14:55:00,-832.06,33669.460000000145,34614.95000000013,-945.4899999999834
2460,2022-01-23 15:00:00,-800.68,32868.780000000144,34614.95000000013,-1746.1699999999837
2461,2022-01-23 15:05:00,1066.94,33935.72000000015,34614.95000000013,-679.2299999999814
2462,2022-01-23 15:10:00,680.54,34616.26000000015,34614.95000000013,1.3100000000194996
2463,2022-01-23 15:15:00,1643.34,36259.600000000144,34614.95000000013,1644.650000000016
2464,2022-01-23 15:20:00,-1981.62,34277.98000000014,34614.95000000013,-336.9699999999866
2465,2022-01-23 15:25:00,-1727.74,32550.24000000014,34614.95000000013,-2064.709999999988
2466,2022-01-23 15:30:00,1297.59,33847.83000000014,34614.95000000013,-767.1199999999881
2467,2022-01-23 15:35:00,1200.38,35048.21000000014,34614.95000000013,433.2600000000093
2468,2022-01-23 15:40:00,1743.94,36792.15000000014,34614.95000000013,2177.2000000000116
2469,2022-01-23 15:45:00,-1775.84,35016.31000000014,34614.95000000013,401.36000000001513
2470,2022-01-23 15:50:00,143.59,35159.90000000014,34614.95000000013,544.9500000000116
2471,2022-01-23 15:55:00,-1763.67,33396.23000000014,34614.95000000013,-1218.7199999999866
2472,2022-01-23 16:00:00,-616.59,32779.640000000145,34614.95000000013,-1835.3099999999831
2473,2022-01-23 16:05:00,-697.88,32081.760000000144,34614.95000000013,-2533.189999999984
2474,2022-01-23 16:10:00,265.01,32346.770000000142,34614.95000000013,-2268.1799999999857
2475,2022-01-23 16:15:00,834.3,33181.070000000145,34614.95000000013,-1433.8799999999828
2476,2022-01-23 16:20:00,-1542.68,31638.390000000145,34614.95000000013,-2976.559999999983
2477,2022-01-23 16:25:00,-1727.84,29910.550000000145,34614.95000000013,-4704.399999999983
2478,2022-01-23 16:30:00,-787.23,29123.320000000145,34614.95000000013,-5491.629999999983
2479,2022-01-23 16:35:00,97.85,29221.170000000144,34614.95000000013,-5393.779999999984
2480,2022-01-23 16:40:00,-507.33,28713.840000000142,34614.95000000013,-5901.109999999986
2481,2022-01-23 16:45:00,-398.49,28315.35000000014,34614.95000000013,-6299.599999999988
2482,2022-01-23 16:50:00,464.46,28779.81000000014,34614.95000000013,-5835.1399999999885
2483,2022-01-23 16:55:00,-1503.24,27276.570000000138,34614.95000000013,-7338.37999999999
2484,2022-01-24 08:00:00,974.08,28250.65000000014,27276.570000000138,974.0800000000017
2485,2022-01-24 08:05:00,90.52,28341.17000000014,27276.570000000138,1064.6000000000022
2486,2022-01-24 08:10:00,149.29,28490.46000000014,27276.570000000138,1213.890000000003
2487,2022-01-24 08:15:00,-297.83,28192.63000000014,27276.570000000138,916.0600000000013
2488,2022-01-24 08:20:00,-1687.86,26504.77000000014,27276.570000000138,-771.7999999999993
2489,2022-01-24 08:25:00,1504.84,28009.61000000014,27276.570000000138,733.0400000000009
2490,2022-01-24 08:30:00,-1846.24,26163.370000000137,27276.570000000138,-1113.2000000000007
2491,2022-01-24 08:35:00,-391.36,25772.010000000137,27276.570000000138,-1504.5600000000013
2492,2022-01-24 08:40:00,-1197.83,24574.18000000014,27276.570000000138,-2702.3899999999994
2493,2022-01-24 08:45:00,-1569.64,23004.54000000014,27276.570000000138,-4272.029999999999
2494,2022-01-24 08:50:00,1844.51,24849.050000000138,27276.570000000138,-2427.5200000000004
2495,2022-01-24 08:55:00,284.13,25133.18000000014,27276.570000000138,-2143.3899999999994
2496,2022-01-24 09:00:00,1191.8,26324.980000000138,27276.570000000138,-951.5900000000001
2497,2022-01-24 09:05:00,216.44,26541.420000000136,27276.570000000138,-735.1500000000015
2498,2022-01-24 09:10:00,-1586.35,24955.070000000138,27276.570000000138,-2321.5
2499,2022-01-24 09:15:00,852.48,25807.550000000138,27276.570000000138,-1469.0200000000004
2500,2022-01-24 09:20:00,-716.02,25091.530000000137,27276.570000000138,-2185.040000000001
2501,2022-01-24 09:25:00,-1908.33,23183.200000000135,27276.570000000138,-4093.3700000000026
2502,2022-01-24 09:30:00,533.32,23716.520000000135,27276.570000000138,-3560.050000000003
2503,2022-01-24 09:35:00,301.38,24017.900000000136,27276.570000000138,-3258.670000000002
2504,2022-01-24 09:40:00,471.38,24489.280000000137,27276.570000000138,-2787.290000000001
2505,2022-01-24 09:45:00,-880.76,23608.52000000014,27276.570000000138,-3668.0499999999993
2506,2022-01-24 09:50:00,-172.25,23436.27000000014,27276.570000000138,-3840.2999999999993
2507,2022-01-24 09:55:00,584.83,24021.10000000014,27276.570000000138,-3255.4699999999975
2508,2022-01-24 10:00:00,831.12,24852.22000000014,27276.570000000138,-2424.3499999999985
2509,2022-01-24 10:05:00,-1212.72,23639.50000000014,27276.570000000138,-3637.0699999999997
2510,2022-01-24 10:10:00,1416.89,25056.390000000138,27276.570000000138,-2220.1800000000003
2511,2022-01-24 10:15:00,1747.18,26803.570000000138,27276.570000000138,-473.0
2512,2022-01-24 10:20:00,-1592.1,25211.47000000014,27276.570000000138,-2065.0999999999985
2513,2022-01-24 10:25:00,-1719.02,23492.45000000014,27276.570000000138,-3784.119999999999
2514,2022-01-24 10:30:00,1407.36,24899.81000000014,27276.570000000138,-2376.7599999999984
2515,2022-01-24 10:35:00,730.88,25630.69000000014,27276.570000000138,-1645.8799999999974
2516,2022-01-24 10:40:00,1720.88,27351.57000000014,27276.570000000138,75.00000000000364
2517,2022-01-24 10:45:00,-422.37,26929.200000000143,27276.570000000138,-347.36999999999534
2518,2022-01-24 10:50:00,-1576.48,25352.720000000143,27276.570000000138,-1923.849999999995
2519,2022-01-24 10:55:00,234.4,25587.120000000145,27276.570000000138,-1689.4499999999935
2520,2022-01-24 11:00:00,864.94,26452.060000000143,27276.570000000138,-824.5099999999948
2521,2022-01-24 11:05:00,635.55,27087.610000000142,27276.570000000138,-188.9599999999955
2522,2022-01-24 11:10:00,-819.64,26267.970000000143,27276.570000000138,-1008.5999999999949
2523,2022-01-24 11:15:00,-1029.62,25238.350000000144,27276.570000000138,-2038.219999999994
2524,2022-01-24 11:20:00,1519.16,26757.510000000144,27276.570000000138,-519.059999999994
2525,2022-01-24 11:25:00,-1784.82,24972.690000000144,27276.570000000138,-2303.8799999999937
2526,2022-01-24 11:30:00,1867.47,26840.160000000145,27276.570000000138,-436.4099999999926
2527,2022-01-24 11:35:00,369.89,27210.050000000145,27276.570000000138,-66.51999999999316
2528,2022-01-24 11:40:00,-1869.57,25340.480000000145,27276.570000000138,-1936.0899999999929
2529,2022-01-24 11:45:00,1707.7,27048.180000000146,27276.570000000138,-228.38999999999214
2530,2022-01-24 11:50:00,206.75,27254.930000000146,27276.570000000138,-21.639999999992142
2531,2022-01-24 11:55:00,1567.58,28822.510000000148,27276.570000000138,1545.9400000000096
2532,2022-01-24 12:00:00,1026.15,29848.66000000015,27276.570000000138,2572.090000000011
2533,2022-01-24 12:05:00,1985.64,31834.30000000015,27276.570000000138,4557.7300000000105
2534,2022-01-24 12:10:00,205.0,32039.30000000015,27276.570000000138,4762.7300000000105
2535,2022-01-24 12:15:00,1944.87,33984.17000000015,27276.570000000138,6707.600000000013
2536,2022-01-24 12:20:00,-410.41,33573.76000000015,27276.570000000138,6297.19000000001
2537,2022-01-24 12:25:00,-755.79,32817.97000000015,27276.570000000138,5541.400000000009
2538,2022-01-24 12:30:00,1433.15,34251.12000000015,27276.570000000138,6974.55000000001
2539,2022-01-24 12:35:00,1044.68,35295.80000000015,27276.570000000138,8019.2300000000105
2540,2022-01-24 12:40:00,-453.52,34842.28000000015,27276.570000000138,7565.710000000014
2541,2022-01-24 12:45:00,357.23,35199.510000000155,27276.570000000138,7922.940000000017
2542,2022-01-24 12:50:00,-906.13,34293.38000000016,27276.570000000138,7016.8100000000195
2543,2022-01-24 12:55:00,-1318.61,32974.77000000016,27276.570000000138,5698.200000000019
2544,2022-01-24 13:00:00,-551.68,32423.090000000157,27276.570000000138,5146.520000000019
2545,2022-01-24 13:05:00,-230.85,32192.240000000158,27276.570000000138,4915.67000000002
2546,2022-01-24 13:10:00,-914.79,31277.450000000157,27276.570000000138,4000.880000000019
2547,2022-01-24 13:15:00,-131.86,31145.590000000157,27276.570000000138,3869.0200000000186
2548,2022-01-24 13:20:00,-1803.67,29341.92000000016,27276.570000000138,2065.3500000000204
2549,2022-01-24 13:25:00,-46.17,29295.75000000016,27276.570000000138,2019.1800000000221
2550,2022-01-24 13:30:00,692.5,29988.25000000016,27276.570000000138,2711.680000000022
2551,2022-01-24 13:35:00,1009.3,30997.55000000016,27276.570000000138,3720.9800000000214
2552,2022-01-24 13:40:00,-916.84,30080.71000000016,27276.570000000138,2804.1400000000212
2553,2022-01-24 13:45:00,-197.05,29883.66000000016,27276.570000000138,2607.090000000022
2554,2022-01-24 13:50:00,1790.22,31673.88000000016,27276.570000000138,4397.310000000023
2555,2022-01-24 13:55:00,1939.92,33613.80000000016,27276.570000000138,6337.230000000025
2556,2022-01-24 14:00:00,299.28,33913.08000000016,27276.570000000138,6636.510000000024
2557,2022-01-24 14:05:00,-550.48,33362.60000000016,27276.570000000138,6086.030000000021
2558,2022-01-24 14:10:00,875.18,34237.78000000016,27276.570000000138,6961.210000000021
2559,2022-01-24 14:15:00,1381.06,35618.84000000016,27276.570000000138,8342.270000000019
2560,2022-01-24 14:20:00,522.2,36141.040000000154,27276.570000000138,8864.470000000016
2561,2022-01-24 14:25:00,1089.43,37230.470000000154,27276.570000000138,9953.900000000016
2562,2022-01-24 14:30:00,-1555.25,35675.220000000154,27276.570000000138,8398.650000000016
2563,2022-01-24 14:35:00,-512.19,35163.03000000015,27276.570000000138,7886.460000000014
2564,2022-01-24 14:40:00,-318.78,34844.25000000015,27276.570000000138,7567.680000000015
2565,2022-01-24 14:45:00,-777.72,34066.53000000015,27276.570000000138,6789.960000000014
2566,2022-01-24 14:50:00,1120.5,35187.03000000015,27276.570000000138,7910.460000000014
2567,2022-01-24 14:55:00,-798.22,34388.81000000015,27276.570000000138,7112.2400000000125
2568,2022-01-24 15:00:00,1420.22,35809.03000000015,27276.570000000138,8532.460000000014
2569,2022-01-24 15:05:00,1158.12,36967.150000000154,27276.570000000138,9690.580000000016
2570,2022-01-24 15:10:00,1394.95,38362.10000000015,27276.570000000138,11085.530000000013
2571,2022-01-24 15:15:00,-1886.72,36475.38000000015,27276.570000000138,9198.810000000012
2572,2022-01-24 15:20:00,1042.62,37518.00000000015,27276.570000000138,10241.430000000015
2573,2022-01-24 15:25:00,-561.83,36956.17000000015,27276.570000000138,9679.600000000013
2574,2022-01-24 15:30:00,-499.22,36456.95000000015,27276.570000000138,9180.380000000012
2575,2022-01-24 15:35:00,153.41,36610.36000000015,27276.570000000138,9333.790000000015
2576,2022-01-24 15:40:00,198.76,36809.120000000155,27276.570000000138,9532.550000000017
2577,2022-01-24 15:45:00,1500.2,38309.32000000015,27276.570000000138,11032.750000000015
2578,2022-01-24 15:50:00,1122.26,39431.580000000155,27276.570000000138,12155.010000000017
2579,2022-01-24 15:55:00,-506.75,38924.830000000155,27276.570000000138,11648.260000000017
2580,2022-01-24 16:00:00,335.37,39260.20000000016,27276.570000000138,11983.63000000002
2581,2022-01-24 16:05:00,960.88,40221.080000000155,27276.570000000138,12944.510000000017
2582,2022-01-24 16:10:00,1411.27,41632.35000000015,27276.570000000138,14355.780000000013
2583,2022-01-24 16:15:00,-1546.55,40085.80000000015,27276.570000000138,12809.23000000001
2584,2022-01-24 16:20:00,-1067.69,39018.110000000146,27276.570000000138,11741.540000000008
2585,2022-01-24 16:25:00,1471.88,40489.99000000014,27276.570000000138,13213.420000000006
2586,2022-01-24 16:30:00,-663.09,39826.90000000015,27276.570000000138,12550.330000000009
2587,2022-01-24 16:35:00,1220.78,41047.680000000146,27276.570000000138,13771.110000000008
2588,2022-01-24 16:40:00,-563.3,40484.38000000014,27276.570000000138,13207.810000000005
2589,2022-01-24 16:45:00,828.01,41312.390000000145,27276.570000000138,14035.820000000007
2590,2022-01-24 16:50:00,-228.72,41083.670000000144,27276.570000000138,13807.100000000006
2591,2022-01-24 16:55:00,764.28,41847.95000000014,27276.570000000138,14571.380000000005
2592,2022-01-25 08:00:00,365.57,42213.52000000014,41847.95000000014,365.5699999999997
2593,2022-01-25 08:05:00,-1782.24,40431.280000000144,41847.95000000014,-1416.6699999999983
2594,2022-01-25 08:10:00,1142.73,41574.01000000015,41847.95000000014,-273.93999999999505
2595,2022-01-25 08:15:00,856.21,42430.22000000015,41847.95000000014,582.2700000000041
2596,2022-01-25 08:20:00,1594.91,44025.13000000015,41847.95000000014,2177.1800000000076
2597,2022-01-25 08:25:00,-191.65,43833.48000000015,41847.95000000014,1985.530000000006
2598,2022-01-25 08:30:00,-397.43,43436.05000000015,41847.95000000014,1588.1000000000058
2599,2022-01-25 08:35:00,1236.5,44672.55000000015,41847.95000000014,2824.600000000006
2600,2022-01-25 08:40:00,1632.06,46304.610000000146,41847.95000000014,4456.6600000000035
2601,2022-01-25 08:45:00,1675.49,47980.100000000144,41847.95000000014,6132.1500000000015
2602,2022-01-25 08:50:00,1714.86,49694.960000000145,41847.95000000014,7847.010000000002
2603,2022-01-25 08:55:00,-1166.53,48528.430000000146,41847.95000000014,6680.480000000003
2604,2022-01-25 09:00:00,714.34,49242.77000000014,41847.95000000014,7394.82
2605,2022-01-25 09:05:00,-14.97,49227.80000000014,41847.95000000014,7379.8499999999985
2606,2022-01-25 09:10:00,-1751.29,47476.51000000014,41847.95000000014,5628.559999999998
2607,2022-01-25 09:15:00,-1298.09,46178.420000000144,41847.95000000014,4330.470000000001
2608,2022-01-25 09:20:00,-314.26,45864.16000000014,41847.95000000014,4016.209999999999
2609,2022-01-25 09:25:00,-1342.18,44521.98000000014,41847.95000000014,2674.029999999999
2610,2022-01-25 09:30:00,-270.04,44251.94000000014,41847.95000000014,2403.989999999998
2611,2022-01-25 09:35:00,842.32,45094.26000000014,41847.95000000014,3246.3099999999977
2612,2022-01-25 09:40:00,-615.17,44479.09000000014,41847.95000000014,2631.1399999999994
2613,2022-01-25 09:45:00,-1479.44,42999.65000000014,41847.95000000014,1151.699999999997
2614,2022-01-25 09:50:00,-1967.29,41032.36000000014,41847.95000000014,-815.5900000000038
2615,2022-01-25 09:55:00,1543.19,42575.55000000014,41847.95000000014,727.5999999999985
2616,2022-01-25 10:00:00,1367.27,43942.82000000014,41847.95000000014,2094.8699999999953
2617,2022-01-25 10:05:00,-202.91,43739.910000000134,41847.95000000014,1891.9599999999919
2618,2022-01-25 10:10:00,-1179.52,42560.39000000014,41847.95000000014,712.439999999995
2619,2022-01-25 10:15:00,392.84,42953.230000000134,41847.95000000014,1105.2799999999916
2620,2022-01-25 10:20:00,-1069.08,41884.15000000013,41847.95000000014,36.199999999989814
2621,2022-01-25 10:25:00,-1004.43,40879.72000000013,41847.95000000014,-968.2300000000105
2622,2022-01-25 10:30:00,-728.19,40151.53000000013,41847.95000000014,-1696.4200000000128
2623,2022-01-25 10:35:00,137.46,40288.99000000013,41847.95000000014,-1558.9600000000137
2624,2022-01-25 10:40:00,-1059.13,39229.86000000013,41847.95000000014,-2618.090000000011
2625,2022-01-25 10:45:00,1125.04,40354.90000000013,41847.95000000014,-1493.0500000000102
2626,2022-01-25 10:50:00,-790.44,39564.46000000013,41847.95000000014,-2283.4900000000125
2627,2022-01-25 10:55:00,699.88,40264.34000000013,41847.95000000014,-1583.6100000000151
2628,2022-01-25 11:00:00,1820.66,42085.00000000013,41847.95000000014,237.04999999998836
2629,2022-01-25 11:05:00,877.14,42962.14000000013,41847.95000000014,1114.1899999999878
2630,2022-01-25 11:10:00,1949.3,44911.44000000013,41847.95000000014,3063.4899999999907
2631,2022-01-25 11:15:00,1421.08,46332.520000000135,41847.95000000014,4484.569999999992
2632,2022-01-25 11:20:00,1120.0,47452.520000000135,41847.95000000014,5604.569999999992
2633,2022-01-25 11:25:00,758.12,48210.64000000014,41847.95000000014,6362.689999999995
2634,2022-01-25 11:30:00,1864.52,50075.160000000134,41847.95000000014,8227.209999999992
2635,2022-01-25 11:35:00,1680.89,51756.050000000134,41847.95000000014,9908.099999999991
2636,2022-01-25 11:40:00,-1571.17,50184.880000000136,41847.95000000014,8336.929999999993
2637,2022-01-25 11:45:00,-417.12,49767.76000000013,41847.95000000014,7919.80999999999
2638,2022-01-25 11:50:00,-1230.85,48536.910000000134,41847.95000000014,6688.959999999992
2639,2022-01-25 11:55:00,1921.97,50458.880000000136,41847.95000000014,8610.929999999993
2640,2022-01-25 12:00:00,258.09,50716.97000000013,41847.95000000014,8869.01999999999
2641,2022-01-25 12:05:00,-1913.62,48803.35000000013,41847.95000000014,6955.399999999987
2642,2022-01-25 12:10:00,378.03,49181.38000000013,41847.95000000014,7333.429999999986
2643,2022-01-25 12:15:00,316.76,49498.14000000013,41847.95000000014,7650.189999999988
2644,2022-01-25 12:20:00,-1120.37,48377.77000000013,41847.95000000014,6529.819999999985
2645,2022-01-25 12:25:00,-1261.11,47116.66000000013,41847.95000000014,5268.709999999985
2646,2022-01-25 12:30:00,-1396.83,45719.830000000125,41847.95000000014,3871.879999999983
2647,2022-01-25 12:35:00,-1141.69,44578.14000000012,41847.95000000014,2730.1899999999805
2648,2022-01-25 12:40:00,-163.36,44414.78000000012,41847.95000000014,2566.82999999998
2649,2022-01-25 12:45:00,-713.76,43701.02000000012,41847.95000000014,1853.0699999999779
2650,2022-01-25 12:50:00,730.43,44431.45000000012,41847.95000000014,2583.499999999978
2651,2022-01-25 12:55:00,-1616.7,42814.750000000124,41847.95000000014,966.7999999999811
2652,2022-01-25 13:00:00,-1539.25,41275.500000000124,41847.95000000014,-572.4500000000189
2653,2022-01-25 13:05:00,1933.02,43208.52000000012,41847.95000000014,1360.5699999999779
2654,2022-01-25 13:10:00,1299.22,44507.74000000012,41847.95000000014,2659.789999999979
2655,2022-01-25 13:15:00,163.07,44670.81000000012,41847.95000000014,2822.8599999999788
2656,2022-01-25 13:20:00,-172.31,44498.500000000124,41847.95000000014,2650.549999999981
2657,2022-01-25 13:25:00,-680.48,43818.02000000012,41847.95000000014,1970.0699999999779
2658,2022-01-25 13:30:00,-756.72,43061.30000000012,41847.95000000014,1213.3499999999767
2659,2022-01-25 13:35:00,-1189.01,41872.29000000012,41847.95000000014,24.33999999997468
2660,2022-01-25 13:40:00,-571.31,41300.98000000012,41847.95000000014,-546.970000000023
2661,2022-01-25 13:45:00,-623.17,40677.81000000012,41847.95000000014,-1170.1400000000212
2662,2022-01-25 13:50:00,-332.33,40345.48000000012,41847.95000000014,-1502.470000000023
2663,2022-01-25 13:55:00,-1227.7,39117.78000000012,41847.95000000014,-2730.17000000002
2664,2022-01-25 14:00:00,1726.84,40844.62000000012,41847.95000000014,-1003.3300000000236
2665,2022-01-25 14:05:00,-1345.76,39498.86000000012,41847.95000000014,-2349.0900000000256
2666,2022-01-25 14:10:00,1293.83,40792.69000000012,41847.95000000014,-1055.2600000000239
2667,2022-01-25 14:15:00,-1979.61,38813.08000000012,41847.95000000014,-3034.8700000000244
2668,2022-01-25 14:20:00,-1253.75,37559.33000000012,41847.95000000014,-4288.620000000024
2669,2022-01-25 14:25:00,-1007.21,36552.12000000012,41847.95000000014,-5295.830000000024
2670,2022-01-25 14:30:00,1533.59,38085.710000000116,41847.95000000014,-3762.240000000027
2671,2022-01-25 14:35:00,-1342.23,36743.48000000011,41847.95000000014,-5104.47000000003
2672,2022-01-25 14:40:00,326.16,37069.640000000116,41847.95000000014,-4778.310000000027
2673,2022-01-25 14:45:00,945.47,38015.11000000012,41847.95000000014,-3832.8400000000256
2674,2022-01-25 14:50:00,1139.73,39154.84000000012,41847.95000000014,-2693.1100000000224
2675,2022-01-25 14:55:00,575.62,39730.46000000012,41847.95000000014,-2117.49000000002
2676,2022-01-25 15:00:00,-232.99,39497.470000000125,41847.95000000014,-2350.4800000000178
2677,2022-01-25 15:05:00,-1460.83,38036.64000000012,41847.95000000014,-3811.3100000000195
2678,2022-01-25 15:10:00,1086.88,39123.52000000012,41847.95000000014,-2724.430000000022
2679,2022-01-25 15:15:00,1471.71,40595.23000000012,41847.95000000014,-1252.720000000023
2680,2022-01-25 15:20:00,1186.46,41781.69000000012,41847.95000000014,-66.26000000002387
2681,2022-01-25 15:25:00,-1391.19,40390.50000000012,41847.95000000014,-1457.4500000000262
2682,2022-01-25 15:30:00,1430.22,41820.72000000012,41847.95000000014,-27.23000000002503
2683,2022-01-25 15:35:00,-43.57,41777.15000000012,41847.95000000014,-70.80000000002474
2684,2022-01-25 15:40:00,1776.46,43553.61000000012,41847.95000000014,1705.6599999999744
2685,2022-01-25 15:45:00,-852.19,42701.420000000115,41847.95000000014,853.4699999999721
2686,2022-01-25 15:50:00,1731.66,44433.08000000012,41847.95000000014,2585.1299999999756
2687,2022-01-25 15:55:00,297.55,44730.63000000012,41847.95000000014,2882.6799999999785
2688,2022-01-25 16:00:00,612.05,45342.680000000124,41847.95000000014,3494.7299999999814
2689,2022-01-25 16:05:00,631.1,45973.78000000012,41847.95000000014,4125.82999999998
2690,2022-01-25 16:10:00,-1682.11,44291.67000000012,41847.95000000014,2443.7199999999793
2691,2022-01-25 16:15:00,-240.86,44050.81000000012,41847.95000000014,2202.8599999999788
2692,2022-01-25 16:20:00,-53.08,43997.73000000012,41847.95000000014,2149.779999999977
2693,2022-01-25 16:25:00,409.07,44406.80000000012,41847.95000000014,2558.8499999999767
2694,2022-01-25 16:30:00,339.73,44746.53000000012,41847.95000000014,2898.57999999998
2695,2022-01-25 16:35:00,1346.85,46093.38000000012,41847.95000000014,4245.4299999999785
2696,2022-01-25 16:40:00,1538.38,47631.76000000012,41847.95000000014,5783.809999999976
2697,2022-01-25 16:45:00,-41.15,47590.61000000012,41847.95000000014,5742.659999999974
2698,2022-01-25 16:50:00,354.3,47944.91000000012,41847.95000000014,6096.959999999977
2699,2022-01-25 16:55:00,-1032.23,46912.68000000012,41847.95000000014,5064.729999999974
2700,2022-01-26 08:00:00,1462.31,48374.990000000114,46912.68000000012,1462.3099999999977
2701,2022-01-26 08:05:00,1035.02,49410.01000000011,46912.68000000012,2497.3299999999945
2702,2022-01-26 08:10:00,430.05,49840.060000000114,46912.68000000012,2927.3799999999974
2703,2022-01-26 08:15:00,876.32,50716.380000000114,46912.68000000012,3803.699999999997
2704,2022-01-26 08:20:00,550.92,51267.30000000011,46912.68000000012,4354.619999999995
2705,2022-01-26 08:25:00,-732.82,50534.48000000011,46912.68000000012,3621.7999999999956
2706,2022-01-26 08:30:00,53.93,50588.41000000011,46912.68000000012,3675.729999999996
2707,2022-01-26 08:35:00,1951.55,52539.960000000116,46912.68000000012,5627.279999999999
2708,2022-01-26 08:40:00,1674.26,54214.22000000012,46912.68000000012,7301.540000000001
2709,2022-01-26 08:45:00,-1769.69,52444.530000000115,46912.68000000012,5531.8499999999985
2710,2022-01-26 08:50:00,-185.76,52258.77000000011,46912.68000000012,5346.0899999999965
2711,2022-01-26 08:55:00,-481.31,51777.460000000116,46912.68000000012,4864.779999999999
2712,2022-01-26 09:00:00,544.0,52321.460000000116,46912.68000000012,5408.779999999999
2713,2022-01-26 09:05:00,997.43,53318.890000000116,46912.68000000012,6406.209999999999
2714,2022-01-26 09:10:00,1288.71,54607.600000000115,46912.68000000012,7694.919999999998
2715,2022-01-26 09:15:00,612.08,55219.68000000012,46912.68000000012,8307.0
2716,2022-01-26 09:20:00,-20.14,55199.54000000012,46912.68000000012,8286.86
2717,2022-01-26 09:25:00,-255.54,54944.00000000012,46912.68000000012,8031.32
2718,2022-01-26 09:30:00,758.17,55702.170000000115,46912.68000000012,8789.489999999998
2719,2022-01-26 09:35:00,528.05,56230.22000000012,46912.68000000012,9317.54
2720,2022-01-26 09:40:00,1700.84,57931.060000000114,46912.68000000012,11018.379999999997
2721,2022-01-26 09:45:00,-1374.04,56557.02000000011,46912.68000000012,9644.339999999997
2722,2022-01-26 09:50:00,-598.91,55958.11000000011,46912.68000000012,9045.429999999993
2723,2022-01-26 09:55:00,721.5,56679.61000000011,46912.68000000012,9766.929999999993
2724,2022-01-26 10:00:00,-18.04,56661.57000000011,46912.68000000012,9748.889999999992
2725,2022-01-26 10:05:00,878.08,57539.65000000011,46912.68000000012,10626.969999999994
2726,2022-01-26 10:10:00,-583.36,56956.29000000011,46912.68000000012,10043.609999999993
2727,2022-01-26 10:15:00,-454.78,56501.51000000011,46912.68000000012,9588.829999999994
2728,2022-01-26 10:20:00,-1524.91,54976.60000000011,46912.68000000012,8063.919999999991
2729,2022-01-26 10:25:00,1159.85,56136.450000000106,46912.68000000012,9223.76999999999
2730,2022-01-26 10:30:00,1417.92,57554.370000000104,46912.68000000012,10641.689999999988
2731,2022-01-26 10:35:00,-951.31,56603.06000000011,46912.68000000012,9690.37999999999
2732,2022-01-26 10:40:00,-1581.32,55021.74000000011,46912.68000000012,8109.05999999999
2733,2022-01-26 10:45:00,1770.57,56792.31000000011,46912.68000000012,9879.62999999999
2734,2022-01-26 10:50:00,847.62,57639.93000000011,46912.68000000012,10727.249999999993
2735,2022-01-26 10:55:00,-680.54,56959.39000000011,46912.68000000012,10046.709999999992
2736,2022-01-26 11:00:00,-1278.99,55680.40000000011,46912.68000000012,8767.719999999994
2737,2022-01-26 11:05:00,1177.47,56857.87000000011,46912.68000000012,9945.189999999995
2738,2022-01-26 11:10:00,-632.33,56225.54000000011,46912.68000000012,9312.859999999993
2739,2022-01-26 11:15:00,-300.66,55924.88000000011,46912.68000000012,9012.19999999999
2740,2022-01-26 11:20:00,-286.18,55638.700000000106,46912.68000000012,8726.01999999999
2741,2022-01-26 11:25:00,641.24,56279.940000000104,46912.68000000012,9367.259999999987
2742,2022-01-26 11:30:00,-3.23,56276.7100000001,46912.68000000012,9364.029999999984
2743,2022-01-26 11:35:00,-1431.58,54845.1300000001,46912.68000000012,7932.4499999999825
2744,2022-01-26 11:40:00,-1645.57,53199.5600000001,46912.68000000012,6286.879999999983
2745,2022-01-26 11:45:00,1809.84,55009.400000000096,46912.68000000012,8096.719999999979
2746,2022-01-26 11:50:00,-534.47,54474.930000000095,46912.68000000012,7562.249999999978
2747,2022-01-26 11:55:00,-1442.98,53031.95000000009,46912.68000000012,6119.269999999975
2748,2022-01-26 12:00:00,1970.29,55002.24000000009,46912.68000000012,8089.559999999976
2749,2022-01-26 12:05:00,1870.71,56872.95000000009,46912.68000000012,9960.269999999975
2750,2022-01-26 12:10:00,-882.81,55990.140000000094,46912.68000000012,9077.459999999977
2751,2022-01-26 12:15:00,1032.7,57022.84000000009,46912.68000000012,10110.159999999974
2752,2022-01-26 12:20:00,566.14,57588.98000000009,46912.68000000012,10676.299999999974
2753,2022-01-26 12:25:00,1662.56,59251.54000000009,46912.68000000012,12338.859999999971
2754,2022-01-26 12:30:00,-1473.41,57778.130000000085,46912.68000000012,10865.449999999968
2755,2022-01-26 12:35:00,1219.26,58997.39000000009,46912.68000000012,12084.70999999997
2756,2022-01-26 12:40:00,-640.77,58356.62000000009,46912.68000000012,11443.939999999973
2757,2022-01-26 12:45:00,1746.7,60103.32000000009,46912.68000000012,13190.63999999997
2758,2022-01-26 12:50:00,-1514.41,58588.91000000008,46912.68000000012,11676.229999999967
2759,2022-01-26 12:55:00,468.73,59057.64000000009,46912.68000000012,12144.95999999997
2760,2022-01-26 13:00:00,-869.02,58188.62000000009,46912.68000000012,11275.939999999973
2761,2022-01-26 13:05:00,1369.84,59558.46000000009,46912.68000000012,12645.77999999997
2762,2022-01-26 13:10:00,-870.46,58688.00000000009,46912.68000000012,11775.31999999997
2763,2022-01-26 13:15:00,-554.41,58133.590000000084,46912.68000000012,11220.909999999967
2764,2022-01-26 13:20:00,-1420.14,56713.450000000084,46912.68000000012,9800.769999999968
2765,2022-01-26 13:25:00,-1964.67,54748.780000000086,46912.68000000012,7836.099999999969
2766,2022-01-26 13:30:00,1684.94,56433.72000000009,46912.68000000012,9521.039999999972
2767,2022-01-26 13:35:00,1541.94,57975.66000000009,46912.68000000012,11062.979999999974
2768,2022-01-26 13:40:00,1056.38,59032.04000000009,46912.68000000012,12119.359999999971
2769,2022-01-26 13:45:00,269.55,59301.59000000009,46912.68000000012,12388.909999999974
2770,2022-01-26 13:50:00,850.33,60151.92000000009,46912.68000000012,13239.239999999976
2771,2022-01-26 13:55:00,108.27,60260.19000000009,46912.68000000012,13347.509999999973
2772,2022-01-26 14:00:00,1545.59,61805.780000000086,46912.68000000012,14893.09999999997
2773,2022-01-26 14:05:00,-14.45,61791.33000000009,46912.68000000012,14878.649999999972
2774,2022-01-26 14:10:00,-1669.45,60121.88000000009,46912.68000000012,13209.199999999975
2775,2022-01-26 14:15:00,-1094.38,59027.500000000095,46912.68000000012,12114.819999999978
2776,2022-01-26 14:20:00,-832.71,58194.790000000095,46912.68000000012,11282.109999999979
2777,2022-01-26 14:25:00,-1533.28,56661.5100000001,46912.68000000012,9748.82999999998
2778,2022-01-26 14:30:00,-711.9,55949.610000000095,46912.68000000012,9036.929999999978
2779,2022-01-26 14:35:00,-1521.9,54427.710000000094,46912.68000000012,7515.029999999977
2780,2022-01-26 14:40:00,-1536.56,52891.150000000096,46912.68000000012,5978.469999999979
2781,2022-01-26 14:45:00,-1203.92,51687.2300000001,46912.68000000012,4774.549999999981
2782,2022-01-26 14:50:00,1259.21,52946.4400000001,46912.68000000012,6033.75999999998
2783,2022-01-26 14:55:00,1784.01,54730.4500000001,46912.68000000012,7817.769999999982
2784,2022-01-26 15:00:00,-1135.09,53595.3600000001,46912.68000000012,6682.679999999986
2785,2022-01-26 15:05:00,-163.11,53432.2500000001,46912.68000000012,6519.569999999985
2786,2022-01-26 15:10:00,-1186.3,52245.9500000001,46912.68000000012,5333.269999999982
2787,2022-01-26 15:15:00,-1076.83,51169.1200000001,46912.68000000012,4256.4399999999805
2788,2022-01-26 15:20:00,1352.39,52521.5100000001,46912.68000000012,5608.82999999998
2789,2022-01-26 15:25:00,1200.25,53721.7600000001,46912.68000000012,6809.07999999998
2790,2022-01-26 15:30:00,-1677.54,52044.220000000096,46912.68000000012,5131.539999999979
2791,2022-01-26 15:35:00,-916.52,51127.7000000001,46912.68000000012,4215.019999999982
2792,2022-01-26 15:40:00,-1889.62,49238.080000000096,46912.68000000012,2325.3999999999796
2793,2022-01-26 15:45:00,-1732.77,47505.3100000001,46912.68000000012,592.6299999999828
2794,2022-01-26 15:50:00,-1105.12,46400.1900000001,46912.68000000012,-512.4900000000198
2795,2022-01-26 15:55:00,-254.61,46145.580000000096,46912.68000000012,-767.1000000000204
2796,2022-01-26 16:00:00,-425.55,45720.03000000009,46912.68000000012,-1192.6500000000233
2797,2022-01-26 16:05:00,771.79,46491.820000000094,46912.68000000012,-420.8600000000224
2798,2022-01-26 16:10:00,461.2,46953.02000000009,46912.68000000012,40.33999999997468
2799,2022-01-26 16:15:00,1285.84,48238.86000000009,46912.68000000012,1326.1799999999712
2800,2022-01-26 16:20:00,-1949.9,46288.96000000009,46912.68000000012,-623.7200000000303
2801,2022-01-26 16:25:00,74.81,46363.770000000084,46912.68000000012,-548.9100000000326
2802,2022-01-26 16:30:00,1941.64,48305.41000000008,46912.68000000012,1392.7299999999668
2803,2022-01-26 16:35:00,-1432.69,46872.72000000008,46912.68000000012,-39.96000000003551
2804,2022-01-26 16:40:00,561.9,47434.62000000008,46912.68000000012,521.939999999966
2805,2022-01-26 16:45:00,177.09,47611.71000000008,46912.68000000012,699.0299999999625
2806,2022-01-26 16:50:00,1558.63,49170.34000000008,46912.68000000012,2257.65999999996
2807,2022-01-26 16:55:00,-1185.19,47985.150000000074,46912.68000000012,1072.4699999999575
2808,2022-01-27 08:00:00,902.33,48887.480000000076,47985.150000000074,902.3300000000017
2809,2022-01-27 08:05:00,665.12,49552.60000000008,47985.150000000074,1567.4500000000044
2810,2022-01-27 08:10:00,524.73,50077.33000000008,47985.150000000074,2092.1800000000076
2811,2022-01-27 08:15:00,1835.2,51912.53000000008,47985.150000000074,3927.3800000000047
2812,2022-01-27 08:20:00,-939.5,50973.03000000008,47985.150000000074,2987.8800000000047
2813,2022-01-27 08:25:00,-1515.75,49457.28000000008,47985.150000000074,1472.1300000000047
2814,2022-01-27 08:30:00,-559.84,48897.44000000008,47985.150000000074,912.2900000000081
2815,2022-01-27 08:35:00,-1941.13,46956.310000000085,47985.150000000074,-1028.8399999999892
2816,2022-01-27 08:40:00,1559.92,48516.23000000008,47985.150000000074,531.080000000009
2817,2022-01-27 08:45:00,-1160.22,47356.01000000008,47985.150000000074,-629.1399999999921
2818,2022-01-27 08:50:00,-1357.02,45998.990000000085,47985.150000000074,-1986.159999999989
2819,2022-01-27 08:55:00,1961.19,47960.18000000009,47985.150000000074,-24.969999999986612
2820,2022-01-27 09:00:00,193.91,48154.09000000009,47985.150000000074,168.94000000001688
2821,2022-01-27 09:05:00,87.99,48242.08000000009,47985.150000000074,256.93000000001484
2822,2022-01-27 09:10:00,786.8,49028.88000000009,47985.150000000074,1043.7300000000178
2823,2022-01-27 09:15:00,1214.72,50243.60000000009,47985.150000000074,2258.450000000019
2824,2022-01-27 09:20:00,-677.9,49565.70000000009,47985.150000000074,1580.5500000000175
2825,2022-01-27 09:25:00,107.17,49672.87000000009,47985.150000000074,1687.7200000000157
2826,2022-01-27 09:30:00,-1928.34,47744.53000000009,47985.150000000074,-240.6199999999808
2827,2022-01-27 09:35:00,-401.33,47343.20000000009,47985.150000000074,-641.9499999999825
2828,2022-01-27 09:40:00,-1014.94,46328.26000000009,47985.150000000074,-1656.8899999999849
2829,2022-01-27 09:45:00,-994.39,45333.87000000009,47985.150000000074,-2651.2799999999843
2830,2022-01-27 09:50:00,-557.94,44775.93000000009,47985.150000000074,-3209.2199999999866
2831,2022-01-27 09:55:00,232.6,45008.530000000086,47985.150000000074,-2976.619999999988
2832,2022-01-27 10:00:00,663.44,45671.97000000009,47985.150000000074,-2313.1799999999857
2833,2022-01-27 10:05:00,-14.15,45657.82000000009,47985.150000000074,-2327.329999999987
2834,2022-01-27 10:10:00,-169.88,45487.94000000009,47985.150000000074,-2497.2099999999846
2835,2022-01-27 10:15:00,1093.98,46581.92000000009,47985.150000000074,-1403.2299999999814
2836,2022-01-27 10:20:00,-1475.51,45106.41000000009,47985.150000000074,-2878.7399999999834
2837,2022-01-27 10:25:00,-1210.64,43895.77000000009,47985.150000000074,-4089.379999999983
2838,2022-01-27 10:30:00,-781.36,43114.41000000009,47985.150000000074,-4870.739999999983
2839,2022-01-27 10:35:00,-702.77,42411.640000000094,47985.150000000074,-5573.50999999998
2840,2022-01-27 10:40:00,1067.71,43479.35000000009,47985.150000000074,-4505.799999999981
2841,2022-01-27 10:45:00,-1582.62,41896.73000000009,47985.150000000074,-6088.419999999984
2842,2022-01-27 10:50:00,901.24,42797.97000000009,47985.150000000074,-5187.179999999986
2843,2022-01-27 10:55:00,-860.5,41937.47000000009,47985.150000000074,-6047.679999999986
2844,2022-01-27 11:00:00,1365.4,43302.87000000009,47985.150000000074,-4682.279999999984
2845,2022-01-27 11:05:00,164.92,43467.79000000009,47985.150000000074,-4517.359999999986
2846,2022-01-27 11:10:00,1892.79,45360.58000000009,47985.150000000074,-2624.569999999985
2847,2022-01-27 11:15:00,-163.26,45197.32000000009,47985.150000000074,-2787.829999999987
2848,2022-01-27 11:20:00,-1548.8,43648.520000000084,47985.150000000074,-4336.62999999999
2849,2022-01-27 11:25:00,-474.19,43174.33000000008,47985.150000000074,-4810.819999999992
2850,2022-01-27 11:30:00,-1124.88,42049.450000000084,47985.150000000074,-5935.69999999999
2851,2022-01-27 11:35:00,373.48,42422.93000000009,47985.150000000074,-5562.219999999987
2852,2022-01-27 11:40:00,-1881.12,40541.810000000085,47985.150000000074,-7443.339999999989
2853,2022-01-27 11:45:00,1653.59,42195.40000000008,47985.150000000074,-5789.749999999993
2854,2022-01-27 11:50:00,1731.32,43926.72000000008,47985.150000000074,-4058.429999999993
2855,2022-01-27 11:55:00,1964.5,45891.22000000008,47985.150000000074,-2093.929999999993
2856,2022-01-27 12:00:00,1867.17,47758.39000000008,47985.150000000074,-226.75999999999476
2857,2022-01-27 12:05:00,-109.43,47648.96000000008,47985.150000000074,-336.18999999999505
2858,2022-01-27 12:10:00,1015.67,48664.63000000008,47985.150000000074,679.4800000000032
2859,2022-01-27 12:15:00,1874.54,50539.17000000008,47985.150000000074,2554.020000000004
2860,2022-01-27 12:20:00,1259.71,51798.88000000008,47985.150000000074,3813.730000000003
2861,2022-01-27 12:25:00,-264.59,51534.29000000008,47985.150000000074,3549.1400000000067
2862,2022-01-27 12:30:00,592.91,52127.200000000084,47985.150000000074,4142.05000000001
2863,2022-01-27 12:35:00,393.26,52520.46000000009,47985.150000000074,4535.310000000012
2864,2022-01-27 12:40:00,-1909.71,50610.75000000009,47985.150000000074,2625.600000000013
2865,2022-01-27 12:45:00,702.89,51313.64000000009,47985.150000000074,3328.4900000000125
2866,2022-01-27 12:50:00,-1470.78,49842.86000000009,47985.150000000074,1857.7100000000137
2867,2022-01-27 12:55:00,-525.31,49317.55000000009,47985.150000000074,1332.400000000016
2868,2022-01-27 13:00:00,175.77,49493.32000000009,47985.150000000074,1508.1700000000128
2869,2022-01-27 13:05:00,1245.41,50738.73000000009,47985.150000000074,2753.5800000000163
2870,2022-01-27 13:10:00,-1798.41,48940.32000000009,47985.150000000074,955.1700000000128
2871,2022-01-27 13:15:00,-1123.97,47816.350000000086,47985.150000000074,-168.79999999998836
2872,2022-01-27 13:20:00,1752.05,49568.40000000009,47985.150000000074,1583.2500000000146
2873,2022-01-27 13:25:00,-745.03,48823.37000000009,47985.150000000074,838.2200000000157
2874,2022-01-27 13:30:00,-295.85,48527.52000000009,47985.150000000074,542.3700000000172
2875,2022-01-27 13:35:00,1409.38,49936.90000000009,47985.150000000074,1951.7500000000146
2876,2022-01-27 13:40:00,-1297.18,48639.72000000009,47985.150000000074,654.5700000000143
2877,2022-01-27 13:45:00,-1710.9,46928.82000000009,47985.150000000074,-1056.3299999999872
2878,2022-01-27 13:50:00,1412.74,48341.560000000085,47985.150000000074,356.41000000001077
2879,2022-01-27 13:55:00,1350.38,49691.94000000008,47985.150000000074,1706.7900000000081
2880,2022-01-27 14:00:00,1923.19,51615.130000000085,47985.150000000074,3629.9800000000105
2881,2022-01-27 14:05:00,-1947.6,49667.530000000086,47985.150000000074,1682.380000000012
2882,2022-01-27 14:10:00,906.05,50573.58000000009,47985.150000000074,2588.430000000015
2883,2022-01-27 14:15:00,1056.09,51629.670000000086,47985.150000000074,3644.5200000000114
2884,2022-01-27 14:20:00,994.27,52623.94000000008,47985.150000000074,4638.790000000008
2885,2022-01-27 14:25:00,284.97,52908.91000000008,47985.150000000074,4923.760000000009
2886,2022-01-27 14:30:00,-991.1,51917.810000000085,47985.150000000074,3932.6600000000108
2887,2022-01-27 14:35:00,-1861.42,50056.39000000009,47985.150000000074,2071.2400000000125
2888,2022-01-27 14:40:00,-1100.56,48955.83000000009,47985.150000000074,970.6800000000148
2889,2022-01-27 14:45:00,-1570.53,47385.30000000009,47985.150000000074,-599.849999999984
2890,2022-01-27 14:50:00,-1699.51,45685.79000000009,47985.150000000074,-2299.359999999986
2891,2022-01-27 14:55:00,518.52,46204.310000000085,47985.150000000074,-1780.8399999999892
2892,2022-01-27 15:00:00,627.45,46831.76000000008,47985.150000000074,-1153.3899999999921
2893,2022-01-27 15:05:00,412.78,47244.54000000008,47985.150000000074,-740.6099999999933
2894,2022-01-27 15:10:00,-1868.22,45376.32000000008,47985.150000000074,-2608.8299999999945
2895,2022-01-27 15:15:00,-1524.74,43851.58000000008,47985.150000000074,-4133.569999999992
2896,2022-01-27 15:20:00,58.16,43909.740000000085,47985.150000000074,-4075.409999999989
2897,2022-01-27 15:25:00,233.78,44143.520000000084,47985.150000000074,-3841.62999999999
2898,2022-01-27 15:30:00,-1833.08,42310.44000000008,47985.150000000074,-5674.709999999992
2899,2022-01-27 15:35:00,378.75,42689.19000000008,47985.150000000074,-5295.959999999992
2900,2022-01-27 15:40:00,-403.51,42285.68000000008,47985.150000000074,-5699.469999999994
2901,2022-01-27 15:45:00,-1607.79,40677.89000000008,47985.150000000074,-7307.259999999995
2902,2022-01-27 15:50:00,-399.5,40278.39000000008,47985.150000000074,-7706.759999999995
2903,2022-01-27 15:55:00,738.7,41017.09000000008,47985.150000000074,-6968.059999999998
2904,2022-01-27 16:00:00,1243.54,42260.63000000008,47985.150000000074,-5724.519999999997
2905,2022-01-27 16:05:00,-691.96,41568.67000000008,47985.150000000074,-6416.479999999996
2906,2022-01-27 16:10:00,-1507.76,40060.910000000076,47985.150000000074,-7924.239999999998
2907,2022-01-27 16:15:00,1035.76,41096.67000000008,47985.150000000074,-6888.479999999996
2908,2022-01-27 16:20:00,-1130.57,39966.10000000008,47985.150000000074,-8019.049999999996
2909,2022-01-27 16:25:00,534.92,40501.02000000008,47985.150000000074,-7484.129999999997
2910,2022-01-27 16:30:00,-750.83,39750.190000000075,47985.150000000074,-8234.96
2911,2022-01-27 16:35:00,-667.28,39082.910000000076,47985.150000000074,-8902.239999999998
2912,2022-01-27 16:40:00,1818.9,40901.81000000008,47985.150000000074,-7083.3399999999965
2913,2022-01-27 16:45:00,958.05,41859.86000000008,47985.150000000074,-6125.289999999994
2914,2022-01-27 16:50:00,46.77,41906.63000000008,47985.150000000074,-6078.519999999997
2915,2022-01-27 16:55:00,-1515.07,40391.56000000008,47985.150000000074,-7593.5899999999965
2916,2022-01-28 08:00:00,-203.61,40187.95000000008,40391.56000000008,-203.61000000000058
2917,2022-01-28 08:05:00,1746.77,41934.720000000074,40391.56000000008,1543.1599999999962
2918,2022-01-28 08:10:00,1289.81,43224.53000000007,40391.56000000008,2832.969999999994
2919,2022-01-28 08:15:00,-128.93,43095.60000000007,40391.56000000008,2704.0399999999936
2920,2022-01-28 08:20:00,1533.26,44628.86000000007,40391.56000000008,4237.299999999996
2921,2022-01-28 08:25:00,-1539.41,43089.45000000007,40391.56000000008,2697.889999999992
2922,2022-01-28 08:30:00,-674.08,42415.37000000007,40391.56000000008,2023.8099999999904
2923,2022-01-28 08:35:00,758.5,43173.87000000007,40391.56000000008,2782.3099999999904
2924,2022-01-28 08:40:00,1859.16,45033.03000000007,40391.56000000008,4641.469999999994
2925,2022-01-28 08:45:00,-1171.19,43861.84000000007,40391.56000000008,3470.2799999999916
2926,2022-01-28 08:50:00,-1703.19,42158.65000000007,40391.56000000008,1767.0899999999892
2927,2022-01-28 08:55:00,1152.02,43310.670000000064,40391.56000000008,2919.109999999986
2928,2022-01-28 09:00:00,-83.42,43227.250000000065,40391.56000000008,2835.689999999988
2929,2022-01-28 09:05:00,-1179.82,42047.430000000066,40391.56000000008,1655.869999999988
2930,2022-01-28 09:10:00,439.36,42486.790000000066,40391.56000000008,2095.2299999999886
2931,2022-01-28 09:15:00,469.47,42956.26000000007,40391.56000000008,2564.69999999999
2932,2022-01-28 09:20:00,-28.57,42927.69000000007,40391.56000000008,2536.12999999999
2933,2022-01-28 09:25:00,-847.67,42080.02000000007,40391.56000000008,1688.4599999999919
2934,2022-01-28 09:30:00,-192.87,41887.15000000007,40391.56000000008,1495.5899999999892
2935,2022-01-28 09:35:00,400.96,42288.110000000066,40391.56000000008,1896.5499999999884
2936,2022-01-28 09:40:00,960.39,43248.500000000065,40391.56000000008,2856.939999999988
2937,2022-01-28 09:45:00,291.23,43539.73000000007,40391.56000000008,3148.169999999991
2938,2022-01-28 09:50:00,1449.74,44989.47000000007,40391.56000000008,4597.909999999989
2939,2022-01-28 09:55:00,968.86,45958.33000000007,40391.56000000008,5566.7699999999895
2940,2022-01-28 10:00:00,-1694.97,44263.360000000066,40391.56000000008,3871.7999999999884
2941,2022-01-28 10:05:00,-703.24,43560.12000000007,40391.56000000008,3168.5599999999904
2942,2022-01-28 10:10:00,-81.0,43479.12000000007,40391.56000000008,3087.5599999999904
2943,2022-01-28 10:15:00,856.27,44335.390000000065,40391.56000000008,3943.829999999987
2944,2022-01-28 10:20:00,1345.57,45680.960000000065,40391.56000000008,5289.399999999987
2945,2022-01-28 10:25:00,-109.94,45571.02000000006,40391.56000000008,5179.459999999985
2946,2022-01-28 10:30:00,1283.61,46854.63000000006,40391.56000000008,6463.069999999985
2947,2022-01-28 10:35:00,-1549.01,45305.62000000006,40391.56000000008,4914.059999999983
2948,2022-01-28 10:40:00,1461.22,46766.84000000006,40391.56000000008,6375.279999999984
2949,2022-01-28 10:45:00,1379.84,48146.68000000006,40391.56000000008,7755.119999999981
2950,2022-01-28 10:50:00,-218.34,47928.34000000006,40391.56000000008,7536.779999999984
2951,2022-01-28 10:55:00,1015.65,48943.99000000006,40391.56000000008,8552.429999999986
2952,2022-01-28 11:00:00,934.95,49878.94000000006,40391.56000000008,9487.379999999983
2953,2022-01-28 11:05:00,-199.81,49679.13000000006,40391.56000000008,9287.569999999985
2954,2022-01-28 11:10:00,-1497.11,48182.02000000006,40391.56000000008,7790.459999999985
2955,2022-01-28 11:15:00,699.86,48881.88000000006,40391.56000000008,8490.319999999985
2956,2022-01-28 11:20:00,1315.43,50197.31000000006,40391.56000000008,9805.749999999985
2957,2022-01-28 11:25:00,-793.46,49403.850000000064,40391.56000000008,9012.289999999986
2958,2022-01-28 11:30:00,-1147.5,48256.350000000064,40391.56000000008,7864.789999999986
2959,2022-01-28 11:35:00,1111.93,49368.280000000064,40391.56000000008,8976.719999999987
2960,2022-01-28 11:40:00,-201.72,49166.56000000006,40391.56000000008,8774.999999999985
2961,2022-01-28 11:45:00,293.35,49459.91000000006,40391.56000000008,9068.349999999984
2962,2022-01-28 11:50:00,-1356.2,48103.710000000065,40391.56000000008,7712.149999999987
2963,2022-01-28 11:55:00,619.9,48723.610000000066,40391.56000000008,8332.049999999988
2964,2022-01-28 12:00:00,-1216.23,47507.38000000006,40391.56000000008,7115.819999999985
2965,2022-01-28 12:05:00,619.52,48126.90000000006,40391.56000000008,7735.339999999982
2966,2022-01-28 12:10:00,1840.95,49967.85000000006,40391.56000000008,9576.289999999979
2967,2022-01-28 12:15:00,400.83,50368.68000000006,40391.56000000008,9977.11999999998
2968,2022-01-28 12:20:00,-1152.39,49216.29000000006,40391.56000000008,8824.729999999981
2969,2022-01-28 12:25:00,-1057.76,48158.53000000006,40391.56000000008,7766.969999999979
2970,2022-01-28 12:30:00,-1495.05,46663.480000000054,40391.56000000008,6271.919999999976
2971,2022-01-28 12:35:00,1775.96,48439.44000000005,40391.56000000008,8047.879999999976
2972,2022-01-28 12:40:00,-457.35,47982.090000000055,40391.56000000008,7590.529999999977
2973,2022-01-28 12:45:00,-296.51,47685.58000000005,40391.56000000008,7294.019999999975
2974,2022-01-28 12:50:00,-1114.52,46571.060000000056,40391.56000000008,6179.499999999978
2975,2022-01-28 12:55:00,-265.32,46305.740000000056,40391.56000000008,5914.1799999999785
2976,2022-01-28 13:00:00,-31.14,46274.60000000006,40391.56000000008,5883.039999999979
2977,2022-01-28 13:05:00,1498.79,47773.39000000006,40391.56000000008,7381.82999999998
2978,2022-01-28 13:10:00,729.01,48502.40000000006,40391.56000000008,8110.839999999982
2979,2022-01-28 13:15:00,-1281.22,47221.18000000006,40391.56000000008,6829.619999999981
2980,2022-01-28 13:20:00,-1342.06,45879.12000000006,40391.56000000008,5487.559999999983
2981,2022-01-28 13:25:00,933.49,46812.61000000006,40391.56000000008,6421.049999999981
2982,2022-01-28 13:30:00,-1382.65,45429.96000000006,40391.56000000008,5038.39999999998
2983,2022-01-28 13:35:00,571.37,46001.33000000006,40391.56000000008,5609.769999999982
2984,2022-01-28 13:40:00,729.05,46730.38000000006,40391.56000000008,6338.819999999985
2985,2022-01-28 13:45:00,1739.05,48469.430000000066,40391.56000000008,8077.869999999988
2986,2022-01-28 13:50:00,1694.49,50163.920000000064,40391.56000000008,9772.359999999986
2987,2022-01-28 13:55:00,-1157.49,49006.430000000066,40391.56000000008,8614.869999999988
2988,2022-01-28 14:00:00,-181.89,48824.540000000066,40391.56000000008,8432.979999999989
2989,2022-01-28 14:05:00,661.75,49486.290000000066,40391.56000000008,9094.729999999989
2990,2022-01-28 14:10:00,-1805.39,47680.90000000007,40391.56000000008,7289.339999999989
2991,2022-01-28 14:15:00,1917.33,49598.23000000007,40391.56000000008,9206.669999999991
2992,2022-01-28 14:20:00,357.73,49955.96000000007,40391.56000000008,9564.399999999994
2993,2022-01-28 14:25:00,167.94,50123.900000000074,40391.56000000008,9732.339999999997
2994,2022-01-28 14:30:00,819.49,50943.39000000007,40391.56000000008,10551.829999999994
2995,2022-01-28 14:35:00,462.37,51405.760000000075,40391.56000000008,11014.199999999997
2996,2022-01-28 14:40:00,-1439.19,49966.57000000007,40391.56000000008,9575.009999999995
2997,2022-01-28 14:45:00,-195.95,49770.620000000075,40391.56000000008,9379.059999999998
2998,2022-01-28 14:50:00,-1303.58,48467.04000000007,40391.56000000008,8075.479999999996
2999,2022-01-28 14:55:00,873.94,49340.980000000076,40391.56000000008,8949.419999999998
3000,2022-01-28 15:00:00,60.56,49401.54000000007,40391.56000000008,9009.979999999996
3001,2022-01-28 15:05:00,-157.11,49244.43000000007,40391.56000000008,8852.869999999995
3002,2022-01-28 15:10:00,1416.03,50660.46000000007,40391.56000000008,10268.899999999994
3003,2022-01-28 15:15:00,357.37,51017.830000000075,40391.56000000008,10626.269999999997
3004,2022-01-28 15:20:00,300.76,51318.59000000008,40391.56000000008,10927.029999999999
3005,2022-01-28 15:25:00,-390.76,50927.830000000075,40391.56000000008,10536.269999999997
3006,2022-01-28 15:30:00,-248.05,50679.78000000007,40391.56000000008,10288.219999999994
3007,2022-01-28 15:35:00,-842.02,49837.760000000075,40391.56000000008,9446.199999999997
3008,2022-01-28 15:40:00,145.27,49983.03000000007,40391.56000000008,9591.469999999994
3009,2022-01-28 15:45:00,-210.29,49772.74000000007,40391.56000000008,9381.179999999993
3010,2022-01-28 15:50:00,322.06,50094.80000000007,40391.56000000008,9703.23999999999
3011,2022-01-28 15:55:00,-684.42,49410.38000000007,40391.56000000008,9018.819999999992
3012,2022-01-28 16:00:00,656.26,50066.64000000007,40391.56000000008,9675.079999999994
3013,2022-01-28 16:05:00,-1450.71,48615.93000000007,40391.56000000008,8224.369999999995
3014,2022-01-28 16:10:00,-1976.35,46639.580000000075,40391.56000000008,6248.019999999997
3015,2022-01-28 16:15:00,-1101.09,45538.49000000008,40391.56000000008,5146.93
3016,2022-01-28 16:20:00,-748.13,44790.36000000008,40391.56000000008,4398.800000000003
3017,2022-01-28 16:25:00,216.49,45006.85000000008,40391.56000000008,4615.290000000001
3018,2022-01-28 16:30:00,-1757.52,43249.33000000008,40391.56000000008,2857.770000000004
3019,2022-01-28 16:35:00,1221.34,44470.67000000008,40391.56000000008,4079.1100000000006
3020,2022-01-28 16:40:00,-437.02,44033.65000000008,40391.56000000008,3642.090000000004
3021,2022-01-28 16:45:00,929.13,44962.78000000008,40391.56000000008,4571.220000000001
3022,2022-01-28 16:50:00,1045.67,46008.45000000008,40391.56000000008,5616.889999999999
3023,2022-01-28 16:55:00,-1384.67,44623.78000000008,40391.56000000008,4232.220000000001
3024,2022-01-29 08:00:00,1951.27,46575.050000000076,44623.78000000008,1951.2699999999968
3025,2022-01-29 08:05:00,-1628.12,44946.93000000007,44623.78000000008,323.1499999999942
3026,2022-01-29 08:10:00,-830.57,44116.36000000007,44623.78000000008,-507.42000000000553
3027,2022-01-29 08:15:00,-1556.17,42560.190000000075,44623.78000000008,-2063.590000000004
3028,2022-01-29 08:20:00,271.1,42831.29000000007,44623.78000000008,-1792.4900000000052
3029,2022-01-29 08:25:00,-1442.74,41388.550000000076,44623.78000000008,-3235.230000000003
3030,2022-01-29 08:30:00,-404.45,40984.10000000008,44623.78000000008,-3639.6800000000003
3031,2022-01-29 08:35:00,1034.06,42018.160000000076,44623.78000000008,-2605.6200000000026
3032,2022-01-29 08:40:00,-705.38,41312.78000000008,44623.78000000008,-3311.0
3033,2022-01-29 08:45:00,-587.56,40725.22000000008,44623.78000000008,-3898.5599999999977
3034,2022-01-29 08:50:00,1227.13,41952.35000000008,44623.78000000008,-2671.4300000000003
3035,2022-01-29 08:55:00,-1787.62,40164.730000000076,44623.78000000008,-4459.050000000003
3036,2022-01-29 09:00:00,-1806.33,38358.400000000074,44623.78000000008,-6265.380000000005
3037,2022-01-29 09:05:00,-227.37,38131.03000000007,44623.78000000008,-6492.750000000007
3038,2022-01-29 09:10:00,1201.68,39332.71000000007,44623.78000000008,-5291.070000000007
3039,2022-01-29 09:15:00,1093.39,40426.10000000007,44623.78000000008,-4197.680000000008
3040,2022-01-29 09:20:00,-546.33,39879.77000000007,44623.78000000008,-4744.010000000009
3041,2022-01-29 09:25:00,-669.36,39210.41000000007,44623.78000000008,-5413.37000000001
3042,2022-01-29 09:30:00,1111.59,40322.000000000065,44623.78000000008,-4301.780000000013
3043,2022-01-29 09:35:00,644.35,40966.350000000064,44623.78000000008,-3657.430000000015
3044,2022-01-29 09:40:00,-1201.6,39764.750000000065,44623.78000000008,-4859.030000000013
3045,2022-01-29 09:45:00,305.05,40069.80000000007,44623.78000000008,-4553.9800000000105
3046,2022-01-29 09:50:00,-732.56,39337.24000000007,44623.78000000008,-5286.540000000008
3047,2022-01-29 09:55:00,1230.26,40567.50000000007,44623.78000000008,-4056.280000000006
3048,2022-01-29 10:00:00,-766.9,39800.60000000007,44623.78000000008,-4823.180000000008
3049,2022-01-29 10:05:00,1762.16,41562.760000000075,44623.78000000008,-3061.020000000004
3050,2022-01-29 10:10:00,87.34,41650.10000000007,44623.78000000008,-2973.6800000000076
3051,2022-01-29 10:15:00,-200.5,41449.60000000007,44623.78000000008,-3174.1800000000076
3052,2022-01-29 10:20:00,84.25,41533.85000000007,44623.78000000008,-3089.9300000000076
3053,2022-01-29 10:25:00,-277.17,41256.68000000007,44623.78000000008,-3367.100000000006
3054,2022-01-29 10:30:00,-1164.39,40092.29000000007,44623.78000000008,-4531.490000000005
3055,2022-01-29 10:35:00,1379.49,41471.78000000007,44623.78000000008,-3152.0000000000073
3056,2022-01-29 10:40:00,813.49,42285.27000000007,44623.78000000008,-2338.5100000000093
3057,2022-01-29 10:45:00,564.42,42849.69000000007,44623.78000000008,-1774.090000000011
3058,2022-01-29 10:50:00,270.9,43120.59000000007,44623.78000000008,-1503.1900000000096
3059,2022-01-29 10:55:00,-532.24,42588.35000000007,44623.78000000008,-2035.4300000000076
3060,2022-01-29 11:00:00,1669.36,44257.71000000007,44623.78000000008,-366.070000000007
3061,2022-01-29 11:05:00,-723.5,43534.21000000007,44623.78000000008,-1089.570000000007
3062,2022-01-29 11:10:00,76.01,43610.220000000074,44623.78000000008,-1013.560000000005
3063,2022-01-29 11:15:00,552.14,44162.36000000007,44623.78000000008,-461.42000000000553
3064,2022-01-29 11:20:00,-121.87,44040.49000000007,44623.78000000008,-583.2900000000081
3065,2022-01-29 11:25:00,-1574.74,42465.75000000007,44623.78000000008,-2158.030000000006
3066,2022-01-29 11:30:00,-835.1,41630.650000000074,44623.78000000008,-2993.1300000000047
3067,2022-01-29 11:35:00,262.25,41892.900000000074,44623.78000000008,-2730.8800000000047
3068,2022-01-29 11:40:00,1492.35,43385.25000000007,44623.78000000008,-1238.530000000006
3069,2022-01-29 11:45:00,175.07,43560.32000000007,44623.78000000008,-1063.4600000000064
3070,2022-01-29 11:50:00,1078.46,44638.78000000007,44623.78000000008,14.999999999992724
3071,2022-01-29 11:55:00,-1094.73,43544.05000000007,44623.78000000008,-1079.7300000000105
3072,2022-01-29 12:00:00,-994.65,42549.40000000007,44623.78000000008,-2074.380000000012
3073,2022-01-29 12:05:00,195.74,42745.140000000065,44623.78000000008,-1878.640000000014
3074,2022-01-29 12:10:00,1495.26,44240.40000000007,44623.78000000008,-383.38000000001193
3075,2022-01-29 12:15:00,353.32,44593.72000000007,44623.78000000008,-30.060000000012224
3076,2022-01-29 12:20:00,-1968.36,42625.360000000066,44623.78000000008,-1998.4200000000128
3077,2022-01-29 12:25:00,-954.49,41670.87000000007,44623.78000000008,-2952.9100000000108
3078,2022-01-29 12:30:00,-1616.98,40053.890000000065,44623.78000000008,-4569.890000000014
3079,2022-01-29 12:35:00,-1939.09,38114.80000000007,44623.78000000008,-6508.9800000000105
3080,2022-01-29 12:40:00,677.61,38792.41000000007,44623.78000000008,-5831.37000000001
3081,2022-01-29 12:45:00,-1604.8,37187.610000000066,44623.78000000008,-7436.170000000013
3082,2022-01-29 12:50:00,-794.15,36393.460000000065,44623.78000000008,-8230.320000000014
3083,2022-01-29 12:55:00,-756.36,35637.100000000064,44623.78000000008,-8986.680000000015
3084,2022-01-29 13:00:00,1536.6,37173.70000000006,44623.78000000008,-7450.080000000016
3085,2022-01-29 13:05:00,-88.29,37085.41000000006,44623.78000000008,-7538.370000000017
3086,2022-01-29 13:10:00,1032.86,38118.27000000006,44623.78000000008,-6505.510000000017
3087,2022-01-29 13:15:00,1498.91,39617.180000000066,44623.78000000008,-5006.600000000013
3088,2022-01-29 13:20:00,-609.05,39008.13000000006,44623.78000000008,-5615.650000000016
3089,2022-01-29 13:25:00,-1579.77,37428.360000000066,44623.78000000008,-7195.420000000013
3090,2022-01-29 13:30:00,-1334.55,36093.81000000006,44623.78000000008,-8529.970000000016
3091,2022-01-29 13:35:00,-1617.95,34475.860000000066,44623.78000000008,-10147.920000000013
3092,2022-01-29 13:40:00,797.05,35272.91000000007,44623.78000000008,-9350.87000000001
3093,2022-01-29 13:45:00,-866.61,34406.30000000007,44623.78000000008,-10217.48000000001
3094,2022-01-29 13:50:00,-525.94,33880.360000000066,44623.78000000008,-10743.420000000013
3095,2022-01-29 13:55:00,830.83,34711.19000000007,44623.78000000008,-9912.590000000011
3096,2022-01-29 14:00:00,1322.5,36033.69000000007,44623.78000000008,-8590.090000000011
3097,2022-01-29 14:05:00,1248.18,37281.87000000007,44623.78000000008,-7341.910000000011
3098,2022-01-29 14:10:00,-320.99,36960.88000000007,44623.78000000008,-7662.900000000009
3099,2022-01-29 14:15:00,-1731.81,35229.07000000007,44623.78000000008,-9394.710000000006
3100,2022-01-29 14:20:00,316.83,35545.900000000074,44623.78000000008,-9077.880000000005
3101,2022-01-29 14:25:00,338.01,35883.910000000076,44623.78000000008,-8739.870000000003
3102,2022-01-29 14:30:00,-1157.99,34725.92000000008,44623.78000000008,-9897.86
3103,2022-01-29 14:35:00,1542.46,36268.38000000008,44623.78000000008,-8355.400000000001
3104,2022-01-29 14:40:00,536.08,36804.46000000008,44623.78000000008,-7819.32
3105,2022-01-29 14:45:00,1488.84,38293.300000000076,44623.78000000008,-6330.480000000003
3106,2022-01-29 14:50:00,1940.22,40233.52000000008,44623.78000000008,-4390.260000000002
3107,2022-01-29 14:55:00,1836.74,42070.260000000075,44623.78000000008,-2553.520000000004
3108,2022-01-29 15:00:00,-1618.16,40452.10000000007,44623.78000000008,-4171.680000000008
3109,2022-01-29 15:05:00,-302.69,40149.41000000007,44623.78000000008,-4474.37000000001
3110,2022-01-29 15:10:00,1339.63,41489.040000000066,44623.78000000008,-3134.7400000000125
3111,2022-01-29 15:15:00,813.64,42302.680000000066,44623.78000000008,-2321.100000000013
3112,2022-01-29 15:20:00,499.46,42802.140000000065,44623.78000000008,-1821.640000000014
3113,2022-01-29 15:25:00,1700.45,44502.59000000006,44623.78000000008,-121.19000000001688
3114,2022-01-29 15:30:00,330.37,44832.960000000065,44623.78000000008,209.17999999998574
3115,2022-01-29 15:35:00,1274.98,46107.94000000007,44623.78000000008,1484.159999999989
3116,2022-01-29 15:40:00,1475.52,47583.460000000065,44623.78000000008,2959.6799999999857
3117,2022-01-29 15:45:00,-116.15,47467.31000000006,44623.78000000008,2843.5299999999843
3118,2022-01-29 15:50:00,-1382.26,46085.05000000006,44623.78000000008,1461.2699999999822
3119,2022-01-29 15:55:00,1892.52,47977.57000000006,44623.78000000008,3353.789999999979
3120,2022-01-29 16:00:00,1372.58,49350.15000000006,44623.78000000008,4726.369999999981
3121,2022-01-29 16:05:00,770.63,50120.78000000006,44623.78000000008,5496.999999999978
3122,2022-01-29 16:10:00,504.08,50624.86000000006,44623.78000000008,6001.07999999998
3123,2022-01-29 16:15:00,1132.04,51756.90000000006,44623.78000000008,7133.119999999981
3124,2022-01-29 16:20:00,-493.05,51263.85000000006,44623.78000000008,6640.069999999978
3125,2022-01-29 16:25:00,863.38,52127.230000000054,44623.78000000008,7503.449999999975
3126,2022-01-29 16:30:00,812.59,52939.82000000005,44623.78000000008,8316.039999999972
3127,2022-01-29 16:35:00,155.21,53095.03000000005,44623.78000000008,8471.24999999997
3128,2022-01-29 16:40:00,-15.11,53079.92000000005,44623.78000000008,8456.13999999997
3129,2022-01-29 16:45:00,1256.67,54336.59000000005,44623.78000000008,9712.809999999969
3130,2022-01-29 16:50:00,61.6,54398.190000000046,44623.78000000008,9774.409999999967
3131,2022-01-29 16:55:00,958.85,55357.040000000045,44623.78000000008,10733.259999999966
3132,2022-01-30 08:00:00,1919.75,57276.790000000045,55357.040000000045,1919.75
3133,2022-01-30 08:05:00,-921.23,56355.56000000004,55357.040000000045,998.5199999999968
3134,2022-01-30 08:10:00,1646.28,58001.84000000004,55357.040000000045,2644.7999999999956
3135,2022-01-30 08:15:00,208.84,58210.68000000004,55357.040000000045,2853.639999999992
3136,2022-01-30 08:20:00,-1013.24,57197.44000000004,55357.040000000045,1840.3999999999942
3137,2022-01-30 08:25:00,-493.63,56703.81000000004,55357.040000000045,1346.7699999999968
3138,2022-01-30 08:30:00,-959.1,55744.71000000004,55357.040000000045,387.66999999999825
3139,2022-01-30 08:35:00,-1159.61,54585.10000000004,55357.040000000045,-771.9400000000023
3140,2022-01-30 08:40:00,-274.26,54310.84000000004,55357.040000000045,-1046.2000000000044
3141,2022-01-30 08:45:00,232.87,54543.71000000004,55357.040000000045,-813.3300000000017
3142,2022-01-30 08:50:00,270.06,54813.77000000004,55357.040000000045,-543.2700000000041
3143,2022-01-30 08:55:00,-439.17,54374.60000000004,55357.040000000045,-982.4400000000023
3144,2022-01-30 09:00:00,1378.27,55752.87000000004,55357.040000000045,395.82999999999447
3145,2022-01-30 09:05:00,-601.03,55151.84000000004,55357.040000000045,-205.20000000000437
3146,2022-01-30 09:10:00,1899.49,57051.33000000004,55357.040000000045,1694.2899999999936
3147,2022-01-30 09:15:00,-1239.47,55811.86000000004,55357.040000000045,454.81999999999243
3148,2022-01-30 09:20:00,1120.18,56932.04000000004,55357.040000000045,1574.9999999999927
3149,2022-01-30 09:25:00,-1191.52,55740.52000000004,55357.040000000045,383.4799999999959
3150,2022-01-30 09:30:00,-1141.79,54598.73000000004,55357.040000000045,-758.310000000005
3151,2022-01-30 09:35:00,-651.99,53946.74000000004,55357.040000000045,-1410.300000000003
3152,2022-01-30 09:40:00,1869.05,55815.790000000045,55357.040000000045,458.75
3153,2022-01-30 09:45:00,1476.59,57292.38000000004,55357.040000000045,1935.3399999999965
3154,2022-01-30 09:50:00,-1637.98,55654.40000000004,55357.040000000045,297.3599999999933
3155,2022-01-30 09:55:00,817.47,56471.87000000004,55357.040000000045,1114.8299999999945
3156,2022-01-30 10:00:00,1835.84,58307.710000000036,55357.040000000045,2950.669999999991
3157,2022-01-30 10:05:00,-1289.1,57018.61000000004,55357.040000000045,1661.5699999999924
3158,2022-01-30 10:10:00,189.14,57207.75000000004,55357.040000000045,1850.7099999999919
3159,2022-01-30 10:15:00,490.06,57697.810000000034,55357.040000000045,2340.7699999999895
3160,2022-01-30 10:20:00,-1974.88,55722.93000000004,55357.040000000045,365.88999999999214
3161,2022-01-30 10:25:00,989.2,56712.130000000034,55357.040000000045,1355.0899999999892
3162,2022-01-30 10:30:00,-1879.31,54832.820000000036,55357.040000000045,-524.2200000000084
3163,2022-01-30 10:35:00,688.68,55521.50000000004,55357.040000000045,164.45999999999185
3164,2022-01-30 10:40:00,-476.69,55044.810000000034,55357.040000000045,-312.2300000000105
3165,2022-01-30 10:45:00,-1073.68,53971.130000000034,55357.040000000045,-1385.9100000000108
3166,2022-01-30 10:50:00,1293.49,55264.62000000003,55357.040000000045,-92.4200000000128
3167,2022-01-30 10:55:00,828.78,56093.40000000003,55357.040000000045,736.359999999986
3168,2022-01-30 11:00:00,189.24,56282.64000000003,55357.040000000045,925.599999999984
3169,2022-01-30 11:05:00,-1598.54,54684.10000000003,55357.040000000045,-672.9400000000169
3170,2022-01-30 11:10:00,-665.69,54018.410000000025,55357.040000000045,-1338.6300000000192
3171,2022-01-30 11:15:00,1444.68,55463.090000000026,55357.040000000045,106.04999999998108
3172,2022-01-30 11:20:00,-1868.96,53594.13000000003,55357.040000000045,-1762.910000000018
3173,2022-01-30 11:25:00,-1909.87,51684.260000000024,55357.040000000045,-3672.7800000000207
3174,2022-01-30 11:30:00,-671.15,51013.11000000002,55357.040000000045,-4343.930000000022
3175,2022-01-30 11:35:00,-1830.46,49182.65000000002,55357.040000000045,-6174.390000000021
3176,2022-01-30 11:40:00,-1063.75,48118.90000000002,55357.040000000045,-7238.140000000021
3177,2022-01-30 11:45:00,209.38,48328.28000000002,55357.040000000045,-7028.760000000024
3178,2022-01-30 11:50:00,1433.1,49761.38000000002,55357.040000000045,-5595.660000000025
3179,2022-01-30 11:55:00,-683.02,49078.36000000002,55357.040000000045,-6278.680000000022
3180,2022-01-30 12:00:00,1656.63,50734.99000000002,55357.040000000045,-4622.050000000025
3181,2022-01-30 12:05:00,-1733.1,49001.89000000002,55357.040000000045,-6355.150000000023
3182,2022-01-30 12:10:00,-76.68,48925.21000000002,55357.040000000045,-6431.830000000024
3183,2022-01-30 12:15:00,-1103.61,47821.60000000002,55357.040000000045,-7535.440000000024
3184,2022-01-30 12:20:00,1955.13,49776.73000000002,55357.040000000045,-5580.310000000027
3185,2022-01-30 12:25:00,-577.06,49199.67000000002,55357.040000000045,-6157.370000000024
3186,2022-01-30 12:30:00,556.38,49756.05000000002,55357.040000000045,-5600.990000000027
3187,2022-01-30 12:35:00,857.49,50613.540000000015,55357.040000000045,-4743.500000000029
3188,2022-01-30 12:40:00,-1864.52,48749.02000000002,55357.040000000045,-6608.020000000026
3189,2022-01-30 12:45:00,-282.11,48466.91000000002,55357.040000000045,-6890.1300000000265
3190,2022-01-30 12:50:00,783.77,49250.680000000015,55357.040000000045,-6106.36000000003
3191,2022-01-30 12:55:00,-1597.23,47653.45000000001,55357.040000000045,-7703.590000000033
3192,2022-01-30 13:00:00,-1983.82,45669.63000000001,55357.040000000045,-9687.410000000033
3193,2022-01-30 13:05:00,441.15,46110.78000000001,55357.040000000045,-9246.260000000031
3194,2022-01-30 13:10:00,-820.01,45290.77000000001,55357.040000000045,-10066.270000000033
3195,2022-01-30 13:15:00,-1828.24,43462.53000000001,55357.040000000045,-11894.510000000031
3196,2022-01-30 13:20:00,-1705.21,41757.320000000014,55357.040000000045,-13599.72000000003
3197,2022-01-30 13:25:00,403.37,42160.69000000002,55357.040000000045,-13196.350000000028
3198,2022-01-30 13:30:00,-1619.33,40541.360000000015,55357.040000000045,-14815.68000000003
3199,2022-01-30 13:35:00,1555.29,42096.650000000016,55357.040000000045,-13260.390000000029
3200,2022-01-30 13:40:00,1087.24,43183.890000000014,55357.040000000045,-12173.15000000003
3201,2022-01-30 13:45:00,-501.39,42682.500000000015,55357.040000000045,-12674.54000000003
3202,2022-01-30 13:50:00,1394.21,44076.710000000014,55357.040000000045,-11280.33000000003
3203,2022-01-30 13:55:00,277.68,44354.390000000014,55357.040000000045,-11002.65000000003
3204,2022-01-30 14:00:00,1058.39,45412.78000000001,55357.040000000045,-9944.260000000031
3205,2022-01-30 14:05:00,-1023.2,44389.580000000016,55357.040000000045,-10967.460000000028
3206,2022-01-30 14:10:00,-1463.53,42926.05000000002,55357.040000000045,-12430.990000000027
3207,2022-01-30 14:15:00,-1500.81,41425.24000000002,55357.040000000045,-13931.800000000025
3208,2022-01-30 14:20:00,1200.94,42626.18000000002,55357.040000000045,-12730.860000000022
3209,2022-01-30 14:25:00,1348.26,43974.440000000024,55357.040000000045,-11382.60000000002
3210,2022-01-30 14:30:00,-946.03,43028.410000000025,55357.040000000045,-12328.63000000002
3211,2022-01-30 14:35:00,-1714.96,41313.450000000026,55357.040000000045,-14043.590000000018
3212,2022-01-30 14:40:00,573.76,41887.21000000003,55357.040000000045,-13469.830000000016
3213,2022-01-30 14:45:00,-1279.78,40607.43000000003,55357.040000000045,-14749.610000000015
3214,2022-01-30 14:50:00,-1598.43,39009.00000000003,55357.040000000045,-16348.040000000015
3215,2022-01-30 14:55:00,-1353.18,37655.82000000003,55357.040000000045,-17701.220000000016
3216,2022-01-30 15:00:00,1057.08,38712.90000000003,55357.040000000045,-16644.140000000014
3217,2022-01-30 15:05:00,-1823.56,36889.34000000003,55357.040000000045,-18467.70000000001
3218,2022-01-30 15:10:00,1803.1,38692.44000000003,55357.040000000045,-16664.600000000013
3219,2022-01-30 15:15:00,485.89,39178.33000000003,55357.040000000045,-16178.710000000014
3220,2022-01-30 15:20:00,1120.71,40299.04000000003,55357.040000000045,-15058.000000000015
3221,2022-01-30 15:25:00,515.19,40814.23000000003,55357.040000000045,-14542.810000000012
3222,2022-01-30 15:30:00,-6.21,40808.02000000003,55357.040000000045,-14549.020000000011
3223,2022-01-30 15:35:00,-793.73,40014.29000000003,55357.040000000045,-15342.750000000015
3224,2022-01-30 15:40:00,-1676.78,38337.51000000003,55357.040000000045,-17019.530000000013
3225,2022-01-30 15:45:00,513.85,38851.36000000003,55357.040000000045,-16505.680000000015
3226,2022-01-30 15:50:00,895.92,39747.28000000003,55357.040000000045,-15609.760000000017
3227,2022-01-30 15:55:00,-1414.66,38332.620000000024,55357.040000000045,-17024.42000000002
3228,2022-01-30 16:00:00,-286.56,38046.06000000003,55357.040000000045,-17310.980000000018
3229,2022-01-30 16:05:00,-841.2,37204.86000000003,55357.040000000045,-18152.180000000015
3230,2022-01-30 16:10:00,-1032.14,36172.72000000003,55357.040000000045,-19184.320000000014
3231,2022-01-30 16:15:00,750.25,36922.97000000003,55357.040000000045,-18434.070000000014
3232,2022-01-30 16:20:00,1071.68,37994.65000000003,55357.040000000045,-17362.390000000014
3233,2022-01-30 16:25:00,1134.03,39128.68000000003,55357.040000000045,-16228.360000000015
3234,2022-01-30 16:30:00,1989.44,41118.12000000003,55357.040000000045,-14238.920000000013
3235,2022-01-30 16:35:00,-264.45,40853.670000000035,55357.040000000045,-14503.37000000001
3236,2022-01-30 16:40:00,500.67,41354.34000000003,55357.040000000045,-14002.700000000012
3237,2022-01-30 16:45:00,164.11,41518.45000000003,55357.040000000045,-13838.590000000011
3238,2022-01-30 16:50:00,-658.03,40860.420000000035,55357.040000000045,-14496.62000000001
3239,2022-01-30 16:55:00,1010.17,41870.59000000003,55357.040000000045,-13486.450000000012
3240,2022-01-31 08:00:00,-1996.63,39873.960000000036,41870.59000000003,-1996.6299999999974
3241,2022-01-31 08:05:00,-375.85,39498.11000000004,41870.59000000003,-2372.479999999996
3242,2022-01-31 08:10:00,-308.26,39189.850000000035,41870.59000000003,-2680.739999999998
3243,2022-01-31 08:15:00,1137.12,40326.97000000004,41870.59000000003,-1543.6199999999953
3244,2022-01-31 08:20:00,-1835.25,38491.72000000004,41870.59000000003,-3378.8699999999953
3245,2022-01-31 08:25:00,-1526.78,36964.94000000004,41870.59000000003,-4905.649999999994
3246,2022-01-31 08:30:00,-414.29,36550.65000000004,41870.59000000003,-5319.939999999995
3247,2022-01-31 08:35:00,1315.28,37865.93000000004,41870.59000000003,-4004.659999999996
3248,2022-01-31 08:40:00,118.66,37984.59000000004,41870.59000000003,-3885.9999999999927
3249,2022-01-31 08:45:00,1748.8,39733.39000000004,41870.59000000003,-2137.19999999999
3250,2022-01-31 08:50:00,1885.31,41618.70000000004,41870.59000000003,-251.88999999999214
3251,2022-01-31 08:55:00,1353.72,42972.42000000004,41870.59000000003,1101.830000000009
3252,2022-01-31 09:00:00,-1138.54,41833.88000000004,41870.59000000003,-36.70999999999185
3253,2022-01-31 09:05:00,1889.85,43723.73000000004,41870.59000000003,1853.1400000000067
3254,2022-01-31 09:10:00,1070.08,44793.81000000004,41870.59000000003,2923.2200000000084
3255,2022-01-31 09:15:00,-440.66,44353.15000000004,41870.59000000003,2482.560000000005
3256,2022-01-31 09:20:00,-1847.36,42505.79000000004,41870.59000000003,635.2000000000044
3257,2022-01-31 09:25:00,869.49,43375.280000000035,41870.59000000003,1504.6900000000023
3258,2022-01-31 09:30:00,-101.36,43273.920000000035,41870.59000000003,1403.3300000000017
3259,2022-01-31 09:35:00,700.85,43974.77000000003,41870.59000000003,2104.1800000000003
3260,2022-01-31 09:40:00,893.31,44868.08000000003,41870.59000000003,2997.489999999998
3261,2022-01-31 09:45:00,1151.8,46019.880000000034,41870.59000000003,4149.290000000001
3262,2022-01-31 09:50:00,-1494.67,44525.210000000036,41870.59000000003,2654.6200000000026
3263,2022-01-31 09:55:00,-1265.29,43259.920000000035,41870.59000000003,1389.3300000000017
3264,2022-01-31 10:00:00,-115.97,43143.95000000003,41870.59000000003,1273.3600000000006
3265,2022-01-31 10:05:00,-1545.47,41598.48000000003,41870.59000000003,-272.1100000000006
3266,2022-01-31 10:10:00,-849.13,40749.350000000035,41870.59000000003,-1121.239999999998
3267,2022-01-31 10:15:00,-908.55,39840.80000000003,41870.59000000003,-2029.7900000000009
3268,2022-01-31 10:20:00,1449.82,41290.62000000003,41870.59000000003,-579.9700000000012
3269,2022-01-31 10:25:00,-1917.37,39373.25000000003,41870.59000000003,-2497.340000000004
3270,2022-01-31 10:30:00,-618.36,38754.89000000003,41870.59000000003,-3115.7000000000044
3271,2022-01-31 10:35:00,-393.27,38361.62000000003,41870.59000000003,-3508.970000000001
3272,2022-01-31 10:40:00,-1439.94,36921.68000000003,41870.59000000003,-4948.9100000000035
3273,2022-01-31 10:45:00,1641.52,38563.200000000026,41870.59000000003,-3307.3900000000067
3274,2022-01-31 10:50:00,-702.07,37861.13000000003,41870.59000000003,-4009.4600000000064
3275,2022-01-31 10:55:00,375.64,38236.770000000026,41870.59000000003,-3633.820000000007
3276,2022-01-31 11:00:00,654.51,38891.28000000003,41870.59000000003,-2979.310000000005
3277,2022-01-31 11:05:00,-1776.94,37114.340000000026,41870.59000000003,-4756.250000000007
3278,2022-01-31 11:10:00,887.56,38001.90000000002,41870.59000000003,-3868.6900000000096
3279,2022-01-31 11:15:00,-1838.84,36163.06000000003,41870.59000000003,-5707.530000000006
3280,2022-01-31 11:20:00,728.02,36891.08000000002,41870.59000000003,-4979.510000000009
3281,2022-01-31 11:25:00,1754.74,38645.82000000002,41870.59000000003,-3224.7700000000114
3282,2022-01-31 11:30:00,-1255.25,37390.57000000002,41870.59000000003,-4480.020000000011
3283,2022-01-31 11:35:00,1413.99,38804.56000000002,41870.59000000003,-3066.0300000000134
3284,2022-01-31 11:40:00,-294.83,38509.73000000002,41870.59000000003,-3360.860000000015
3285,2022-01-31 11:45:00,1070.54,39580.27000000002,41870.59000000003,-2290.3200000000143
3286,2022-01-31 11:50:00,-1055.17,38525.10000000002,41870.59000000003,-3345.4900000000125
3287,2022-01-31 11:55:00,-511.71,38013.39000000002,41870.59000000003,-3857.2000000000116
3288,2022-01-31 12:00:00,50.97,38064.36000000002,41870.59000000003,-3806.2300000000105
3289,2022-01-31 12:05:00,1624.69,39689.050000000025,41870.59000000003,-2181.540000000008
3290,2022-01-31 12:10:00,-105.51,39583.54000000002,41870.59000000003,-2287.05000000001
3291,2022-01-31 12:15:00,1455.46,41039.00000000002,41870.59000000003,-831.5900000000111
3292,2022-01-31 12:20:00,-194.21,40844.79000000002,41870.59000000003,-1025.8000000000102
3293,2022-01-31 12:25:00,-102.87,40741.92000000002,41870.59000000003,-1128.6700000000128
3294,2022-01-31 12:30:00,266.18,41008.10000000002,41870.59000000003,-862.4900000000125
3295,2022-01-31 12:35:00,-823.34,40184.760000000024,41870.59000000003,-1685.830000000009
3296,2022-01-31 12:40:00,1730.06,41914.82000000002,41870.59000000003,44.22999999998865
3297,2022-01-31 12:45:00,-383.47,41531.35000000002,41870.59000000003,-339.2400000000125
3298,2022-01-31 12:50:00,1553.25,43084.60000000002,41870.59000000003,1214.0099999999875
3299,2022-01-31 12:55:00,1208.36,44292.96000000002,41870.59000000003,2422.369999999988
3300,2022-01-31 13:00:00,1854.57,46147.53000000002,41870.59000000003,4276.939999999988
3301,2022-01-31 13:05:00,-1791.99,44355.54000000002,41870.59000000003,2484.94999999999
3302,2022-01-31 13:10:00,416.99,44772.53000000002,41870.59000000003,2901.939999999988
3303,2022-01-31 13:15:00,-1247.68,43524.85000000002,41870.59000000003,1654.2599999999875
3304,2022-01-31 13:20:00,-1035.94,42488.91000000002,41870.59000000003,618.3199999999852
3305,2022-01-31 13:25:00,123.16,42612.07000000002,41870.59000000003,741.4799999999886
3306,2022-01-31 13:30:00,-975.12,41636.95000000002,41870.59000000003,-233.64000000001397
3307,2022-01-31 13:35:00,1770.63,43407.580000000016,41870.59000000003,1536.9899999999834
3308,2022-01-31 13:40:00,-1186.24,42221.34000000002,41870.59000000003,350.74999999998545
3309,2022-01-31 13:45:00,-1859.2,40362.14000000002,41870.59000000003,-1508.4500000000116
3310,2022-01-31 13:50:00,988.43,41350.57000000002,41870.59000000003,-520.0200000000114
3311,2022-01-31 13:55:00,1435.7,42786.27000000002,41870.59000000003,915.6799999999857
3312,2022-01-31 14:00:00,-517.09,42269.18000000002,41870.59000000003,398.58999999998923
3313,2022-01-31 14:05:00,-171.63,42097.550000000025,41870.59000000003,226.95999999999185
3314,2022-01-31 14:10:00,1269.96,43367.510000000024,41870.59000000003,1496.919999999991
3315,2022-01-31 14:15:00,-1565.36,41802.15000000002,41870.59000000003,-68.4400000000096
3316,2022-01-31 14:20:00,928.51,42730.660000000025,41870.59000000003,860.0699999999924
3317,2022-01-31 14:25:00,595.9,43326.56000000003,41870.59000000003,1455.969999999994
3318,2022-01-31 14:30:00,-55.44,43271.120000000024,41870.59000000003,1400.5299999999916
3319,2022-01-31 14:35:00,-983.66,42287.46000000002,41870.59000000003,416.86999999998807
3320,2022-01-31 14:40:00,1684.4,43971.86000000002,41870.59000000003,2101.2699999999895
3321,2022-01-31 14:45:00,1618.3,45590.160000000025,41870.59000000003,3719.5699999999924
3322,2022-01-31 14:50:00,124.15,45714.31000000003,41870.59000000003,3843.719999999994
3323,2022-01-31 14:55:00,1981.19,47695.50000000003,41870.59000000003,5824.909999999996
3324,2022-01-31 15:00:00,1146.25,48841.75000000003,41870.59000000003,6971.159999999996
3325,2022-01-31 15:05:00,-1732.31,47109.44000000003,41870.59000000003,5238.8499999999985
3326,2022-01-31 15:10:00,1635.2,48744.64000000003,41870.59000000003,6874.049999999996
3327,2022-01-31 15:15:00,-234.67,48509.97000000003,41870.59000000003,6639.379999999997
3328,2022-01-31 15:20:00,-1005.74,47504.23000000003,41870.59000000003,5633.639999999999
3329,2022-01-31 15:25:00,-1619.1,45885.130000000034,41870.59000000003,4014.540000000001
3330,2022-01-31 15:30:00,-1313.63,44571.50000000004,41870.59000000003,2700.9100000000035
3331,2022-01-31 15:35:00,-424.41,44147.09000000003,41870.59000000003,2276.5
3332,2022-01-31 15:40:00,-326.29,43820.80000000003,41870.59000000003,1950.2099999999991
3333,2022-01-31 15:45:00,154.63,43975.43000000003,41870.59000000003,2104.8399999999965
3334,2022-01-31 15:50:00,240.76,44216.19000000003,41870.59000000003,2345.5999999999985
3335,2022-01-31 15:55:00,375.69,44591.880000000034,41870.59000000003,2721.290000000001
3336,2022-01-31 16:00:00,530.75,45122.630000000034,41870.59000000003,3252.040000000001
3337,2022-01-31 16:05:00,-926.98,44195.65000000003,41870.59000000003,2325.0599999999977
3338,2022-01-31 16:10:00,-1958.57,42237.08000000003,41870.59000000003,366.48999999999796
3339,2022-01-31 16:15:00,-753.0,41484.08000000003,41870.59000000003,-386.51000000000204
3340,2022-01-31 16:20:00,-1774.44,39709.64000000003,41870.59000000003,-2160.9500000000044
3341,2022-01-31 16:25:00,-1834.96,37874.68000000003,41870.59000000003,-3995.9100000000035
3342,2022-01-31 16:30:00,-131.41,37743.270000000026,41870.59000000003,-4127.320000000007
3343,2022-01-31 16:35:00,-1309.62,36433.65000000002,41870.59000000003,-5436.94000000001
3344,2022-01-31 16:40:00,28.38,36462.03000000002,41870.59000000003,-5408.560000000012
3345,2022-01-31 16:45:00,-705.66,35756.37000000002,41870.59000000003,-6114.220000000016
3346,2022-01-31 16:50:00,851.28,36607.650000000016,41870.59000000003,-5262.940000000017
3347,2022-01-31 16:55:00,-133.12,36474.53000000001,41870.59000000003,-5396.0600000000195
3348,2022-02-01 08:00:00,772.05,37246.580000000016,36474.53000000001,772.0500000000029
3349,2022-02-01 08:05:00,1555.28,38801.860000000015,36474.53000000001,2327.3300000000017
3350,2022-02-01 08:10:00,255.88,39057.74000000001,36474.53000000001,2583.209999999999
3351,2022-02-01 08:15:00,-311.05,38746.69000000001,36474.53000000001,2272.159999999996
3352,2022-02-01 08:20:00,878.6,39625.29000000001,36474.53000000001,3150.7599999999948
3353,2022-02-01 08:25:00,1707.96,41333.25000000001,36474.53000000001,4858.719999999994
3354,2022-02-01 08:30:00,-1073.55,40259.700000000004,36474.53000000001,3785.169999999991
3355,2022-02-01 08:35:00,1376.18,41635.880000000005,36474.53000000001,5161.349999999991
3356,2022-02-01 08:40:00,1414.09,43049.97,36474.53000000001,6575.439999999988
3357,2022-02-01 08:45:00,247.39,43297.36,36474.53000000001,6822.829999999987
3358,2022-02-01 08:50:00,-1277.28,42020.08,36474.53000000001,5545.549999999988
3359,2022-02-01 08:55:00,-1978.45,40041.630000000005,36474.53000000001,3567.0999999999913
3360,2022-02-01 09:00:00,-1357.1,38684.530000000006,36474.53000000001,2209.9999999999927
3361,2022-02-01 09:05:00,-736.33,37948.200000000004,36474.53000000001,1473.669999999991
3362,2022-02-01 09:10:00,-1625.26,36322.94,36474.53000000001,-151.59000000001106
3363,2022-02-01 09:15:00,429.34,36752.28,36474.53000000001,277.74999999998545
3364,2022-02-01 09:20:00,1425.24,38177.52,36474.53000000001,1702.9899999999834
3365,2022-02-01 09:25:00,-117.55,38059.969999999994,36474.53000000001,1585.4399999999805
3366,2022-02-01 09:30:00,38.68,38098.649999999994,36474.53000000001,1624.1199999999808
3367,2022-02-01 09:35:00,789.87,38888.52,36474.53000000001,2413.9899999999834
3368,2022-02-01 09:40:00,-1015.75,37872.77,36474.53000000001,1398.2399999999834
3369,2022-02-01 09:45:00,-458.03,37414.74,36474.53000000001,940.2099999999846
3370,2022-02-01 09:50:00,669.41,38084.15,36474.53000000001,1609.619999999988
3371,2022-02-01 09:55:00,-1717.2,36366.950000000004,36474.53000000001,-107.58000000000902
3372,2022-02-01 10:00:00,-330.09,36036.86000000001,36474.53000000001,-437.67000000000553
3373,2022-02-01 10:05:00,-894.48,35142.380000000005,36474.53000000001,-1332.1500000000087
3374,2022-02-01 10:10:00,1495.3,36637.68000000001,36474.53000000001,163.14999999999418
3375,2022-02-01 10:15:00,1782.67,38420.350000000006,36474.53000000001,1945.8199999999924
3376,2022-02-01 10:20:00,1614.74,40035.090000000004,36474.53000000001,3560.5599999999904
3377,2022-02-01 10:25:00,-1671.57,38363.520000000004,36474.53000000001,1888.9899999999907
3378,2022-02-01 10:30:00,1124.71,39488.23,36474.53000000001,3013.69999999999
3379,2022-02-01 10:35:00,1845.37,41333.600000000006,36474.53000000001,4859.069999999992
3380,2022-02-01 10:40:00,-1605.78,39727.82000000001,36474.53000000001,3253.2899999999936
3381,2022-02-01 10:45:00,-391.52,39336.30000000001,36474.53000000001,2861.769999999997
3382,2022-02-01 10:50:00,-1665.17,37671.13000000001,36474.53000000001,1196.5999999999985
3383,2022-02-01 10:55:00,1519.32,39190.45000000001,36474.53000000001,2715.9199999999983
3384,2022-02-01 11:00:00,-1420.19,37770.26000000001,36474.53000000001,1295.729999999996
3385,2022-02-01 11:05:00,-283.16,37487.100000000006,36474.53000000001,1012.5699999999924
3386,2022-02-01 11:10:00,1050.85,38537.950000000004,36474.53000000001,2063.419999999991
3387,2022-02-01 11:15:00,141.77,38679.72,36474.53000000001,2205.189999999988
3388,2022-02-01 11:20:00,-1043.46,37636.26,36474.53000000001,1161.7299999999886
3389,2022-02-01 11:25:00,-166.58,37469.68,36474.53000000001,995.1499999999869
3390,2022-02-01 11:30:00,1861.71,39331.39,36474.53000000001,2856.859999999986
3391,2022-02-01 11:35:00,760.0,40091.39,36474.53000000001,3616.859999999986
3392,2022-02-01 11:40:00,-181.33,39910.06,36474.53000000001,3435.5299999999843
3393,2022-02-01 11:45:00,649.14,40559.2,36474.53000000001,4084.6699999999837
3394,2022-02-01 11:50:00,1436.13,41995.329999999994,36474.53000000001,5520.799999999981
3395,2022-02-01 11:55:00,1744.25,43739.579999999994,36474.53000000001,7265.049999999981
3396,2022-02-01 12:00:00,737.57,44477.149999999994,36474.53000000001,8002.619999999981
3397,2022-02-01 12:05:00,-715.72,43761.42999999999,36474.53000000001,7286.89999999998
3398,2022-02-01 12:10:00,-1809.21,41952.219999999994,36474.53000000001,5477.6899999999805
3399,2022-02-01 12:15:00,-288.38,41663.84,36474.53000000001,5189.309999999983
3400,2022-02-01 12:20:00,1136.88,42800.719999999994,36474.53000000001,6326.1899999999805
3401,2022-02-01 12:25:00,-900.17,41900.549999999996,36474.53000000001,5426.019999999982
3402,2022-02-01 12:30:00,374.03,42274.579999999994,36474.53000000001,5800.049999999981
3403,2022-02-01 12:35:00,-115.75,42158.829999999994,36474.53000000001,5684.299999999981
3404,2022-02-01 12:40:00,-1496.2,40662.63,36474.53000000001,4188.099999999984
3405,2022-02-01 12:45:00,290.79,40953.42,36474.53000000001,4478.889999999985
3406,2022-02-01 12:50:00,-728.48,40224.939999999995,36474.53000000001,3750.4099999999817
3407,2022-02-01 12:55:00,717.26,40942.2,36474.53000000001,4467.669999999984
3408,2022-02-01 13:00:00,-1079.86,39862.34,36474.53000000001,3387.809999999983
3409,2022-02-01 13:05:00,398.69,40261.03,36474.53000000001,3786.4999999999854
3410,2022-02-01 13:10:00,-450.03,39811.0,36474.53000000001,3336.4699999999866
3411,2022-02-01 13:15:00,100.84,39911.84,36474.53000000001,3437.309999999983
3412,2022-02-01 13:20:00,-1277.76,38634.079999999994,36474.53000000001,2159.549999999981
3413,2022-02-01 13:25:00,-858.93,37775.149999999994,36474.53000000001,1300.6199999999808
3414,2022-02-01 13:30:00,-954.54,36820.60999999999,36474.53000000001,346.0799999999799
3415,2022-02-01 13:35:00,1816.27,38636.87999999999,36474.53000000001,2162.3499999999767
3416,2022-02-01 13:40:00,-974.44,37662.43999999999,36474.53000000001,1187.9099999999744
3417,2022-02-01 13:45:00,-1258.91,36403.529999999984,36474.53000000001,-71.0000000000291
3418,2022-02-01 13:50:00,-293.71,36109.819999999985,36474.53000000001,-364.71000000002823
3419,2022-02-01 13:55:00,-1377.33,34732.48999999998,36474.53000000001,-1742.04000000003
3420,2022-02-01 14:00:00,-116.51,34615.97999999998,36474.53000000001,-1858.550000000032
3421,2022-02-01 14:05:00,-1824.48,32791.49999999998,36474.53000000001,-3683.030000000035
3422,2022-02-01 14:10:00,-29.94,32761.55999999998,36474.53000000001,-3712.970000000034
3423,2022-02-01 14:15:00,1538.32,34299.87999999998,36474.53000000001,-2174.6500000000306
3424,2022-02-01 14:20:00,-1962.18,32337.699999999983,36474.53000000001,-4136.830000000031
3425,2022-02-01 14:25:00,760.2,33097.89999999998,36474.53000000001,-3376.6300000000338
3426,2022-02-01 14:30:00,-1104.83,31993.069999999978,36474.53000000001,-4481.4600000000355
3427,2022-02-01 14:35:00,-323.26,31669.80999999998,36474.53000000001,-4804.720000000034
3428,2022-02-01 14:40:00,-1362.96,30306.84999999998,36474.53000000001,-6167.680000000033
3429,2022-02-01 14:45:00,781.04,31087.88999999998,36474.53000000001,-5386.640000000032
3430,2022-02-01 14:50:00,-1950.68,29137.20999999998,36474.53000000001,-7337.320000000032
3431,2022-02-01 14:55:00,1726.82,30864.02999999998,36474.53000000001,-5610.500000000033
3432,2022-02-01 15:00:00,-1700.95,29163.07999999998,36474.53000000001,-7311.4500000000335
3433,2022-02-01 15:05:00,-1842.47,27320.60999999998,36474.53000000001,-9153.920000000035
3434,2022-02-01 15:10:00,1167.8,28488.409999999978,36474.53000000001,-7986.120000000035
3435,2022-02-01 15:15:00,-507.2,27981.209999999977,36474.53000000001,-8493.320000000036
3436,2022-02-01 15:20:00,-1464.89,26516.319999999978,36474.53000000001,-9958.210000000036
3437,2022-02-01 15:25:00,-1818.36,24697.959999999977,36474.53000000001,-11776.570000000036
3438,2022-02-01 15:30:00,1465.76,26163.719999999976,36474.53000000001,-10310.810000000038
3439,2022-02-01 15:35:00,-1234.89,24928.829999999976,36474.53000000001,-11545.700000000037
3440,2022-02-01 15:40:00,674.65,25603.479999999978,36474.53000000001,-10871.050000000036
3441,2022-02-01 15:45:00,-1016.39,24587.08999999998,36474.53000000001,-11887.440000000035
3442,2022-02-01 15:50:00,1923.3,26510.389999999978,36474.53000000001,-9964.140000000036
3443,2022-02-01 15:55:00,-1180.13,25330.259999999977,36474.53000000001,-11144.270000000037
3444,2022-02-01 16:00:00,1144.75,26475.009999999977,36474.53000000001,-9999.520000000037
3445,2022-02-01 16:05:00,-9.08,26465.929999999975,36474.53000000001,-10008.600000000039
3446,2022-02-01 16:10:00,-401.64,26064.289999999975,36474.53000000001,-10410.240000000038
3447,2022-02-01 16:15:00,-155.48,25908.809999999976,36474.53000000001,-10565.720000000038
3448,2022-02-01 16:20:00,301.78,26210.589999999975,36474.53000000001,-10263.940000000039
3449,2022-02-01 16:25:00,-336.42,25874.169999999976,36474.53000000001,-10600.360000000037
3450,2022-02-01 16:30:00,-981.17,24892.999999999978,36474.53000000001,-11581.530000000035
3451,2022-02-01 16:35:00,1360.38,26253.37999999998,36474.53000000001,-10221.150000000034
3452,2022-02-01 16:40:00,1407.97,27661.34999999998,36474.53000000001,-8813.180000000033
3453,2022-02-01 16:45:00,-1238.96,26422.38999999998,36474.53000000001,-10052.140000000032
3454,2022-02-01 16:50:00,-1512.47,24909.91999999998,36474.53000000001,-11564.610000000033
3455,2022-02-01 16:55:00,-189.45,24720.46999999998,36474.53000000001,-11754.060000000034
3456,2022-02-02 08:00:00,1827.32,26547.78999999998,24720.46999999998,1827.3199999999997
3457,2022-02-02 08:05:00,1129.15,27676.93999999998,24720.46999999998,2956.470000000001
3458,2022-02-02 08:10:00,-1416.56,26260.37999999998,24720.46999999998,1539.9099999999999
3459,2022-02-02 08:15:00,545.24,26805.61999999998,24720.46999999998,2085.1500000000015
3460,2022-02-02 08:20:00,-1869.86,24935.75999999998,24720.46999999998,215.29000000000087
3461,2022-02-02 08:25:00,1138.33,26074.089999999982,24720.46999999998,1353.6200000000026
3462,2022-02-02 08:30:00,-41.9,26032.18999999998,24720.46999999998,1311.7200000000012
3463,2022-02-02 08:35:00,1880.49,27912.679999999982,24720.46999999998,3192.2100000000028
3464,2022-02-02 08:40:00,-160.21,27752.469999999983,24720.46999999998,3032.0000000000036
3465,2022-02-02 08:45:00,-1793.57,25958.899999999983,24720.46999999998,1238.430000000004
3466,2022-02-02 08:50:00,-1430.12,24528.779999999984,24720.46999999998,-191.68999999999505
3467,2022-02-02 08:55:00,990.31,25519.089999999986,24720.46999999998,798.6200000000063
3468,2022-02-02 09:00:00,1550.99,27070.079999999987,24720.46999999998,2349.610000000008
3469,2022-02-02 09:05:00,-1277.26,25792.81999999999,24720.46999999998,1072.3500000000095
3470,2022-02-02 09:10:00,1586.64,27379.45999999999,24720.46999999998,2658.990000000009
3471,2022-02-02 09:15:00,201.19,27580.649999999987,24720.46999999998,2860.1800000000076
3472,2022-02-02 09:20:00,-926.03,26654.619999999988,24720.46999999998,1934.1500000000087
3473,2022-02-02 09:25:00,-203.09,26451.529999999988,24720.46999999998,1731.0600000000086
3474,2022-02-02 09:30:00,-1212.44,25239.08999999999,24720.46999999998,518.6200000000099
3475,2022-02-02 09:35:00,1046.19,26285.279999999988,24720.46999999998,1564.8100000000086
3476,2022-02-02 09:40:00,343.96,26629.239999999987,24720.46999999998,1908.7700000000077
3477,2022-02-02 09:45:00,1824.67,28453.90999999999,24720.46999999998,3733.4400000000096
3478,2022-02-02 09:50:00,254.67,28708.579999999987,24720.46999999998,3988.110000000008
3479,2022-02-02 09:55:00,79.58,28788.15999999999,24720.46999999998,4067.6900000000096
3480,2022-02-02 10:00:00,-705.0,28083.15999999999,24720.46999999998,3362.6900000000096
3481,2022-02-02 10:05:00,1308.84,29391.99999999999,24720.46999999998,4671.53000000001
3482,2022-02-02 10:10:00,418.56,29810.55999999999,24720.46999999998,5090.090000000011
3483,2022-02-02 10:15:00,1481.24,31291.799999999992,24720.46999999998,6571.330000000013
3484,2022-02-02 10:20:00,1275.65,32567.449999999993,24720.46999999998,7846.980000000014
3485,2022-02-02 10:25:00,-1108.22,31459.229999999992,24720.46999999998,6738.760000000013
3486,2022-02-02 10:30:00,342.47,31801.699999999993,24720.46999999998,7081.230000000014
3487,2022-02-02 10:35:00,585.31,32387.009999999995,24720.46999999998,7666.540000000015
3488,2022-02-02 10:40:00,-1542.68,30844.329999999994,24720.46999999998,6123.860000000015
3489,2022-02-02 10:45:00,-561.25,30283.079999999994,24720.46999999998,5562.610000000015
3490,2022-02-02 10:50:00,466.81,30749.889999999996,24720.46999999998,6029.420000000016
3491,2022-02-02 10:55:00,-1423.88,29326.009999999995,24720.46999999998,4605.540000000015
3492,2022-02-02 11:00:00,-448.61,28877.399999999994,24720.46999999998,4156.930000000015
3493,2022-02-02 11:05:00,-1730.24,27147.159999999993,24720.46999999998,2426.6900000000132
3494,2022-02-02 11:10:00,1393.74,28540.899999999994,24720.46999999998,3820.430000000015
3495,2022-02-02 11:15:00,-740.45,27800.449999999993,24720.46999999998,3079.980000000014
3496,2022-02-02 11:20:00,-977.78,26822.669999999995,24720.46999999998,2102.2000000000153
3497,2022-02-02 11:25:00,-1054.81,25767.859999999993,24720.46999999998,1047.390000000014
3498,2022-02-02 11:30:00,-651.97,25115.889999999992,24720.46999999998,395.4200000000128
3499,2022-02-02 11:35:00,-1073.14,24042.749999999993,24720.46999999998,-677.7199999999866
3500,2022-02-02 11:40:00,-1244.58,22798.16999999999,24720.46999999998,-1922.2999999999884
3501,2022-02-02 11:45:00,550.59,23348.75999999999,24720.46999999998,-1371.7099999999882
3502,2022-02-02 11:50:00,-630.99,22717.76999999999,24720.46999999998,-2002.6999999999898
3503,2022-02-02 11:55:00,1994.59,24712.35999999999,24720.46999999998,-8.109999999989668
3504,2022-02-02 12:00:00,-434.97,24277.38999999999,24720.46999999998,-443.07999999999083
3505,2022-02-02 12:05:00,-1629.74,22647.649999999987,24720.46999999998,-2072.8199999999924
3506,2022-02-02 12:10:00,1303.68,23951.329999999987,24720.46999999998,-769.1399999999921
3507,2022-02-02 12:15:00,865.8,24817.129999999986,24720.46999999998,96.66000000000713
3508,2022-02-02 12:20:00,-1609.22,23207.909999999985,24720.46999999998,-1512.559999999994
3509,2022-02-02 12:25:00,-780.49,22427.419999999984,24720.46999999998,-2293.0499999999956
3510,2022-02-02 12:30:00,-569.9,21857.519999999982,24720.46999999998,-2862.949999999997
3511,2022-02-02 12:35:00,218.62,22076.13999999998,24720.46999999998,-2644.329999999998
3512,2022-02-02 12:40:00,-1861.62,20214.519999999982,24720.46999999998,-4505.949999999997
3513,2022-02-02 12:45:00,-673.31,19541.20999999998,24720.46999999998,-5179.259999999998
3514,2022-02-02 12:50:00,1291.75,20832.95999999998,24720.46999999998,-3887.5099999999984
3515,2022-02-02 12:55:00,-1335.76,19497.199999999983,24720.46999999998,-5223.269999999997
3516,2022-02-02 13:00:00,1312.47,20809.669999999984,24720.46999999998,-3910.7999999999956
3517,2022-02-02 13:05:00,68.43,20878.099999999984,24720.46999999998,-3842.3699999999953
3518,2022-02-02 13:10:00,673.52,21551.619999999984,24720.46999999998,-3168.849999999995
3519,2022-02-02 13:15:00,-346.3,21205.319999999985,24720.46999999998,-3515.149999999994
3520,2022-02-02 13:20:00,-1285.55,19919.769999999986,24720.46999999998,-4800.699999999993
3521,2022-02-02 13:25:00,-1108.97,18810.799999999985,24720.46999999998,-5909.669999999995
3522,2022-02-02 13:30:00,904.97,19715.769999999986,24720.46999999998,-5004.699999999993
3523,2022-02-02 13:35:00,1371.04,21086.809999999987,24720.46999999998,-3633.6599999999926
3524,2022-02-02 13:40:00,560.28,21647.089999999986,24720.46999999998,-3073.3799999999937
3525,2022-02-02 13:45:00,-1575.0,20072.089999999986,24720.46999999998,-4648.379999999994
3526,2022-02-02 13:50:00,2.01,20074.099999999984,24720.46999999998,-4646.369999999995
3527,2022-02-02 13:55:00,411.92,20486.019999999982,24720.46999999998,-4234.449999999997
3528,2022-02-02 14:00:00,443.92,20929.93999999998,24720.46999999998,-3790.529999999999
3529,2022-02-02 14:05:00,-181.11,20748.82999999998,24720.46999999998,-3971.6399999999994
3530,2022-02-02 14:10:00,1640.65,22389.47999999998,24720.46999999998,-2330.989999999998
3531,2022-02-02 14:15:00,-1839.04,20550.43999999998,24720.46999999998,-4170.029999999999
3532,2022-02-02 14:20:00,859.05,21409.48999999998,24720.46999999998,-3310.9799999999996
3533,2022-02-02 14:25:00,-1128.25,20281.23999999998,24720.46999999998,-4439.23
3534,2022-02-02 14:30:00,-1247.07,19034.16999999998,24720.46999999998,-5686.299999999999
3535,2022-02-02 14:35:00,1681.83,20715.999999999978,24720.46999999998,-4004.470000000001
3536,2022-02-02 14:40:00,-1517.54,19198.459999999977,24720.46999999998,-5522.010000000002
3537,2022-02-02 14:45:00,1249.99,20448.44999999998,24720.46999999998,-4272.02
3538,2022-02-02 14:50:00,-508.9,19939.549999999977,24720.46999999998,-4780.920000000002
3539,2022-02-02 14:55:00,915.9,20855.44999999998,24720.46999999998,-3865.0200000000004
3540,2022-02-02 15:00:00,-1715.29,19140.159999999978,24720.46999999998,-5580.310000000001
3541,2022-02-02 15:05:00,1707.22,20847.37999999998,24720.46999999998,-3873.09
3542,2022-02-02 15:10:00,-1128.18,19719.19999999998,24720.46999999998,-5001.27
3543,2022-02-02 15:15:00,-1935.41,17783.78999999998,24720.46999999998,-6936.68
3544,2022-02-02 15:20:00,-1569.41,16214.37999999998,24720.46999999998,-8506.09
3545,2022-02-02 15:25:00,-704.75,15509.62999999998,24720.46999999998,-9210.84
3546,2022-02-02 15:30:00,902.31,16411.93999999998,24720.46999999998,-8308.529999999999
3547,2022-02-02 15:35:00,525.11,16937.04999999998,24720.46999999998,-7783.419999999998
3548,2022-02-02 15:40:00,-1616.66,15320.389999999981,24720.46999999998,-9400.079999999998
3549,2022-02-02 15:45:00,1060.35,16380.739999999982,24720.46999999998,-8339.729999999998
3550,2022-02-02 15:50:00,1854.73,18235.469999999983,24720.46999999998,-6484.999999999996
3551,2022-02-02 15:55:00,1858.96,20094.429999999982,24720.46999999998,-4626.039999999997
3552,2022-02-02 16:00:00,1056.24,21150.669999999984,24720.46999999998,-3569.7999999999956
3553,2022-02-02 16:05:00,-1260.79,19889.879999999983,24720.46999999998,-4830.5899999999965
3554,2022-02-02 16:10:00,-1503.34,18386.539999999983,24720.46999999998,-6333.929999999997
3555,2022-02-02 16:15:00,-1736.07,16650.469999999983,24720.46999999998,-8069.999999999996
3556,2022-02-02 16:20:00,-769.61,15880.859999999982,24720.46999999998,-8839.609999999997
3557,2022-02-02 16:25:00,-1224.88,14655.979999999981,24720.46999999998,-10064.489999999998
3558,2022-02-02 16:30:00,-1830.8,12825.179999999982,24720.46999999998,-11895.289999999997
3559,2022-02-02 16:35:00,-321.19,12503.989999999982,24720.46999999998,-12216.479999999998
3560,2022-02-02 16:40:00,-11.81,12492.179999999982,24720.46999999998,-12228.289999999997
3561,2022-02-02 16:45:00,-117.56,12374.619999999983,24720.46999999998,-12345.849999999997
3562,2022-02-02 16:50:00,1754.08,14128.699999999983,24720.46999999998,-10591.769999999997
3563,2022-02-02 16:55:00,-1933.16,12195.539999999983,24720.46999999998,-12524.929999999997
3564,2022-02-03 08:00:00,-517.3,11678.239999999983,12195.539999999983,-517.2999999999993
3565,2022-02-03 08:05:00,-1841.71,9836.529999999984,12195.539999999983,-2359.0099999999984
3566,2022-02-03 08:10:00,51.33,9887.859999999984,12195.539999999983,-2307.6799999999985
3567,2022-02-03 08:15:00,1165.45,11053.309999999985,12195.539999999983,-1142.2299999999977
3568,2022-02-03 08:20:00,-591.2,10462.109999999984,12195.539999999983,-1733.4299999999985
3569,2022-02-03 08:25:00,-767.15,9694.959999999985,12195.539999999983,-2500.579999999998
3570,2022-02-03 08:30:00,-1224.6,8470.359999999984,12195.539999999983,-3725.1799999999985
3571,2022-02-03 08:35:00,1451.87,9922.229999999985,12195.539999999983,-2273.3099999999977
3572,2022-02-03 08:40:00,857.09,10779.319999999985,12195.539999999983,-1416.2199999999975
3573,2022-02-03 08:45:00,-799.86,9979.459999999985,12195.539999999983,-2216.079999999998
3574,2022-02-03 08:50:00,1592.51,11571.969999999985,12195.539999999983,-623.5699999999979
3575,2022-02-03 08:55:00,1699.4,13271.369999999984,12195.539999999983,1075.8300000000017
3576,2022-02-03 09:00:00,1653.44,14924.809999999985,12195.539999999983,2729.2700000000023
3577,2022-02-03 09:05:00,115.74,15040.549999999985,12195.539999999983,2845.010000000002
3578,2022-02-03 09:10:00,-1175.86,13864.689999999984,12195.539999999983,1669.1500000000015
3579,2022-02-03 09:15:00,287.29,14151.979999999985,12195.539999999983,1956.4400000000023
3580,2022-02-03 09:20:00,1443.89,15595.869999999984,12195.539999999983,3400.3300000000017
3581,2022-02-03 09:25:00,1772.09,17367.959999999985,12195.539999999983,5172.420000000002
3582,2022-02-03 09:30:00,-1237.75,16130.209999999985,12195.539999999983,3934.670000000002
3583,2022-02-03 09:35:00,127.87,16258.079999999985,12195.539999999983,4062.5400000000027
3584,2022-02-03 09:40:00,-1115.26,15142.819999999985,12195.539999999983,2947.2800000000025
3585,2022-02-03 09:45:00,1204.94,16347.759999999986,12195.539999999983,4152.220000000003
3586,2022-02-03 09:50:00,1986.38,18334.139999999985,12195.539999999983,6138.600000000002
3587,2022-02-03 09:55:00,471.16,18805.299999999985,12195.539999999983,6609.760000000002
3588,2022-02-03 10:00:00,1309.07,20114.369999999984,12195.539999999983,7918.830000000002
3589,2022-02-03 10:05:00,1878.12,21992.489999999983,12195.539999999983,9796.95
3590,2022-02-03 10:10:00,1976.48,23968.969999999983,12195.539999999983,11773.43
3591,2022-02-03 10:15:00,-1131.66,22837.309999999983,12195.539999999983,10641.77
3592,2022-02-03 10:20:00,-506.89,22330.419999999984,12195.539999999983,10134.880000000001
3593,2022-02-03 10:25:00,-1199.56,21130.859999999982,12195.539999999983,8935.32
3594,2022-02-03 10:30:00,-14.48,21116.379999999983,12195.539999999983,8920.84
3595,2022-02-03 10:35:00,-1790.36,19326.019999999982,12195.539999999983,7130.48
3596,2022-02-03 10:40:00,-936.8,18389.219999999983,12195.539999999983,6193.68
3597,2022-02-03 10:45:00,-1469.48,16919.739999999983,12195.539999999983,4724.200000000001
3598,2022-02-03 10:50:00,-204.15,16715.589999999982,12195.539999999983,4520.049999999999
3599,2022-02-03 10:55:00,352.61,17068.199999999983,12195.539999999983,4872.66
3600,2022-02-03 11:00:00,-611.63,16456.56999999998,12195.539999999983,4261.029999999999
3601,2022-02-03 11:05:00,-709.36,15747.209999999981,12195.539999999983,3551.6699999999983
3602,2022-02-03 11:10:00,-1593.49,14153.719999999981,12195.539999999983,1958.1799999999985
3603,2022-02-03 11:15:00,534.95,14688.669999999982,12195.539999999983,2493.129999999999
3604,2022-02-03 11:20:00,-1710.49,12978.179999999982,12195.539999999983,782.6399999999994
3605,2022-02-03 11:25:00,1042.87,14021.049999999981,12195.539999999983,1825.5099999999984
3606,2022-02-03 11:30:00,1584.97,15606.01999999998,12195.539999999983,3410.4799999999977
3607,2022-02-03 11:35:00,1485.58,17091.59999999998,12195.539999999983,4896.059999999998
3608,2022-02-03 11:40:00,-235.48,16856.11999999998,12195.539999999983,4660.579999999998
3609,2022-02-03 11:45:00,-990.24,15865.879999999981,12195.539999999983,3670.3399999999983
3610,2022-02-03 11:50:00,936.39,16802.269999999982,12195.539999999983,4606.73
3611,2022-02-03 11:55:00,-1529.12,15273.149999999983,12195.539999999983,3077.6100000000006
3612,2022-02-03 12:00:00,-833.43,14439.719999999983,12195.539999999983,2244.1800000000003
3613,2022-02-03 12:05:00,-639.99,13799.729999999983,12195.539999999983,1604.1900000000005
3614,2022-02-03 12:10:00,1362.38,15162.109999999982,12195.539999999983,2966.5699999999997
3615,2022-02-03 12:15:00,-260.52,14901.589999999982,12195.539999999983,2706.0499999999993
3616,2022-02-03 12:20:00,-219.21,14682.379999999983,12195.539999999983,2486.84
3617,2022-02-03 12:25:00,-294.03,14388.349999999982,12195.539999999983,2192.8099999999995
3618,2022-02-03 12:30:00,-449.1,13939.249999999982,12195.539999999983,1743.7099999999991
3619,2022-02-03 12:35:00,-1229.45,12709.799999999981,12195.539999999983,514.2599999999984
3620,2022-02-03 12:40:00,965.87,13675.669999999982,12195.539999999983,1480.1299999999992
3621,2022-02-03 12:45:00,1112.52,14788.189999999982,12195.539999999983,2592.6499999999996
3622,2022-02-03 12:50:00,560.95,15349.139999999983,12195.539999999983,3153.6000000000004
3623,2022-02-03 12:55:00,-406.19,14942.949999999983,12195.539999999983,2747.41
3624,2022-02-03 13:00:00,867.52,15810.469999999983,12195.539999999983,3614.9300000000003
3625,2022-02-03 13:05:00,296.65,16107.119999999983,12195.539999999983,3911.58
3626,2022-02-03 13:10:00,1666.76,17773.879999999983,12195.539999999983,5578.34
3627,2022-02-03 13:15:00,109.49,17883.369999999984,12195.539999999983,5687.830000000002
3628,2022-02-03 13:20:00,1592.58,19475.949999999983,12195.539999999983,7280.41
3629,2022-02-03 13:25:00,1913.61,21389.559999999983,12195.539999999983,9194.02
3630,2022-02-03 13:30:00,-851.98,20537.579999999984,12195.539999999983,8342.04
3631,2022-02-03 13:35:00,597.82,21135.399999999983,12195.539999999983,8939.86
3632,2022-02-03 13:40:00,721.39,21856.789999999983,12195.539999999983,9661.25
3633,2022-02-03 13:45:00,-701.6,21155.189999999984,12195.539999999983,8959.650000000001
3634,2022-02-03 13:50:00,1300.4,22455.589999999986,12195.539999999983,10260.050000000003
3635,2022-02-03 13:55:00,-508.1,21947.489999999987,12195.539999999983,9751.950000000004
3636,2022-02-03 14:00:00,1944.34,23891.829999999987,12195.539999999983,11696.290000000005
3637,2022-02-03 14:05:00,821.83,24713.65999999999,12195.539999999983,12518.120000000006
3638,2022-02-03 14:10:00,-992.68,23720.97999999999,12195.539999999983,11525.440000000006
3639,2022-02-03 14:15:00,1968.14,25689.119999999988,12195.539999999983,13493.580000000005
3640,2022-02-03 14:20:00,-711.65,24977.469999999987,12195.539999999983,12781.930000000004
3641,2022-02-03 14:25:00,689.02,25666.489999999987,12195.539999999983,13470.950000000004
3642,2022-02-03 14:30:00,-1138.1,24528.38999999999,12195.539999999983,12332.850000000006
3643,2022-02-03 14:35:00,1261.76,25790.149999999987,12195.539999999983,13594.610000000004
3644,2022-02-03 14:40:00,589.77,26379.919999999987,12195.539999999983,14184.380000000005
3645,2022-02-03 14:45:00,1289.0,27668.919999999987,12195.539999999983,15473.380000000005
3646,2022-02-03 14:50:00,576.51,28245.429999999986,12195.539999999983,16049.890000000003
3647,2022-02-03 14:55:00,-1012.02,27233.409999999985,12195.539999999983,15037.870000000003
3648,2022-02-03 15:00:00,89.46,27322.869999999984,12195.539999999983,15127.330000000002
3649,2022-02-03 15:05:00,-1844.09,25478.779999999984,12195.539999999983,13283.240000000002
3650,2022-02-03 15:10:00,1260.4,26739.179999999986,12195.539999999983,14543.640000000003
3651,2022-02-03 15:15:00,-1051.14,25688.039999999986,12195.539999999983,13492.500000000004
3652,2022-02-03 15:20:00,774.18,26462.219999999987,12195.539999999983,14266.680000000004
3653,2022-02-03 15:25:00,-1934.18,24528.039999999986,12195.539999999983,12332.500000000004
3654,2022-02-03 15:30:00,-1987.39,22540.649999999987,12195.539999999983,10345.110000000004
3655,2022-02-03 15:35:00,-1180.51,21360.13999999999,12195.539999999983,9164.600000000006
3656,2022-02-03 15:40:00,704.52,22064.65999999999,12195.539999999983,9869.120000000006
3657,2022-02-03 15:45:00,145.8,22210.45999999999,12195.539999999983,10014.920000000006
3658,2022-02-03 15:50:00,476.45,22686.90999999999,12195.539999999983,10491.370000000006
3659,2022-02-03 15:55:00,-1333.08,21353.829999999987,12195.539999999983,9158.290000000005
3660,2022-02-03 16:00:00,-1263.63,20090.199999999986,12195.539999999983,7894.6600000000035
3661,2022-02-03 16:05:00,-1082.56,19007.639999999985,12195.539999999983,6812.100000000002
3662,2022-02-03 16:10:00,-885.44,18122.199999999986,12195.539999999983,5926.6600000000035
3663,2022-02-03 16:15:00,-1801.76,16320.439999999986,12195.539999999983,4124.900000000003
3664,2022-02-03 16:20:00,1758.18,18078.619999999984,12195.539999999983,5883.080000000002
3665,2022-02-03 16:25:00,-678.71,17399.909999999985,12195.539999999983,5204.370000000003
3666,2022-02-03 16:30:00,-945.83,16454.079999999984,12195.539999999983,4258.540000000001
3667,2022-02-03 16:35:00,1800.81,18254.889999999985,12195.539999999983,6059.350000000002
3668,2022-02-03 16:40:00,-49.07,18205.819999999985,12195.539999999983,6010.2800000000025
3669,2022-02-03 16:45:00,303.72,18509.539999999986,12195.539999999983,6314.000000000004
3670,2022-02-03 16:50:00,-719.27,17790.269999999986,12195.539999999983,5594.730000000003
3671,2022-02-03 16:55:00,-1799.84,15990.429999999986,12195.539999999983,3794.890000000003
3672,2022-02-04 08:00:00,1007.63,16998.059999999987,15990.429999999986,1007.630000000001
3673,2022-02-04 08:05:00,1015.71,18013.769999999986,15990.429999999986,2023.3400000000001
3674,2022-02-04 08:10:00,1414.35,19428.119999999984,15990.429999999986,3437.6899999999987
3675,2022-02-04 08:15:00,-598.37,18829.749999999985,15990.429999999986,2839.3199999999997
3676,2022-02-04 08:20:00,379.51,19209.259999999984,15990.429999999986,3218.829999999998
3677,2022-02-04 08:25:00,1985.44,21194.699999999983,15990.429999999986,5204.269999999997
3678,2022-02-04 08:30:00,-911.15,20283.54999999998,15990.429999999986,4293.119999999995
3679,2022-02-04 08:35:00,-1411.27,18872.27999999998,15990.429999999986,2881.849999999995
3680,2022-02-04 08:40:00,-581.5,18290.77999999998,15990.429999999986,2300.349999999995
3681,2022-02-04 08:45:00,-1330.43,16960.34999999998,15990.429999999986,969.9199999999946
3682,2022-02-04 08:50:00,127.65,17087.99999999998,15990.429999999986,1097.569999999996
3683,2022-02-04 08:55:00,1860.46,18948.45999999998,15990.429999999986,2958.029999999995
3684,2022-02-04 09:00:00,837.07,19785.52999999998,15990.429999999986,3795.099999999995
3685,2022-02-04 09:05:00,-1335.69,18449.839999999982,15990.429999999986,2459.409999999996
3686,2022-02-04 09:10:00,541.7,18991.539999999983,15990.429999999986,3001.109999999997
3687,2022-02-04 09:15:00,1725.71,20717.24999999998,15990.429999999986,4726.819999999996
3688,2022-02-04 09:20:00,1193.32,21910.56999999998,15990.429999999986,5920.139999999996
3689,2022-02-04 09:25:00,-255.71,21654.859999999982,15990.429999999986,5664.429999999997
3690,2022-02-04 09:30:00,-504.54,21150.31999999998,15990.429999999986,5159.889999999996
3691,2022-02-04 09:35:00,-544.69,20605.629999999983,15990.429999999986,4615.199999999997
3692,2022-02-04 09:40:00,1932.28,22537.90999999998,15990.429999999986,6547.479999999996
3693,2022-02-04 09:45:00,298.13,22836.039999999983,15990.429999999986,6845.609999999997
3694,2022-02-04 09:50:00,1329.76,24165.79999999998,15990.429999999986,8175.369999999995
3695,2022-02-04 09:55:00,-1503.69,22662.109999999982,15990.429999999986,6671.679999999997
3696,2022-02-04 10:00:00,1622.75,24284.859999999982,15990.429999999986,8294.429999999997
3697,2022-02-04 10:05:00,1778.86,26063.719999999983,15990.429999999986,10073.289999999997
3698,2022-02-04 10:10:00,-1516.53,24547.189999999984,15990.429999999986,8556.759999999998
3699,2022-02-04 10:15:00,-843.97,23703.219999999983,15990.429999999986,7712.789999999997
3700,2022-02-04 10:20:00,-184.38,23518.839999999982,15990.429999999986,7528.409999999996
3701,2022-02-04 10:25:00,1020.77,24539.609999999982,15990.429999999986,8549.179999999997
3702,2022-02-04 10:30:00,895.16,25434.769999999982,15990.429999999986,9444.339999999997
3703,2022-02-04 10:35:00,-1699.09,23735.679999999982,15990.429999999986,7745.249999999996
3704,2022-02-04 10:40:00,-227.08,23508.59999999998,15990.429999999986,7518.169999999995
3705,2022-02-04 10:45:00,760.62,24269.21999999998,15990.429999999986,8278.789999999994
3706,2022-02-04 10:50:00,-1685.47,22583.749999999978,15990.429999999986,6593.319999999992
3707,2022-02-04 10:55:00,-964.24,21619.509999999977,15990.429999999986,5629.079999999991
3708,2022-02-04 11:00:00,271.55,21891.059999999976,15990.429999999986,5900.62999999999
3709,2022-02-04 11:05:00,218.92,22109.979999999974,15990.429999999986,6119.549999999988
3710,2022-02-04 11:10:00,-680.03,21429.949999999975,15990.429999999986,5439.5199999999895
3711,2022-02-04 11:15:00,-234.28,21195.669999999976,15990.429999999986,5205.239999999991
3712,2022-02-04 11:20:00,-1718.9,19476.769999999975,15990.429999999986,3486.3399999999892
3713,2022-02-04 11:25:00,978.06,20454.829999999976,15990.429999999986,4464.3999999999905
3714,2022-02-04 11:30:00,1726.42,22181.249999999978,15990.429999999986,6190.819999999992
3715,2022-02-04 11:35:00,1698.37,23879.619999999977,15990.429999999986,7889.189999999991
3716,2022-02-04 11:40:00,-438.21,23441.409999999978,15990.429999999986,7450.979999999992
3717,2022-02-04 11:45:00,274.89,23716.299999999977,15990.429999999986,7725.869999999992
3718,2022-02-04 11:50:00,-1096.03,22620.26999999998,15990.429999999986,6629.839999999993
3719,2022-02-04 11:55:00,134.22,22754.48999999998,15990.429999999986,6764.059999999994
3720,2022-02-04 12:00:00,-1965.76,20788.72999999998,15990.429999999986,4798.299999999996
3721,2022-02-04 12:05:00,-169.79,20618.93999999998,15990.429999999986,4628.509999999995
3722,2022-02-04 12:10:00,-438.05,20180.88999999998,15990.429999999986,4190.4599999999955
3723,2022-02-04 12:15:00,-70.64,20110.24999999998,15990.429999999986,4119.819999999996
3724,2022-02-04 12:20:00,-1715.0,18395.24999999998,15990.429999999986,2404.819999999996
3725,2022-02-04 12:25:00,1864.3,20259.54999999998,15990.429999999986,4269.119999999995
3726,2022-02-04 12:30:00,1800.7,22060.24999999998,15990.429999999986,6069.819999999996
3727,2022-02-04 12:35:00,1131.99,23192.239999999983,15990.429999999986,7201.809999999998
3728,2022-02-04 12:40:00,-38.56,23153.679999999982,15990.429999999986,7163.249999999996
3729,2022-02-04 12:45:00,-401.17,22752.509999999984,15990.429999999986,6762.079999999998
3730,2022-02-04 12:50:00,-1425.41,21327.099999999984,15990.429999999986,5336.669999999998
3731,2022-02-04 12:55:00,-1217.56,20109.539999999983,15990.429999999986,4119.109999999997
3732,2022-02-04 13:00:00,32.83,20142.369999999984,15990.429999999986,4151.939999999999
3733,2022-02-04 13:05:00,83.48,20225.849999999984,15990.429999999986,4235.419999999998
3734,2022-02-04 13:10:00,-562.54,19663.309999999983,15990.429999999986,3672.8799999999974
3735,2022-02-04 13:15:00,1890.89,21554.199999999983,15990.429999999986,5563.769999999997
3736,2022-02-04 13:20:00,314.38,21868.579999999984,15990.429999999986,5878.149999999998
3737,2022-02-04 13:25:00,-1375.58,20492.999999999985,15990.429999999986,4502.57
3738,2022-02-04 13:30:00,836.9,21329.899999999987,15990.429999999986,5339.470000000001
3739,2022-02-04 13:35:00,1308.82,22638.719999999987,15990.429999999986,6648.290000000001
3740,2022-02-04 13:40:00,-122.22,22516.499999999985,15990.429999999986,6526.07
3741,2022-02-04 13:45:00,-192.16,22324.339999999986,15990.429999999986,6333.91
3742,2022-02-04 13:50:00,-376.53,21947.809999999987,15990.429999999986,5957.380000000001
3743,2022-02-04 13:55:00,1329.54,23277.349999999988,15990.429999999986,7286.920000000002
3744,2022-02-04 14:00:00,80.77,23358.119999999988,15990.429999999986,7367.690000000002
3745,2022-02-04 14:05:00,-1194.97,22163.149999999987,15990.429999999986,6172.720000000001
3746,2022-02-04 14:10:00,7.18,22170.329999999987,15990.429999999986,6179.9000000000015
3747,2022-02-04 14:15:00,1044.33,23214.65999999999,15990.429999999986,7224.230000000003
3748,2022-02-04 14:20:00,-1705.86,21508.79999999999,15990.429999999986,5518.370000000003
3749,2022-02-04 14:25:00,484.53,21993.329999999987,15990.429999999986,6002.9000000000015
3750,2022-02-04 14:30:00,-609.52,21383.809999999987,15990.429999999986,5393.380000000001
3751,2022-02-04 14:35:00,1229.32,22613.129999999986,15990.429999999986,6622.700000000001
3752,2022-02-04 14:40:00,-160.38,22452.749999999985,15990.429999999986,6462.32
3753,2022-02-04 14:45:00,-526.8,21925.949999999986,15990.429999999986,5935.52
3754,2022-02-04 14:50:00,206.64,22132.589999999986,15990.429999999986,6142.16
3755,2022-02-04 14:55:00,1831.64,23964.229999999985,15990.429999999986,7973.799999999999
3756,2022-02-04 15:00:00,-356.88,23607.349999999984,15990.429999999986,7616.919999999998
3757,2022-02-04 15:05:00,158.43,23765.779999999984,15990.429999999986,7775.3499999999985
3758,2022-02-04 15:10:00,-901.66,22864.119999999984,15990.429999999986,6873.689999999999
3759,2022-02-04 15:15:00,-1300.97,21563.149999999983,15990.429999999986,5572.7199999999975
3760,2022-02-04 15:20:00,672.26,22235.40999999998,15990.429999999986,6244.979999999996
3761,2022-02-04 15:25:00,-1630.54,20604.86999999998,15990.429999999986,4614.439999999995
3762,2022-02-04 15:30:00,-1254.22,19350.64999999998,15990.429999999986,3360.219999999994
3763,2022-02-04 15:35:00,1699.06,21049.70999999998,15990.429999999986,5059.279999999995
3764,2022-02-04 15:40:00,36.83,21086.539999999983,15990.429999999986,5096.109999999997
3765,2022-02-04 15:45:00,-149.31,20937.22999999998,15990.429999999986,4946.799999999996
3766,2022-02-04 15:50:00,-1171.5,19765.72999999998,15990.429999999986,3775.2999999999956
3767,2022-02-04 15:55:00,-577.26,19188.469999999983,15990.429999999986,3198.0399999999972
3768,2022-02-04 16:00:00,1894.45,21082.919999999984,15990.429999999986,5092.489999999998
3769,2022-02-04 16:05:00,-300.63,20782.289999999983,15990.429999999986,4791.859999999997
3770,2022-02-04 16:10:00,1311.39,22093.679999999982,15990.429999999986,6103.249999999996
3771,2022-02-04 16:15:00,1741.5,23835.179999999982,15990.429999999986,7844.749999999996
3772,2022-02-04 16:20:00,325.58,24160.759999999984,15990.429999999986,8170.329999999998
3773,2022-02-04 16:25:00,-863.56,23297.199999999983,15990.429999999986,7306.769999999997
3774,2022-02-04 16:30:00,565.63,23862.829999999984,15990.429999999986,7872.399999999998
3775,2022-02-04 16:35:00,-989.53,22873.299999999985,15990.429999999986,6882.869999999999
3776,2022-02-04 16:40:00,321.51,23194.809999999983,15990.429999999986,7204.379999999997
3777,2022-02-04 16:45:00,1673.64,24868.449999999983,15990.429999999986,8878.019999999997
3778,2022-02-04 16:50:00,227.9,25096.349999999984,15990.429999999986,9105.919999999998
3779,2022-02-04 16:55:00,-748.87,24347.479999999985,15990.429999999986,8357.05
3780,2022-02-05 08:00:00,853.46,25200.939999999984,24347.479999999985,853.4599999999991
3781,2022-02-05 08:05:00,1969.74,27170.679999999986,24347.479999999985,2823.2000000000007
3782,2022-02-05 08:10:00,1913.73,29084.409999999985,24347.479999999985,4736.93
3783,2022-02-05 08:15:00,1196.13,30280.539999999986,24347.479999999985,5933.060000000001
3784,2022-02-05 08:20:00,1843.7,32124.239999999987,24347.479999999985,7776.760000000002
3785,2022-02-05 08:25:00,1498.06,33622.29999999999,24347.479999999985,9274.820000000003
3786,2022-02-05 08:30:00,928.63,34550.929999999986,24347.479999999985,10203.45
3787,2022-02-05 08:35:00,1943.82,36494.749999999985,24347.479999999985,12147.27
3788,2022-02-05 08:40:00,-79.8,36414.94999999998,24347.479999999985,12067.469999999998
3789,2022-02-05 08:45:00,1957.02,38371.96999999998,24347.479999999985,14024.489999999994
3790,2022-02-05 08:50:00,1244.26,39616.22999999998,24347.479999999985,15268.749999999996
3791,2022-02-05 08:55:00,-906.38,38709.849999999984,24347.479999999985,14362.369999999999
3792,2022-02-05 09:00:00,-1130.28,37579.569999999985,24347.479999999985,13232.09
3793,2022-02-05 09:05:00,609.61,38189.179999999986,24347.479999999985,13841.7
3794,2022-02-05 09:10:00,-1721.42,36467.75999999999,24347.479999999985,12120.280000000002
3795,2022-02-05 09:15:00,-1531.46,34936.29999999999,24347.479999999985,10588.820000000003
3796,2022-02-05 09:20:00,-934.98,34001.319999999985,24347.479999999985,9653.84
3797,2022-02-05 09:25:00,323.29,34324.609999999986,24347.479999999985,9977.130000000001
3798,2022-02-05 09:30:00,1531.18,35855.789999999986,24347.479999999985,11508.310000000001
3799,2022-02-05 09:35:00,-200.35,35655.43999999999,24347.479999999985,11307.960000000003
3800,2022-02-05 09:40:00,-549.56,35105.87999999999,24347.479999999985,10758.400000000005
3801,2022-02-05 09:45:00,-285.27,34820.60999999999,24347.479999999985,10473.130000000008
3802,2022-02-05 09:50:00,-1828.77,32991.84,24347.479999999985,8644.360000000011
3803,2022-02-05 09:55:00,62.68,33054.52,24347.479999999985,8707.040000000012
3804,2022-02-05 10:00:00,-1740.78,31313.739999999998,24347.479999999985,6966.260000000013
3805,2022-02-05 10:05:00,1684.57,32998.31,24347.479999999985,8650.830000000013
3806,2022-02-05 10:10:00,-329.81,32668.499999999996,24347.479999999985,8321.020000000011
3807,2022-02-05 10:15:00,-1519.24,31149.259999999995,24347.479999999985,6801.78000000001
3808,2022-02-05 10:20:00,717.42,31866.679999999993,24347.479999999985,7519.200000000008
3809,2022-02-05 10:25:00,911.85,32778.52999999999,24347.479999999985,8431.050000000007
3810,2022-02-05 10:30:00,1814.64,34593.16999999999,24347.479999999985,10245.690000000006
3811,2022-02-05 10:35:00,-1936.58,32656.58999999999,24347.479999999985,8309.110000000004
3812,2022-02-05 10:40:00,1129.63,33786.21999999999,24347.479999999985,9438.740000000002
3813,2022-02-05 10:45:00,-937.25,32848.96999999999,24347.479999999985,8501.490000000002
3814,2022-02-05 10:50:00,1325.28,34174.249999999985,24347.479999999985,9826.77
3815,2022-02-05 10:55:00,-686.5,33487.749999999985,24347.479999999985,9140.27
3816,2022-02-05 11:00:00,436.07,33923.819999999985,24347.479999999985,9576.34
3817,2022-02-05 11:05:00,-1845.96,32077.859999999986,24347.479999999985,7730.380000000001
3818,2022-02-05 11:10:00,-456.21,31621.649999999987,24347.479999999985,7274.170000000002
3819,2022-02-05 11:15:00,-212.02,31409.629999999986,24347.479999999985,7062.1500000000015
3820,2022-02-05 11:20:00,-130.3,31279.329999999987,24347.479999999985,6931.850000000002
3821,2022-02-05 11:25:00,-535.68,30743.649999999987,24347.479999999985,6396.170000000002
3822,2022-02-05 11:30:00,-1623.92,29119.72999999999,24347.479999999985,4772.250000000004
3823,2022-02-05 11:35:00,-522.73,28596.99999999999,24347.479999999985,4249.520000000004
3824,2022-02-05 11:40:00,-202.87,28394.12999999999,24347.479999999985,4046.650000000005
3825,2022-02-05 11:45:00,1255.79,29649.91999999999,24347.479999999985,5302.440000000006
3826,2022-02-05 11:50:00,1230.23,30880.14999999999,24347.479999999985,6532.6700000000055
3827,2022-02-05 11:55:00,-1333.8,29546.34999999999,24347.479999999985,5198.870000000006
3828,2022-02-05 12:00:00,-596.34,28950.00999999999,24347.479999999985,4602.530000000006
3829,2022-02-05 12:05:00,-1020.54,27929.46999999999,24347.479999999985,3581.9900000000052
3830,2022-02-05 12:10:00,-673.7,27255.76999999999,24347.479999999985,2908.2900000000045
3831,2022-02-05 12:15:00,603.9,27859.66999999999,24347.479999999985,3512.190000000006
3832,2022-02-05 12:20:00,1185.66,29045.32999999999,24347.479999999985,4697.850000000006
3833,2022-02-05 12:25:00,1389.59,30434.91999999999,24347.479999999985,6087.440000000006
3834,2022-02-05 12:30:00,-1338.3,29096.61999999999,24347.479999999985,4749.140000000007
3835,2022-02-05 12:35:00,332.3,29428.91999999999,24347.479999999985,5081.440000000006
3836,2022-02-05 12:40:00,1501.78,30930.69999999999,24347.479999999985,6583.220000000005
3837,2022-02-05 12:45:00,-1058.96,29871.73999999999,24347.479999999985,5524.260000000006
3838,2022-02-05 12:50:00,1523.25,31394.98999999999,24347.479999999985,7047.510000000006
3839,2022-02-05 12:55:00,-839.7,30555.28999999999,24347.479999999985,6207.810000000005
3840,2022-02-05 13:00:00,-208.63,30346.65999999999,24347.479999999985,5999.180000000004
3841,2022-02-05 13:05:00,26.48,30373.13999999999,24347.479999999985,6025.6600000000035
3842,2022-02-05 13:10:00,1556.27,31929.40999999999,24347.479999999985,7581.930000000004
3843,2022-02-05 13:15:00,-76.43,31852.97999999999,24347.479999999985,7505.500000000004
3844,2022-02-05 13:20:00,511.25,32364.22999999999,24347.479999999985,8016.750000000004
3845,2022-02-05 13:25:00,1002.07,33366.29999999999,24347.479999999985,9018.820000000003
3846,2022-02-05 13:30:00,-327.38,33038.91999999999,24347.479999999985,8691.440000000006
3847,2022-02-05 13:35:00,-1986.28,31052.639999999992,24347.479999999985,6705.160000000007
3848,2022-02-05 13:40:00,-903.97,30148.66999999999,24347.479999999985,5801.190000000006
3849,2022-02-05 13:45:00,575.01,30723.67999999999,24347.479999999985,6376.200000000004
3850,2022-02-05 13:50:00,1246.16,31969.83999999999,24347.479999999985,7622.360000000004
3851,2022-02-05 13:55:00,478.13,32447.96999999999,24347.479999999985,8100.490000000005
3852,2022-02-05 14:00:00,134.31,32582.27999999999,24347.479999999985,8234.800000000007
3853,2022-02-05 14:05:00,-1834.08,30748.19999999999,24347.479999999985,6400.720000000005
3854,2022-02-05 14:10:00,-245.15,30503.04999999999,24347.479999999985,6155.570000000003
3855,2022-02-05 14:15:00,1769.02,32272.06999999999,24347.479999999985,7924.590000000004
3856,2022-02-05 14:20:00,322.78,32594.849999999988,24347.479999999985,8247.370000000003
3857,2022-02-05 14:25:00,-97.05,32497.79999999999,24347.479999999985,8150.320000000003
3858,2022-02-05 14:30:00,-978.57,31519.22999999999,24347.479999999985,7171.750000000004
3859,2022-02-05 14:35:00,1974.48,33493.70999999999,24347.479999999985,9146.230000000007
3860,2022-02-05 14:40:00,-526.2,32967.509999999995,24347.479999999985,8620.03000000001
3861,2022-02-05 14:45:00,1208.72,34176.229999999996,24347.479999999985,9828.750000000011
3862,2022-02-05 14:50:00,1697.34,35873.56999999999,24347.479999999985,11526.090000000007
3863,2022-02-05 14:55:00,1499.38,37372.94999999999,24347.479999999985,13025.470000000005
3864,2022-02-05 15:00:00,663.53,38036.47999999999,24347.479999999985,13689.000000000004
3865,2022-02-05 15:05:00,478.93,38515.40999999999,24347.479999999985,14167.930000000004
3866,2022-02-05 15:10:00,1137.44,39652.84999999999,24347.479999999985,15305.370000000006
3867,2022-02-05 15:15:00,1720.22,41373.06999999999,24347.479999999985,17025.590000000007
3868,2022-02-05 15:20:00,-94.31,41278.759999999995,24347.479999999985,16931.28000000001
3869,2022-02-05 15:25:00,1347.35,42626.10999999999,24347.479999999985,18278.63000000001
3870,2022-02-05 15:30:00,-996.48,41629.62999999999,24347.479999999985,17282.150000000005
3871,2022-02-05 15:35:00,-111.12,41518.50999999999,24347.479999999985,17171.030000000002
3872,2022-02-05 15:40:00,1269.9,42788.40999999999,24347.479999999985,18440.930000000004
3873,2022-02-05 15:45:00,-567.14,42221.26999999999,24347.479999999985,17873.790000000005
3874,2022-02-05 15:50:00,-1194.53,41026.73999999999,24347.479999999985,16679.260000000006
3875,2022-02-05 15:55:00,1596.95,42623.68999999999,24347.479999999985,18276.210000000003
3876,2022-02-05 16:00:00,40.17,42663.859999999986,24347.479999999985,18316.38
3877,2022-02-05 16:05:00,-996.55,41667.30999999998,24347.479999999985,17319.829999999998
3878,2022-02-05 16:10:00,-283.39,41383.919999999984,24347.479999999985,17036.44
3879,2022-02-05 16:15:00,1329.65,42713.569999999985,24347.479999999985,18366.09
3880,2022-02-05 16:20:00,417.52,43131.08999999998,24347.479999999985,18783.609999999997
3881,2022-02-05 16:25:00,-1393.8,41737.28999999998,24347.479999999985,17389.809999999994
3882,2022-02-05 16:30:00,-678.5,41058.78999999998,24347.479999999985,16711.309999999994
3883,2022-02-05 16:35:00,-564.97,40493.81999999998,24347.479999999985,16146.339999999993
3884,2022-02-05 16:40:00,1207.64,41701.45999999998,24347.479999999985,17353.979999999992
3885,2022-02-05 16:45:00,-141.61,41559.84999999998,24347.479999999985,17212.36999999999
3886,2022-02-05 16:50:00,-981.99,40577.85999999998,24347.479999999985,16230.379999999994
3887,2022-02-05 16:55:00,-382.43,40195.42999999998,24347.479999999985,15847.949999999993
3888,2022-02-06 08:00:00,-314.83,39880.59999999998,40195.42999999998,-314.83000000000175
3889,2022-02-06 08:05:00,459.27,40339.86999999997,40195.42999999998,144.43999999999505
3890,2022-02-06 08:10:00,1673.62,42013.489999999976,40195.42999999998,1818.0599999999977
3891,2022-02-06 08:15:00,335.8,42349.28999999998,40195.42999999998,2153.8600000000006
3892,2022-02-06 08:20:00,980.46,43329.74999999998,40195.42999999998,3134.3199999999997
3893,2022-02-06 08:25:00,1291.25,44620.99999999998,40195.42999999998,4425.57
3894,2022-02-06 08:30:00,-394.34,44226.65999999998,40195.42999999998,4031.230000000003
3895,2022-02-06 08:35:00,-1725.9,42500.75999999998,40195.42999999998,2305.3300000000017
3896,2022-02-06 08:40:00,62.12,42562.87999999998,40195.42999999998,2367.4500000000044
3897,2022-02-06 08:45:00,-294.75,42268.12999999998,40195.42999999998,2072.7000000000044
3898,2022-02-06 08:50:00,1122.85,43390.97999999998,40195.42999999998,3195.550000000003
3899,2022-02-06 08:55:00,-646.05,42744.92999999998,40195.42999999998,2549.5
3900,2022-02-06 09:00:00,1256.32,44001.24999999998,40195.42999999998,3805.8199999999997
3901,2022-02-06 09:05:00,-519.69,43481.559999999976,40195.42999999998,3286.1299999999974
3902,2022-02-06 09:10:00,950.75,44432.309999999976,40195.42999999998,4236.879999999997
3903,2022-02-06 09:15:00,250.16,44682.46999999998,40195.42999999998,4487.040000000001
3904,2022-02-06 09:20:00,1179.98,45862.44999999998,40195.42999999998,5667.020000000004
3905,2022-02-06 09:25:00,-540.01,45322.43999999998,40195.42999999998,5127.010000000002
3906,2022-02-06 09:30:00,-462.1,44860.33999999998,40195.42999999998,4664.9100000000035
3907,2022-02-06 09:35:00,195.35,45055.68999999998,40195.42999999998,4860.260000000002
3908,2022-02-06 09:40:00,1394.81,46450.49999999998,40195.42999999998,6255.07
3909,2022-02-06 09:45:00,686.38,47136.879999999976,40195.42999999998,6941.449999999997
3910,2022-02-06 09:50:00,-644.17,46492.70999999998,40195.42999999998,6297.279999999999
3911,2022-02-06 09:55:00,-291.28,46201.42999999998,40195.42999999998,6006.0
3912,2022-02-06 10:00:00,393.37,46594.79999999998,40195.42999999998,6399.370000000003
3913,2022-02-06 10:05:00,-1750.03,44844.76999999998,40195.42999999998,4649.340000000004
3914,2022-02-06 10:10:00,-1432.54,43412.22999999998,40195.42999999998,3216.800000000003
3915,2022-02-06 10:15:00,-1848.94,41563.28999999998,40195.42999999998,1367.8600000000006
3916,2022-02-06 10:20:00,1853.05,43416.33999999998,40195.42999999998,3220.9100000000035
3917,2022-02-06 10:25:00,1048.6,44464.93999999998,40195.42999999998,4269.510000000002
3918,2022-02-06 10:30:00,-996.91,43468.02999999998,40195.42999999998,3272.5999999999985
3919,2022-02-06 10:35:00,522.83,43990.85999999998,40195.42999999998,3795.4300000000003
3920,2022-02-06 10:40:00,131.28,44122.13999999998,40195.42999999998,3926.709999999999
3921,2022-02-06 10:45:00,-1453.0,42669.13999999998,40195.42999999998,2473.709999999999
3922,2022-02-06 10:50:00,244.24,42913.379999999976,40195.42999999998,2717.949999999997
3923,2022-02-06 10:55:00,706.14,43619.519999999975,40195.42999999998,3424.0899999999965
3924,2022-02-06 11:00:00,1648.12,45267.63999999998,40195.42999999998,5072.209999999999
3925,2022-02-06 11:05:00,79.58,45347.21999999998,40195.42999999998,5151.790000000001
3926,2022-02-06 11:10:00,-160.65,45186.56999999998,40195.42999999998,4991.139999999999
3927,2022-02-06 11:15:00,1814.07,47000.63999999998,40195.42999999998,6805.209999999999
3928,2022-02-06 11:20:00,-1503.91,45496.729999999974,40195.42999999998,5301.299999999996
3929,2022-02-06 11:25:00,-1890.58,43606.14999999997,40195.42999999998,3410.719999999994
3930,2022-02-06 11:30:00,-563.75,43042.39999999997,40195.42999999998,2846.969999999994
3931,2022-02-06 11:35:00,714.07,43756.46999999997,40195.42999999998,3561.0399999999936
3932,2022-02-06 11:40:00,662.17,44418.63999999997,40195.42999999998,4223.209999999992
3933,2022-02-06 11:45:00,1992.72,46411.35999999997,40195.42999999998,6215.929999999993
3934,2022-02-06 11:50:00,843.09,47254.44999999997,40195.42999999998,7059.0199999999895
3935,2022-02-06 11:55:00,-1889.2,45365.24999999997,40195.42999999998,5169.819999999992
3936,2022-02-06 12:00:00,-1782.67,43582.57999999997,40195.42999999998,3387.149999999994
3937,2022-02-06 12:05:00,573.21,44155.78999999997,40195.42999999998,3960.3599999999933
3938,2022-02-06 12:10:00,1847.4,46003.18999999997,40195.42999999998,5807.759999999995
3939,2022-02-06 12:15:00,1752.52,47755.70999999997,40195.42999999998,7560.279999999992
3940,2022-02-06 12:20:00,-580.75,47174.95999999997,40195.42999999998,6979.529999999992
3941,2022-02-06 12:25:00,514.9,47689.85999999997,40195.42999999998,7494.429999999993
3942,2022-02-06 12:30:00,-476.53,47213.32999999997,40195.42999999998,7017.899999999994
3943,2022-02-06 12:35:00,1154.32,48367.64999999997,40195.42999999998,8172.219999999994
3944,2022-02-06 12:40:00,-742.98,47624.66999999997,40195.42999999998,7429.239999999991
3945,2022-02-06 12:45:00,-1210.42,46414.24999999997,40195.42999999998,6218.819999999992
3946,2022-02-06 12:50:00,760.64,47174.88999999997,40195.42999999998,6979.459999999992
3947,2022-02-06 12:55:00,1646.39,48821.27999999997,40195.42999999998,8625.849999999991
3948,2022-02-06 13:00:00,1281.74,50103.01999999997,40195.42999999998,9907.58999999999
3949,2022-02-06 13:05:00,1082.32,51185.33999999997,40195.42999999998,10989.909999999989
3950,2022-02-06 13:10:00,-495.06,50690.27999999997,40195.42999999998,10494.849999999991
3951,2022-02-06 13:15:00,586.34,51276.619999999966,40195.42999999998,11081.189999999988
3952,2022-02-06 13:20:00,-1707.02,49569.59999999997,40195.42999999998,9374.169999999991
3953,2022-02-06 13:25:00,-1269.27,48300.32999999997,40195.42999999998,8104.899999999994
3954,2022-02-06 13:30:00,161.77,48462.09999999997,40195.42999999998,8266.669999999991
3955,2022-02-06 13:35:00,1095.45,49557.54999999997,40195.42999999998,9362.119999999988
3956,2022-02-06 13:40:00,20.23,49577.77999999997,40195.42999999998,9382.349999999991
3957,2022-02-06 13:45:00,-1966.36,47611.41999999997,40195.42999999998,7415.989999999991
3958,2022-02-06 13:50:00,255.36,47866.77999999997,40195.42999999998,7671.349999999991
3959,2022-02-06 13:55:00,-1106.3,46760.47999999997,40195.42999999998,6565.049999999988
3960,2022-02-06 14:00:00,1474.22,48234.69999999997,40195.42999999998,8039.2699999999895
3961,2022-02-06 14:05:00,-467.01,47767.689999999966,40195.42999999998,7572.2599999999875
3962,2022-02-06 14:10:00,-56.87,47710.81999999996,40195.42999999998,7515.389999999985
3963,2022-02-06 14:15:00,-287.28,47423.539999999964,40195.42999999998,7228.109999999986
3964,2022-02-06 14:20:00,1895.73,49319.26999999997,40195.42999999998,9123.83999999999
3965,2022-02-06 14:25:00,-377.63,48941.63999999997,40195.42999999998,8746.209999999992
3966,2022-02-06 14:30:00,347.24,49288.87999999997,40195.42999999998,9093.44999999999
3967,2022-02-06 14:35:00,116.47,49405.34999999997,40195.42999999998,9209.919999999991
3968,2022-02-06 14:40:00,326.72,49732.06999999997,40195.42999999998,9536.639999999992
3969,2022-02-06 14:45:00,-289.15,49442.91999999997,40195.42999999998,9247.48999999999
3970,2022-02-06 14:50:00,966.49,50409.40999999997,40195.42999999998,10213.979999999989
3971,2022-02-06 14:55:00,1319.61,51729.01999999997,40195.42999999998,11533.58999999999
3972,2022-02-06 15:00:00,1543.93,53272.94999999997,40195.42999999998,13077.51999999999
3973,2022-02-06 15:05:00,-193.59,53079.35999999997,40195.42999999998,12883.929999999993
3974,2022-02-06 15:10:00,1835.94,54915.299999999974,40195.42999999998,14719.869999999995
3975,2022-02-06 15:15:00,-19.13,54896.16999999998,40195.42999999998,14700.739999999998
3976,2022-02-06 15:20:00,-1885.15,53011.019999999975,40195.42999999998,12815.589999999997
3977,2022-02-06 15:25:00,-725.53,52285.489999999976,40195.42999999998,12090.059999999998
3978,2022-02-06 15:30:00,-864.72,51420.769999999975,40195.42999999998,11225.339999999997
3979,2022-02-06 15:35:00,-1998.17,49422.59999999998,40195.42999999998,9227.169999999998
3980,2022-02-06 15:40:00,861.24,50283.839999999975,40195.42999999998,10088.409999999996
3981,2022-02-06 15:45:00,-359.57,49924.269999999975,40195.42999999998,9728.839999999997
3982,2022-02-06 15:50:00,-78.61,49845.659999999974,40195.42999999998,9650.229999999996
3983,2022-02-06 15:55:00,723.8,50569.45999999998,40195.42999999998,10374.029999999999
3984,2022-02-06 16:00:00,-585.94,49983.519999999975,40195.42999999998,9788.089999999997
3985,2022-02-06 16:05:00,1763.7,51747.21999999997,40195.42999999998,11551.789999999994
3986,2022-02-06 16:10:00,612.27,52359.48999999997,40195.42999999998,12164.05999999999
3987,2022-02-06 16:15:00,1154.86,53514.34999999997,40195.42999999998,13318.919999999991
3988,2022-02-06 16:20:00,-1384.76,52129.58999999997,40195.42999999998,11934.159999999989
3989,2022-02-06 16:25:00,-1736.06,50393.52999999997,40195.42999999998,10198.099999999991
3990,2022-02-06 16:30:00,-99.56,50293.96999999997,40195.42999999998,10098.539999999994
3991,2022-02-06 16:35:00,-732.44,49561.52999999997,40195.42999999998,9366.099999999991
3992,2022-02-06 16:40:00,1069.75,50631.27999999997,40195.42999999998,10435.849999999991
3993,2022-02-06 16:45:00,166.67,50797.94999999997,40195.42999999998,10602.51999999999
3994,2022-02-06 16:50:00,-1138.06,49659.88999999997,40195.42999999998,9464.459999999992
3995,2022-02-06 16:55:00,161.8,49821.68999999997,40195.42999999998,9626.259999999995
3996,2022-02-07 08:00:00,-47.5,49774.18999999997,49821.68999999997,-47.5
3997,2022-02-07 08:05:00,-576.33,49197.85999999997,49821.68999999997,-623.8300000000017
3998,2022-02-07 08:10:00,1161.78,50359.63999999997,49821.68999999997,537.9499999999971
3999,2022-02-07 08:15:00,-1676.22,48683.41999999997,49821.68999999997,-1138.270000000004
4000,2022-02-07 08:20:00,-347.23,48336.189999999966,49821.68999999997,-1485.5000000000073
4001,2022-02-07 08:25:00,3.42,48339.609999999964,49821.68999999997,-1482.080000000009
4002,2022-02-07 08:30:00,-1099.09,47240.51999999997,49821.68999999997,-2581.1700000000055
4003,2022-02-07 08:35:00,1299.04,48539.55999999997,49821.68999999997,-1282.1300000000047
4004,2022-02-07 08:40:00,335.17,48874.72999999997,49821.68999999997,-946.9600000000064
4005,2022-02-07 08:45:00,-100.71,48774.01999999997,49821.68999999997,-1047.6700000000055
4006,2022-02-07 08:50:00,-231.16,48542.859999999964,49821.68999999997,-1278.830000000009
4007,2022-02-07 08:55:00,1347.42,49890.27999999996,49821.68999999997,68.58999999998923
4008,2022-02-07 09:00:00,-526.37,49363.90999999996,49821.68999999997,-457.7800000000134
4009,2022-02-07 09:05:00,1005.95,50369.85999999996,49821.68999999997,548.1699999999837
4010,2022-02-07 09:10:00,1971.42,52341.279999999955,49821.68999999997,2519.589999999982
4011,2022-02-07 09:15:00,-1224.74,51116.53999999996,49821.68999999997,1294.849999999984
4012,2022-02-07 09:20:00,-406.65,50709.889999999956,49821.68999999997,888.1999999999825
4013,2022-02-07 09:25:00,266.71,50976.599999999955,49821.68999999997,1154.9099999999817
4014,2022-02-07 09:30:00,-565.17,50411.42999999996,49821.68999999997,589.7399999999834
4015,2022-02-07 09:35:00,1029.49,51440.919999999955,49821.68999999997,1619.2299999999814
4016,2022-02-07 09:40:00,-498.59,50942.32999999996,49821.68999999997,1120.6399999999849
4017,2022-02-07 09:45:00,510.23,51452.55999999996,49821.68999999997,1630.869999999988
4018,2022-02-07 09:50:00,1531.62,52984.179999999964,49821.68999999997,3162.4899999999907
4019,2022-02-07 09:55:00,-1615.82,51368.359999999964,49821.68999999997,1546.669999999991
4020,2022-02-07 10:00:00,1433.45,52801.80999999996,49821.68999999997,2980.119999999988
4021,2022-02-07 10:05:00,505.62,53307.429999999964,49821.68999999997,3485.7399999999907
4022,2022-02-07 10:10:00,-1931.89,51375.539999999964,49821.68999999997,1553.8499999999913
4023,2022-02-07 10:15:00,618.65,51994.189999999966,49821.68999999997,2172.4999999999927
4024,2022-02-07 10:20:00,-413.23,51580.95999999996,49821.68999999997,1759.2699999999895
4025,2022-02-07 10:25:00,1416.88,52997.83999999996,49821.68999999997,3176.149999999987
4026,2022-02-07 10:30:00,81.43,53079.26999999996,49821.68999999997,3257.579999999987
4027,2022-02-07 10:35:00,-1149.76,51929.50999999996,49821.68999999997,2107.819999999985
4028,2022-02-07 10:40:00,706.09,52635.599999999955,49821.68999999997,2813.9099999999817
4029,2022-02-07 10:45:00,-1695.2,50940.39999999996,49821.68999999997,1118.7099999999846
4030,2022-02-07 10:50:00,-534.68,50405.71999999996,49821.68999999997,584.0299999999843
4031,2022-02-07 10:55:00,224.91,50630.62999999996,49821.68999999997,808.9399999999878
4032,2022-02-07 11:00:00,1155.64,51786.26999999996,49821.68999999997,1964.5799999999872
4033,2022-02-07 11:05:00,-38.62,51747.64999999996,49821.68999999997,1925.9599999999846
4034,2022-02-07 11:10:00,30.58,51778.22999999996,49821.68999999997,1956.5399999999863
4035,2022-02-07 11:15:00,411.94,52190.16999999996,49821.68999999997,2368.4799999999886
4036,2022-02-07 11:20:00,-1736.03,50454.13999999996,49821.68999999997,632.4499999999898
4037,2022-02-07 11:25:00,399.4,50853.539999999964,49821.68999999997,1031.8499999999913
4038,2022-02-07 11:30:00,-797.17,50056.369999999966,49821.68999999997,234.67999999999302
4039,2022-02-07 11:35:00,480.06,50536.429999999964,49821.68999999997,714.7399999999907
4040,2022-02-07 11:40:00,938.49,51474.91999999996,49821.68999999997,1653.2299999999886
4041,2022-02-07 11:45:00,1008.05,52482.969999999965,49821.68999999997,2661.2799999999916
4042,2022-02-07 11:50:00,878.93,53361.899999999965,49821.68999999997,3540.209999999992
4043,2022-02-07 11:55:00,859.17,54221.06999999996,49821.68999999997,4399.37999999999
4044,2022-02-07 12:00:00,-1987.79,52233.27999999996,49821.68999999997,2411.5899999999892
4045,2022-02-07 12:05:00,-1172.8,51060.47999999996,49821.68999999997,1238.7899999999863
4046,2022-02-07 12:10:00,-618.75,50441.72999999996,49821.68999999997,620.0399999999863
4047,2022-02-07 12:15:00,-445.38,49996.34999999996,49821.68999999997,174.65999999998894
4048,2022-02-07 12:20:00,1765.14,51761.48999999996,49821.68999999997,1939.7999999999884
4049,2022-02-07 12:25:00,49.68,51811.16999999996,49821.68999999997,1989.4799999999886
4050,2022-02-07 12:30:00,5.04,51816.20999999996,49821.68999999997,1994.5199999999895
4051,2022-02-07 12:35:00,-1707.07,50109.13999999996,49821.68999999997,287.4499999999898
4052,2022-02-07 12:40:00,47.99,50157.12999999996,49821.68999999997,335.4399999999878
4053,2022-02-07 12:45:00,-78.31,50078.81999999996,49821.68999999997,257.1299999999901
4054,2022-02-07 12:50:00,-67.52,50011.29999999997,49821.68999999997,189.6099999999933
4055,2022-02-07 12:55:00,386.43,50397.72999999997,49821.68999999997,576.0399999999936
4056,2022-02-07 13:00:00,2.56,50400.289999999964,49821.68999999997,578.5999999999913
4057,2022-02-07 13:05:00,-1184.87,49215.41999999996,49821.68999999997,-606.2700000000114
4058,2022-02-07 13:10:00,-497.93,48717.48999999996,49821.68999999997,-1104.2000000000116
4059,2022-02-07 13:15:00,-701.82,48015.66999999996,49821.68999999997,-1806.0200000000114
4060,2022-02-07 13:20:00,-794.36,47221.30999999996,49821.68999999997,-2600.380000000012
4061,2022-02-07 13:25:00,56.73,47278.039999999964,49821.68999999997,-2543.6500000000087
4062,2022-02-07 13:30:00,1465.74,48743.77999999996,49821.68999999997,-1077.9100000000108
4063,2022-02-07 13:35:00,-762.19,47981.58999999996,49821.68999999997,-1840.100000000013
4064,2022-02-07 13:40:00,1117.25,49098.83999999996,49821.68999999997,-722.8500000000131
4065,2022-02-07 13:45:00,405.51,49504.34999999996,49821.68999999997,-317.34000000001106
4066,2022-02-07 13:50:00,-1323.59,48180.759999999966,49821.68999999997,-1640.9300000000076
4067,2022-02-07 13:55:00,1220.44,49401.19999999997,49821.68999999997,-420.49000000000524
4068,2022-02-07 14:00:00,-324.53,49076.66999999997,49821.68999999997,-745.0200000000041
4069,2022-02-07 14:05:00,-948.9,48127.76999999997,49821.68999999997,-1693.9200000000055
4070,2022-02-07 14:10:00,-841.63,47286.13999999997,49821.68999999997,-2535.550000000003
4071,2022-02-07 14:15:00,1516.68,48802.81999999997,49821.68999999997,-1018.8700000000026
4072,2022-02-07 14:20:00,1444.73,50247.549999999974,49821.68999999997,425.8600000000006
4073,2022-02-07 14:25:00,-1043.67,49203.879999999976,49821.68999999997,-617.8099999999977
4074,2022-02-07 14:30:00,-1180.25,48023.629999999976,49821.68999999997,-1798.0599999999977
4075,2022-02-07 14:35:00,-515.01,47508.61999999997,49821.68999999997,-2313.0699999999997
4076,2022-02-07 14:40:00,1239.4,48748.019999999975,49821.68999999997,-1073.6699999999983
4077,2022-02-07 14:45:00,-706.06,48041.95999999998,49821.68999999997,-1779.729999999996
4078,2022-02-07 14:50:00,-379.51,47662.449999999975,49821.68999999997,-2159.239999999998
4079,2022-02-07 14:55:00,-1173.2,46489.24999999998,49821.68999999997,-3332.439999999995
4080,2022-02-07 15:00:00,533.68,47022.92999999998,49821.68999999997,-2798.7599999999948
4081,2022-02-07 15:05:00,324.33,47347.25999999998,49821.68999999997,-2474.429999999993
4082,2022-02-07 15:10:00,-1784.86,45562.39999999998,49821.68999999997,-4259.289999999994
4083,2022-02-07 15:15:00,1242.21,46804.60999999998,49821.68999999997,-3017.0799999999945
4084,2022-02-07 15:20:00,-1099.78,45704.82999999998,49821.68999999997,-4116.859999999993
4085,2022-02-07 15:25:00,-1249.33,44455.49999999998,49821.68999999997,-5366.189999999995
4086,2022-02-07 15:30:00,808.03,45263.52999999998,49821.68999999997,-4558.159999999996
4087,2022-02-07 15:35:00,1262.99,46526.519999999975,49821.68999999997,-3295.1699999999983
4088,2022-02-07 15:40:00,-1165.41,45361.10999999997,49821.68999999997,-4460.580000000002
4089,2022-02-07 15:45:00,-157.81,45203.299999999974,49821.68999999997,-4618.389999999999
4090,2022-02-07 15:50:00,-1685.27,43518.02999999998,49821.68999999997,-6303.659999999996
4091,2022-02-07 15:55:00,-877.18,42640.84999999998,49821.68999999997,-7180.8399999999965
4092,2022-02-07 16:00:00,1338.28,43979.129999999976,49821.68999999997,-5842.559999999998
4093,2022-02-07 16:05:00,-79.64,43899.489999999976,49821.68999999997,-5922.199999999997
4094,2022-02-07 16:10:00,798.29,44697.77999999998,49821.68999999997,-5123.909999999996
4095,2022-02-07 16:15:00,1722.93,46420.70999999998,49821.68999999997,-3400.979999999996
4096,2022-02-07 16:20:00,416.12,46836.82999999998,49821.68999999997,-2984.8599999999933
4097,2022-02-07 16:25:00,830.2,47667.02999999998,49821.68999999997,-2154.659999999996
4098,2022-02-07 16:30:00,-47.89,47619.13999999998,49821.68999999997,-2202.5499999999956
4099,2022-02-07 16:35:00,301.71,47920.84999999998,49821.68999999997,-1900.8399999999965
4100,2022-02-07 16:40:00,-265.24,47655.60999999998,49821.68999999997,-2166.0799999999945
4101,2022-02-07 16:45:00,3.02,47658.629999999976,49821.68999999997,-2163.0599999999977
4102,2022-02-07 16:50:00,1750.7,49409.32999999997,49821.68999999997,-412.3600000000006
4103,2022-02-07 16:55:00,1232.85,50642.17999999997,49821.68999999997,820.489999999998
4104,2022-02-08 08:00:00,3.99,50646.16999999997,50642.17999999997,3.9899999999979627
4105,2022-02-08 08:05:00,-952.04,49694.12999999997,50642.17999999997,-948.0500000000029
4106,2022-02-08 08:10:00,1346.08,51040.20999999997,50642.17999999997,398.02999999999884
4107,2022-02-08 08:15:00,-1169.28,49870.92999999997,50642.17999999997,-771.25
4108,2022-02-08 08:20:00,1773.13,51644.05999999997,50642.17999999997,1001.8799999999974
4109,2022-02-08 08:25:00,1772.47,53416.52999999997,50642.17999999997,2774.3499999999985
4110,2022-02-08 08:30:00,-561.5,52855.02999999997,50642.17999999997,2212.8499999999985
4111,2022-02-08 08:35:00,-848.66,52006.369999999966,50642.17999999997,1364.189999999995
4112,2022-02-08 08:40:00,-1345.29,50661.079999999965,50642.17999999997,18.89999999999418
4113,2022-02-08 08:45:00,1575.59,52236.66999999996,50642.17999999997,1594.4899999999907
4114,2022-02-08 08:50:00,-697.89,51538.77999999996,50642.17999999997,896.5999999999913
4115,2022-02-08 08:55:00,348.33,51887.109999999964,50642.17999999997,1244.929999999993
4116,2022-02-08 09:00:00,1498.34,53385.44999999996,50642.17999999997,2743.2699999999895
4117,2022-02-08 09:05:00,1971.1,55356.54999999996,50642.17999999997,4714.369999999988
4118,2022-02-08 09:10:00,425.95,55782.499999999956,50642.17999999997,5140.319999999985
4119,2022-02-08 09:15:00,497.76,56280.25999999996,50642.17999999997,5638.079999999987
4120,2022-02-08 09:20:00,-1309.35,54970.90999999996,50642.17999999997,4328.729999999989
4121,2022-02-08 09:25:00,623.4,55594.30999999996,50642.17999999997,4952.12999999999
4122,2022-02-08 09:30:00,-93.67,55500.63999999996,50642.17999999997,4858.459999999992
4123,2022-02-08 09:35:00,910.41,56411.04999999997,50642.17999999997,5768.869999999995
4124,2022-02-08 09:40:00,-418.2,55992.84999999997,50642.17999999997,5350.669999999998
4125,2022-02-08 09:45:00,27.03,56019.87999999997,50642.17999999997,5377.699999999997
4126,2022-02-08 09:50:00,80.29,56100.16999999997,50642.17999999997,5457.989999999998
4127,2022-02-08 09:55:00,-879.97,55220.19999999997,50642.17999999997,4578.019999999997
4128,2022-02-08 10:00:00,352.44,55572.63999999997,50642.17999999997,4930.459999999999
4129,2022-02-08 10:05:00,1980.03,57552.66999999997,50642.17999999997,6910.489999999998
4130,2022-02-08 10:10:00,-927.66,56625.009999999966,50642.17999999997,5982.8299999999945
4131,2022-02-08 10:15:00,-1313.3,55311.70999999996,50642.17999999997,4669.529999999992
4132,2022-02-08 10:20:00,1390.19,56701.899999999965,50642.17999999997,6059.719999999994
4133,2022-02-08 10:25:00,-1960.51,54741.38999999996,50642.17999999997,4099.209999999992
4134,2022-02-08 10:30:00,-1295.22,53446.16999999996,50642.17999999997,2803.9899999999907
4135,2022-02-08 10:35:00,-921.78,52524.38999999996,50642.17999999997,1882.2099999999919
4136,2022-02-08 10:40:00,-1656.46,50867.929999999964,50642.17999999997,225.74999999999272
4137,2022-02-08 10:45:00,560.66,51428.58999999997,50642.17999999997,786.4099999999962
4138,2022-02-08 10:50:00,413.22,51841.80999999997,50642.17999999997,1199.6299999999974
4139,2022-02-08 10:55:00,764.7,52606.509999999966,50642.17999999997,1964.3299999999945
4140,2022-02-08 11:00:00,409.71,53016.219999999965,50642.17999999997,2374.0399999999936
4141,2022-02-08 11:05:00,958.39,53974.609999999964,50642.17999999997,3332.429999999993
4142,2022-02-08 11:10:00,632.71,54607.31999999996,50642.17999999997,3965.139999999992
4143,2022-02-08 11:15:00,1972.75,56580.06999999996,50642.17999999997,5937.889999999992
4144,2022-02-08 11:20:00,772.04,57352.109999999964,50642.17999999997,6709.929999999993
4145,2022-02-08 11:25:00,685.79,58037.899999999965,50642.17999999997,7395.719999999994
4146,2022-02-08 11:30:00,980.0,59017.899999999965,50642.17999999997,8375.719999999994
4147,2022-02-08 11:35:00,1770.66,60788.55999999997,50642.17999999997,10146.379999999997
4148,2022-02-08 11:40:00,1028.1,61816.65999999997,50642.17999999997,11174.479999999996
4149,2022-02-08 11:45:00,1935.22,63751.87999999997,50642.17999999997,13109.699999999997
4150,2022-02-08 11:50:00,1523.33,65275.20999999997,50642.17999999997,14633.029999999999
4151,2022-02-08 11:55:00,653.31,65928.51999999997,50642.17999999997,15286.340000000004
4152,2022-02-08 12:00:00,921.09,66849.60999999997,50642.17999999997,16207.43
4153,2022-02-08 12:05:00,-1105.67,65743.93999999997,50642.17999999997,15101.760000000002
4154,2022-02-08 12:10:00,795.69,66539.62999999998,50642.17999999997,15897.450000000004
4155,2022-02-08 12:15:00,1510.46,68050.08999999998,50642.17999999997,17407.91000000001
4156,2022-02-08 12:20:00,-540.78,67509.30999999998,50642.17999999997,16867.130000000012
4157,2022-02-08 12:25:00,519.93,68029.23999999998,50642.17999999997,17387.060000000005
4158,2022-02-08 12:30:00,439.41,68468.64999999998,50642.17999999997,17826.47000000001
4159,2022-02-08 12:35:00,866.65,69335.29999999997,50642.17999999997,18693.120000000003
4160,2022-02-08 12:40:00,-523.65,68811.64999999998,50642.17999999997,18169.47000000001
4161,2022-02-08 12:45:00,1518.49,70330.13999999998,50642.17999999997,19687.960000000014
4162,2022-02-08 12:50:00,872.57,71202.70999999999,50642.17999999997,20560.53000000002
4163,2022-02-08 12:55:00,1363.36,72566.06999999999,50642.17999999997,21923.89000000002
4164,2022-02-08 13:00:00,668.74,73234.81,50642.17999999997,22592.630000000026
4165,2022-02-08 13:05:00,395.33,73630.14,50642.17999999997,22987.96000000003
4166,2022-02-08 13:10:00,-714.8,72915.34,50642.17999999997,22273.160000000025
4167,2022-02-08 13:15:00,214.2,73129.54,50642.17999999997,22487.360000000022
4168,2022-02-08 13:20:00,-821.16,72308.37999999999,50642.17999999997,21666.20000000002
4169,2022-02-08 13:25:00,1195.7,73504.07999999999,50642.17999999997,22861.900000000016
4170,2022-02-08 13:30:00,45.83,73549.90999999999,50642.17999999997,22907.730000000018
4171,2022-02-08 13:35:00,-136.65,73413.26,50642.17999999997,22771.080000000024
4172,2022-02-08 13:40:00,-220.63,73192.62999999999,50642.17999999997,22550.45000000002
4173,2022-02-08 13:45:00,-283.73,72908.9,50642.17999999997,22266.720000000023
4174,2022-02-08 13:50:00,1764.35,74673.25,50642.17999999997,24031.07000000003
4175,2022-02-08 13:55:00,984.59,75657.84,50642.17999999997,25015.660000000025
4176,2022-02-08 14:00:00,1343.61,77001.45,50642.17999999997,26359.270000000026
4177,2022-02-08 14:05:00,-1126.19,75875.26,50642.17999999997,25233.080000000024
4178,2022-02-08 14:10:00,-921.12,74954.14,50642.17999999997,24311.96000000003
4179,2022-02-08 14:15:00,-1318.12,73636.02,50642.17999999997,22993.840000000033
4180,2022-02-08 14:20:00,-1688.92,71947.1,50642.17999999997,21304.920000000035
4181,2022-02-08 14:25:00,-1006.73,70940.37000000001,50642.17999999997,20298.19000000004
4182,2022-02-08 14:30:00,1927.6,72867.97000000002,50642.17999999997,22225.790000000045
4183,2022-02-08 14:35:00,-59.86,72808.11000000002,50642.17999999997,22165.930000000044
4184,2022-02-08 14:40:00,1971.91,74780.02000000002,50642.17999999997,24137.840000000047
4185,2022-02-08 14:45:00,-1815.19,72964.83000000002,50642.17999999997,22322.650000000045
4186,2022-02-08 14:50:00,1131.47,74096.30000000002,50642.17999999997,23454.120000000046
4187,2022-02-08 14:55:00,-550.16,73546.14000000001,50642.17999999997,22903.960000000043
4188,2022-02-08 15:00:00,1221.16,74767.30000000002,50642.17999999997,24125.120000000046
4189,2022-02-08 15:05:00,-1741.31,73025.99000000002,50642.17999999997,22383.81000000005
4190,2022-02-08 15:10:00,1137.19,74163.18000000002,50642.17999999997,23521.00000000005
4191,2022-02-08 15:15:00,1163.23,75326.41000000002,50642.17999999997,24684.230000000047
4192,2022-02-08 15:20:00,934.68,76261.09000000001,50642.17999999997,25618.91000000004
4193,2022-02-08 15:25:00,-710.39,75550.70000000001,50642.17999999997,24908.52000000004
4194,2022-02-08 15:30:00,1174.03,76724.73000000001,50642.17999999997,26082.55000000004
4195,2022-02-08 15:35:00,-827.32,75897.41,50642.17999999997,25255.230000000032
4196,2022-02-08 15:40:00,-1329.5,74567.91,50642.17999999997,23925.730000000032
4197,2022-02-08 15:45:00,-1668.61,72899.3,50642.17999999997,22257.12000000003
4198,2022-02-08 15:50:00,1517.25,74416.55,50642.17999999997,23774.37000000003
4199,2022-02-08 15:55:00,-1883.46,72533.09,50642.17999999997,21890.910000000025
4200,2022-02-08 16:00:00,-386.21,72146.87999999999,50642.17999999997,21504.70000000002
4201,2022-02-08 16:05:00,160.1,72306.98,50642.17999999997,21664.800000000025
4202,2022-02-08 16:10:00,-10.93,72296.05,50642.17999999997,21653.87000000003
4203,2022-02-08 16:15:00,1424.66,73720.71,50642.17999999997,23078.530000000035
4204,2022-02-08 16:20:00,377.76,74098.47,50642.17999999997,23456.29000000003
4205,2022-02-08 16:25:00,-904.62,73193.85,50642.17999999997,22551.670000000035
4206,2022-02-08 16:30:00,-1487.43,71706.42000000001,50642.17999999997,21064.24000000004
4207,2022-02-08 16:35:00,-737.05,70969.37000000001,50642.17999999997,20327.19000000004
4208,2022-02-08 16:40:00,1513.66,72483.03000000001,50642.17999999997,21840.850000000042
4209,2022-02-08 16:45:00,1206.87,73689.90000000001,50642.17999999997,23047.720000000038
4210,2022-02-08 16:50:00,315.12,74005.02,50642.17999999997,23362.840000000033
4211,2022-02-08 16:55:00,872.07,74877.09000000001,50642.17999999997,24234.91000000004
4212,2022-02-09 08:00:00,112.85,74989.94000000002,74877.09000000001,112.85000000000582
4213,2022-02-09 08:05:00,1240.09,76230.03000000001,74877.09000000001,1352.9400000000023
4214,2022-02-09 08:10:00,-1393.65,74836.38000000002,74877.09000000001,-40.70999999999185
4215,2022-02-09 08:15:00,-1703.97,73132.41000000002,74877.09000000001,-1744.679999999993
4216,2022-02-09 08:20:00,-1719.27,71413.14000000001,74877.09000000001,-3463.949999999997
4217,2022-02-09 08:25:00,821.58,72234.72000000002,74877.09000000001,-2642.3699999999953
4218,2022-02-09 08:30:00,1252.31,73487.03000000001,74877.09000000001,-1390.0599999999977
4219,2022-02-09 08:35:00,-1898.31,71588.72000000002,74877.09000000001,-3288.3699999999953
4220,2022-02-09 08:40:00,-1257.32,70331.40000000001,74877.09000000001,-4545.690000000002
4221,2022-02-09 08:45:00,1739.42,72070.82,74877.09000000001,-2806.270000000004
4222,2022-02-09 08:50:00,517.22,72588.04000000001,74877.09000000001,-2289.050000000003
4223,2022-02-09 08:55:00,-174.21,72413.83,74877.09000000001,-2463.2600000000093
4224,2022-02-09 09:00:00,-1077.59,71336.24,74877.09000000001,-3540.850000000006
4225,2022-02-09 09:05:00,695.52,72031.76000000001,74877.09000000001,-2845.3300000000017
4226,2022-02-09 09:10:00,-1951.16,70080.6,74877.09000000001,-4796.490000000005
4227,2022-02-09 09:15:00,985.31,71065.91,74877.09000000001,-3811.1800000000076
4228,2022-02-09 09:20:00,1908.11,72974.02,74877.09000000001,-1903.070000000007
4229,2022-02-09 09:25:00,-1794.35,71179.67,74877.09000000001,-3697.420000000013
4230,2022-02-09 09:30:00,-78.24,71101.43,74877.09000000001,-3775.660000000018
4231,2022-02-09 09:35:00,-305.88,70795.54999999999,74877.09000000001,-4081.5400000000227
4232,2022-02-09 09:40:00,-1357.33,69438.21999999999,74877.09000000001,-5438.870000000024
4233,2022-02-09 09:45:00,1478.28,70916.49999999999,74877.09000000001,-3960.5900000000256
4234,2022-02-09 09:50:00,-1367.94,69548.55999999998,74877.09000000001,-5328.530000000028
4235,2022-02-09 09:55:00,-1353.01,68195.54999999999,74877.09000000001,-6681.540000000023
4236,2022-02-09 10:00:00,1619.89,69815.43999999999,74877.09000000001,-5061.650000000023
4237,2022-02-09 10:05:00,382.01,70197.44999999998,74877.09000000001,-4679.6400000000285
4238,2022-02-09 10:10:00,1278.69,71476.13999999998,74877.09000000001,-3400.950000000026
4239,2022-02-09 10:15:00,904.95,72381.08999999998,74877.09000000001,-2496.000000000029
4240,2022-02-09 10:20:00,-1431.16,70949.92999999998,74877.09000000001,-3927.1600000000326
4241,2022-02-09 10:25:00,-817.62,70132.30999999998,74877.09000000001,-4744.780000000028
4242,2022-02-09 10:30:00,527.51,70659.81999999998,74877.09000000001,-4217.270000000033
4243,2022-02-09 10:35:00,-505.18,70154.63999999998,74877.09000000001,-4722.450000000026
4244,2022-02-09 10:40:00,-1655.53,68499.10999999999,74877.09000000001,-6377.980000000025
4245,2022-02-09 10:45:00,-80.94,68418.16999999998,74877.09000000001,-6458.920000000027
4246,2022-02-09 10:50:00,-988.08,67430.08999999998,74877.09000000001,-7447.000000000029
4247,2022-02-09 10:55:00,1964.89,69394.97999999998,74877.09000000001,-5482.11000000003
4248,2022-02-09 11:00:00,641.42,70036.39999999998,74877.09000000001,-4840.690000000031
4249,2022-02-09 11:05:00,-871.67,69164.72999999998,74877.09000000001,-5712.36000000003
4250,2022-02-09 11:10:00,-763.76,68400.96999999999,74877.09000000001,-6476.120000000024
4251,2022-02-09 11:15:00,1710.37,70111.33999999998,74877.09000000001,-4765.750000000029
4252,2022-02-09 11:20:00,-1851.64,68259.69999999998,74877.09000000001,-6617.3900000000285
4253,2022-02-09 11:25:00,-1012.69,67247.00999999998,74877.09000000001,-7630.080000000031
4254,2022-02-09 11:30:00,1439.26,68686.26999999997,74877.09000000001,-6190.820000000036
4255,2022-02-09 11:35:00,683.84,69370.10999999997,74877.09000000001,-5506.98000000004
4256,2022-02-09 11:40:00,-152.19,69217.91999999997,74877.09000000001,-5659.170000000042
4257,2022-02-09 11:45:00,-1647.54,67570.37999999998,74877.09000000001,-7306.7100000000355
4258,2022-02-09 11:50:00,1572.63,69143.00999999998,74877.09000000001,-5734.080000000031
4259,2022-02-09 11:55:00,-866.79,68276.21999999999,74877.09000000001,-6600.870000000024
4260,2022-02-09 12:00:00,-496.49,67779.72999999998,74877.09000000001,-7097.36000000003
4261,2022-02-09 12:05:00,-893.68,66886.04999999999,74877.09000000001,-7991.040000000023
4262,2022-02-09 12:10:00,1868.76,68754.80999999998,74877.09000000001,-6122.280000000028
4263,2022-02-09 12:15:00,-1923.0,66831.80999999998,74877.09000000001,-8045.280000000028
4264,2022-02-09 12:20:00,-446.88,66384.92999999998,74877.09000000001,-8492.160000000033
4265,2022-02-09 12:25:00,369.52,66754.44999999998,74877.09000000001,-8122.6400000000285
4266,2022-02-09 12:30:00,1997.44,68751.88999999998,74877.09000000001,-6125.200000000026
4267,2022-02-09 12:35:00,67.54,68819.42999999998,74877.09000000001,-6057.660000000033
4268,2022-02-09 12:40:00,-1833.71,66985.71999999997,74877.09000000001,-7891.370000000039
4269,2022-02-09 12:45:00,537.75,67523.46999999997,74877.09000000001,-7353.620000000039
4270,2022-02-09 12:50:00,-1080.13,66443.33999999997,74877.09000000001,-8433.750000000044
4271,2022-02-09 12:55:00,1517.98,67961.31999999996,74877.09000000001,-6915.770000000048
4272,2022-02-09 13:00:00,1142.1,69103.41999999997,74877.09000000001,-5773.670000000042
4273,2022-02-09 13:05:00,-1606.05,67497.36999999997,74877.09000000001,-7379.720000000045
4274,2022-02-09 13:10:00,1596.46,69093.82999999997,74877.09000000001,-5783.260000000038
4275,2022-02-09 13:15:00,-1303.73,67790.09999999998,74877.09000000001,-7086.990000000034
4276,2022-02-09 13:20:00,-294.68,67495.41999999998,74877.09000000001,-7381.670000000027
4277,2022-02-09 13:25:00,-659.0,66836.41999999998,74877.09000000001,-8040.670000000027
4278,2022-02-09 13:30:00,-1722.54,65113.87999999998,74877.09000000001,-9763.210000000028
4279,2022-02-09 13:35:00,-269.37,64844.50999999998,74877.09000000001,-10032.58000000003
4280,2022-02-09 13:40:00,-826.97,64017.53999999998,74877.09000000001,-10859.550000000032
4281,2022-02-09 13:45:00,1778.7,65796.23999999998,74877.09000000001,-9080.850000000035
4282,2022-02-09 13:50:00,-1413.77,64382.46999999998,74877.09000000001,-10494.620000000032
4283,2022-02-09 13:55:00,687.13,65069.59999999998,74877.09000000001,-9807.490000000034
4284,2022-02-09 14:00:00,201.17,65270.769999999975,74877.09000000001,-9606.320000000036
4285,2022-02-09 14:05:00,529.85,65800.61999999998,74877.09000000001,-9076.47000000003
4286,2022-02-09 14:10:00,-1016.69,64783.92999999998,74877.09000000001,-10093.160000000033
4287,2022-02-09 14:15:00,1883.24,66667.16999999998,74877.09000000001,-8209.920000000027
4288,2022-02-09 14:20:00,-1419.1,65248.069999999985,74877.09000000001,-9629.020000000026
4289,2022-02-09 14:25:00,1195.51,66443.57999999999,74877.09000000001,-8433.510000000024
4290,2022-02-09 14:30:00,-1342.18,65101.39999999999,74877.09000000001,-9775.690000000024
4291,2022-02-09 14:35:00,651.56,65752.95999999999,74877.09000000001,-9124.13000000002
4292,2022-02-09 14:40:00,1809.88,67562.84,74877.09000000001,-7314.250000000015
4293,2022-02-09 14:45:00,-387.6,67175.23999999999,74877.09000000001,-7701.85000000002
4294,2022-02-09 14:50:00,1993.44,69168.68,74877.09000000001,-5708.410000000018
4295,2022-02-09 14:55:00,-1113.8,68054.87999999999,74877.09000000001,-6822.210000000021
4296,2022-02-09 15:00:00,514.93,68569.80999999998,74877.09000000001,-6307.280000000028
4297,2022-02-09 15:05:00,-649.19,67920.61999999998,74877.09000000001,-6956.47000000003
4298,2022-02-09 15:10:00,-860.57,67060.04999999997,74877.09000000001,-7817.040000000037
4299,2022-02-09 15:15:00,927.81,67987.85999999997,74877.09000000001,-6889.23000000004
4300,2022-02-09 15:20:00,1564.98,69552.83999999997,74877.09000000001,-5324.250000000044
4301,2022-02-09 15:25:00,448.29,70001.12999999996,74877.09000000001,-4875.96000000005
4302,2022-02-09 15:30:00,926.64,70927.76999999996,74877.09000000001,-3949.3200000000506
4303,2022-02-09 15:35:00,-1542.83,69384.93999999996,74877.09000000001,-5492.150000000052
4304,2022-02-09 15:40:00,1585.79,70970.72999999995,74877.09000000001,-3906.360000000059
4305,2022-02-09 15:45:00,1158.13,72128.85999999996,74877.09000000001,-2748.230000000054
4306,2022-02-09 15:50:00,1972.78,74101.63999999996,74877.09000000001,-775.4500000000553
4307,2022-02-09 15:55:00,405.66,74507.29999999996,74877.09000000001,-369.7900000000518
4308,2022-02-09 16:00:00,-1303.68,73203.61999999997,74877.09000000001,-1673.4700000000448
4309,2022-02-09 16:05:00,921.79,74125.40999999996,74877.09000000001,-751.6800000000512
4310,2022-02-09 16:10:00,-1733.21,72392.19999999995,74877.09000000001,-2484.8900000000576
4311,2022-02-09 16:15:00,-1711.26,70680.93999999996,74877.09000000001,-4196.150000000052
4312,2022-02-09 16:20:00,-1810.17,68870.76999999996,74877.09000000001,-6006.320000000051
4313,2022-02-09 16:25:00,-592.57,68278.19999999995,74877.09000000001,-6598.890000000058
4314,2022-02-09 16:30:00,-1247.28,67030.91999999995,74877.09000000001,-7846.1700000000565
4315,2022-02-09 16:35:00,-958.04,66072.87999999996,74877.09000000001,-8804.21000000005
4316,2022-02-09 16:40:00,1879.22,67952.09999999996,74877.09000000001,-6924.990000000049
4317,2022-02-09 16:45:00,-1019.49,66932.60999999996,74877.09000000001,-7944.480000000054
4318,2022-02-09 16:50:00,-1495.65,65436.959999999955,74877.09000000001,-9440.130000000056
4319,2022-02-09 16:55:00,1172.25,66609.20999999996,74877.09000000001,-8267.880000000048
4320,2022-02-10 08:00:00,-877.45,65731.75999999997,66609.20999999996,-877.4499999999971
4321,2022-02-10 08:05:00,506.69,66238.44999999997,66609.20999999996,-370.75999999999476
4322,2022-02-10 08:10:00,136.19,66374.63999999997,66609.20999999996,-234.56999999999243
4323,2022-02-10 08:15:00,-697.5,65677.13999999997,66609.20999999996,-932.0699999999924
4324,2022-02-10 08:20:00,411.09,66088.22999999997,66609.20999999996,-520.9799999999959
4325,2022-02-10 08:25:00,1860.53,67948.75999999997,66609.20999999996,1339.550000000003
4326,2022-02-10 08:30:00,-775.39,67173.36999999997,66609.20999999996,564.1600000000035
4327,2022-02-10 08:35:00,-1054.94,66118.42999999996,66609.20999999996,-490.77999999999884
4328,2022-02-10 08:40:00,-1225.68,64892.74999999996,66609.20999999996,-1716.4599999999991
4329,2022-02-10 08:45:00,449.58,65342.329999999965,66609.20999999996,-1266.8799999999974
4330,2022-02-10 08:50:00,-406.2,64936.12999999997,66609.20999999996,-1673.0799999999945
4331,2022-02-10 08:55:00,1295.52,66231.64999999997,66609.20999999996,-377.5599999999977
4332,2022-02-10 09:00:00,1221.75,67453.39999999997,66609.20999999996,844.1900000000023
4333,2022-02-10 09:05:00,1918.03,69371.42999999996,66609.20999999996,2762.220000000001
4334,2022-02-10 09:10:00,-514.42,68857.00999999997,66609.20999999996,2247.800000000003
4335,2022-02-10 09:15:00,431.1,69288.10999999997,66609.20999999996,2678.9000000000087
4336,2022-02-10 09:20:00,-1963.92,67324.18999999997,66609.20999999996,714.9800000000105
4337,2022-02-10 09:25:00,1779.43,69103.61999999997,66609.20999999996,2494.4100000000035
4338,2022-02-10 09:30:00,-832.97,68270.64999999997,66609.20999999996,1661.4400000000023
4339,2022-02-10 09:35:00,210.3,68480.94999999997,66609.20999999996,1871.7400000000052
4340,2022-02-10 09:40:00,-409.56,68071.38999999997,66609.20999999996,1462.1800000000076
4341,2022-02-10 09:45:00,-593.7,67477.68999999997,66609.20999999996,868.4800000000105
4342,2022-02-10 09:50:00,-1128.11,66349.57999999997,66609.20999999996,-259.6299999999901
4343,2022-02-10 09:55:00,1038.83,67388.40999999997,66609.20999999996,779.2000000000116
4344,2022-02-10 10:00:00,1926.09,69314.49999999997,66609.20999999996,2705.290000000008
4345,2022-02-10 10:05:00,-705.47,68609.02999999997,66609.20999999996,1999.820000000007
4346,2022-02-10 10:10:00,94.66,68703.68999999997,66609.20999999996,2094.4800000000105
4347,2022-02-10 10:15:00,1361.54,70065.22999999997,66609.20999999996,3456.020000000004
4348,2022-02-10 10:20:00,-1809.59,68255.63999999997,66609.20999999996,1646.4300000000076
4349,2022-02-10 10:25:00,827.5,69083.13999999997,66609.20999999996,2473.9300000000076
4350,2022-02-10 10:30:00,-1610.21,67472.92999999996,66609.20999999996,863.7200000000012
4351,2022-02-10 10:35:00,-1960.97,65511.95999999996,66609.20999999996,-1097.25
4352,2022-02-10 10:40:00,161.45,65673.40999999996,66609.20999999996,-935.8000000000029
4353,2022-02-10 10:45:00,-654.56,65018.84999999996,66609.20999999996,-1590.3600000000006
4354,2022-02-10 10:50:00,-400.01,64618.83999999996,66609.20999999996,-1990.3700000000026
4355,2022-02-10 10:55:00,-1406.99,63211.84999999996,66609.20999999996,-3397.3600000000006
4356,2022-02-10 11:00:00,813.45,64025.29999999996,66609.20999999996,-2583.9100000000035
4357,2022-02-10 11:05:00,-1809.6,62215.69999999996,66609.20999999996,-4393.510000000002
4358,2022-02-10 11:10:00,-1219.22,60996.47999999996,66609.20999999996,-5612.730000000003
4359,2022-02-10 11:15:00,-1087.41,59909.069999999956,66609.20999999996,-6700.140000000007
4360,2022-02-10 11:20:00,-1850.58,58058.489999999954,66609.20999999996,-8550.720000000008
4361,2022-02-10 11:25:00,-1284.52,56773.96999999996,66609.20999999996,-9835.240000000005
4362,2022-02-10 11:30:00,1209.12,57983.08999999996,66609.20999999996,-8626.120000000003
4363,2022-02-10 11:35:00,-1272.44,56710.64999999996,66609.20999999996,-9898.560000000005
4364,2022-02-10 11:40:00,-1854.88,54855.76999999996,66609.20999999996,-11753.440000000002
4365,2022-02-10 11:45:00,1173.9,56029.66999999996,66609.20999999996,-10579.54
4366,2022-02-10 11:50:00,-1882.95,54146.719999999965,66609.20999999996,-12462.489999999998
4367,2022-02-10 11:55:00,1860.86,56007.579999999965,66609.20999999996,-10601.629999999997
4368,2022-02-10 12:00:00,1173.47,57181.04999999997,66609.20999999996,-9428.159999999996
4369,2022-02-10 12:05:00,-658.73,56522.31999999996,66609.20999999996,-10086.89
4370,2022-02-10 12:10:00,-384.74,56137.579999999965,66609.20999999996,-10471.629999999997
4371,2022-02-10 12:15:00,-544.96,55592.619999999966,66609.20999999996,-11016.589999999997
4372,2022-02-10 12:20:00,84.17,55676.789999999964,66609.20999999996,-10932.419999999998
4373,2022-02-10 12:25:00,-215.73,55461.05999999996,66609.20999999996,-11148.150000000001
4374,2022-02-10 12:30:00,1838.02,57299.07999999996,66609.20999999996,-9310.130000000005
4375,2022-02-10 12:35:00,123.39,57422.46999999996,66609.20999999996,-9186.740000000005
4376,2022-02-10 12:40:00,1592.99,59015.459999999955,66609.20999999996,-7593.750000000007
4377,2022-02-10 12:45:00,-1490.36,57525.099999999955,66609.20999999996,-9084.110000000008
4378,2022-02-10 12:50:00,-87.81,57437.28999999996,66609.20999999996,-9171.920000000006
4379,2022-02-10 12:55:00,-445.86,56991.42999999996,66609.20999999996,-9617.780000000006
4380,2022-02-10 13:00:00,-216.38,56775.04999999996,66609.20999999996,-9834.160000000003
4381,2022-02-10 13:05:00,404.45,57179.499999999956,66609.20999999996,-9429.710000000006
4382,2022-02-10 13:10:00,1647.38,58826.879999999954,66609.20999999996,-7782.330000000009
4383,2022-02-10 13:15:00,1027.24,59854.11999999995,66609.20999999996,-6755.090000000011
4384,2022-02-10 13:20:00,-109.05,59745.06999999995,66609.20999999996,-6864.140000000014
4385,2022-02-10 13:25:00,548.06,60293.12999999995,66609.20999999996,-6316.080000000016
4386,2022-02-10 13:30:00,-1527.97,58765.159999999945,66609.20999999996,-7844.0500000000175
4387,2022-02-10 13:35:00,79.99,58845.14999999994,66609.20999999996,-7764.0600000000195
4388,2022-02-10 13:40:00,1152.45,59997.59999999994,66609.20999999996,-6611.610000000022
4389,2022-02-10 13:45:00,-378.59,59619.009999999944,66609.20999999996,-6990.200000000019
4390,2022-02-10 13:50:00,-1611.23,58007.77999999994,66609.20999999996,-8601.430000000022
4391,2022-02-10 13:55:00,-1371.51,56636.26999999994,66609.20999999996,-9972.940000000024
4392,2022-02-10 14:00:00,1415.11,58051.37999999994,66609.20999999996,-8557.830000000024
4393,2022-02-10 14:05:00,-1018.78,57032.59999999994,66609.20999999996,-9576.610000000022
4394,2022-02-10 14:10:00,-1793.48,55239.11999999994,66609.20999999996,-11370.090000000026
4395,2022-02-10 14:15:00,216.55,55455.66999999994,66609.20999999996,-11153.540000000023
4396,2022-02-10 14:20:00,-1272.86,54182.80999999994,66609.20999999996,-12426.400000000023
4397,2022-02-10 14:25:00,-306.45,53876.35999999994,66609.20999999996,-12732.85000000002
4398,2022-02-10 14:30:00,-16.07,53860.28999999994,66609.20999999996,-12748.92000000002
4399,2022-02-10 14:35:00,-1587.92,52272.369999999944,66609.20999999996,-14336.840000000018
4400,2022-02-10 14:40:00,-350.47,51921.89999999994,66609.20999999996,-14687.31000000002
4401,2022-02-10 14:45:00,-1011.45,50910.449999999946,66609.20999999996,-15698.760000000017
4402,2022-02-10 14:50:00,1854.68,52765.12999999995,66609.20999999996,-13844.080000000016
4403,2022-02-10 14:55:00,-1099.44,51665.689999999944,66609.20999999996,-14943.520000000019
4404,2022-02-10 15:00:00,847.2,52512.88999999994,66609.20999999996,-14096.320000000022
4405,2022-02-10 15:05:00,316.64,52829.52999999994,66609.20999999996,-13779.680000000022
4406,2022-02-10 15:10:00,-1752.85,51076.67999999994,66609.20999999996,-15532.53000000002
4407,2022-02-10 15:15:00,1299.12,52375.799999999945,66609.20999999996,-14233.410000000018
4408,2022-02-10 15:20:00,586.03,52961.82999999994,66609.20999999996,-13647.38000000002
4409,2022-02-10 15:25:00,1983.42,54945.24999999994,66609.20999999996,-11663.960000000021
4410,2022-02-10 15:30:00,-620.21,54325.03999999994,66609.20999999996,-12284.17000000002
4411,2022-02-10 15:35:00,-1183.79,53141.24999999994,66609.20999999996,-13467.960000000021
4412,2022-02-10 15:40:00,-1781.2,51360.049999999945,66609.20999999996,-15249.160000000018
4413,2022-02-10 15:45:00,319.71,51679.759999999944,66609.20999999996,-14929.450000000019
4414,2022-02-10 15:50:00,1101.81,52781.56999999994,66609.20999999996,-13827.640000000021
4415,2022-02-10 15:55:00,-1556.46,51225.10999999994,66609.20999999996,-15384.10000000002
4416,2022-02-10 16:00:00,-1532.01,49693.09999999994,66609.20999999996,-16916.110000000022
4417,2022-02-10 16:05:00,-1178.93,48514.16999999994,66609.20999999996,-18095.040000000023
4418,2022-02-10 16:10:00,1376.69,49890.85999999994,66609.20999999996,-16718.35000000002
4419,2022-02-10 16:15:00,-263.37,49627.48999999994,66609.20999999996,-16981.720000000023
4420,2022-02-10 16:20:00,-432.02,49195.46999999994,66609.20999999996,-17413.74000000002
4421,2022-02-10 16:25:00,1429.98,50625.449999999946,66609.20999999996,-15983.760000000017
4422,2022-02-10 16:30:00,-141.56,50483.88999999995,66609.20999999996,-16125.320000000014
4423,2022-02-10 16:35:00,319.28,50803.16999999995,66609.20999999996,-15806.040000000015
4424,2022-02-10 16:40:00,225.88,51029.049999999945,66609.20999999996,-15580.160000000018
4425,2022-02-10 16:45:00,-701.95,50327.09999999995,66609.20999999996,-16282.110000000015
4426,2022-02-10 16:50:00,-466.99,49860.10999999995,66609.20999999996,-16749.100000000013
4427,2022-02-10 16:55:00,-93.24,49766.86999999995,66609.20999999996,-16842.34000000001
4428,2022-02-11 08:00:00,1637.09,51403.95999999995,49766.86999999995,1637.0899999999965
4429,2022-02-11 08:05:00,-840.58,50563.37999999995,49766.86999999995,796.5099999999948
4430,2022-02-11 08:10:00,-43.12,50520.259999999944,49766.86999999995,753.3899999999921
4431,2022-02-11 08:15:00,1242.6,51762.85999999994,49766.86999999995,1995.9899999999907
4432,2022-02-11 08:20:00,1025.97,52788.82999999994,49766.86999999995,3021.959999999992
4433,2022-02-11 08:25:00,1858.25,54647.07999999994,49766.86999999995,4880.209999999992
4434,2022-02-11 08:30:00,1354.81,56001.88999999994,49766.86999999995,6235.0199999999895
4435,2022-02-11 08:35:00,1883.23,57885.119999999944,49766.86999999995,8118.249999999993
4436,2022-02-11 08:40:00,-734.77,57150.34999999995,49766.86999999995,7383.479999999996
4437,2022-02-11 08:45:00,-451.03,56699.31999999995,49766.86999999995,6932.449999999997
4438,2022-02-11 08:50:00,-1433.84,55265.47999999995,49766.86999999995,5498.610000000001
4439,2022-02-11 08:55:00,386.57,55652.04999999995,49766.86999999995,5885.18
4440,2022-02-11 09:00:00,-241.6,55410.44999999995,49766.86999999995,5643.580000000002
4441,2022-02-11 09:05:00,648.47,56058.919999999955,49766.86999999995,6292.050000000003
4442,2022-02-11 09:10:00,-1928.84,54130.07999999996,49766.86999999995,4363.210000000006
4443,2022-02-11 09:15:00,443.16,54573.23999999996,49766.86999999995,4806.37000000001
4444,2022-02-11 09:20:00,1801.8,56375.039999999964,49766.86999999995,6608.170000000013
4445,2022-02-11 09:25:00,-309.18,56065.859999999964,49766.86999999995,6298.9900000000125
4446,2022-02-11 09:30:00,-788.26,55277.59999999996,49766.86999999995,5510.7300000000105
4447,2022-02-11 09:35:00,742.49,56020.08999999996,49766.86999999995,6253.220000000008
4448,2022-02-11 09:40:00,886.09,56906.17999999996,49766.86999999995,7139.310000000005
4449,2022-02-11 09:45:00,-534.15,56372.029999999955,49766.86999999995,6605.1600000000035
4450,2022-02-11 09:50:00,-65.0,56307.029999999955,49766.86999999995,6540.1600000000035
4451,2022-02-11 09:55:00,-1289.05,55017.97999999995,49766.86999999995,5251.110000000001
4452,2022-02-11 10:00:00,656.37,55674.349999999955,49766.86999999995,5907.480000000003
4453,2022-02-11 10:05:00,546.82,56221.169999999955,49766.86999999995,6454.300000000003
4454,2022-02-11 10:10:00,424.78,56645.94999999995,49766.86999999995,6879.080000000002
4455,2022-02-11 10:15:00,-540.7,56105.249999999956,49766.86999999995,6338.380000000005
4456,2022-02-11 10:20:00,-1184.12,54921.129999999954,49766.86999999995,5154.260000000002
4457,2022-02-11 10:25:00,-186.64,54734.489999999954,49766.86999999995,4967.620000000003
4458,2022-02-11 10:30:00,495.22,55229.709999999955,49766.86999999995,5462.840000000004
4459,2022-02-11 10:35:00,330.31,55560.01999999995,49766.86999999995,5793.1500000000015
4460,2022-02-11 10:40:00,-275.32,55284.69999999995,49766.86999999995,5517.830000000002
4461,2022-02-11 10:45:00,-1977.88,53306.819999999956,49766.86999999995,3539.9500000000044
4462,2022-02-11 10:50:00,1296.59,54603.40999999995,49766.86999999995,4836.540000000001
4463,2022-02-11 10:55:00,-151.61,54451.79999999995,49766.86999999995,4684.93
4464,2022-02-11 11:00:00,-1273.63,53178.169999999955,49766.86999999995,3411.300000000003
4465,2022-02-11 11:05:00,145.43,53323.599999999955,49766.86999999995,3556.730000000003
4466,2022-02-11 11:10:00,-1885.45,51438.14999999996,49766.86999999995,1671.280000000006
4467,2022-02-11 11:15:00,-597.76,50840.389999999956,49766.86999999995,1073.520000000004
4468,2022-02-11 11:20:00,1527.33,52367.71999999996,49766.86999999995,2600.850000000006
4469,2022-02-11 11:25:00,-1387.89,50979.82999999996,49766.86999999995,1212.9600000000064
4470,2022-02-11 11:30:00,1511.29,52491.11999999996,49766.86999999995,2724.2500000000073
4471,2022-02-11 11:35:00,734.4,53225.51999999996,49766.86999999995,3458.6500000000087
4472,2022-02-11 11:40:00,-986.65,52238.86999999996,49766.86999999995,2472.0000000000073
4473,2022-02-11 11:45:00,651.33,52890.19999999996,49766.86999999995,3123.330000000009
4474,2022-02-11 11:50:00,-1120.39,51769.80999999996,49766.86999999995,2002.9400000000096
4475,2022-02-11 11:55:00,1849.33,53619.13999999996,49766.86999999995,3852.2700000000114
4476,2022-02-11 12:00:00,837.94,54457.079999999965,49766.86999999995,4690.210000000014
4477,2022-02-11 12:05:00,-20.05,54437.02999999996,49766.86999999995,4670.160000000011
4478,2022-02-11 12:10:00,1138.24,55575.26999999996,49766.86999999995,5808.400000000009
4479,2022-02-11 12:15:00,-457.5,55117.76999999996,49766.86999999995,5350.900000000009
4480,2022-02-11 12:20:00,1607.89,56725.65999999996,49766.86999999995,6958.790000000008
4481,2022-02-11 12:25:00,1317.46,58043.11999999996,49766.86999999995,8276.250000000007
4482,2022-02-11 12:30:00,-1410.79,56632.32999999996,49766.86999999995,6865.460000000006
4483,2022-02-11 12:35:00,-1888.03,54744.29999999996,49766.86999999995,4977.430000000008
4484,2022-02-11 12:40:00,-624.3,54119.999999999956,49766.86999999995,4353.130000000005
4485,2022-02-11 12:45:00,849.58,54969.57999999996,49766.86999999995,5202.710000000006
4486,2022-02-11 12:50:00,-989.65,53979.92999999996,49766.86999999995,4213.060000000005
4487,2022-02-11 12:55:00,1024.19,55004.11999999996,49766.86999999995,5237.250000000007
4488,2022-02-11 13:00:00,104.06,55108.17999999996,49766.86999999995,5341.310000000005
4489,2022-02-11 13:05:00,1049.21,56157.389999999956,49766.86999999995,6390.520000000004
4490,2022-02-11 13:10:00,-1245.16,54912.22999999995,49766.86999999995,5145.360000000001
4491,2022-02-11 13:15:00,439.89,55352.11999999995,49766.86999999995,5585.25
4492,2022-02-11 13:20:00,381.47,55733.58999999995,49766.86999999995,5966.720000000001
4493,2022-02-11 13:25:00,-930.83,54802.75999999995,49766.86999999995,5035.889999999999
4494,2022-02-11 13:30:00,-481.66,54321.09999999995,49766.86999999995,4554.229999999996
4495,2022-02-11 13:35:00,1949.3,56270.39999999995,49766.86999999995,6503.529999999999
4496,2022-02-11 13:40:00,826.45,57096.84999999995,49766.86999999995,7329.979999999996
4497,2022-02-11 13:45:00,758.85,57855.699999999946,49766.86999999995,8088.8299999999945
4498,2022-02-11 13:50:00,-869.04,56986.659999999945,49766.86999999995,7219.789999999994
4499,2022-02-11 13:55:00,731.78,57718.439999999944,49766.86999999995,7951.569999999992
4500,2022-02-11 14:00:00,230.78,57949.21999999994,49766.86999999995,8182.349999999991
4501,2022-02-11 14:05:00,1463.87,59413.089999999946,49766.86999999995,9646.219999999994
4502,2022-02-11 14:10:00,1248.09,60661.17999999994,49766.86999999995,10894.30999999999
4503,2022-02-11 14:15:00,1959.19,62620.369999999944,49766.86999999995,12853.499999999993
4504,2022-02-11 14:20:00,-249.56,62370.80999999995,49766.86999999995,12603.939999999995
4505,2022-02-11 14:25:00,-1243.27,61127.53999999995,49766.86999999995,11360.669999999998
4506,2022-02-11 14:30:00,104.21,61231.74999999995,49766.86999999995,11464.879999999997
4507,2022-02-11 14:35:00,1172.89,62404.63999999995,49766.86999999995,12637.769999999997
4508,2022-02-11 14:40:00,-70.64,62333.99999999995,49766.86999999995,12567.129999999997
4509,2022-02-11 14:45:00,-1598.85,60735.14999999995,49766.86999999995,10968.279999999999
4510,2022-02-11 14:50:00,649.27,61384.41999999995,49766.86999999995,11617.549999999996
4511,2022-02-11 14:55:00,1106.45,62490.869999999944,49766.86999999995,12723.999999999993
4512,2022-02-11 15:00:00,-1467.82,61023.049999999945,49766.86999999995,11256.179999999993
4513,2022-02-11 15:05:00,288.26,61311.30999999995,49766.86999999995,11544.439999999995
4514,2022-02-11 15:10:00,-1318.15,59993.159999999945,49766.86999999995,10226.289999999994
4515,2022-02-11 15:15:00,-1851.83,58141.32999999994,49766.86999999995,8374.459999999992
4516,2022-02-11 15:20:00,-345.14,57796.189999999944,49766.86999999995,8029.319999999992
4517,2022-02-11 15:25:00,-118.66,57677.52999999994,49766.86999999995,7910.659999999989
4518,2022-02-11 15:30:00,1614.98,59292.509999999944,49766.86999999995,9525.639999999992
4519,2022-02-11 15:35:00,-932.04,58360.46999999994,49766.86999999995,8593.599999999991
4520,2022-02-11 15:40:00,-1118.92,57241.549999999945,49766.86999999995,7474.679999999993
4521,2022-02-11 15:45:00,-378.0,56863.549999999945,49766.86999999995,7096.679999999993
4522,2022-02-11 15:50:00,-1406.39,55457.159999999945,49766.86999999995,5690.289999999994
4523,2022-02-11 15:55:00,-564.83,54892.32999999994,49766.86999999995,5125.459999999992
4524,2022-02-11 16:00:00,-415.16,54477.16999999994,49766.86999999995,4710.299999999988
4525,2022-02-11 16:05:00,1538.46,56015.62999999994,49766.86999999995,6248.7599999999875
4526,2022-02-11 16:10:00,-1787.1,54228.52999999994,49766.86999999995,4461.659999999989
4527,2022-02-11 16:15:00,-627.02,53601.509999999944,49766.86999999995,3834.639999999992
4528,2022-02-11 16:20:00,1647.62,55249.12999999995,49766.86999999995,5482.259999999995
4529,2022-02-11 16:25:00,-118.7,55130.42999999995,49766.86999999995,5363.559999999998
4530,2022-02-11 16:30:00,-811.58,54318.84999999995,49766.86999999995,4551.979999999996
4531,2022-02-11 16:35:00,1253.99,55572.839999999946,49766.86999999995,5805.969999999994
4532,2022-02-11 16:40:00,-1186.66,54386.17999999994,49766.86999999995,4619.30999999999
4533,2022-02-11 16:45:00,-1551.29,52834.88999999994,49766.86999999995,3068.0199999999895
4534,2022-02-11 16:50:00,633.82,53468.70999999994,49766.86999999995,3701.8399999999892
4535,2022-02-11 16:55:00,1908.26,55376.96999999994,49766.86999999995,5610.099999999991
4536,2022-02-12 08:00:00,-732.08,54644.88999999994,55376.96999999994,-732.0800000000017
4537,2022-02-12 08:05:00,1916.96,56561.84999999994,55376.96999999994,1184.8799999999974
4538,2022-02-12 08:10:00,-1301.88,55259.96999999994,55376.96999999994,-117.0
4539,2022-02-12 08:15:00,-219.63,55040.339999999946,55376.96999999994,-336.6299999999974
4540,2022-02-12 08:20:00,-523.31,54517.02999999995,55376.96999999994,-859.939999999995
4541,2022-02-12 08:25:00,-845.22,53671.80999999995,55376.96999999994,-1705.1599999999962
4542,2022-02-12 08:30:00,1106.83,54778.63999999995,55376.96999999994,-598.3299999999945
4543,2022-02-12 08:35:00,104.68,54883.31999999995,55376.96999999994,-493.6499999999942
4544,2022-02-12 08:40:00,-1064.11,53819.20999999995,55376.96999999994,-1557.7599999999948
4545,2022-02-12 08:45:00,1445.6,55264.80999999995,55376.96999999994,-112.15999999999622
4546,2022-02-12 08:50:00,-1717.64,53547.16999999995,55376.96999999994,-1829.7999999999956
4547,2022-02-12 08:55:00,-848.94,52698.229999999945,55376.96999999994,-2678.739999999998
4548,2022-02-12 09:00:00,1180.57,53878.799999999945,55376.96999999994,-1498.1699999999983
4549,2022-02-12 09:05:00,728.31,54607.10999999994,55376.96999999994,-769.8600000000006
4550,2022-02-12 09:10:00,1342.29,55949.39999999994,55376.96999999994,572.4300000000003
4551,2022-02-12 09:15:00,659.9,56609.299999999945,55376.96999999994,1232.3300000000017
4552,2022-02-12 09:20:00,1034.75,57644.049999999945,55376.96999999994,2267.0800000000017
4553,2022-02-12 09:25:00,-1189.67,56454.37999999995,55376.96999999994,1077.4100000000035
4554,2022-02-12 09:30:00,867.6,57321.979999999945,55376.96999999994,1945.010000000002
4555,2022-02-12 09:35:00,-1718.89,55603.089999999946,55376.96999999994,226.12000000000262
4556,2022-02-12 09:40:00,768.66,56371.74999999995,55376.96999999994,994.7800000000061
4557,2022-02-12 09:45:00,640.96,57012.70999999995,55376.96999999994,1635.7400000000052
4558,2022-02-12 09:50:00,582.5,57595.20999999995,55376.96999999994,2218.2400000000052
4559,2022-02-12 09:55:00,-900.34,56694.86999999995,55376.96999999994,1317.9000000000087
4560,2022-02-12 10:00:00,359.86,57054.72999999995,55376.96999999994,1677.7600000000093
4561,2022-02-12 10:05:00,123.2,57177.92999999995,55376.96999999994,1800.9600000000064
4562,2022-02-12 10:10:00,1204.67,58382.59999999995,55376.96999999994,3005.6300000000047
4563,2022-02-12 10:15:00,1398.07,59780.66999999995,55376.96999999994,4403.700000000004
4564,2022-02-12 10:20:00,-1127.5,58653.16999999995,55376.96999999994,3276.2000000000044
4565,2022-02-12 10:25:00,-1961.33,56691.839999999946,55376.96999999994,1314.8700000000026
4566,2022-02-12 10:30:00,806.92,57498.759999999944,55376.96999999994,2121.790000000001
4567,2022-02-12 10:35:00,-1905.7,55593.05999999995,55376.96999999994,216.09000000000378
4568,2022-02-12 10:40:00,1478.66,57071.71999999995,55376.96999999994,1694.7500000000073
4569,2022-02-12 10:45:00,-1459.33,55612.38999999995,55376.96999999994,235.42000000000553
4570,2022-02-12 10:50:00,-294.12,55318.269999999946,55376.96999999994,-58.69999999999709
4571,2022-02-12 10:55:00,-1275.11,54043.159999999945,55376.96999999994,-1333.8099999999977
4572,2022-02-12 11:00:00,1109.6,55152.759999999944,55376.96999999994,-224.20999999999913
4573,2022-02-12 11:05:00,451.49,55604.24999999994,55376.96999999994,227.27999999999884
4574,2022-02-12 11:10:00,1526.48,57130.729999999945,55376.96999999994,1753.760000000002
4575,2022-02-12 11:15:00,58.97,57189.699999999946,55376.96999999994,1812.7300000000032
4576,2022-02-12 11:20:00,-128.73,57060.96999999994,55376.96999999994,1684.0
4577,2022-02-12 11:25:00,-940.99,56119.979999999945,55376.96999999994,743.010000000002
4578,2022-02-12 11:30:00,915.37,57035.34999999995,55376.96999999994,1658.3800000000047
4579,2022-02-12 11:35:00,-1197.95,55837.39999999995,55376.96999999994,460.43000000000757
4580,2022-02-12 11:40:00,-1952.95,53884.44999999995,55376.96999999994,-1492.5199999999895
4581,2022-02-12 11:45:00,1588.49,55472.93999999995,55376.96999999994,95.97000000000844
4582,2022-02-12 11:50:00,635.37,56108.309999999954,55376.96999999994,731.3400000000111
4583,2022-02-12 11:55:00,1245.23,57353.53999999996,55376.96999999994,1976.5700000000143
4584,2022-02-12 12:00:00,-1173.23,56180.309999999954,55376.96999999994,803.3400000000111
4585,2022-02-12 12:05:00,1432.8,57613.10999999996,55376.96999999994,2236.140000000014
4586,2022-02-12 12:10:00,-1208.6,56404.50999999996,55376.96999999994,1027.5400000000154
4587,2022-02-12 12:15:00,1074.25,57478.75999999996,55376.96999999994,2101.7900000000154
4588,2022-02-12 12:20:00,-772.79,56705.96999999996,55376.96999999994,1329.0000000000146
4589,2022-02-12 12:25:00,-449.29,56256.67999999996,55376.96999999994,879.7100000000137
4590,2022-02-12 12:30:00,531.12,56787.79999999996,55376.96999999994,1410.8300000000163
4591,2022-02-12 12:35:00,-159.49,56628.30999999996,55376.96999999994,1251.3400000000183
4592,2022-02-12 12:40:00,-182.43,56445.87999999996,55376.96999999994,1068.910000000018
4593,2022-02-12 12:45:00,960.57,57406.44999999996,55376.96999999994,2029.4800000000178
4594,2022-02-12 12:50:00,95.24,57501.68999999996,55376.96999999994,2124.7200000000157
4595,2022-02-12 12:55:00,1127.63,58629.319999999956,55376.96999999994,3252.350000000013
4596,2022-02-12 13:00:00,-92.08,58537.239999999954,55376.96999999994,3160.2700000000114
4597,2022-02-12 13:05:00,-1773.57,56763.669999999955,55376.96999999994,1386.7000000000116
4598,2022-02-12 13:10:00,17.15,56780.819999999956,55376.96999999994,1403.850000000013
4599,2022-02-12 13:15:00,1437.19,58218.00999999996,55376.96999999994,2841.0400000000154
4600,2022-02-12 13:20:00,1565.97,59783.97999999996,55376.96999999994,4407.010000000017
4601,2022-02-12 13:25:00,-523.31,59260.66999999996,55376.96999999994,3883.700000000019
4602,2022-02-12 13:30:00,1487.66,60748.329999999965,55376.96999999994,5371.360000000022
4603,2022-02-12 13:35:00,-1317.27,59431.05999999997,55376.96999999994,4054.0900000000256
4604,2022-02-12 13:40:00,-254.77,59176.28999999997,55376.96999999994,3799.320000000029
4605,2022-02-12 13:45:00,209.5,59385.78999999997,55376.96999999994,4008.820000000029
4606,2022-02-12 13:50:00,633.63,60019.41999999997,55376.96999999994,4642.450000000026
4607,2022-02-12 13:55:00,-495.88,59523.53999999997,55376.96999999994,4146.570000000029
4608,2022-02-12 14:00:00,-1268.33,58255.20999999997,55376.96999999994,2878.240000000027
4609,2022-02-12 14:05:00,675.73,58930.93999999997,55376.96999999994,3553.9700000000303
4610,2022-02-12 14:10:00,-1276.92,57654.019999999975,55376.96999999994,2277.050000000032
4611,2022-02-12 14:15:00,891.05,58545.06999999998,55376.96999999994,3168.100000000035
4612,2022-02-12 14:20:00,844.08,59389.14999999998,55376.96999999994,4012.1800000000367
4613,2022-02-12 14:25:00,330.34,59719.489999999976,55376.96999999994,4342.520000000033
4614,2022-02-12 14:30:00,-501.91,59217.57999999997,55376.96999999994,3840.6100000000297
4615,2022-02-12 14:35:00,593.04,59810.61999999997,55376.96999999994,4433.650000000031
4616,2022-02-12 14:40:00,764.03,60574.64999999997,55376.96999999994,5197.680000000029
4617,2022-02-12 14:45:00,649.45,61224.09999999997,55376.96999999994,5847.1300000000265
4618,2022-02-12 14:50:00,-549.06,60675.03999999997,55376.96999999994,5298.070000000029
4619,2022-02-12 14:55:00,1110.67,61785.70999999997,55376.96999999994,6408.740000000027
4620,2022-02-12 15:00:00,-1100.03,60685.67999999997,55376.96999999994,5308.710000000028
4621,2022-02-12 15:05:00,314.15,60999.82999999997,55376.96999999994,5622.86000000003
4622,2022-02-12 15:10:00,-1160.34,59839.489999999976,55376.96999999994,4462.520000000033
4623,2022-02-12 15:15:00,-1060.25,58779.239999999976,55376.96999999994,3402.270000000033
4624,2022-02-12 15:20:00,-911.28,57867.95999999998,55376.96999999994,2490.9900000000343
4625,2022-02-12 15:25:00,1429.77,59297.729999999974,55376.96999999994,3920.760000000031
4626,2022-02-12 15:30:00,-832.96,58464.769999999975,55376.96999999994,3087.800000000032
4627,2022-02-12 15:35:00,-765.47,57699.299999999974,55376.96999999994,2322.330000000031
4628,2022-02-12 15:40:00,-1146.43,56552.86999999997,55376.96999999994,1175.9000000000306
4629,2022-02-12 15:45:00,434.62,56987.489999999976,55376.96999999994,1610.5200000000332
4630,2022-02-12 15:50:00,1241.35,58228.839999999975,55376.96999999994,2851.8700000000317
4631,2022-02-12 15:55:00,1246.61,59475.449999999975,55376.96999999994,4098.480000000032
4632,2022-02-12 16:00:00,-1512.37,57963.07999999997,55376.96999999994,2586.1100000000297
4633,2022-02-12 16:05:00,-1986.61,55976.46999999997,55376.96999999994,599.5000000000291
4634,2022-02-12 16:10:00,-780.6,55195.86999999997,55376.96999999994,-181.09999999996944
4635,2022-02-12 16:15:00,-116.88,55078.989999999976,55376.96999999994,-297.9799999999668
4636,2022-02-12 16:20:00,-1253.66,53825.32999999997,55376.96999999994,-1551.6399999999703
4637,2022-02-12 16:25:00,504.21,54329.53999999997,55376.96999999994,-1047.4299999999712
4638,2022-02-12 16:30:00,1450.06,55779.59999999997,55376.96999999994,402.6300000000265
4639,2022-02-12 16:35:00,-1436.11,54343.48999999997,55376.96999999994,-1033.479999999974
4640,2022-02-12 16:40:00,1097.01,55440.49999999997,55376.96999999994,63.53000000002794
4641,2022-02-12 16:45:00,896.07,56336.56999999997,55376.96999999994,959.6000000000276
4642,2022-02-12 16:50:00,220.6,56557.16999999997,55376.96999999994,1180.2000000000262
4643,2022-02-12 16:55:00,-1598.05,54959.119999999966,55376.96999999994,-417.8499999999767
4644,2022-02-13 08:00:00,333.1,55292.219999999965,54959.119999999966,333.09999999999854
4645,2022-02-13 08:05:00,-1627.24,53664.97999999997,54959.119999999966,-1294.1399999999994
4646,2022-02-13 08:10:00,-692.77,52972.20999999997,54959.119999999966,-1986.9099999999962
4647,2022-02-13 08:15:00,599.76,53571.96999999997,54959.119999999966,-1387.1499999999942
4648,2022-02-13 08:20:00,-1548.45,52023.519999999975,54959.119999999966,-2935.5999999999913
4649,2022-02-13 08:25:00,-1667.89,50355.629999999976,54959.119999999966,-4603.489999999991
4650,2022-02-13 08:30:00,-1893.79,48461.839999999975,54959.119999999966,-6497.279999999992
4651,2022-02-13 08:35:00,-358.99,48102.84999999998,54959.119999999966,-6856.2699999999895
4652,2022-02-13 08:40:00,-24.82,48078.02999999998,54959.119999999966,-6881.089999999989
4653,2022-02-13 08:45:00,-758.78,47319.24999999998,54959.119999999966,-7639.869999999988
4654,2022-02-13 08:50:00,1211.66,48530.90999999998,54959.119999999966,-6428.209999999985
4655,2022-02-13 08:55:00,246.05,48776.959999999985,54959.119999999966,-6182.159999999982
4656,2022-02-13 09:00:00,437.36,49214.319999999985,54959.119999999966,-5744.799999999981
4657,2022-02-13 09:05:00,1823.35,51037.669999999984,54959.119999999966,-3921.4499999999825
4658,2022-02-13 09:10:00,1460.01,52497.679999999986,54959.119999999966,-2461.4399999999805
4659,2022-02-13 09:15:00,-786.79,51710.889999999985,54959.119999999966,-3248.2299999999814
4660,2022-02-13 09:20:00,921.59,52632.47999999998,54959.119999999966,-2326.639999999985
4661,2022-02-13 09:25:00,435.03,53067.50999999998,54959.119999999966,-1891.609999999986
4662,2022-02-13 09:30:00,-272.5,52795.00999999998,54959.119999999966,-2164.109999999986
4663,2022-02-13 09:35:00,-299.93,52495.07999999998,54959.119999999966,-2464.0399999999863
4664,2022-02-13 09:40:00,1990.68,54485.75999999998,54959.119999999966,-473.35999999998603
4665,2022-02-13 09:45:00,-825.29,53660.46999999998,54959.119999999966,-1298.649999999987
4666,2022-02-13 09:50:00,611.77,54272.239999999976,54959.119999999966,-686.8799999999901
4667,2022-02-13 09:55:00,1787.91,56060.14999999998,54959.119999999966,1101.0300000000134
4668,2022-02-13 10:00:00,-85.22,55974.92999999998,54959.119999999966,1015.8100000000122
4669,2022-02-13 10:05:00,1411.84,57386.769999999975,54959.119999999966,2427.6500000000087
4670,2022-02-13 10:10:00,-1858.97,55527.799999999974,54959.119999999966,568.6800000000076
4671,2022-02-13 10:15:00,-1696.31,53831.489999999976,54959.119999999966,-1127.62999999999
4672,2022-02-13 10:20:00,670.57,54502.059999999976,54959.119999999966,-457.0599999999904
4673,2022-02-13 10:25:00,984.8,55486.85999999998,54959.119999999966,527.7400000000125
4674,2022-02-13 10:30:00,-384.31,55102.54999999998,54959.119999999966,143.43000000001484
4675,2022-02-13 10:35:00,1612.49,56715.03999999998,54959.119999999966,1755.9200000000128
4676,2022-02-13 10:40:00,1069.96,57784.99999999998,54959.119999999966,2825.880000000012
4677,2022-02-13 10:45:00,-1687.45,56097.54999999998,54959.119999999966,1138.4300000000148
4678,2022-02-13 10:50:00,-1775.34,54322.209999999985,54959.119999999966,-636.9099999999817
4679,2022-02-13 10:55:00,1244.32,55566.529999999984,54959.119999999966,607.410000000018
4680,2022-02-13 11:00:00,-297.41,55269.11999999998,54959.119999999966,310.00000000001455
4681,2022-02-13 11:05:00,-1239.09,54030.029999999984,54959.119999999966,-929.089999999982
4682,2022-02-13 11:10:00,1877.14,55907.169999999984,54959.119999999966,948.0500000000175
4683,2022-02-13 11:15:00,-1726.78,54180.389999999985,54959.119999999966,-778.7299999999814
4684,2022-02-13 11:20:00,64.48,54244.86999999999,54959.119999999966,-714.2499999999782
4685,2022-02-13 11:25:00,-1766.05,52478.819999999985,54959.119999999966,-2480.299999999981
4686,2022-02-13 11:30:00,330.63,52809.44999999998,54959.119999999966,-2149.6699999999837
4687,2022-02-13 11:35:00,1589.84,54399.28999999998,54959.119999999966,-559.8299999999872
4688,2022-02-13 11:40:00,925.83,55325.11999999998,54959.119999999966,366.00000000001455
4689,2022-02-13 11:45:00,-752.24,54572.87999999998,54959.119999999966,-386.2399999999834
4690,2022-02-13 11:50:00,-1830.14,52742.73999999998,54959.119999999966,-2216.379999999983
4691,2022-02-13 11:55:00,356.82,53099.55999999998,54959.119999999966,-1859.5599999999831
4692,2022-02-13 12:00:00,1663.74,54763.29999999998,54959.119999999966,-195.81999999998516
4693,2022-02-13 12:05:00,-1316.42,53446.87999999998,54959.119999999966,-1512.2399999999834
4694,2022-02-13 12:10:00,-766.16,52680.71999999998,54959.119999999966,-2278.399999999987
4695,2022-02-13 12:15:00,1903.46,54584.17999999998,54959.119999999966,-374.9399999999878
4696,2022-02-13 12:20:00,57.48,54641.65999999998,54959.119999999966,-317.4599999999846
4697,2022-02-13 12:25:00,272.72,54914.37999999998,54959.119999999966,-44.73999999998341
4698,2022-02-13 12:30:00,-86.24,54828.139999999985,54959.119999999966,-130.97999999998137
4699,2022-02-13 12:35:00,-1385.22,53442.919999999984,54959.119999999966,-1516.1999999999825
4700,2022-02-13 12:40:00,-1051.67,52391.249999999985,54959.119999999966,-2567.869999999981
4701,2022-02-13 12:45:00,-649.74,51741.50999999999,54959.119999999966,-3217.6099999999788
4702,2022-02-13 12:50:00,-395.61,51345.89999999999,54959.119999999966,-3613.2199999999793
4703,2022-02-13 12:55:00,1537.79,52883.68999999999,54959.119999999966,-2075.4299999999785
4704,2022-02-13 13:00:00,-11.34,52872.34999999999,54959.119999999966,-2086.769999999975
4705,2022-02-13 13:05:00,-601.19,52271.15999999999,54959.119999999966,-2687.9599999999773
4706,2022-02-13 13:10:00,-1508.4,50762.75999999999,54959.119999999966,-4196.359999999979
4707,2022-02-13 13:15:00,1525.54,52288.29999999999,54959.119999999966,-2670.819999999978
4708,2022-02-13 13:20:00,-775.32,51512.97999999999,54959.119999999966,-3446.1399999999776
4709,2022-02-13 13:25:00,-1769.67,49743.30999999999,54959.119999999966,-5215.809999999976
4710,2022-02-13 13:30:00,1401.36,51144.66999999999,54959.119999999966,-3814.4499999999753
4711,2022-02-13 13:35:00,-320.51,50824.15999999999,54959.119999999966,-4134.959999999977
4712,2022-02-13 13:40:00,-790.43,50033.72999999999,54959.119999999966,-4925.389999999978
4713,2022-02-13 13:45:00,-535.55,49498.179999999986,54959.119999999966,-5460.9399999999805
4714,2022-02-13 13:50:00,500.52,49998.69999999998,54959.119999999966,-4960.419999999984
4715,2022-02-13 13:55:00,709.32,50708.01999999998,54959.119999999966,-4251.099999999984
4716,2022-02-13 14:00:00,817.03,51525.04999999998,54959.119999999966,-3434.069999999985
4717,2022-02-13 14:05:00,1789.2,53314.24999999998,54959.119999999966,-1644.869999999988
4718,2022-02-13 14:10:00,935.34,54249.589999999975,54959.119999999966,-709.5299999999916
4719,2022-02-13 14:15:00,-1601.54,52648.049999999974,54959.119999999966,-2311.0699999999924
4720,2022-02-13 14:20:00,215.37,52863.41999999998,54959.119999999966,-2095.69999999999
4721,2022-02-13 14:25:00,-761.26,52102.159999999974,54959.119999999966,-2856.959999999992
4722,2022-02-13 14:30:00,-566.12,51536.03999999997,54959.119999999966,-3423.0799999999945
4723,2022-02-13 14:35:00,534.44,52070.479999999974,54959.119999999966,-2888.639999999992
4724,2022-02-13 14:40:00,-1177.11,50893.36999999997,54959.119999999966,-4065.7499999999927
4725,2022-02-13 14:45:00,-1795.07,49098.299999999974,54959.119999999966,-5860.819999999992
4726,2022-02-13 14:50:00,-1332.83,47765.46999999997,54959.119999999966,-7193.649999999994
4727,2022-02-13 14:55:00,-732.05,47033.41999999997,54959.119999999966,-7925.699999999997
4728,2022-02-13 15:00:00,1130.29,48163.70999999997,54959.119999999966,-6795.409999999996
4729,2022-02-13 15:05:00,184.05,48347.75999999997,54959.119999999966,-6611.359999999993
4730,2022-02-13 15:10:00,372.86,48720.61999999997,54959.119999999966,-6238.499999999993
4731,2022-02-13 15:15:00,-553.41,48167.20999999997,54959.119999999966,-6791.909999999996
4732,2022-02-13 15:20:00,-197.23,47969.97999999997,54959.119999999966,-6989.139999999999
4733,2022-02-13 15:25:00,1389.84,49359.81999999996,54959.119999999966,-5599.300000000003
4734,2022-02-13 15:30:00,1617.41,50977.22999999997,54959.119999999966,-3981.8899999999994
4735,2022-02-13 15:35:00,1728.54,52705.76999999997,54959.119999999966,-2253.3499999999985
4736,2022-02-13 15:40:00,-1241.4,51464.369999999966,54959.119999999966,-3494.75
4737,2022-02-13 15:45:00,492.97,51957.33999999997,54959.119999999966,-3001.779999999999
4738,2022-02-13 15:50:00,151.36,52108.69999999997,54959.119999999966,-2850.4199999999983
4739,2022-02-13 15:55:00,1860.22,53968.91999999997,54959.119999999966,-990.1999999999971
4740,2022-02-13 16:00:00,751.71,54720.62999999997,54959.119999999966,-238.48999999999796
4741,2022-02-13 16:05:00,1949.59,56670.219999999965,54959.119999999966,1711.0999999999985
4742,2022-02-13 16:10:00,-1782.13,54888.08999999997,54959.119999999966,-71.02999999999884
4743,2022-02-13 16:15:00,1659.23,56547.31999999997,54959.119999999966,1588.2000000000044
4744,2022-02-13 16:20:00,-363.7,56183.61999999997,54959.119999999966,1224.5000000000073
4745,2022-02-13 16:25:00,713.72,56897.339999999975,54959.119999999966,1938.2200000000084
4746,2022-02-13 16:30:00,-1293.59,55603.74999999998,54959.119999999966,644.6300000000119
4747,2022-02-13 16:35:00,-508.41,55095.339999999975,54959.119999999966,136.22000000000844
4748,2022-02-13 16:40:00,-141.87,54953.46999999997,54959.119999999966,-5.649999999994179
4749,2022-02-13 16:45:00,1848.82,56802.28999999997,54959.119999999966,1843.1700000000055
4750,2022-02-13 16:50:00,-1935.28,54867.00999999997,54959.119999999966,-92.1099999999933
4751,2022-02-13 16:55:00,302.0,55169.00999999997,54959.119999999966,209.8900000000067
4752,2022-02-14 08:00:00,1427.75,56596.75999999997,55169.00999999997,1427.75
4753,2022-02-14 08:05:00,582.83,57179.589999999975,55169.00999999997,2010.5800000000017
4754,2022-02-14 08:10:00,-1541.31,55638.27999999998,55169.00999999997,469.2700000000041
4755,2022-02-14 08:15:00,844.21,56482.489999999976,55169.00999999997,1313.4800000000032
4756,2022-02-14 08:20:00,1616.28,58098.769999999975,55169.00999999997,2929.760000000002
4757,2022-02-14 08:25:00,-1414.67,56684.09999999998,55169.00999999997,1515.0900000000038
4758,2022-02-14 08:30:00,19.06,56703.159999999974,55169.00999999997,1534.1500000000015
4759,2022-02-14 08:35:00,1726.45,58429.60999999997,55169.00999999997,3260.5999999999985
4760,2022-02-14 08:40:00,131.74,58561.34999999997,55169.00999999997,3392.3399999999965
4761,2022-02-14 08:45:00,-137.35,58423.99999999997,55169.00999999997,3254.989999999998
4762,2022-02-14 08:50:00,1473.75,59897.74999999997,55169.00999999997,4728.739999999998
4763,2022-02-14 08:55:00,1750.71,61648.45999999997,55169.00999999997,6479.449999999997
4764,2022-02-14 09:00:00,-68.58,61579.87999999997,55169.00999999997,6410.869999999995
4765,2022-02-14 09:05:00,243.83,61823.70999999997,55169.00999999997,6654.699999999997
4766,2022-02-14 09:10:00,628.22,62451.92999999997,55169.00999999997,7282.919999999998
4767,2022-02-14 09:15:00,331.41,62783.339999999975,55169.00999999997,7614.330000000002
4768,2022-02-14 09:20:00,-1670.56,61112.77999999998,55169.00999999997,5943.770000000004
4769,2022-02-14 09:25:00,-509.89,60602.88999999998,55169.00999999997,5433.880000000005
4770,2022-02-14 09:30:00,604.08,61206.96999999998,55169.00999999997,6037.960000000006
4771,2022-02-14 09:35:00,-1077.22,60129.74999999998,55169.00999999997,4960.740000000005
4772,2022-02-14 09:40:00,10.23,60139.97999999998,55169.00999999997,4970.970000000008
4773,2022-02-14 09:45:00,-1127.71,59012.26999999998,55169.00999999997,3843.2600000000093
4774,2022-02-14 09:50:00,-1114.48,57897.78999999998,55169.00999999997,2728.780000000006
4775,2022-02-14 09:55:00,1905.14,59802.92999999998,55169.00999999997,4633.9200000000055
4776,2022-02-14 10:00:00,1946.07,61748.99999999998,55169.00999999997,6579.990000000005
4777,2022-02-14 10:05:00,-691.8,61057.199999999975,55169.00999999997,5888.190000000002
4778,2022-02-14 10:10:00,-96.06,60961.13999999998,55169.00999999997,5792.130000000005
4779,2022-02-14 10:15:00,-1419.39,59541.74999999998,55169.00999999997,4372.740000000005
4780,2022-02-14 10:20:00,1867.94,61409.68999999998,55169.00999999997,6240.680000000008
4781,2022-02-14 10:25:00,-1230.88,60178.80999999998,55169.00999999997,5009.80000000001
4782,2022-02-14 10:30:00,-66.63,60112.179999999986,55169.00999999997,4943.170000000013
4783,2022-02-14 10:35:00,1118.74,61230.919999999984,55169.00999999997,6061.910000000011
4784,2022-02-14 10:40:00,222.03,61452.94999999998,55169.00999999997,6283.94000000001
4785,2022-02-14 10:45:00,573.71,62026.65999999998,55169.00999999997,6857.650000000009
4786,2022-02-14 10:50:00,1311.05,63337.709999999985,55169.00999999997,8168.700000000012
4787,2022-02-14 10:55:00,1896.35,65234.05999999998,55169.00999999997,10065.05000000001
4788,2022-02-14 11:00:00,388.94,65622.99999999999,55169.00999999997,10453.990000000013
4789,2022-02-14 11:05:00,-141.68,65481.319999999985,55169.00999999997,10312.310000000012
4790,2022-02-14 11:10:00,29.65,65510.96999999999,55169.00999999997,10341.960000000014
4791,2022-02-14 11:15:00,1576.99,67087.95999999999,55169.00999999997,11918.950000000019
4792,2022-02-14 11:20:00,44.31,67132.26999999999,55169.00999999997,11963.260000000017
4793,2022-02-14 11:25:00,-1137.52,65994.74999999999,55169.00999999997,10825.740000000013
4794,2022-02-14 11:30:00,-206.39,65788.35999999999,55169.00999999997,10619.350000000013
4795,2022-02-14 11:35:00,-702.11,65086.249999999985,55169.00999999997,9917.240000000013
4796,2022-02-14 11:40:00,1855.02,66941.26999999999,55169.00999999997,11772.260000000017
4797,2022-02-14 11:45:00,-1014.14,65927.12999999999,55169.00999999997,10758.120000000017
4798,2022-02-14 11:50:00,1255.69,67182.81999999999,55169.00999999997,12013.81000000002
4799,2022-02-14 11:55:00,-1024.37,66158.45,55169.00999999997,10989.440000000024
4800,2022-02-14 12:00:00,113.61,66272.06,55169.00999999997,11103.050000000025
4801,2022-02-14 12:05:00,-1543.35,64728.71,55169.00999999997,9559.700000000026
4802,2022-02-14 12:10:00,692.15,65420.86,55169.00999999997,10251.850000000028
4803,2022-02-14 12:15:00,-279.5,65141.36,55169.00999999997,9972.350000000028
4804,2022-02-14 12:20:00,-301.28,64840.08,55169.00999999997,9671.070000000029
4805,2022-02-14 12:25:00,-639.73,64200.35,55169.00999999997,9031.340000000026
4806,2022-02-14 12:30:00,1540.22,65740.56999999999,55169.00999999997,10571.56000000002
4807,2022-02-14 12:35:00,635.99,66376.56,55169.00999999997,11207.550000000025
4808,2022-02-14 12:40:00,-1355.07,65021.49,55169.00999999997,9852.480000000025
4809,2022-02-14 12:45:00,1982.8,67004.29,55169.00999999997,11835.28000000002
4810,2022-02-14 12:50:00,-729.94,66274.34999999999,55169.00999999997,11105.340000000018
4811,2022-02-14 12:55:00,1631.67,67906.01999999999,55169.00999999997,12737.010000000017
4812,2022-02-14 13:00:00,875.82,68781.84,55169.00999999997,13612.830000000024
4813,2022-02-14 13:05:00,1199.31,69981.15,55169.00999999997,14812.140000000021
4814,2022-02-14 13:10:00,1826.24,71807.39,55169.00999999997,16638.380000000026
4815,2022-02-14 13:15:00,-1231.25,70576.14,55169.00999999997,15407.130000000026
4816,2022-02-14 13:20:00,954.48,71530.62,55169.00999999997,16361.610000000022
4817,2022-02-14 13:25:00,1648.41,73179.03,55169.00999999997,18010.020000000026
4818,2022-02-14 13:30:00,1920.99,75100.02,55169.00999999997,19931.01000000003
4819,2022-02-14 13:35:00,878.97,75978.99,55169.00999999997,20809.980000000032
4820,2022-02-14 13:40:00,-1243.79,74735.20000000001,55169.00999999997,19566.19000000004
4821,2022-02-14 13:45:00,1619.24,76354.44000000002,55169.00999999997,21185.430000000044
4822,2022-02-14 13:50:00,364.7,76719.14000000001,55169.00999999997,21550.13000000004
4823,2022-02-14 13:55:00,-1780.52,74938.62000000001,55169.00999999997,19769.610000000037
4824,2022-02-14 14:00:00,-1059.71,73878.91,55169.00999999997,18709.90000000003
4825,2022-02-14 14:05:00,1516.07,75394.98000000001,55169.00999999997,20225.970000000038
4826,2022-02-14 14:10:00,348.47,75743.45000000001,55169.00999999997,20574.44000000004
4827,2022-02-14 14:15:00,230.02,75973.47000000002,55169.00999999997,20804.460000000043
4828,2022-02-14 14:20:00,790.22,76763.69000000002,55169.00999999997,21594.680000000044
4829,2022-02-14 14:25:00,1137.79,77901.48000000001,55169.00999999997,22732.470000000038
4830,2022-02-14 14:30:00,723.83,78625.31000000001,55169.00999999997,23456.30000000004
4831,2022-02-14 14:35:00,1564.35,80189.66000000002,55169.00999999997,25020.650000000045
4832,2022-02-14 14:40:00,-110.24,80079.42000000001,55169.00999999997,24910.41000000004
4833,2022-02-14 14:45:00,1757.51,81836.93000000001,55169.00999999997,26667.920000000035
4834,2022-02-14 14:50:00,1238.16,83075.09000000001,55169.00999999997,27906.080000000038
4835,2022-02-14 14:55:00,82.86,83157.95000000001,55169.00999999997,27988.94000000004
4836,2022-02-14 15:00:00,1341.85,84499.80000000002,55169.00999999997,29330.790000000045
4837,2022-02-14 15:05:00,-66.97,84432.83000000002,55169.00999999997,29263.820000000043
4838,2022-02-14 15:10:00,-1721.34,82711.49000000002,55169.00999999997,27542.480000000047
4839,2022-02-14 15:15:00,126.45,82837.94000000002,55169.00999999997,27668.930000000044
4840,2022-02-14 15:20:00,-558.34,82279.60000000002,55169.00999999997,27110.590000000047
4841,2022-02-14 15:25:00,1714.99,83994.59000000003,55169.00999999997,28825.580000000053
4842,2022-02-14 15:30:00,910.31,84904.90000000002,55169.00999999997,29735.89000000005
4843,2022-02-14 15:35:00,113.27,85018.17000000003,55169.00999999997,29849.160000000054
4844,2022-02-14 15:40:00,-107.85,84910.32000000002,55169.00999999997,29741.31000000005
4845,2022-02-14 15:45:00,1680.99,86591.31000000003,55169.00999999997,31422.300000000054
4846,2022-02-14 15:50:00,1853.78,88445.09000000003,55169.00999999997,33276.08000000005
4847,2022-02-14 15:55:00,-531.12,87913.97000000003,55169.00999999997,32744.960000000057
4848,2022-02-14 16:00:00,-1659.75,86254.22000000003,55169.00999999997,31085.210000000057
4849,2022-02-14 16:05:00,763.23,87017.45000000003,55169.00999999997,31848.440000000053
4850,2022-02-14 16:10:00,418.12,87435.57000000002,55169.00999999997,32266.56000000005
4851,2022-02-14 16:15:00,1149.31,88584.88000000002,55169.00999999997,33415.870000000046
4852,2022-02-14 16:20:00,428.33,89013.21000000002,55169.00999999997,33844.20000000005
4853,2022-02-14 16:25:00,-1617.21,87396.00000000001,55169.00999999997,32226.99000000004
4854,2022-02-14 16:30:00,-1948.03,85447.97000000002,55169.00999999997,30278.960000000043
4855,2022-02-14 16:35:00,896.74,86344.71000000002,55169.00999999997,31175.700000000048
4856,2022-02-14 16:40:00,-853.94,85490.77000000002,55169.00999999997,30321.760000000046
4857,2022-02-14 16:45:00,965.68,86456.45000000001,55169.00999999997,31287.44000000004
4858,2022-02-14 16:50:00,444.23,86900.68000000001,55169.00999999997,31731.670000000035
4859,2022-02-14 16:55:00,-659.78,86240.90000000001,55169.00999999997,31071.890000000036
4860,2022-02-15 08:00:00,1349.99,87590.89000000001,86240.90000000001,1349.9900000000052
4861,2022-02-15 08:05:00,1353.48,88944.37000000001,86240.90000000001,2703.470000000001
4862,2022-02-15 08:10:00,-1240.28,87704.09000000001,86240.90000000001,1463.1900000000023
4863,2022-02-15 08:15:00,1236.61,88940.70000000001,86240.90000000001,2699.800000000003
4864,2022-02-15 08:20:00,1813.36,90754.06000000001,86240.90000000001,4513.1600000000035
4865,2022-02-15 08:25:00,1820.73,92574.79000000001,86240.90000000001,6333.889999999999
4866,2022-02-15 08:30:00,1356.32,93931.11000000002,86240.90000000001,7690.210000000006
4867,2022-02-15 08:35:00,1945.91,95877.02000000002,86240.90000000001,9636.12000000001
4868,2022-02-15 08:40:00,1799.85,97676.87000000002,86240.90000000001,11435.970000000016
4869,2022-02-15 08:45:00,-1310.71,96366.16000000002,86240.90000000001,10125.26000000001
4870,2022-02-15 08:50:00,801.81,97167.97000000002,86240.90000000001,10927.070000000007
4871,2022-02-15 08:55:00,1406.19,98574.16000000002,86240.90000000001,12333.26000000001
4872,2022-02-15 09:00:00,-174.47,98399.69000000002,86240.90000000001,12158.790000000008
4873,2022-02-15 09:05:00,-1603.51,96796.18000000002,86240.90000000001,10555.280000000013
4874,2022-02-15 09:10:00,-652.29,96143.89000000003,86240.90000000001,9902.99000000002
4875,2022-02-15 09:15:00,-1927.22,94216.67000000003,86240.90000000001,7975.770000000019
4876,2022-02-15 09:20:00,-1655.03,92561.64000000003,86240.90000000001,6320.74000000002
4877,2022-02-15 09:25:00,-1713.84,90847.80000000003,86240.90000000001,4606.900000000023
4878,2022-02-15 09:30:00,1144.87,91992.67000000003,86240.90000000001,5751.770000000019
4879,2022-02-15 09:35:00,1102.55,93095.22000000003,86240.90000000001,6854.3200000000215
4880,2022-02-15 09:40:00,1297.9,94393.12000000002,86240.90000000001,8152.220000000016
4881,2022-02-15 09:45:00,-1426.08,92967.04000000002,86240.90000000001,6726.140000000014
4882,2022-02-15 09:50:00,-1638.53,91328.51000000002,86240.90000000001,5087.610000000015
4883,2022-02-15 09:55:00,-170.54,91157.97000000003,86240.90000000001,4917.0700000000215
4884,2022-02-15 10:00:00,1999.96,93157.93000000004,86240.90000000001,6917.030000000028
4885,2022-02-15 10:05:00,1218.22,94376.15000000004,86240.90000000001,8135.250000000029
4886,2022-02-15 10:10:00,-1041.07,93335.08000000003,86240.90000000001,7094.180000000022
4887,2022-02-15 10:15:00,664.81,93999.89000000003,86240.90000000001,7758.99000000002
4888,2022-02-15 10:20:00,-326.87,93673.02000000003,86240.90000000001,7432.120000000024
4889,2022-02-15 10:25:00,-344.78,93328.24000000003,86240.90000000001,7087.340000000026
4890,2022-02-15 10:30:00,-1614.0,91714.24000000003,86240.90000000001,5473.340000000026
4891,2022-02-15 10:35:00,1927.69,93641.93000000004,86240.90000000001,7401.030000000028
4892,2022-02-15 10:40:00,1214.36,94856.29000000004,86240.90000000001,8615.390000000029
4893,2022-02-15 10:45:00,40.39,94896.68000000004,86240.90000000001,8655.780000000028
4894,2022-02-15 10:50:00,-439.05,94457.63000000003,86240.90000000001,8216.730000000025
4895,2022-02-15 10:55:00,755.4,95213.03000000003,86240.90000000001,8972.13000000002
4896,2022-02-15 11:00:00,-483.54,94729.49000000003,86240.90000000001,8488.590000000026
4897,2022-02-15 11:05:00,-679.76,94049.73000000004,86240.90000000001,7808.830000000031
4898,2022-02-15 11:10:00,1811.1,95860.83000000005,86240.90000000001,9619.930000000037
4899,2022-02-15 11:15:00,277.36,96138.19000000005,86240.90000000001,9897.290000000037
4900,2022-02-15 11:20:00,502.94,96641.13000000005,86240.90000000001,10400.23000000004
4901,2022-02-15 11:25:00,962.45,97603.58000000005,86240.90000000001,11362.680000000037
4902,2022-02-15 11:30:00,-1127.18,96476.40000000005,86240.90000000001,10235.500000000044
4903,2022-02-15 11:35:00,1033.81,97510.21000000005,86240.90000000001,11269.310000000041
4904,2022-02-15 11:40:00,-599.85,96910.36000000004,86240.90000000001,10669.460000000036
4905,2022-02-15 11:45:00,-1441.05,95469.31000000004,86240.90000000001,9228.410000000033
4906,2022-02-15 11:50:00,-344.61,95124.70000000004,86240.90000000001,8883.800000000032
4907,2022-02-15 11:55:00,1395.6,96520.30000000005,86240.90000000001,10279.400000000038
4908,2022-02-15 12:00:00,1101.45,97621.75000000004,86240.90000000001,11380.850000000035
4909,2022-02-15 12:05:00,1916.52,99538.27000000005,86240.90000000001,13297.370000000039
4910,2022-02-15 12:10:00,57.17,99595.44000000005,86240.90000000001,13354.540000000037
4911,2022-02-15 12:15:00,1867.3,101462.74000000005,86240.90000000001,15221.84000000004
4912,2022-02-15 12:20:00,-1895.59,99567.15000000005,86240.90000000001,13326.250000000044
4913,2022-02-15 12:25:00,1713.27,101280.42000000006,86240.90000000001,15039.520000000048
4914,2022-02-15 12:30:00,-1767.75,99512.67000000006,86240.90000000001,13271.770000000048
4915,2022-02-15 12:35:00,1812.72,101325.39000000006,86240.90000000001,15084.490000000049
4916,2022-02-15 12:40:00,1692.35,103017.74000000006,86240.90000000001,16776.840000000055
4917,2022-02-15 12:45:00,-254.38,102763.36000000006,86240.90000000001,16522.46000000005
4918,2022-02-15 12:50:00,-1903.95,100859.41000000006,86240.90000000001,14618.510000000053
4919,2022-02-15 12:55:00,-322.09,100537.32000000007,86240.90000000001,14296.420000000056
4920,2022-02-15 13:00:00,-359.06,100178.26000000007,86240.90000000001,13937.360000000059
4921,2022-02-15 13:05:00,812.98,100991.24000000006,86240.90000000001,14750.340000000055
4922,2022-02-15 13:10:00,1335.92,102327.16000000006,86240.90000000001,16086.260000000053
4923,2022-02-15 13:15:00,-103.02,102224.14000000006,86240.90000000001,15983.240000000049
4924,2022-02-15 13:20:00,-125.15,102098.99000000006,86240.90000000001,15858.090000000055
4925,2022-02-15 13:25:00,-836.71,101262.28000000006,86240.90000000001,15021.380000000048
4926,2022-02-15 13:30:00,746.21,102008.49000000006,86240.90000000001,15767.590000000055
4927,2022-02-15 13:35:00,-1363.68,100644.81000000007,86240.90000000001,14403.910000000062
4928,2022-02-15 13:40:00,1957.36,102602.17000000007,86240.90000000001,16361.270000000062
4929,2022-02-15 13:45:00,1801.59,104403.76000000007,86240.90000000001,18162.86000000006
4930,2022-02-15 13:50:00,1784.19,106187.95000000007,86240.90000000001,19947.05000000006
4931,2022-02-15 13:55:00,-234.68,105953.27000000008,86240.90000000001,19712.370000000068
4932,2022-02-15 14:00:00,-95.49,105857.78000000007,86240.90000000001,19616.880000000063
4933,2022-02-15 14:05:00,-1659.28,104198.50000000007,86240.90000000001,17957.600000000064
4934,2022-02-15 14:10:00,493.54,104692.04000000007,86240.90000000001,18451.140000000058
4935,2022-02-15 14:15:00,288.01,104980.05000000006,86240.90000000001,18739.150000000052
4936,2022-02-15 14:20:00,-230.52,104749.53000000006,86240.90000000001,18508.63000000005
4937,2022-02-15 14:25:00,-1246.01,103503.52000000006,86240.90000000001,17262.620000000054
4938,2022-02-15 14:30:00,1452.83,104956.35000000006,86240.90000000001,18715.450000000055
4939,2022-02-15 14:35:00,67.84,105024.19000000006,86240.90000000001,18783.29000000005
4940,2022-02-15 14:40:00,1811.31,106835.50000000006,86240.90000000001,20594.60000000005
4941,2022-02-15 14:45:00,-1685.17,105150.33000000006,86240.90000000001,18909.43000000005
4942,2022-02-15 14:50:00,972.83,106123.16000000006,86240.90000000001,19882.260000000053
4943,2022-02-15 14:55:00,200.09,106323.25000000006,86240.90000000001,20082.35000000005
4944,2022-02-15 15:00:00,371.61,106694.86000000006,86240.90000000001,20453.96000000005
4945,2022-02-15 15:05:00,1337.52,108032.38000000006,86240.90000000001,21791.480000000054
4946,2022-02-15 15:10:00,1417.09,109449.47000000006,86240.90000000001,23208.57000000005
4947,2022-02-15 15:15:00,-1223.83,108225.64000000006,86240.90000000001,21984.74000000005
4948,2022-02-15 15:20:00,642.89,108868.53000000006,86240.90000000001,22627.63000000005
4949,2022-02-15 15:25:00,-1323.6,107544.93000000005,86240.90000000001,21304.030000000042
4950,2022-02-15 15:30:00,1678.41,109223.34000000005,86240.90000000001,22982.440000000046
4951,2022-02-15 15:35:00,-47.09,109176.25000000006,86240.90000000001,22935.35000000005
4952,2022-02-15 15:40:00,-1361.17,107815.08000000006,86240.90000000001,21574.18000000005
4953,2022-02-15 15:45:00,1913.65,109728.73000000005,86240.90000000001,23487.830000000045
4954,2022-02-15 15:50:00,376.99,110105.72000000006,86240.90000000001,23864.82000000005
4955,2022-02-15 15:55:00,-1927.44,108178.28000000006,86240.90000000001,21937.38000000005
4956,2022-02-15 16:00:00,666.38,108844.66000000006,86240.90000000001,22603.760000000053
4957,2022-02-15 16:05:00,1497.28,110341.94000000006,86240.90000000001,24101.04000000005
4958,2022-02-15 16:10:00,-27.97,110313.97000000006,86240.90000000001,24073.07000000005
4959,2022-02-15 16:15:00,-356.77,109957.20000000006,86240.90000000001,23716.300000000047
4960,2022-02-15 16:20:00,-1523.41,108433.79000000005,86240.90000000001,22192.890000000043
4961,2022-02-15 16:25:00,1551.76,109985.55000000005,86240.90000000001,23744.650000000038
4962,2022-02-15 16:30:00,1841.5,111827.05000000005,86240.90000000001,25586.150000000038
4963,2022-02-15 16:35:00,690.09,112517.14000000004,86240.90000000001,26276.240000000034
4964,2022-02-15 16:40:00,-793.2,111723.94000000005,86240.90000000001,25483.040000000037
4965,2022-02-15 16:45:00,57.26,111781.20000000004,86240.90000000001,25540.300000000032
4966,2022-02-15 16:50:00,-1803.32,109977.88000000003,86240.90000000001,23736.980000000025
4967,2022-02-15 16:55:00,-1850.2,108127.68000000004,86240.90000000001,21886.780000000028
4968,2022-02-16 08:00:00,486.17,108613.85000000003,108127.68000000004,486.16999999999825
4969,2022-02-16 08:05:00,1364.86,109978.71000000004,108127.68000000004,1851.0299999999988
4970,2022-02-16 08:10:00,975.29,110954.00000000003,108127.68000000004,2826.3199999999924
4971,2022-02-16 08:15:00,25.65,110979.65000000002,108127.68000000004,2851.9699999999866
4972,2022-02-16 08:20:00,-793.85,110185.80000000002,108127.68000000004,2058.119999999981
4973,2022-02-16 08:25:00,91.77,110277.57000000002,108127.68000000004,2149.889999999985
4974,2022-02-16 08:30:00,450.5,110728.07000000002,108127.68000000004,2600.389999999985
4975,2022-02-16 08:35:00,-1578.01,109150.06000000003,108127.68000000004,1022.3799999999901
4976,2022-02-16 08:40:00,567.02,109717.08000000003,108127.68000000004,1589.3999999999942
4977,2022-02-16 08:45:00,-1105.11,108611.97000000003,108127.68000000004,484.2899999999936
4978,2022-02-16 08:50:00,119.66,108731.63000000003,108127.68000000004,603.9499999999971
4979,2022-02-16 08:55:00,-89.58,108642.05000000003,108127.68000000004,514.3699999999953
4980,2022-02-16 09:00:00,1207.3,109849.35000000003,108127.68000000004,1721.6699999999983
4981,2022-02-16 09:05:00,143.65,109993.00000000003,108127.68000000004,1865.3199999999924
4982,2022-02-16 09:10:00,-897.82,109095.18000000002,108127.68000000004,967.4999999999854
4983,2022-02-16 09:15:00,1388.2,110483.38000000002,108127.68000000004,2355.6999999999825
4984,2022-02-16 09:20:00,-1560.75,108922.63000000002,108127.68000000004,794.9499999999825
4985,2022-02-16 09:25:00,1764.21,110686.84000000003,108127.68000000004,2559.159999999989
4986,2022-02-16 09:30:00,-434.25,110252.59000000003,108127.68000000004,2124.909999999989
4987,2022-02-16 09:35:00,1131.72,111384.31000000003,108127.68000000004,3256.62999999999
4988,2022-02-16 09:40:00,-139.54,111244.77000000003,108127.68000000004,3117.0899999999965
4989,2022-02-16 09:45:00,-467.54,110777.23000000004,108127.68000000004,2649.550000000003
4990,2022-02-16 09:50:00,-1844.32,108932.91000000003,108127.68000000004,805.2299999999959
4991,2022-02-16 09:55:00,1435.14,110368.05000000003,108127.68000000004,2240.3699999999953
4992,2022-02-16 10:00:00,1577.96,111946.01000000004,108127.68000000004,3818.3300000000017
4993,2022-02-16 10:05:00,-1910.42,110035.59000000004,108127.68000000004,1907.9100000000035
4994,2022-02-16 10:10:00,-505.02,109530.57000000004,108127.68000000004,1402.8899999999994
4995,2022-02-16 10:15:00,1314.21,110844.78000000004,108127.68000000004,2717.100000000006
4996,2022-02-16 10:20:00,-1918.7,108926.08000000005,108127.68000000004,798.4000000000087
4997,2022-02-16 10:25:00,344.89,109270.97000000004,108127.68000000004,1143.2900000000081
4998,2022-02-16 10:30:00,-384.3,108886.67000000004,108127.68000000004,758.9900000000052
4999,2022-02-16 10:35:00,820.24,109706.91000000005,108127.68000000004,1579.2300000000105
5000,2022-02-16 10:40:00,1097.52,110804.43000000005,108127.68000000004,2676.7500000000146
5001,2022-02-16 10:45:00,1795.15,112599.58000000005,108127.68000000004,4471.900000000009
5002,2022-02-16 10:50:00,-102.32,112497.26000000004,108127.68000000004,4369.580000000002
5003,2022-02-16 10:55:00,-90.8,112406.46000000004,108127.68000000004,4278.779999999999
5004,2022-02-16 11:00:00,-276.19,112130.27000000003,108127.68000000004,4002.5899999999965
5005,2022-02-16 11:05:00,-916.09,111214.18000000004,108127.68000000004,3086.5
5006,2022-02-16 11:10:00,-106.32,111107.86000000003,108127.68000000004,2980.179999999993
5007,2022-02-16 11:15:00,849.52,111957.38000000003,108127.68000000004,3829.699999999997
5008,2022-02-16 11:20:00,-900.97,111056.41000000003,108127.68000000004,2928.729999999996
5009,2022-02-16 11:25:00,-1032.06,110024.35000000003,108127.68000000004,1896.6699999999983
5010,2022-02-16 11:30:00,-1843.59,108180.76000000004,108127.68000000004,53.080000000001746
5011,2022-02-16 11:35:00,1647.75,109828.51000000004,108127.68000000004,1700.8300000000017
5012,2022-02-16 11:40:00,207.83,110036.34000000004,108127.68000000004,1908.6600000000035
5013,2022-02-16 11:45:00,1962.14,111998.48000000004,108127.68000000004,3870.800000000003
5014,2022-02-16 11:50:00,924.09,112922.57000000004,108127.68000000004,4794.889999999999
5015,2022-02-16 11:55:00,998.58,113921.15000000004,108127.68000000004,5793.470000000001
5016,2022-02-16 12:00:00,-1314.97,112606.18000000004,108127.68000000004,4478.5
5017,2022-02-16 12:05:00,-367.11,112239.07000000004,108127.68000000004,4111.389999999999
5018,2022-02-16 12:10:00,1374.07,113613.14000000004,108127.68000000004,5485.460000000006
5019,2022-02-16 12:15:00,-645.37,112967.77000000005,108127.68000000004,4840.090000000011
5020,2022-02-16 12:20:00,154.32,113122.09000000005,108127.68000000004,4994.410000000018
5021,2022-02-16 12:25:00,897.89,114019.98000000005,108127.68000000004,5892.3000000000175
5022,2022-02-16 12:30:00,1695.5,115715.48000000005,108127.68000000004,7587.8000000000175
5023,2022-02-16 12:35:00,-609.75,115105.73000000005,108127.68000000004,6978.0500000000175
5024,2022-02-16 12:40:00,624.23,115729.96000000005,108127.68000000004,7602.280000000013
5025,2022-02-16 12:45:00,-1026.71,114703.25000000004,108127.68000000004,6575.570000000007
5026,2022-02-16 12:50:00,-1610.99,113092.26000000004,108127.68000000004,4964.580000000002
5027,2022-02-16 12:55:00,-932.97,112159.29000000004,108127.68000000004,4031.6100000000006
5028,2022-02-16 13:00:00,927.24,113086.53000000004,108127.68000000004,4958.850000000006
5029,2022-02-16 13:05:00,-291.26,112795.27000000005,108127.68000000004,4667.590000000011
5030,2022-02-16 13:10:00,1385.37,114180.64000000004,108127.68000000004,6052.960000000006
5031,2022-02-16 13:15:00,1969.82,116150.46000000005,108127.68000000004,8022.780000000013
5032,2022-02-16 13:20:00,1227.01,117377.47000000004,108127.68000000004,9249.790000000008
5033,2022-02-16 13:25:00,1806.69,119184.16000000005,108127.68000000004,11056.48000000001
5034,2022-02-16 13:30:00,-527.19,118656.97000000004,108127.68000000004,10529.290000000008
5035,2022-02-16 13:35:00,-513.39,118143.58000000005,108127.68000000004,10015.900000000009
5036,2022-02-16 13:40:00,-1370.6,116772.98000000004,108127.68000000004,8645.300000000003
5037,2022-02-16 13:45:00,1669.14,118442.12000000004,108127.68000000004,10314.440000000002
5038,2022-02-16 13:50:00,-1906.41,116535.71000000004,108127.68000000004,8408.029999999999
5039,2022-02-16 13:55:00,899.06,117434.77000000003,108127.68000000004,9307.089999999997
5040,2022-02-16 14:00:00,-497.58,116937.19000000003,108127.68000000004,8809.509999999995
5041,2022-02-16 14:05:00,163.27,117100.46000000004,108127.68000000004,8972.779999999999
5042,2022-02-16 14:10:00,-689.86,116410.60000000003,108127.68000000004,8282.919999999998
5043,2022-02-16 14:15:00,190.42,116601.02000000003,108127.68000000004,8473.339999999997
5044,2022-02-16 14:20:00,429.23,117030.25000000003,108127.68000000004,8902.569999999992
5045,2022-02-16 14:25:00,1023.09,118053.34000000003,108127.68000000004,9925.659999999989
5046,2022-02-16 14:30:00,974.97,119028.31000000003,108127.68000000004,10900.62999999999
5047,2022-02-16 14:35:00,30.77,119059.08000000003,108127.68000000004,10931.399999999994
5048,2022-02-16 14:40:00,-461.44,118597.64000000003,108127.68000000004,10469.959999999992
5049,2022-02-16 14:45:00,1552.39,120150.03000000003,108127.68000000004,12022.349999999991
5050,2022-02-16 14:50:00,1093.78,121243.81000000003,108127.68000000004,13116.12999999999
5051,2022-02-16 14:55:00,-1277.2,119966.61000000003,108127.68000000004,11838.929999999993
5052,2022-02-16 15:00:00,-900.12,119066.49000000003,108127.68000000004,10938.809999999998
5053,2022-02-16 15:05:00,913.82,119980.31000000004,108127.68000000004,11852.630000000005
5054,2022-02-16 15:10:00,594.02,120574.33000000005,108127.68000000004,12446.650000000009
5055,2022-02-16 15:15:00,-1039.11,119535.22000000004,108127.68000000004,11407.540000000008
5056,2022-02-16 15:20:00,261.67,119796.89000000004,108127.68000000004,11669.210000000006
5057,2022-02-16 15:25:00,-353.52,119443.37000000004,108127.68000000004,11315.690000000002
5058,2022-02-16 15:30:00,1014.17,120457.54000000004,108127.68000000004,12329.86
5059,2022-02-16 15:35:00,-34.77,120422.77000000003,108127.68000000004,12295.089999999997
5060,2022-02-16 15:40:00,1734.4,122157.17000000003,108127.68000000004,14029.48999999999
5061,2022-02-16 15:45:00,487.5,122644.67000000003,108127.68000000004,14516.98999999999
5062,2022-02-16 15:50:00,568.43,123213.10000000002,108127.68000000004,15085.419999999984
5063,2022-02-16 15:55:00,59.41,123272.51000000002,108127.68000000004,15144.829999999987
5064,2022-02-16 16:00:00,1850.38,125122.89000000003,108127.68000000004,16995.209999999992
5065,2022-02-16 16:05:00,1155.79,126278.68000000002,108127.68000000004,18150.999999999985
5066,2022-02-16 16:10:00,34.66,126313.34000000003,108127.68000000004,18185.65999999999
5067,2022-02-16 16:15:00,-322.27,125991.07000000002,108127.68000000004,17863.389999999985
5068,2022-02-16 16:20:00,-1286.16,124704.91000000002,108127.68000000004,16577.22999999998
5069,2022-02-16 16:25:00,1476.68,126181.59000000001,108127.68000000004,18053.909999999974
5070,2022-02-16 16:30:00,-788.21,125393.38,108127.68000000004,17265.699999999968
5071,2022-02-16 16:35:00,437.2,125830.58,108127.68000000004,17702.899999999965
5072,2022-02-16 16:40:00,-868.03,124962.55,108127.68000000004,16834.869999999966
5073,2022-02-16 16:45:00,-1185.17,123777.38,108127.68000000004,15649.699999999968
5074,2022-02-16 16:50:00,-720.27,123057.11,108127.68000000004,14929.429999999964
5075,2022-02-16 16:55:00,-1772.07,121285.04,108127.68000000004,13157.359999999957
5076,2022-02-17 08:00:00,-1761.64,119523.4,121285.04,-1761.6399999999994
5077,2022-02-17 08:05:00,-1855.78,117667.62,121285.04,-3617.4199999999983
5078,2022-02-17 08:10:00,-879.99,116787.62999999999,121285.04,-4497.4100000000035
5079,2022-02-17 08:15:00,1798.01,118585.63999999998,121285.04,-2699.4000000000087
5080,2022-02-17 08:20:00,992.84,119578.47999999998,121285.04,-1706.5600000000122
5081,2022-02-17 08:25:00,581.59,120160.06999999998,121285.04,-1124.9700000000157
5082,2022-02-17 08:30:00,703.17,120863.23999999998,121285.04,-421.80000000001746
5083,2022-02-17 08:35:00,1540.72,122403.95999999998,121285.04,1118.9199999999837
5084,2022-02-17 08:40:00,-611.17,121792.78999999998,121285.04,507.74999999998545
5085,2022-02-17 08:45:00,-1451.83,120340.95999999998,121285.04,-944.0800000000163
5086,2022-02-17 08:50:00,56.17,120397.12999999998,121285.04,-887.910000000018
5087,2022-02-17 08:55:00,-1222.92,119174.20999999998,121285.04,-2110.8300000000163
5088,2022-02-17 09:00:00,1873.07,121047.27999999998,121285.04,-237.7600000000093
5089,2022-02-17 09:05:00,1568.79,122616.06999999998,121285.04,1331.0299999999843
5090,2022-02-17 09:10:00,-1187.22,121428.84999999998,121285.04,143.80999999998312
5091,2022-02-17 09:15:00,-653.94,120774.90999999997,121285.04,-510.1300000000192
5092,2022-02-17 09:20:00,1909.82,122684.72999999998,121285.04,1399.6899999999878
5093,2022-02-17 09:25:00,375.83,123060.55999999998,121285.04,1775.5199999999895
5094,2022-02-17 09:30:00,-847.16,122213.39999999998,121285.04,928.359999999986
5095,2022-02-17 09:35:00,-1638.77,120574.62999999998,121285.04,-710.410000000018
5096,2022-02-17 09:40:00,1724.54,122299.16999999997,121285.04,1014.1299999999756
5097,2022-02-17 09:45:00,1491.57,123790.73999999998,121285.04,2505.6999999999825
5098,2022-02-17 09:50:00,62.34,123853.07999999997,121285.04,2568.039999999979
5099,2022-02-17 09:55:00,-1189.74,122663.33999999997,121285.04,1378.2999999999738
5100,2022-02-17 10:00:00,473.17,123136.50999999997,121285.04,1851.469999999972
5101,2022-02-17 10:05:00,-381.28,122755.22999999997,121285.04,1470.1899999999732
5102,2022-02-17 10:10:00,-1695.94,121059.28999999996,121285.04,-225.7500000000291
5103,2022-02-17 10:15:00,1717.72,122777.00999999997,121285.04,1491.969999999972
5104,2022-02-17 10:20:00,-1087.95,121689.05999999997,121285.04,404.01999999997497
5105,2022-02-17 10:25:00,-1167.74,120521.31999999996,121285.04,-763.7200000000303
5106,2022-02-17 10:30:00,-251.32,120269.99999999996,121285.04,-1015.0400000000373
5107,2022-02-17 10:35:00,1600.43,121870.42999999995,121285.04,585.3899999999558
5108,2022-02-17 10:40:00,159.82,122030.24999999996,121285.04,745.2099999999627
5109,2022-02-17 10:45:00,-913.43,121116.81999999996,121285.04,-168.22000000003027
5110,2022-02-17 10:50:00,721.51,121838.32999999996,121285.04,553.2899999999645
5111,2022-02-17 10:55:00,875.52,122713.84999999996,121285.04,1428.8099999999686
5112,2022-02-17 11:00:00,768.31,123482.15999999996,121285.04,2197.1199999999662
5113,2022-02-17 11:05:00,-1630.56,121851.59999999996,121285.04,566.5599999999686
5114,2022-02-17 11:10:00,-1839.05,120012.54999999996,121285.04,-1272.4900000000343
5115,2022-02-17 11:15:00,1921.42,121933.96999999996,121285.04,648.9299999999639
5116,2022-02-17 11:20:00,1616.6,123550.56999999996,121285.04,2265.5299999999697
5117,2022-02-17 11:25:00,435.42,123985.98999999996,121285.04,2700.949999999968
5118,2022-02-17 11:30:00,451.8,124437.78999999996,121285.04,3152.749999999971
5119,2022-02-17 11:35:00,191.89,124629.67999999996,121285.04,3344.6399999999703
5120,2022-02-17 11:40:00,-858.51,123771.16999999997,121285.04,2486.1299999999756
5121,2022-02-17 11:45:00,292.75,124063.91999999997,121285.04,2778.8799999999756
5122,2022-02-17 11:50:00,-1104.92,122958.99999999997,121285.04,1673.9599999999773
5123,2022-02-17 11:55:00,-880.69,122078.30999999997,121285.04,793.269999999975
5124,2022-02-17 12:00:00,-1399.63,120678.67999999996,121285.04,-606.3600000000297
5125,2022-02-17 12:05:00,1880.56,122559.23999999996,121285.04,1274.199999999968
5126,2022-02-17 12:10:00,532.9,123092.13999999996,121285.04,1807.0999999999622
5127,2022-02-17 12:15:00,-394.23,122697.90999999996,121285.04,1412.8699999999662
5128,2022-02-17 12:20:00,1644.32,124342.22999999997,121285.04,3057.189999999973
5129,2022-02-17 12:25:00,-786.78,123555.44999999997,121285.04,2270.4099999999744
5130,2022-02-17 12:30:00,1040.54,124595.98999999996,121285.04,3310.949999999968
5131,2022-02-17 12:35:00,955.92,125551.90999999996,121285.04,4266.869999999966
5132,2022-02-17 12:40:00,845.52,126397.42999999996,121285.04,5112.38999999997
5133,2022-02-17 12:45:00,-1915.99,124481.43999999996,121285.04,3196.399999999965
5134,2022-02-17 12:50:00,1961.02,126442.45999999996,121285.04,5157.419999999969
5135,2022-02-17 12:55:00,1546.38,127988.83999999997,121285.04,6703.799999999974
5136,2022-02-17 13:00:00,-1454.73,126534.10999999997,121285.04,5249.069999999978
5137,2022-02-17 13:05:00,-874.78,125659.32999999997,121285.04,4374.289999999979
5138,2022-02-17 13:10:00,-975.19,124684.13999999997,121285.04,3399.0999999999767
5139,2022-02-17 13:15:00,-1743.27,122940.86999999997,121285.04,1655.8299999999726
5140,2022-02-17 13:20:00,-1265.46,121675.40999999996,121285.04,390.36999999996624
5141,2022-02-17 13:25:00,325.47,122000.87999999996,121285.04,715.8399999999674
5142,2022-02-17 13:30:00,424.16,122425.03999999996,121285.04,1139.999999999971
5143,2022-02-17 13:35:00,1447.4,123872.43999999996,121285.04,2587.399999999965
5144,2022-02-17 13:40:00,1165.96,125038.39999999997,121285.04,3753.3599999999715
5145,2022-02-17 13:45:00,-1353.34,123685.05999999997,121285.04,2400.019999999975
5146,2022-02-17 13:50:00,1993.67,125678.72999999997,121285.04,4393.689999999973
5147,2022-02-17 13:55:00,1764.45,127443.17999999996,121285.04,6158.13999999997
5148,2022-02-17 14:00:00,-1800.43,125642.74999999997,121285.04,4357.709999999977
5149,2022-02-17 14:05:00,237.99,125880.73999999998,121285.04,4595.6999999999825
5150,2022-02-17 14:10:00,-838.36,125042.37999999998,121285.04,3757.339999999982
5151,2022-02-17 14:15:00,503.86,125546.23999999998,121285.04,4261.1999999999825
5152,2022-02-17 14:20:00,618.52,126164.75999999998,121285.04,4879.719999999987
5153,2022-02-17 14:25:00,863.05,127027.80999999998,121285.04,5742.7699999999895
5154,2022-02-17 14:30:00,-720.28,126307.52999999998,121285.04,5022.489999999991
5155,2022-02-17 14:35:00,1279.08,127586.60999999999,121285.04,6301.569999999992
5156,2022-02-17 14:40:00,595.83,128182.43999999999,121285.04,6897.399999999994
5157,2022-02-17 14:45:00,-662.86,127519.57999999999,121285.04,6234.539999999994
5158,2022-02-17 14:50:00,-1646.75,125872.82999999999,121285.04,4587.789999999994
5159,2022-02-17 14:55:00,-1722.9,124149.93,121285.04,2864.8899999999994
5160,2022-02-17 15:00:00,1405.16,125555.09,121285.04,4270.050000000003
5161,2022-02-17 15:05:00,-1813.38,123741.70999999999,121285.04,2456.6699999999983
5162,2022-02-17 15:10:00,-1756.04,121985.67,121285.04,700.6300000000047
5163,2022-02-17 15:15:00,-640.4,121345.27,121285.04,60.23000000001048
5164,2022-02-17 15:20:00,-353.39,120991.88,121285.04,-293.15999999998894
5165,2022-02-17 15:25:00,-687.99,120303.89,121285.04,-981.1499999999942
5166,2022-02-17 15:30:00,-331.57,119972.31999999999,121285.04,-1312.7200000000012
5167,2022-02-17 15:35:00,-457.35,119514.96999999999,121285.04,-1770.070000000007
5168,2022-02-17 15:40:00,-1482.4,118032.56999999999,121285.04,-3252.470000000001
5169,2022-02-17 15:45:00,336.64,118369.20999999999,121285.04,-2915.8300000000017
5170,2022-02-17 15:50:00,-1306.11,117063.09999999999,121285.04,-4221.940000000002
5171,2022-02-17 15:55:00,86.34,117149.43999999999,121285.04,-4135.600000000006
5172,2022-02-17 16:00:00,-1932.13,115217.30999999998,121285.04,-6067.7300000000105
5173,2022-02-17 16:05:00,351.89,115569.19999999998,121285.04,-5715.840000000011
5174,2022-02-17 16:10:00,1385.74,116954.93999999999,121285.04,-4330.100000000006
5175,2022-02-17 16:15:00,912.17,117867.10999999999,121285.04,-3417.9300000000076
5176,2022-02-17 16:20:00,1118.56,118985.66999999998,121285.04,-2299.37000000001
5177,2022-02-17 16:25:00,-1458.68,117526.98999999999,121285.04,-3758.050000000003
5178,2022-02-17 16:30:00,-1398.71,116128.27999999998,121285.04,-5156.760000000009
5179,2022-02-17 16:35:00,1131.59,117259.86999999998,121285.04,-4025.170000000013
5180,2022-02-17 16:40:00,479.37,117739.23999999998,121285.04,-3545.8000000000175
5181,2022-02-17 16:45:00,-1508.1,116231.13999999997,121285.04,-5053.900000000023
5182,2022-02-17 16:50:00,-712.81,115518.32999999997,121285.04,-5766.710000000021
5183,2022-02-17 16:55:00,-892.56,114625.76999999997,121285.04,-6659.270000000019
5184,2022-02-18 08:00:00,-1640.32,112985.44999999997,114625.76999999997,-1640.320000000007
5185,2022-02-18 08:05:00,414.81,113400.25999999997,114625.76999999997,-1225.5100000000093
5186,2022-02-18 08:10:00,-1871.48,111528.77999999997,114625.76999999997,-3096.9900000000052
5187,2022-02-18 08:15:00,-1256.98,110271.79999999997,114625.76999999997,-4353.970000000001
5188,2022-02-18 08:20:00,618.36,110890.15999999997,114625.76999999997,-3735.6100000000006
5189,2022-02-18 08:25:00,-1304.03,109586.12999999998,114625.76999999997,-5039.639999999999
5190,2022-02-18 08:30:00,-1404.06,108182.06999999998,114625.76999999997,-6443.699999999997
5191,2022-02-18 08:35:00,-1966.02,106216.04999999997,114625.76999999997,-8409.720000000001
5192,2022-02-18 08:40:00,-413.33,105802.71999999997,114625.76999999997,-8823.050000000003
5193,2022-02-18 08:45:00,1664.21,107466.92999999998,114625.76999999997,-7158.8399999999965
5194,2022-02-18 08:50:00,1113.01,108579.93999999997,114625.76999999997,-6045.830000000002
5195,2022-02-18 08:55:00,924.24,109504.17999999998,114625.76999999997,-5121.5899999999965
5196,2022-02-18 09:00:00,898.77,110402.94999999998,114625.76999999997,-4222.819999999992
5197,2022-02-18 09:05:00,1773.33,112176.27999999998,114625.76999999997,-2449.4899999999907
5198,2022-02-18 09:10:00,1566.82,113743.09999999999,114625.76999999997,-882.6699999999837
5199,2022-02-18 09:15:00,-480.29,113262.81,114625.76999999997,-1362.9599999999773
5200,2022-02-18 09:20:00,338.06,113600.87,114625.76999999997,-1024.8999999999796
5201,2022-02-18 09:25:00,403.9,114004.76999999999,114625.76999999997,-620.9999999999854
5202,2022-02-18 09:30:00,1906.11,115910.87999999999,114625.76999999997,1285.1100000000151
5203,2022-02-18 09:35:00,-1957.07,113953.80999999998,114625.76999999997,-671.9599999999919
5204,2022-02-18 09:40:00,-909.67,113044.13999999998,114625.76999999997,-1581.62999999999
5205,2022-02-18 09:45:00,-913.25,112130.88999999998,114625.76999999997,-2494.87999999999
5206,2022-02-18 09:50:00,-1737.15,110393.73999999999,114625.76999999997,-4232.029999999984
5207,2022-02-18 09:55:00,-253.83,110139.90999999999,114625.76999999997,-4485.859999999986
5208,2022-02-18 10:00:00,1922.12,112062.02999999998,114625.76999999997,-2563.7399999999907
5209,2022-02-18 10:05:00,-1739.1,110322.92999999998,114625.76999999997,-4302.8399999999965
5210,2022-02-18 10:10:00,-630.84,109692.08999999998,114625.76999999997,-4933.679999999993
5211,2022-02-18 10:15:00,1376.17,111068.25999999998,114625.76999999997,-3557.5099999999948
5212,2022-02-18 10:20:00,-1801.84,109266.41999999998,114625.76999999997,-5359.349999999991
5213,2022-02-18 10:25:00,-1173.59,108092.82999999999,114625.76999999997,-6532.939999999988
5214,2022-02-18 10:30:00,445.9,108538.72999999998,114625.76999999997,-6087.039999999994
5215,2022-02-18 10:35:00,-594.52,107944.20999999998,114625.76999999997,-6681.559999999998
5216,2022-02-18 10:40:00,-828.01,107116.19999999998,114625.76999999997,-7509.569999999992
5217,2022-02-18 10:45:00,-1608.21,105507.98999999998,114625.76999999997,-9117.779999999999
5218,2022-02-18 10:50:00,538.82,106046.80999999998,114625.76999999997,-8578.959999999992
5219,2022-02-18 10:55:00,-1564.0,104482.80999999998,114625.76999999997,-10142.959999999992
5220,2022-02-18 11:00:00,1759.17,106241.97999999998,114625.76999999997,-8383.789999999994
5221,2022-02-18 11:05:00,-601.77,105640.20999999998,114625.76999999997,-8985.559999999998
5222,2022-02-18 11:10:00,236.82,105877.02999999998,114625.76999999997,-8748.73999999999
5223,2022-02-18 11:15:00,82.9,105959.92999999998,114625.76999999997,-8665.839999999997
5224,2022-02-18 11:20:00,805.52,106765.44999999998,114625.76999999997,-7860.319999999992
5225,2022-02-18 11:25:00,1166.77,107932.21999999999,114625.76999999997,-6693.549999999988
5226,2022-02-18 11:30:00,139.49,108071.70999999999,114625.76999999997,-6554.059999999983
5227,2022-02-18 11:35:00,-971.98,107099.73,114625.76999999997,-7526.039999999979
5228,2022-02-18 11:40:00,184.9,107284.62999999999,114625.76999999997,-7341.139999999985
5229,2022-02-18 11:45:00,-1086.06,106198.56999999999,114625.76999999997,-8427.199999999983
5230,2022-02-18 11:50:00,-1439.71,104758.85999999999,114625.76999999997,-9866.909999999989
5231,2022-02-18 11:55:00,1153.4,105912.25999999998,114625.76999999997,-8713.509999999995
5232,2022-02-18 12:00:00,1740.49,107652.74999999999,114625.76999999997,-6973.0199999999895
5233,2022-02-18 12:05:00,671.36,108324.10999999999,114625.76999999997,-6301.659999999989
5234,2022-02-18 12:10:00,-240.89,108083.21999999999,114625.76999999997,-6542.549999999988
5235,2022-02-18 12:15:00,915.03,108998.24999999999,114625.76999999997,-5627.5199999999895
5236,2022-02-18 12:20:00,-1794.5,107203.74999999999,114625.76999999997,-7422.0199999999895
5237,2022-02-18 12:25:00,-1479.1,105724.64999999998,114625.76999999997,-8901.119999999995
5238,2022-02-18 12:30:00,444.73,106169.37999999998,114625.76999999997,-8456.39
5239,2022-02-18 12:35:00,-1788.62,104380.75999999998,114625.76999999997,-10245.009999999995
5240,2022-02-18 12:40:00,781.03,105161.78999999998,114625.76999999997,-9463.979999999996
5241,2022-02-18 12:45:00,557.11,105718.89999999998,114625.76999999997,-8906.869999999995
5242,2022-02-18 12:50:00,1856.3,107575.19999999998,114625.76999999997,-7050.569999999992
5243,2022-02-18 12:55:00,-400.07,107175.12999999998,114625.76999999997,-7450.639999999999
5244,2022-02-18 13:00:00,1520.32,108695.44999999998,114625.76999999997,-5930.319999999992
5245,2022-02-18 13:05:00,628.68,109324.12999999998,114625.76999999997,-5301.639999999999
5246,2022-02-18 13:10:00,551.14,109875.26999999997,114625.76999999997,-4750.5
5247,2022-02-18 13:15:00,104.52,109979.78999999998,114625.76999999997,-4645.979999999996
5248,2022-02-18 13:20:00,-1979.37,108000.41999999998,114625.76999999997,-6625.349999999991
5249,2022-02-18 13:25:00,-1186.31,106814.10999999999,114625.76999999997,-7811.659999999989
5250,2022-02-18 13:30:00,-1817.7,104996.40999999999,114625.76999999997,-9629.359999999986
5251,2022-02-18 13:35:00,240.65,105237.05999999998,114625.76999999997,-9388.709999999992
5252,2022-02-18 13:40:00,1324.37,106561.42999999998,114625.76999999997,-8064.3399999999965
5253,2022-02-18 13:45:00,607.88,107169.30999999998,114625.76999999997,-7456.459999999992
5254,2022-02-18 13:50:00,1030.23,108199.53999999998,114625.76999999997,-6426.229999999996
5255,2022-02-18 13:55:00,-1871.66,106327.87999999998,114625.76999999997,-8297.89
5256,2022-02-18 14:00:00,1261.89,107589.76999999997,114625.76999999997,-7036.0
5257,2022-02-18 14:05:00,-769.32,106820.44999999997,114625.76999999997,-7805.320000000007
5258,2022-02-18 14:10:00,-97.53,106722.91999999997,114625.76999999997,-7902.850000000006
5259,2022-02-18 14:15:00,1163.17,107886.08999999997,114625.76999999997,-6739.680000000008
5260,2022-02-18 14:20:00,-1148.73,106737.35999999997,114625.76999999997,-7888.4100000000035
5261,2022-02-18 14:25:00,-778.19,105959.16999999997,114625.76999999997,-8666.600000000006
5262,2022-02-18 14:30:00,-391.75,105567.41999999997,114625.76999999997,-9058.350000000006
5263,2022-02-18 14:35:00,-340.7,105226.71999999997,114625.76999999997,-9399.050000000003
5264,2022-02-18 14:40:00,-1154.93,104071.78999999998,114625.76999999997,-10553.979999999996
5265,2022-02-18 14:45:00,496.69,104568.47999999998,114625.76999999997,-10057.289999999994
5266,2022-02-18 14:50:00,1093.32,105661.79999999999,114625.76999999997,-8963.969999999987
5267,2022-02-18 14:55:00,-1113.63,104548.16999999998,114625.76999999997,-10077.599999999991
5268,2022-02-18 15:00:00,1762.43,106310.59999999998,114625.76999999997,-8315.169999999998
5269,2022-02-18 15:05:00,-1490.04,104820.55999999998,114625.76999999997,-9805.209999999992
5270,2022-02-18 15:10:00,-1575.91,103244.64999999998,114625.76999999997,-11381.119999999995
5271,2022-02-18 15:15:00,-546.91,102697.73999999998,114625.76999999997,-11928.029999999999
5272,2022-02-18 15:20:00,747.22,103444.95999999998,114625.76999999997,-11180.809999999998
5273,2022-02-18 15:25:00,383.86,103828.81999999998,114625.76999999997,-10796.949999999997
5274,2022-02-18 15:30:00,703.72,104532.53999999998,114625.76999999997,-10093.229999999996
5275,2022-02-18 15:35:00,-1378.38,103154.15999999997,114625.76999999997,-11471.61
5276,2022-02-18 15:40:00,985.32,104139.47999999998,114625.76999999997,-10486.289999999994
5277,2022-02-18 15:45:00,-1814.36,102325.11999999998,114625.76999999997,-12300.649999999994
5278,2022-02-18 15:50:00,885.71,103210.82999999999,114625.76999999997,-11414.939999999988
5279,2022-02-18 15:55:00,178.54,103389.36999999998,114625.76999999997,-11236.399999999994
5280,2022-02-18 16:00:00,612.28,104001.64999999998,114625.76999999997,-10624.119999999995
5281,2022-02-18 16:05:00,-865.41,103136.23999999998,114625.76999999997,-11489.529999999999
5282,2022-02-18 16:10:00,-1981.13,101155.10999999997,114625.76999999997,-13470.660000000003
5283,2022-02-18 16:15:00,-1053.57,100101.53999999996,114625.76999999997,-14524.23000000001
5284,2022-02-18 16:20:00,1952.81,102054.34999999996,114625.76999999997,-12571.420000000013
5285,2022-02-18 16:25:00,-244.16,101810.18999999996,114625.76999999997,-12815.580000000016
5286,2022-02-18 16:30:00,-1151.11,100659.07999999996,114625.76999999997,-13966.690000000017
5287,2022-02-18 16:35:00,1806.23,102465.30999999995,114625.76999999997,-12160.460000000021
5288,2022-02-18 16:40:00,-1170.58,101294.72999999995,114625.76999999997,-13331.040000000023
5289,2022-02-18 16:45:00,-534.71,100760.01999999995,114625.76999999997,-13865.75000000003
5290,2022-02-18 16:50:00,1613.79,102373.80999999994,114625.76999999997,-12251.960000000036
5291,2022-02-18 16:55:00,1886.91,104260.71999999994,114625.76999999997,-10365.050000000032
5292,2022-02-19 08:00:00,-1711.2,102549.51999999995,104260.71999999994,-1711.199999999997
5293,2022-02-19 08:05:00,-1009.03,101540.48999999995,104260.71999999994,-2720.229999999996
5294,2022-02-19 08:10:00,-497.36,101043.12999999995,104260.71999999994,-3217.5899999999965
5295,2022-02-19 08:15:00,674.49,101717.61999999995,104260.71999999994,-2543.0999999999913
5296,2022-02-19 08:20:00,327.17,102044.78999999995,104260.71999999994,-2215.929999999993
5297,2022-02-19 08:25:00,-1961.82,100082.96999999994,104260.71999999994,-4177.75
5298,2022-02-19 08:30:00,1662.0,101744.96999999994,104260.71999999994,-2515.75
5299,2022-02-19 08:35:00,1625.23,103370.19999999994,104260.71999999994,-890.5200000000041
5300,2022-02-19 08:40:00,471.01,103841.20999999993,104260.71999999994,-419.5100000000093
5301,2022-02-19 08:45:00,-1356.77,102484.43999999993,104260.71999999994,-1776.2800000000134
5302,2022-02-19 08:50:00,-1592.17,100892.26999999993,104260.71999999994,-3368.4500000000116
5303,2022-02-19 08:55:00,1640.25,102532.51999999993,104260.71999999994,-1728.2000000000116
5304,2022-02-19 09:00:00,-1825.19,100707.32999999993,104260.71999999994,-3553.390000000014
5305,2022-02-19 09:05:00,-1267.14,99440.18999999993,104260.71999999994,-4820.530000000013
5306,2022-02-19 09:10:00,-1542.02,97898.16999999993,104260.71999999994,-6362.5500000000175
5307,2022-02-19 09:15:00,1586.65,99484.81999999992,104260.71999999994,-4775.900000000023
5308,2022-02-19 09:20:00,-135.01,99349.80999999992,104260.71999999994,-4910.910000000018
5309,2022-02-19 09:25:00,-1850.93,97498.87999999993,104260.71999999994,-6761.840000000011
5310,2022-02-19 09:30:00,-380.71,97118.16999999993,104260.71999999994,-7142.5500000000175
5311,2022-02-19 09:35:00,705.31,97823.47999999992,104260.71999999994,-6437.24000000002
5312,2022-02-19 09:40:00,-1504.0,96319.47999999992,104260.71999999994,-7941.24000000002
5313,2022-02-19 09:45:00,-1939.04,94380.43999999993,104260.71999999994,-9880.280000000013
5314,2022-02-19 09:50:00,-755.23,93625.20999999993,104260.71999999994,-10635.51000000001
5315,2022-02-19 09:55:00,-1509.52,92115.68999999993,104260.71999999994,-12145.030000000013
5316,2022-02-19 10:00:00,1700.03,93815.71999999993,104260.71999999994,-10445.000000000015
5317,2022-02-19 10:05:00,-762.59,93053.12999999993,104260.71999999994,-11207.590000000011
5318,2022-02-19 10:10:00,1256.69,94309.81999999993,104260.71999999994,-9950.900000000009
5319,2022-02-19 10:15:00,-161.11,94148.70999999993,104260.71999999994,-10112.01000000001
5320,2022-02-19 10:20:00,-1246.93,92901.77999999994,104260.71999999994,-11358.940000000002
5321,2022-02-19 10:25:00,-309.77,92592.00999999994,104260.71999999994,-11668.710000000006
5322,2022-02-19 10:30:00,1350.95,93942.95999999993,104260.71999999994,-10317.76000000001
5323,2022-02-19 10:35:00,-185.28,93757.67999999993,104260.71999999994,-10503.040000000008
5324,2022-02-19 10:40:00,-1681.56,92076.11999999994,104260.71999999994,-12184.600000000006
5325,2022-02-19 10:45:00,-717.64,91358.47999999994,104260.71999999994,-12902.240000000005
5326,2022-02-19 10:50:00,510.68,91869.15999999993,104260.71999999994,-12391.560000000012
5327,2022-02-19 10:55:00,1134.92,93004.07999999993,104260.71999999994,-11256.640000000014
5328,2022-02-19 11:00:00,1291.57,94295.64999999994,104260.71999999994,-9965.070000000007
5329,2022-02-19 11:05:00,442.73,94738.37999999993,104260.71999999994,-9522.340000000011
5330,2022-02-19 11:10:00,-1999.82,92738.55999999992,104260.71999999994,-11522.160000000018
5331,2022-02-19 11:15:00,468.27,93206.82999999993,104260.71999999994,-11053.890000000014
5332,2022-02-19 11:20:00,930.91,94137.73999999993,104260.71999999994,-10122.98000000001
5333,2022-02-19 11:25:00,1052.01,95189.74999999993,104260.71999999994,-9070.970000000016
5334,2022-02-19 11:30:00,758.28,95948.02999999993,104260.71999999994,-8312.690000000017
5335,2022-02-19 11:35:00,-1025.76,94922.26999999993,104260.71999999994,-9338.450000000012
5336,2022-02-19 11:40:00,1128.84,96051.10999999993,104260.71999999994,-8209.610000000015
5337,2022-02-19 11:45:00,1296.38,97347.48999999993,104260.71999999994,-6913.2300000000105
5338,2022-02-19 11:50:00,1235.8,98583.28999999994,104260.71999999994,-5677.430000000008
5339,2022-02-19 11:55:00,1077.37,99660.65999999993,104260.71999999994,-4600.060000000012
5340,2022-02-19 12:00:00,1888.82,101549.47999999994,104260.71999999994,-2711.2400000000052
5341,2022-02-19 12:05:00,1301.16,102850.63999999994,104260.71999999994,-1410.0800000000017
5342,2022-02-19 12:10:00,-444.94,102405.69999999994,104260.71999999994,-1855.020000000004
5343,2022-02-19 12:15:00,-229.69,102176.00999999994,104260.71999999994,-2084.7100000000064
5344,2022-02-19 12:20:00,765.52,102941.52999999994,104260.71999999994,-1319.1900000000023
5345,2022-02-19 12:25:00,-1167.59,101773.93999999994,104260.71999999994,-2486.779999999999
5346,2022-02-19 12:30:00,-642.79,101131.14999999995,104260.71999999994,-3129.5699999999924
5347,2022-02-19 12:35:00,-310.19,100820.95999999995,104260.71999999994,-3439.7599999999948
5348,2022-02-19 12:40:00,-1656.91,99164.04999999994,104260.71999999994,-5096.669999999998
5349,2022-02-19 12:45:00,603.42,99767.46999999994,104260.71999999994,-4493.25
5350,2022-02-19 12:50:00,1460.39,101227.85999999994,104260.71999999994,-3032.8600000000006
5351,2022-02-19 12:55:00,1962.97,103190.82999999994,104260.71999999994,-1069.8899999999994
5352,2022-02-19 13:00:00,-726.29,102464.53999999995,104260.71999999994,-1796.179999999993
5353,2022-02-19 13:05:00,631.21,103095.74999999996,104260.71999999994,-1164.9699999999866
5354,2022-02-19 13:10:00,806.99,103902.73999999996,104260.71999999994,-357.9799999999814
5355,2022-02-19 13:15:00,-1056.08,102846.65999999996,104260.71999999994,-1414.0599999999831
5356,2022-02-19 13:20:00,1296.15,104142.80999999995,104260.71999999994,-117.90999999998894
5357,2022-02-19 13:25:00,-1161.87,102980.93999999996,104260.71999999994,-1279.7799999999843
5358,2022-02-19 13:30:00,-164.32,102816.61999999995,104260.71999999994,-1444.0999999999913
5359,2022-02-19 13:35:00,670.42,103487.03999999995,104260.71999999994,-773.679999999993
5360,2022-02-19 13:40:00,-1791.47,101695.56999999995,104260.71999999994,-2565.149999999994
5361,2022-02-19 13:45:00,-570.59,101124.97999999995,104260.71999999994,-3135.7399999999907
5362,2022-02-19 13:50:00,893.4,102018.37999999995,104260.71999999994,-2242.3399999999965
5363,2022-02-19 13:55:00,-1434.81,100583.56999999995,104260.71999999994,-3677.149999999994
5364,2022-02-19 14:00:00,-332.9,100250.66999999995,104260.71999999994,-4010.0499999999884
5365,2022-02-19 14:05:00,153.33,100403.99999999996,104260.71999999994,-3856.7199999999866
5366,2022-02-19 14:10:00,1215.39,101619.38999999996,104260.71999999994,-2641.329999999987
5367,2022-02-19 14:15:00,-1626.05,99993.33999999995,104260.71999999994,-4267.37999999999
5368,2022-02-19 14:20:00,-1604.52,98388.81999999995,104260.71999999994,-5871.899999999994
5369,2022-02-19 14:25:00,-606.93,97781.88999999996,104260.71999999994,-6478.829999999987
5370,2022-02-19 14:30:00,1958.04,99739.92999999995,104260.71999999994,-4520.789999999994
5371,2022-02-19 14:35:00,-1632.19,98107.73999999995,104260.71999999994,-6152.979999999996
5372,2022-02-19 14:40:00,508.72,98616.45999999995,104260.71999999994,-5644.259999999995
5373,2022-02-19 14:45:00,69.37,98685.82999999994,104260.71999999994,-5574.889999999999
5374,2022-02-19 14:50:00,1817.97,100503.79999999994,104260.71999999994,-3756.9199999999983
5375,2022-02-19 14:55:00,-981.35,99522.44999999994,104260.71999999994,-4738.270000000004
5376,2022-02-19 15:00:00,1870.36,101392.80999999994,104260.71999999994,-2867.9100000000035
5377,2022-02-19 15:05:00,1193.29,102586.09999999993,104260.71999999994,-1674.62000000001
5378,2022-02-19 15:10:00,-137.06,102449.03999999994,104260.71999999994,-1811.6800000000076
5379,2022-02-19 15:15:00,-321.28,102127.75999999994,104260.71999999994,-2132.9600000000064
5380,2022-02-19 15:20:00,516.19,102643.94999999994,104260.71999999994,-1616.770000000004
5381,2022-02-19 15:25:00,-1630.35,101013.59999999993,104260.71999999994,-3247.12000000001
5382,2022-02-19 15:30:00,-1727.35,99286.24999999993,104260.71999999994,-4974.470000000016
5383,2022-02-19 15:35:00,215.54,99501.78999999992,104260.71999999994,-4758.930000000022
5384,2022-02-19 15:40:00,498.94,100000.72999999992,104260.71999999994,-4259.99000000002
5385,2022-02-19 15:45:00,-1832.63,98168.09999999992,104260.71999999994,-6092.620000000024
5386,2022-02-19 15:50:00,1465.56,99633.65999999992,104260.71999999994,-4627.060000000027
5387,2022-02-19 15:55:00,-1276.72,98356.93999999992,104260.71999999994,-5903.780000000028
5388,2022-02-19 16:00:00,1589.58,99946.51999999992,104260.71999999994,-4314.200000000026
5389,2022-02-19 16:05:00,-1676.67,98269.84999999992,104260.71999999994,-5990.870000000024
5390,2022-02-19 16:10:00,1328.66,99598.50999999992,104260.71999999994,-4662.210000000021
5391,2022-02-19 16:15:00,1814.12,101412.62999999992,104260.71999999994,-2848.0900000000256
5392,2022-02-19 16:20:00,-1280.33,100132.29999999992,104260.71999999994,-4128.420000000027
5393,2022-02-19 16:25:00,-21.79,100110.50999999992,104260.71999999994,-4150.210000000021
5394,2022-02-19 16:30:00,-1836.16,98274.34999999992,104260.71999999994,-5986.370000000024
5395,2022-02-19 16:35:00,-1950.18,96324.16999999993,104260.71999999994,-7936.5500000000175
5396,2022-02-19 16:40:00,177.35,96501.51999999993,104260.71999999994,-7759.200000000012
5397,2022-02-19 16:45:00,-82.82,96418.69999999992,104260.71999999994,-7842.020000000019
5398,2022-02-19 16:50:00,900.74,97319.43999999993,104260.71999999994,-6941.280000000013
5399,2022-02-19 16:55:00,1224.46,98543.89999999994,104260.71999999994,-5716.820000000007
5400,2022-02-20 08:00:00,1933.99,100477.88999999994,98543.89999999994,1933.9900000000052
5401,2022-02-20 08:05:00,-1519.49,98958.39999999994,98543.89999999994,414.5
5402,2022-02-20 08:10:00,1040.59,99998.98999999993,98543.89999999994,1455.0899999999965
5403,2022-02-20 08:15:00,-37.48,99961.50999999994,98543.89999999994,1417.6100000000006
5404,2022-02-20 08:20:00,1938.26,101899.76999999993,98543.89999999994,3355.8699999999953
5405,2022-02-20 08:25:00,124.36,102024.12999999993,98543.89999999994,3480.229999999996
5406,2022-02-20 08:30:00,-1048.18,100975.94999999994,98543.89999999994,2432.050000000003
5407,2022-02-20 08:35:00,-356.82,100619.12999999993,98543.89999999994,2075.229999999996
5408,2022-02-20 08:40:00,-1268.13,99350.99999999993,98543.89999999994,807.0999999999913
5409,2022-02-20 08:45:00,-1915.62,97435.37999999993,98543.89999999994,-1108.520000000004
5410,2022-02-20 08:50:00,1119.22,98554.59999999993,98543.89999999994,10.69999999999709
5411,2022-02-20 08:55:00,1713.94,100268.53999999994,98543.89999999994,1724.6399999999994
5412,2022-02-20 09:00:00,-1157.6,99110.93999999993,98543.89999999994,567.0399999999936
5413,2022-02-20 09:05:00,1027.13,100138.06999999993,98543.89999999994,1594.1699999999983
5414,2022-02-20 09:10:00,-1203.22,98934.84999999993,98543.89999999994,390.9499999999971
5415,2022-02-20 09:15:00,-1940.07,96994.77999999993,98543.89999999994,-1549.12000000001
5416,2022-02-20 09:20:00,61.64,97056.41999999993,98543.89999999994,-1487.4800000000105
5417,2022-02-20 09:25:00,1836.55,98892.96999999993,98543.89999999994,349.06999999999243
5418,2022-02-20 09:30:00,559.75,99452.71999999993,98543.89999999994,908.8199999999924
5419,2022-02-20 09:35:00,786.89,100239.60999999993,98543.89999999994,1695.7099999999919
5420,2022-02-20 09:40:00,-1711.29,98528.31999999993,98543.89999999994,-15.580000000001746
5421,2022-02-20 09:45:00,1563.97,100092.28999999994,98543.89999999994,1548.3899999999994
5422,2022-02-20 09:50:00,1892.09,101984.37999999993,98543.89999999994,3440.479999999996
5423,2022-02-20 09:55:00,-1942.51,100041.86999999994,98543.89999999994,1497.9700000000012
5424,2022-02-20 10:00:00,-738.61,99303.25999999994,98543.89999999994,759.3600000000006
5425,2022-02-20 10:05:00,122.99,99426.24999999994,98543.89999999994,882.3500000000058
5426,2022-02-20 10:10:00,519.88,99946.12999999995,98543.89999999994,1402.2300000000105
5427,2022-02-20 10:15:00,-305.03,99641.09999999995,98543.89999999994,1097.2000000000116
5428,2022-02-20 10:20:00,-1532.69,98108.40999999995,98543.89999999994,-435.4899999999907
5429,2022-02-20 10:25:00,-745.46,97362.94999999994,98543.89999999994,-1180.949999999997
5430,2022-02-20 10:30:00,1296.04,98658.98999999993,98543.89999999994,115.08999999999651
5431,2022-02-20 10:35:00,1199.31,99858.29999999993,98543.89999999994,1314.3999999999942
5432,2022-02-20 10:40:00,332.71,100191.00999999994,98543.89999999994,1647.1100000000006
5433,2022-02-20 10:45:00,-936.0,99255.00999999994,98543.89999999994,711.1100000000006
5434,2022-02-20 10:50:00,215.62,99470.62999999993,98543.89999999994,926.7299999999959
5435,2022-02-20 10:55:00,-504.79,98965.83999999994,98543.89999999994,421.9400000000023
5436,2022-02-20 11:00:00,1935.18,100901.01999999993,98543.89999999994,2357.1199999999953
5437,2022-02-20 11:05:00,-178.89,100722.12999999993,98543.89999999994,2178.229999999996
5438,2022-02-20 11:10:00,73.38,100795.50999999994,98543.89999999994,2251.6100000000006
5439,2022-02-20 11:15:00,-783.23,100012.27999999994,98543.89999999994,1468.3800000000047
5440,2022-02-20 11:20:00,194.24,100206.51999999995,98543.89999999994,1662.62000000001
5441,2022-02-20 11:25:00,1804.07,102010.58999999995,98543.89999999994,3466.690000000017
5442,2022-02-20 11:30:00,1761.74,103772.32999999996,98543.89999999994,5228.430000000022
5443,2022-02-20 11:35:00,1202.0,104974.32999999996,98543.89999999994,6430.430000000022
5444,2022-02-20 11:40:00,-1711.3,103263.02999999996,98543.89999999994,4719.130000000019
5445,2022-02-20 11:45:00,-1981.93,101281.09999999996,98543.89999999994,2737.200000000026
5446,2022-02-20 11:50:00,-154.24,101126.85999999996,98543.89999999994,2582.960000000021
5447,2022-02-20 11:55:00,909.07,102035.92999999996,98543.89999999994,3492.030000000028
5448,2022-02-20 12:00:00,1628.11,103664.03999999996,98543.89999999994,5120.1400000000285
5449,2022-02-20 12:05:00,1532.77,105196.80999999997,98543.89999999994,6652.910000000033
5450,2022-02-20 12:10:00,97.37,105294.17999999996,98543.89999999994,6750.280000000028
5451,2022-02-20 12:15:00,-1709.04,103585.13999999997,98543.89999999994,5041.240000000034
5452,2022-02-20 12:20:00,-476.67,103108.46999999997,98543.89999999994,4564.570000000036
5453,2022-02-20 12:25:00,-87.49,103020.97999999997,98543.89999999994,4477.080000000031
5454,2022-02-20 12:30:00,-1706.92,101314.05999999997,98543.89999999994,2770.1600000000326
5455,2022-02-20 12:35:00,1888.66,103202.71999999997,98543.89999999994,4658.820000000036
5456,2022-02-20 12:40:00,-1712.03,101490.68999999997,98543.89999999994,2946.7900000000373
5457,2022-02-20 12:45:00,1390.83,102881.51999999997,98543.89999999994,4337.620000000039
5458,2022-02-20 12:50:00,-419.02,102462.49999999997,98543.89999999994,3918.600000000035
5459,2022-02-20 12:55:00,-1360.4,101102.09999999998,98543.89999999994,2558.2000000000407
5460,2022-02-20 13:00:00,-288.84,100813.25999999998,98543.89999999994,2269.3600000000442
5461,2022-02-20 13:05:00,1758.98,102572.23999999998,98543.89999999994,4028.34000000004
5462,2022-02-20 13:10:00,1073.79,103646.02999999997,98543.89999999994,5102.130000000034
5463,2022-02-20 13:15:00,-1651.27,101994.75999999997,98543.89999999994,3450.8600000000297
5464,2022-02-20 13:20:00,-183.89,101810.86999999997,98543.89999999994,3266.9700000000303
5465,2022-02-20 13:25:00,747.51,102558.37999999996,98543.89999999994,4014.480000000025
5466,2022-02-20 13:30:00,-1452.56,101105.81999999996,98543.89999999994,2561.9200000000274
5467,2022-02-20 13:35:00,-1552.4,99553.41999999997,98543.89999999994,1009.5200000000332
5468,2022-02-20 13:40:00,1907.73,101461.14999999997,98543.89999999994,2917.250000000029
5469,2022-02-20 13:45:00,-1254.04,100207.10999999997,98543.89999999994,1663.2100000000355
5470,2022-02-20 13:50:00,201.72,100408.82999999997,98543.89999999994,1864.9300000000367
5471,2022-02-20 13:55:00,1138.02,101546.84999999998,98543.89999999994,3002.9500000000407
5472,2022-02-20 14:00:00,-1837.08,99709.76999999997,98543.89999999994,1165.870000000039
5473,2022-02-20 14:05:00,1749.86,101459.62999999998,98543.89999999994,2915.7300000000396
5474,2022-02-20 14:10:00,-897.51,100562.11999999998,98543.89999999994,2018.2200000000448
5475,2022-02-20 14:15:00,-140.55,100421.56999999998,98543.89999999994,1877.670000000042
5476,2022-02-20 14:20:00,254.43,100675.99999999997,98543.89999999994,2132.100000000035
5477,2022-02-20 14:25:00,1813.78,102489.77999999997,98543.89999999994,3945.8800000000338
5478,2022-02-20 14:30:00,1352.29,103842.06999999996,98543.89999999994,5298.170000000027
5479,2022-02-20 14:35:00,571.87,104413.93999999996,98543.89999999994,5870.040000000023
5480,2022-02-20 14:40:00,-254.63,104159.30999999995,98543.89999999994,5615.410000000018
5481,2022-02-20 14:45:00,1595.04,105754.34999999995,98543.89999999994,7210.450000000012
5482,2022-02-20 14:50:00,-315.54,105438.80999999995,98543.89999999994,6894.910000000018
5483,2022-02-20 14:55:00,-1123.85,104314.95999999995,98543.89999999994,5771.060000000012
5484,2022-02-20 15:00:00,932.4,105247.35999999994,98543.89999999994,6703.460000000006
5485,2022-02-20 15:05:00,967.1,106214.45999999995,98543.89999999994,7670.560000000012
5486,2022-02-20 15:10:00,392.27,106606.72999999995,98543.89999999994,8062.830000000016
5487,2022-02-20 15:15:00,1318.88,107925.60999999996,98543.89999999994,9381.710000000021
5488,2022-02-20 15:20:00,1169.56,109095.16999999995,98543.89999999994,10551.270000000019
5489,2022-02-20 15:25:00,1800.76,110895.92999999995,98543.89999999994,12352.030000000013
5490,2022-02-20 15:30:00,-355.39,110540.53999999995,98543.89999999994,11996.640000000014
5491,2022-02-20 15:35:00,-622.59,109917.94999999995,98543.89999999994,11374.050000000017
5492,2022-02-20 15:40:00,182.45,110100.39999999995,98543.89999999994,11556.500000000015
5493,2022-02-20 15:45:00,1378.25,111478.64999999995,98543.89999999994,12934.750000000015
5494,2022-02-20 15:50:00,379.17,111857.81999999995,98543.89999999994,13313.920000000013
5495,2022-02-20 15:55:00,-1196.49,110661.32999999994,98543.89999999994,12117.430000000008
5496,2022-02-20 16:00:00,-64.35,110596.97999999994,98543.89999999994,12053.080000000002
5497,2022-02-20 16:05:00,-1008.16,109588.81999999993,98543.89999999994,11044.919999999998
5498,2022-02-20 16:10:00,619.39,110208.20999999993,98543.89999999994,11664.309999999998
5499,2022-02-20 16:15:00,-1896.2,108312.00999999994,98543.89999999994,9768.11
5500,2022-02-20 16:20:00,652.9,108964.90999999993,98543.89999999994,10421.009999999995
5501,2022-02-20 16:25:00,-1071.01,107893.89999999994,98543.89999999994,9350.0
5502,2022-02-20 16:30:00,1675.56,109569.45999999993,98543.89999999994,11025.559999999998
5503,2022-02-20 16:35:00,-195.54,109373.91999999994,98543.89999999994,10830.020000000004
5504,2022-02-20 16:40:00,-920.65,108453.26999999995,98543.89999999994,9909.37000000001
5505,2022-02-20 16:45:00,-420.47,108032.79999999994,98543.89999999994,9488.900000000009
5506,2022-02-20 16:50:00,-542.29,107490.50999999995,98543.89999999994,8946.610000000015
5507,2022-02-20 16:55:00,216.29,107706.79999999994,98543.89999999994,9162.900000000009
5508,2022-02-21 08:00:00,-1576.15,106130.64999999995,107706.79999999994,-1576.1499999999942
5509,2022-02-21 08:05:00,-448.75,105681.89999999995,107706.79999999994,-2024.8999999999942
5510,2022-02-21 08:10:00,-318.77,105363.12999999995,107706.79999999994,-2343.6699999999983
5511,2022-02-21 08:15:00,-464.42,104898.70999999995,107706.79999999994,-2808.0899999999965
5512,2022-02-21 08:20:00,831.07,105729.77999999996,107706.79999999994,-1977.0199999999895
5513,2022-02-21 08:25:00,1127.33,106857.10999999996,107706.79999999994,-849.6899999999878
5514,2022-02-21 08:30:00,831.38,107688.48999999996,107706.79999999994,-18.30999999998312
5515,2022-02-21 08:35:00,-1317.84,106370.64999999997,107706.79999999994,-1336.1499999999796
5516,2022-02-21 08:40:00,1934.02,108304.66999999997,107706.79999999994,597.8700000000244
5517,2022-02-21 08:45:00,396.62,108701.28999999996,107706.79999999994,994.4900000000198
5518,2022-02-21 08:50:00,708.12,109409.40999999996,107706.79999999994,1702.6100000000151
5519,2022-02-21 08:55:00,-429.49,108979.91999999995,107706.79999999994,1273.12000000001
5520,2022-02-21 09:00:00,-60.65,108919.26999999996,107706.79999999994,1212.4700000000157
5521,2022-02-21 09:05:00,38.71,108957.97999999997,107706.79999999994,1251.1800000000221
5522,2022-02-21 09:10:00,-1266.13,107691.84999999996,107706.79999999994,-14.949999999982538
5523,2022-02-21 09:15:00,1383.56,109075.40999999996,107706.79999999994,1368.6100000000151
5524,2022-02-21 09:20:00,-146.94,108928.46999999996,107706.79999999994,1221.6700000000128
5525,2022-02-21 09:25:00,-730.65,108197.81999999996,107706.79999999994,491.0200000000186
5526,2022-02-21 09:30:00,665.46,108863.27999999997,107706.79999999994,1156.480000000025
5527,2022-02-21 09:35:00,435.69,109298.96999999997,107706.79999999994,1592.1700000000274
5528,2022-02-21 09:40:00,-1687.55,107611.41999999997,107706.79999999994,-95.37999999997555
5529,2022-02-21 09:45:00,277.07,107888.48999999998,107706.79999999994,181.69000000003143
5530,2022-02-21 09:50:00,-1922.26,105966.22999999998,107706.79999999994,-1740.5699999999633
5531,2022-02-21 09:55:00,83.07,106049.29999999999,107706.79999999994,-1657.4999999999563
5532,2022-02-21 10:00:00,20.73,106070.02999999998,107706.79999999994,-1636.7699999999604
5533,2022-02-21 10:05:00,-872.04,105197.98999999999,107706.79999999994,-2508.809999999954
5534,2022-02-21 10:10:00,-1350.3,103847.68999999999,107706.79999999994,-3859.109999999957
5535,2022-02-21 10:15:00,56.64,103904.32999999999,107706.79999999994,-3802.4699999999575
5536,2022-02-21 10:20:00,466.31,104370.63999999998,107706.79999999994,-3336.15999999996
5537,2022-02-21 10:25:00,1382.81,105753.44999999998,107706.79999999994,-1953.3499999999622
5538,2022-02-21 10:30:00,-307.21,105446.23999999998,107706.79999999994,-2260.5599999999686
5539,2022-02-21 10:35:00,429.13,105875.36999999998,107706.79999999994,-1831.429999999964
5540,2022-02-21 10:40:00,1148.24,107023.60999999999,107706.79999999994,-683.1899999999587
5541,2022-02-21 10:45:00,1123.82,108147.43,107706.79999999994,440.6300000000483
5542,2022-02-21 10:50:00,1333.81,109481.23999999999,107706.79999999994,1774.440000000046
5543,2022-02-21 10:55:00,710.8,110192.04,107706.79999999994,2485.240000000049
5544,2022-02-21 11:00:00,175.53,110367.56999999999,107706.79999999994,2660.7700000000477
5545,2022-02-21 11:05:00,-418.68,109948.89,107706.79999999994,2242.0900000000547
5546,2022-02-21 11:10:00,-1821.82,108127.06999999999,107706.79999999994,420.27000000004773
5547,2022-02-21 11:15:00,1246.81,109373.87999999999,107706.79999999994,1667.0800000000454
5548,2022-02-21 11:20:00,-309.4,109064.48,107706.79999999994,1357.6800000000512
5549,2022-02-21 11:25:00,477.18,109541.65999999999,107706.79999999994,1834.8600000000442
5550,2022-02-21 11:30:00,188.33,109729.98999999999,107706.79999999994,2023.190000000046
5551,2022-02-21 11:35:00,-261.82,109468.16999999998,107706.79999999994,1761.370000000039
5552,2022-02-21 11:40:00,1346.02,110814.18999999999,107706.79999999994,3107.390000000043
5553,2022-02-21 11:45:00,1404.8,112218.98999999999,107706.79999999994,4512.190000000046
5554,2022-02-21 11:50:00,1882.8,114101.79,107706.79999999994,6394.990000000049
5555,2022-02-21 11:55:00,770.16,114871.95,107706.79999999994,7165.150000000052
5556,2022-02-21 12:00:00,-1131.26,113740.69,107706.79999999994,6033.890000000058
5557,2022-02-21 12:05:00,-416.35,113324.34,107706.79999999994,5617.540000000052
5558,2022-02-21 12:10:00,134.58,113458.92,107706.79999999994,5752.120000000054
5559,2022-02-21 12:15:00,999.88,114458.8,107706.79999999994,6752.000000000058
5560,2022-02-21 12:20:00,-1291.88,113166.92,107706.79999999994,5460.120000000054
5561,2022-02-21 12:25:00,-403.35,112763.56999999999,107706.79999999994,5056.770000000048
5562,2022-02-21 12:30:00,643.3,113406.87,107706.79999999994,5700.070000000051
5563,2022-02-21 12:35:00,-292.23,113114.64,107706.79999999994,5407.840000000055
5564,2022-02-21 12:40:00,-1816.88,111297.76,107706.79999999994,3590.96000000005
5565,2022-02-21 12:45:00,-349.53,110948.23,107706.79999999994,3241.430000000051
5566,2022-02-21 12:50:00,-1007.94,109940.29,107706.79999999994,2233.490000000049
5567,2022-02-21 12:55:00,-707.89,109232.4,107706.79999999994,1525.6000000000495
5568,2022-02-21 13:00:00,1924.27,111156.67,107706.79999999994,3449.8700000000536
5569,2022-02-21 13:05:00,-917.51,110239.16,107706.79999999994,2532.360000000059
5570,2022-02-21 13:10:00,-125.37,110113.79000000001,107706.79999999994,2406.9900000000634
5571,2022-02-21 13:15:00,726.77,110840.56000000001,107706.79999999994,3133.7600000000675
5572,2022-02-21 13:20:00,-1025.38,109815.18000000001,107706.79999999994,2108.380000000063
5573,2022-02-21 13:25:00,-692.95,109122.23000000001,107706.79999999994,1415.4300000000658
5574,2022-02-21 13:30:00,-1158.07,107964.16,107706.79999999994,257.3600000000588
5575,2022-02-21 13:35:00,1763.58,109727.74,107706.79999999994,2020.9400000000605
5576,2022-02-21 13:40:00,1095.97,110823.71,107706.79999999994,3116.9100000000617
5577,2022-02-21 13:45:00,181.08,111004.79000000001,107706.79999999994,3297.9900000000634
5578,2022-02-21 13:50:00,1584.33,112589.12000000001,107706.79999999994,4882.320000000065
5579,2022-02-21 13:55:00,1012.97,113602.09000000001,107706.79999999994,5895.290000000066
5580,2022-02-21 14:00:00,1.92,113604.01000000001,107706.79999999994,5897.210000000065
5581,2022-02-21 14:05:00,483.76,114087.77,107706.79999999994,6380.970000000059
5582,2022-02-21 14:10:00,-1053.54,113034.23000000001,107706.79999999994,5327.430000000066
5583,2022-02-21 14:15:00,56.9,113091.13,107706.79999999994,5384.33000000006
5584,2022-02-21 14:20:00,910.19,114001.32,107706.79999999994,6294.520000000062
5585,2022-02-21 14:25:00,-459.3,113542.02,107706.79999999994,5835.220000000059
5586,2022-02-21 14:30:00,21.56,113563.58,107706.79999999994,5856.780000000057
5587,2022-02-21 14:35:00,-1386.34,112177.24,107706.79999999994,4470.4400000000605
5588,2022-02-21 14:40:00,346.57,112523.81000000001,107706.79999999994,4817.0100000000675
5589,2022-02-21 14:45:00,-1075.94,111447.87000000001,107706.79999999994,3741.070000000065
5590,2022-02-21 14:50:00,-988.66,110459.21,107706.79999999994,2752.4100000000617
5591,2022-02-21 14:55:00,114.27,110573.48000000001,107706.79999999994,2866.680000000066
5592,2022-02-21 15:00:00,-1162.15,109411.33000000002,107706.79999999994,1704.5300000000716
5593,2022-02-21 15:05:00,679.09,110090.42000000001,107706.79999999994,2383.620000000068
5594,2022-02-21 15:10:00,723.38,110813.80000000002,107706.79999999994,3107.0000000000728
5595,2022-02-21 15:15:00,-1305.41,109508.39000000001,107706.79999999994,1801.5900000000693
5596,2022-02-21 15:20:00,-192.07,109316.32,107706.79999999994,1609.5200000000623
5597,2022-02-21 15:25:00,-1232.67,108083.65000000001,107706.79999999994,376.85000000006403
5598,2022-02-21 15:30:00,1539.93,109623.58,107706.79999999994,1916.780000000057
5599,2022-02-21 15:35:00,1955.91,111579.49,107706.79999999994,3872.6900000000605
5600,2022-02-21 15:40:00,-26.39,111553.1,107706.79999999994,3846.300000000061
5601,2022-02-21 15:45:00,-259.08,111294.02,107706.79999999994,3587.2200000000594
5602,2022-02-21 15:50:00,247.58,111541.6,107706.79999999994,3834.800000000061
5603,2022-02-21 15:55:00,710.74,112252.34000000001,107706.79999999994,4545.540000000066
5604,2022-02-21 16:00:00,1800.72,114053.06000000001,107706.79999999994,6346.2600000000675
5605,2022-02-21 16:05:00,-1883.85,112169.21,107706.79999999994,4462.410000000062
5606,2022-02-21 16:10:00,1234.5,113403.71,107706.79999999994,5696.910000000062
5607,2022-02-21 16:15:00,-1762.19,111641.52,107706.79999999994,3934.7200000000594
5608,2022-02-21 16:20:00,1783.98,113425.5,107706.79999999994,5718.700000000055
5609,2022-02-21 16:25:00,353.91,113779.41,107706.79999999994,6072.610000000059
5610,2022-02-21 16:30:00,-1354.05,112425.36,107706.79999999994,4718.560000000056
5611,2022-02-21 16:35:00,-1831.8,110593.56,107706.79999999994,2886.760000000053
5612,2022-02-21 16:40:00,857.07,111450.63,107706.79999999994,3743.83000000006
5613,2022-02-21 16:45:00,1386.14,112836.77,107706.79999999994,5129.970000000059
5614,2022-02-21 16:50:00,-1282.48,111554.29000000001,107706.79999999994,3847.4900000000634
5615,2022-02-21 16:55:00,1029.31,112583.6,107706.79999999994,4876.800000000061
5616,2022-02-22 08:00:00,-631.62,111951.98000000001,112583.6,-631.6199999999953
5617,2022-02-22 08:05:00,-1596.35,110355.63,112583.6,-2227.970000000001
5618,2022-02-22 08:10:00,-1151.25,109204.38,112583.6,-3379.220000000001
5619,2022-02-22 08:15:00,1238.02,110442.40000000001,112583.6,-2141.199999999997
5620,2022-02-22 08:20:00,-407.48,110034.92000000001,112583.6,-2548.679999999993
5621,2022-02-22 08:25:00,-629.37,109405.55000000002,112583.6,-3178.0499999999884
5622,2022-02-22 08:30:00,-1465.59,107939.96000000002,112583.6,-4643.639999999985
5623,2022-02-22 08:35:00,18.58,107958.54000000002,112583.6,-4625.059999999983
5624,2022-02-22 08:40:00,-1442.67,106515.87000000002,112583.6,-6067.729999999981
5625,2022-02-22 08:45:00,473.55,106989.42000000003,112583.6,-5594.1799999999785
5626,2022-02-22 08:50:00,561.08,107550.50000000003,112583.6,-5033.099999999977
5627,2022-02-22 08:55:00,1821.15,109371.65000000002,112583.6,-3211.9499999999825
5628,2022-02-22 09:00:00,1256.66,110628.31000000003,112583.6,-1955.289999999979
5629,2022-02-22 09:05:00,-625.74,110002.57000000002,112583.6,-2581.0299999999843
5630,2022-02-22 09:10:00,-346.49,109656.08000000002,112583.6,-2927.5199999999895
5631,2022-02-22 09:15:00,1276.74,110932.82000000002,112583.6,-1650.7799999999843
5632,2022-02-22 09:20:00,918.37,111851.19000000002,112583.6,-732.4099999999889
5633,2022-02-22 09:25:00,-110.76,111740.43000000002,112583.6,-843.1699999999837
5634,2022-02-22 09:30:00,253.11,111993.54000000002,112583.6,-590.0599999999831
5635,2022-02-22 09:35:00,-28.97,111964.57000000002,112583.6,-619.0299999999843
5636,2022-02-22 09:40:00,1407.97,113372.54000000002,112583.6,788.9400000000169
5637,2022-02-22 09:45:00,-1443.44,111929.10000000002,112583.6,-654.4999999999854
5638,2022-02-22 09:50:00,-1210.76,110718.34000000003,112583.6,-1865.2599999999802
5639,2022-02-22 09:55:00,-1704.51,109013.83000000003,112583.6,-3569.769999999975
5640,2022-02-22 10:00:00,639.83,109653.66000000003,112583.6,-2929.939999999973
5641,2022-02-22 10:05:00,1407.04,111060.70000000003,112583.6,-1522.8999999999796
5642,2022-02-22 10:10:00,-330.35,110730.35000000002,112583.6,-1853.2499999999854
5643,2022-02-22 10:15:00,1213.95,111944.30000000002,112583.6,-639.2999999999884
5644,2022-02-22 10:20:00,1498.66,113442.96000000002,112583.6,859.3600000000151
5645,2022-02-22 10:25:00,-1821.14,111621.82000000002,112583.6,-961.7799999999843
5646,2022-02-22 10:30:00,25.16,111646.98000000003,112583.6,-936.6199999999808
5647,2022-02-22 10:35:00,-357.56,111289.42000000003,112583.6,-1294.1799999999785
5648,2022-02-22 10:40:00,-446.98,110842.44000000003,112583.6,-1741.1599999999744
5649,2022-02-22 10:45:00,-896.07,109946.37000000002,112583.6,-2637.2299999999814
5650,2022-02-22 10:50:00,-745.94,109200.43000000002,112583.6,-3383.1699999999837
5651,2022-02-22 10:55:00,928.26,110128.69000000002,112583.6,-2454.909999999989
5652,2022-02-22 11:00:00,-513.77,109614.92000000001,112583.6,-2968.679999999993
5653,2022-02-22 11:05:00,-933.53,108681.39000000001,112583.6,-3902.209999999992
5654,2022-02-22 11:10:00,1935.86,110617.25000000001,112583.6,-1966.3499999999913
5655,2022-02-22 11:15:00,1813.9,112431.15000000001,112583.6,-152.4499999999971
5656,2022-02-22 11:20:00,-1623.6,110807.55,112583.6,-1776.050000000003
5657,2022-02-22 11:25:00,-1881.96,108925.59,112583.6,-3658.0100000000093
5658,2022-02-22 11:30:00,37.19,108962.78,112583.6,-3620.820000000007
5659,2022-02-22 11:35:00,836.12,109798.9,112583.6,-2784.7000000000116
5660,2022-02-22 11:40:00,1589.06,111387.95999999999,112583.6,-1195.640000000014
5661,2022-02-22 11:45:00,507.21,111895.17,112583.6,-688.4300000000076
5662,2022-02-22 11:50:00,-1888.99,110006.18,112583.6,-2577.420000000013
5663,2022-02-22 11:55:00,-419.08,109587.09999999999,112583.6,-2996.5000000000146
5664,2022-02-22 12:00:00,-1987.71,107599.38999999998,112583.6,-4984.210000000021
5665,2022-02-22 12:05:00,-1854.62,105744.76999999999,112583.6,-6838.830000000016
5666,2022-02-22 12:10:00,450.87,106195.63999999998,112583.6,-6387.960000000021
5667,2022-02-22 12:15:00,1489.57,107685.20999999999,112583.6,-4898.390000000014
5668,2022-02-22 12:20:00,937.26,108622.46999999999,112583.6,-3961.130000000019
5669,2022-02-22 12:25:00,407.31,109029.77999999998,112583.6,-3553.8200000000215
5670,2022-02-22 12:30:00,709.35,109739.12999999999,112583.6,-2844.4700000000157
5671,2022-02-22 12:35:00,324.81,110063.93999999999,112583.6,-2519.660000000018
5672,2022-02-22 12:40:00,-582.65,109481.29,112583.6,-3102.310000000012
5673,2022-02-22 12:45:00,-1272.37,108208.92,112583.6,-4374.680000000008
5674,2022-02-22 12:50:00,301.13,108510.05,112583.6,-4073.550000000003
5675,2022-02-22 12:55:00,-357.71,108152.34,112583.6,-4431.260000000009
5676,2022-02-22 13:00:00,-349.84,107802.5,112583.6,-4781.100000000006
5677,2022-02-22 13:05:00,-388.66,107413.84,112583.6,-5169.760000000009
5678,2022-02-22 13:10:00,237.93,107651.76999999999,112583.6,-4931.830000000016
5679,2022-02-22 13:15:00,-452.93,107198.84,112583.6,-5384.760000000009
5680,2022-02-22 13:20:00,-1027.03,106171.81,112583.6,-6411.790000000008
5681,2022-02-22 13:25:00,1913.04,108084.84999999999,112583.6,-4498.750000000015
5682,2022-02-22 13:30:00,1714.65,109799.49999999999,112583.6,-2784.1000000000204
5683,2022-02-22 13:35:00,575.63,110375.12999999999,112583.6,-2208.4700000000157
5684,2022-02-22 13:40:00,1634.11,112009.23999999999,112583.6,-574.3600000000151
5685,2022-02-22 13:45:00,1398.21,113407.45,112583.6,823.8499999999913
5686,2022-02-22 13:50:00,1399.49,114806.94,112583.6,2223.3399999999965
5687,2022-02-22 13:55:00,-717.45,114089.49,112583.6,1505.8899999999994
5688,2022-02-22 14:00:00,841.05,114930.54000000001,112583.6,2346.9400000000023
5689,2022-02-22 14:05:00,-1272.47,113658.07,112583.6,1074.4700000000012
5690,2022-02-22 14:10:00,25.55,113683.62000000001,112583.6,1100.020000000004
5691,2022-02-22 14:15:00,-1669.82,112013.8,112583.6,-569.8000000000029
5692,2022-02-22 14:20:00,-1516.06,110497.74,112583.6,-2085.8600000000006
5693,2022-02-22 14:25:00,-1900.26,108597.48000000001,112583.6,-3986.1199999999953
5694,2022-02-22 14:30:00,1058.89,109656.37000000001,112583.6,-2927.229999999996
5695,2022-02-22 14:35:00,805.55,110461.92000000001,112583.6,-2121.679999999993
5696,2022-02-22 14:40:00,1408.92,111870.84000000001,112583.6,-712.7599999999948
5697,2022-02-22 14:45:00,1825.72,113696.56000000001,112583.6,1112.9600000000064
5698,2022-02-22 14:50:00,-687.81,113008.75000000001,112583.6,425.15000000000873
5699,2022-02-22 14:55:00,-877.75,112131.00000000001,112583.6,-452.59999999999127
5700,2022-02-22 15:00:00,-1989.59,110141.41000000002,112583.6,-2442.189999999988
5701,2022-02-22 15:05:00,-1383.39,108758.02000000002,112583.6,-3825.579999999987
5702,2022-02-22 15:10:00,1876.11,110634.13000000002,112583.6,-1949.4699999999866
5703,2022-02-22 15:15:00,90.72,110724.85000000002,112583.6,-1858.7499999999854
5704,2022-02-22 15:20:00,1656.62,112381.47000000002,112583.6,-202.1299999999901
5705,2022-02-22 15:25:00,587.12,112968.59000000001,112583.6,384.99000000000524
5706,2022-02-22 15:30:00,-1914.5,111054.09000000001,112583.6,-1529.5099999999948
5707,2022-02-22 15:35:00,419.13,111473.22000000002,112583.6,-1110.37999999999
5708,2022-02-22 15:40:00,-1082.72,110390.50000000001,112583.6,-2193.0999999999913
5709,2022-02-22 15:45:00,485.13,110875.63000000002,112583.6,-1707.9699999999866
5710,2022-02-22 15:50:00,-5.1,110870.53000000001,112583.6,-1713.0699999999924
5711,2022-02-22 15:55:00,-1148.86,109721.67000000001,112583.6,-2861.929999999993
5712,2022-02-22 16:00:00,-835.86,108885.81000000001,112583.6,-3697.7899999999936
5713,2022-02-22 16:05:00,-1045.3,107840.51000000001,112583.6,-4743.0899999999965
5714,2022-02-22 16:10:00,365.61,108206.12000000001,112583.6,-4377.479999999996
5715,2022-02-22 16:15:00,-1345.16,106860.96,112583.6,-5722.639999999999
5716,2022-02-22 16:20:00,864.35,107725.31000000001,112583.6,-4858.289999999994
5717,2022-02-22 16:25:00,985.2,108710.51000000001,112583.6,-3873.0899999999965
5718,2022-02-22 16:30:00,-1278.37,107432.14000000001,112583.6,-5151.459999999992
5719,2022-02-22 16:35:00,67.1,107499.24000000002,112583.6,-5084.359999999986
5720,2022-02-22 16:40:00,933.39,108432.63000000002,112583.6,-4150.969999999987
5721,2022-02-22 16:45:00,947.61,109380.24000000002,112583.6,-3203.359999999986
5722,2022-02-22 16:50:00,-591.28,108788.96000000002,112583.6,-3794.639999999985
5723,2022-02-22 16:55:00,429.79,109218.75000000001,112583.6,-3364.8499999999913
5724,2022-02-23 08:00:00,1129.85,110348.60000000002,109218.75000000001,1129.8500000000058
5725,2022-02-23 08:05:00,1847.46,112196.06000000003,109218.75000000001,2977.310000000012
5726,2022-02-23 08:10:00,-698.07,111497.99000000002,109218.75000000001,2279.2400000000052
5727,2022-02-23 08:15:00,1726.06,113224.05000000002,109218.75000000001,4005.300000000003
5728,2022-02-23 08:20:00,1271.55,114495.60000000002,109218.75000000001,5276.850000000006
5729,2022-02-23 08:25:00,18.15,114513.75000000001,109218.75000000001,5295.0
5730,2022-02-23 08:30:00,-345.03,114168.72000000002,109218.75000000001,4949.970000000001
5731,2022-02-23 08:35:00,1799.53,115968.25000000001,109218.75000000001,6749.5
5732,2022-02-23 08:40:00,148.46,116116.71000000002,109218.75000000001,6897.960000000006
5733,2022-02-23 08:45:00,1604.7,117721.41000000002,109218.75000000001,8502.660000000003
5734,2022-02-23 08:50:00,726.22,118447.63000000002,109218.75000000001,9228.880000000005
5735,2022-02-23 08:55:00,216.63,118664.26000000002,109218.75000000001,9445.51000000001
5736,2022-02-23 09:00:00,1163.84,119828.10000000002,109218.75000000001,10609.350000000006
5737,2022-02-23 09:05:00,-233.42,119594.68000000002,109218.75000000001,10375.930000000008
5738,2022-02-23 09:10:00,-150.16,119444.52000000002,109218.75000000001,10225.770000000004
5739,2022-02-23 09:15:00,-23.35,119421.17000000001,109218.75000000001,10202.419999999998
5740,2022-02-23 09:20:00,1897.53,121318.70000000001,109218.75000000001,12099.949999999997
5741,2022-02-23 09:25:00,434.95,121753.65000000001,109218.75000000001,12534.899999999994
5742,2022-02-23 09:30:00,1873.06,123626.71,109218.75000000001,14407.959999999992
5743,2022-02-23 09:35:00,-1731.79,121894.92000000001,109218.75000000001,12676.169999999998
5744,2022-02-23 09:40:00,-126.29,121768.63000000002,109218.75000000001,12549.880000000005
5745,2022-02-23 09:45:00,1493.54,123262.17000000001,109218.75000000001,14043.419999999998
5746,2022-02-23 09:50:00,1695.99,124958.16000000002,109218.75000000001,15739.410000000003
5747,2022-02-23 09:55:00,-335.27,124622.89000000001,109218.75000000001,15404.14
5748,2022-02-23 10:00:00,1405.82,126028.71000000002,109218.75000000001,16809.960000000006
5749,2022-02-23 10:05:00,977.65,127006.36000000002,109218.75000000001,17787.61
5750,2022-02-23 10:10:00,-720.06,126286.30000000002,109218.75000000001,17067.550000000003
5751,2022-02-23 10:15:00,-609.73,125676.57000000002,109218.75000000001,16457.820000000007
5752,2022-02-23 10:20:00,-1716.64,123959.93000000002,109218.75000000001,14741.180000000008
5753,2022-02-23 10:25:00,-898.84,123061.09000000003,109218.75000000001,13842.340000000011
5754,2022-02-23 10:30:00,1111.92,124173.01000000002,109218.75000000001,14954.26000000001
5755,2022-02-23 10:35:00,-498.49,123674.52000000002,109218.75000000001,14455.770000000004
5756,2022-02-23 10:40:00,308.29,123982.81000000001,109218.75000000001,14764.059999999998
5757,2022-02-23 10:45:00,-235.43,123747.38000000002,109218.75000000001,14528.630000000005
5758,2022-02-23 10:50:00,-1298.7,122448.68000000002,109218.75000000001,13229.930000000008
5759,2022-02-23 10:55:00,-910.41,121538.27000000002,109218.75000000001,12319.520000000004
5760,2022-02-23 11:00:00,1528.28,123066.55000000002,109218.75000000001,13847.800000000003
5761,2022-02-23 11:05:00,-1694.42,121372.13000000002,109218.75000000001,12153.380000000005
5762,2022-02-23 11:10:00,353.66,121725.79000000002,109218.75000000001,12507.040000000008
5763,2022-02-23 11:15:00,-311.06,121414.73000000003,109218.75000000001,12195.98000000001
5764,2022-02-23 11:20:00,-763.39,120651.34000000003,109218.75000000001,11432.590000000011
5765,2022-02-23 11:25:00,1759.1,122410.44000000003,109218.75000000001,13191.690000000017
5766,2022-02-23 11:30:00,-1275.07,121135.37000000002,109218.75000000001,11916.62000000001
5767,2022-02-23 11:35:00,-582.03,120553.34000000003,109218.75000000001,11334.590000000011
5768,2022-02-23 11:40:00,1781.32,122334.66000000003,109218.75000000001,13115.910000000018
5769,2022-02-23 11:45:00,1977.12,124311.78000000003,109218.75000000001,15093.030000000013
5770,2022-02-23 11:50:00,1545.17,125856.95000000003,109218.75000000001,16638.20000000001
5771,2022-02-23 11:55:00,-325.72,125531.23000000003,109218.75000000001,16312.48000000001
5772,2022-02-23 12:00:00,1781.54,127312.77000000002,109218.75000000001,18094.020000000004
5773,2022-02-23 12:05:00,552.27,127865.04000000002,109218.75000000001,18646.290000000008
5774,2022-02-23 12:10:00,-330.33,127534.71000000002,109218.75000000001,18315.960000000006
5775,2022-02-23 12:15:00,-1076.56,126458.15000000002,109218.75000000001,17239.40000000001
5776,2022-02-23 12:20:00,-1544.74,124913.41000000002,109218.75000000001,15694.660000000003
5777,2022-02-23 12:25:00,82.13,124995.54000000002,109218.75000000001,15776.790000000008
5778,2022-02-23 12:30:00,-496.9,124498.64000000003,109218.75000000001,15279.890000000014
5779,2022-02-23 12:35:00,449.67,124948.31000000003,109218.75000000001,15729.560000000012
5780,2022-02-23 12:40:00,-1861.23,123087.08000000003,109218.75000000001,13868.330000000016
5781,2022-02-23 12:45:00,1545.0,124632.08000000003,109218.75000000001,15413.330000000016
5782,2022-02-23 12:50:00,316.89,124948.97000000003,109218.75000000001,15730.220000000016
5783,2022-02-23 12:55:00,530.65,125479.62000000002,109218.75000000001,16260.87000000001
5784,2022-02-23 13:00:00,1396.64,126876.26000000002,109218.75000000001,17657.51000000001
5785,2022-02-23 13:05:00,810.4,127686.66000000002,109218.75000000001,18467.910000000003
5786,2022-02-23 13:10:00,1424.83,129111.49000000002,109218.75000000001,19892.740000000005
5787,2022-02-23 13:15:00,-513.51,128597.98000000003,109218.75000000001,19379.23000000001
5788,2022-02-23 13:20:00,-1655.85,126942.13000000002,109218.75000000001,17723.380000000005
5789,2022-02-23 13:25:00,61.22,127003.35000000002,109218.75000000001,17784.600000000006
5790,2022-02-23 13:30:00,-9.3,126994.05000000002,109218.75000000001,17775.300000000003
5791,2022-02-23 13:35:00,637.48,127631.53000000001,109218.75000000001,18412.78
5792,2022-02-23 13:40:00,1552.86,129184.39000000001,109218.75000000001,19965.64
5793,2022-02-23 13:45:00,445.89,129630.28000000001,109218.75000000001,20411.53
5794,2022-02-23 13:50:00,284.73,129915.01000000001,109218.75000000001,20696.259999999995
5795,2022-02-23 13:55:00,620.47,130535.48000000001,109218.75000000001,21316.729999999996
5796,2022-02-23 14:00:00,1754.3,132289.78,109218.75000000001,23071.029999999984
5797,2022-02-23 14:05:00,477.21,132766.99,109218.75000000001,23548.239999999976
5798,2022-02-23 14:10:00,-1715.03,131051.95999999999,109218.75000000001,21833.209999999977
5799,2022-02-23 14:15:00,1024.69,132076.65,109218.75000000001,22857.89999999998
5800,2022-02-23 14:20:00,-617.66,131458.99,109218.75000000001,22240.239999999976
5801,2022-02-23 14:25:00,1042.43,132501.41999999998,109218.75000000001,23282.66999999997
5802,2022-02-23 14:30:00,-1716.24,130785.17999999998,109218.75000000001,21566.429999999964
5803,2022-02-23 14:35:00,-9.89,130775.28999999998,109218.75000000001,21556.539999999964
5804,2022-02-23 14:40:00,-205.75,130569.53999999998,109218.75000000001,21350.789999999964
5805,2022-02-23 14:45:00,1176.65,131746.18999999997,109218.75000000001,22527.43999999996
5806,2022-02-23 14:50:00,1900.13,133646.31999999998,109218.75000000001,24427.569999999963
5807,2022-02-23 14:55:00,849.42,134495.74,109218.75000000001,25276.989999999976
5808,2022-02-23 15:00:00,1828.67,136324.41,109218.75000000001,27105.65999999999
5809,2022-02-23 15:05:00,1209.27,137533.68,109218.75000000001,28314.92999999998
5810,2022-02-23 15:10:00,-456.72,137076.96,109218.75000000001,27858.209999999977
5811,2022-02-23 15:15:00,-1487.76,135589.19999999998,109218.75000000001,26370.449999999968
5812,2022-02-23 15:20:00,-1009.91,134579.28999999998,109218.75000000001,25360.539999999964
5813,2022-02-23 15:25:00,-1773.34,132805.94999999998,109218.75000000001,23587.199999999968
5814,2022-02-23 15:30:00,-183.45,132622.49999999997,109218.75000000001,23403.749999999956
5815,2022-02-23 15:35:00,1189.81,133812.30999999997,109218.75000000001,24593.559999999954
5816,2022-02-23 15:40:00,-1799.09,132013.21999999997,109218.75000000001,22794.469999999958
5817,2022-02-23 15:45:00,1828.07,133841.28999999998,109218.75000000001,24622.539999999964
5818,2022-02-23 15:50:00,836.79,134678.08,109218.75000000001,25459.329999999973
5819,2022-02-23 15:55:00,1084.89,135762.97,109218.75000000001,26544.219999999987
5820,2022-02-23 16:00:00,76.75,135839.72,109218.75000000001,26620.969999999987
5821,2022-02-23 16:05:00,-316.9,135522.82,109218.75000000001,26304.069999999992
5822,2022-02-23 16:10:00,-1986.28,133536.54,109218.75000000001,24317.789999999994
5823,2022-02-23 16:15:00,-894.64,132641.9,109218.75000000001,23423.14999999998
5824,2022-02-23 16:20:00,-31.01,132610.88999999998,109218.75000000001,23392.13999999997
5825,2022-02-23 16:25:00,-1110.53,131500.36,109218.75000000001,22281.60999999997
5826,2022-02-23 16:30:00,334.52,131834.87999999998,109218.75000000001,22616.12999999996
5827,2022-02-23 16:35:00,334.12,132168.99999999997,109218.75000000001,22950.249999999956
5828,2022-02-23 16:40:00,-1529.82,130639.17999999996,109218.75000000001,21420.42999999995
5829,2022-02-23 16:45:00,554.4,131193.57999999996,109218.75000000001,21974.829999999944
5830,2022-02-23 16:50:00,-1206.15,129987.42999999996,109218.75000000001,20768.67999999995
5831,2022-02-23 16:55:00,-479.92,129507.50999999997,109218.75000000001,20288.75999999995
5832,2022-02-24 08:00:00,-1350.35,128157.15999999996,129507.50999999997,-1350.3500000000058
5833,2022-02-24 08:05:00,-1828.53,126328.62999999996,129507.50999999997,-3178.8800000000047
5834,2022-02-24 08:10:00,-1933.1,124395.52999999996,129507.50999999997,-5111.9800000000105
5835,2022-02-24 08:15:00,1773.03,126168.55999999995,129507.50999999997,-3338.9500000000116
5836,2022-02-24 08:20:00,-1630.18,124538.37999999996,129507.50999999997,-4969.130000000005
5837,2022-02-24 08:25:00,-182.82,124355.55999999995,129507.50999999997,-5151.950000000012
5838,2022-02-24 08:30:00,-1206.97,123148.58999999995,129507.50999999997,-6358.920000000013
5839,2022-02-24 08:35:00,982.93,124131.51999999995,129507.50999999997,-5375.99000000002
5840,2022-02-24 08:40:00,937.91,125069.42999999995,129507.50999999997,-4438.080000000016
5841,2022-02-24 08:45:00,1335.65,126405.07999999994,129507.50999999997,-3102.430000000022
5842,2022-02-24 08:50:00,281.94,126687.01999999995,129507.50999999997,-2820.49000000002
5843,2022-02-24 08:55:00,-251.95,126435.06999999995,129507.50999999997,-3072.440000000017
5844,2022-02-24 09:00:00,720.35,127155.41999999995,129507.50999999997,-2352.090000000011
5845,2022-02-24 09:05:00,223.09,127378.50999999995,129507.50999999997,-2129.0000000000146
5846,2022-02-24 09:10:00,1659.58,129038.08999999995,129507.50999999997,-469.4200000000128
5847,2022-02-24 09:15:00,-1109.77,127928.31999999995,129507.50999999997,-1579.1900000000169
5848,2022-02-24 09:20:00,-886.56,127041.75999999995,129507.50999999997,-2465.7500000000146
5849,2022-02-24 09:25:00,142.46,127184.21999999996,129507.50999999997,-2323.290000000008
5850,2022-02-24 09:30:00,1963.04,129147.25999999995,129507.50999999997,-360.25000000001455
5851,2022-02-24 09:35:00,240.17,129387.42999999995,129507.50999999997,-120.0800000000163
5852,2022-02-24 09:40:00,-1946.4,127441.02999999996,129507.50999999997,-2066.4800000000105
5853,2022-02-24 09:45:00,345.51,127786.53999999995,129507.50999999997,-1720.9700000000157
5854,2022-02-24 09:50:00,-247.98,127538.55999999995,129507.50999999997,-1968.9500000000116
5855,2022-02-24 09:55:00,736.07,128274.62999999996,129507.50999999997,-1232.8800000000047
5856,2022-02-24 10:00:00,1320.83,129595.45999999996,129507.50999999997,87.94999999999709
5857,2022-02-24 10:05:00,922.76,130518.21999999996,129507.50999999997,1010.7099999999919
5858,2022-02-24 10:10:00,-1815.35,128702.86999999995,129507.50999999997,-804.640000000014
5859,2022-02-24 10:15:00,1805.9,130508.76999999995,129507.50999999997,1001.2599999999802
5860,2022-02-24 10:20:00,-1154.8,129353.96999999994,129507.50999999997,-153.5400000000227
5861,2022-02-24 10:25:00,787.84,130141.80999999994,129507.50999999997,634.2999999999738
5862,2022-02-24 10:30:00,575.22,130717.02999999994,129507.50999999997,1209.519999999975
5863,2022-02-24 10:35:00,-1050.08,129666.94999999994,129507.50999999997,159.43999999997322
5864,2022-02-24 10:40:00,-946.61,128720.33999999994,129507.50999999997,-787.1700000000274
5865,2022-02-24 10:45:00,-1285.32,127435.01999999993,129507.50999999997,-2072.4900000000343
5866,2022-02-24 10:50:00,1573.54,129008.55999999992,129507.50999999997,-498.95000000004075
5867,2022-02-24 10:55:00,1449.71,130458.26999999993,129507.50999999997,950.7599999999657
5868,2022-02-24 11:00:00,-445.25,130013.01999999993,129507.50999999997,505.50999999996566
5869,2022-02-24 11:05:00,-535.44,129477.57999999993,129507.50999999997,-29.93000000003667
5870,2022-02-24 11:10:00,1984.47,131462.04999999993,129507.50999999997,1954.5399999999645
5871,2022-02-24 11:15:00,-1749.6,129712.44999999992,129507.50999999997,204.93999999995867
5872,2022-02-24 11:20:00,520.59,130233.03999999992,129507.50999999997,725.5299999999552
5873,2022-02-24 11:25:00,709.02,130942.05999999992,129507.50999999997,1434.5499999999593
5874,2022-02-24 11:30:00,635.94,131577.9999999999,129507.50999999997,2070.489999999947
5875,2022-02-24 11:35:00,379.35,131957.34999999992,129507.50999999997,2449.839999999953
5876,2022-02-24 11:40:00,-798.92,131158.4299999999,129507.50999999997,1650.91999999994
5877,2022-02-24 11:45:00,604.05,131762.4799999999,129507.50999999997,2254.9699999999284
5878,2022-02-24 11:50:00,-1544.48,130217.9999999999,129507.50999999997,710.4899999999325
5879,2022-02-24 11:55:00,1530.64,131748.6399999999,129507.50999999997,2241.129999999932
5880,2022-02-24 12:00:00,560.65,132309.2899999999,129507.50999999997,2801.779999999926
5881,2022-02-24 12:05:00,383.01,132692.2999999999,129507.50999999997,3184.7899999999354
5882,2022-02-24 12:10:00,336.23,133028.5299999999,129507.50999999997,3521.019999999946
5883,2022-02-24 12:15:00,-272.64,132755.8899999999,129507.50999999997,3248.379999999932
5884,2022-02-24 12:20:00,-338.88,132417.0099999999,129507.50999999997,2909.4999999999272
5885,2022-02-24 12:25:00,-724.52,131692.4899999999,129507.50999999997,2184.9799999999377
5886,2022-02-24 12:30:00,-29.85,131662.6399999999,129507.50999999997,2155.129999999932
5887,2022-02-24 12:35:00,1640.44,133303.0799999999,129507.50999999997,3795.569999999934
5888,2022-02-24 12:40:00,1723.34,135026.4199999999,129507.50999999997,5518.909999999931
5889,2022-02-24 12:45:00,-530.24,134496.1799999999,129507.50999999997,4988.66999999994
5890,2022-02-24 12:50:00,-908.16,133588.0199999999,129507.50999999997,4080.5099999999366
5891,2022-02-24 12:55:00,-684.82,132903.1999999999,129507.50999999997,3395.6899999999296
5892,2022-02-24 13:00:00,-469.66,132433.5399999999,129507.50999999997,2926.029999999926
5893,2022-02-24 13:05:00,-804.05,131629.4899999999,129507.50999999997,2121.9799999999377
5894,2022-02-24 13:10:00,1572.05,133201.5399999999,129507.50999999997,3694.029999999926
5895,2022-02-24 13:15:00,261.11,133462.64999999988,129507.50999999997,3955.139999999912
5896,2022-02-24 13:20:00,363.75,133826.39999999988,129507.50999999997,4318.889999999912
5897,2022-02-24 13:25:00,818.82,134645.21999999988,129507.50999999997,5137.709999999919
5898,2022-02-24 13:30:00,-504.25,134140.96999999988,129507.50999999997,4633.459999999919
5899,2022-02-24 13:35:00,-1671.22,132469.74999999988,129507.50999999997,2962.239999999918
5900,2022-02-24 13:40:00,408.08,132877.82999999987,129507.50999999997,3370.319999999905
5901,2022-02-24 13:45:00,-1199.53,131678.29999999987,129507.50999999997,2170.7899999999063
5902,2022-02-24 13:50:00,1775.57,133453.86999999988,129507.50999999997,3946.3599999999133
5903,2022-02-24 13:55:00,-1062.94,132390.92999999988,129507.50999999997,2883.419999999911
5904,2022-02-24 14:00:00,-263.43,132127.49999999988,129507.50999999997,2619.989999999918
5905,2022-02-24 14:05:00,-1416.73,130710.76999999989,129507.50999999997,1203.259999999922
5906,2022-02-24 14:10:00,1766.51,132477.27999999988,129507.50999999997,2969.7699999999168
5907,2022-02-24 14:15:00,209.52,132686.79999999987,129507.50999999997,3179.2899999999063
5908,2022-02-24 14:20:00,829.98,133516.77999999988,129507.50999999997,4009.2699999999168
5909,2022-02-24 14:25:00,757.59,134274.36999999988,129507.50999999997,4766.859999999913
5910,2022-02-24 14:30:00,-1290.23,132984.13999999987,129507.50999999997,3476.629999999903
5911,2022-02-24 14:35:00,559.57,133543.70999999988,129507.50999999997,4036.19999999991
5912,2022-02-24 14:40:00,-1064.08,132479.6299999999,129507.50999999997,2972.1199999999226
5913,2022-02-24 14:45:00,1970.23,134449.8599999999,129507.50999999997,4942.349999999933
5914,2022-02-24 14:50:00,-1593.77,132856.0899999999,129507.50999999997,3348.5799999999435
5915,2022-02-24 14:55:00,-1347.32,131508.7699999999,129507.50999999997,2001.2599999999366
5916,2022-02-24 15:00:00,279.19,131787.9599999999,129507.50999999997,2280.449999999939
5917,2022-02-24 15:05:00,1377.46,133165.4199999999,129507.50999999997,3657.9099999999307
5918,2022-02-24 15:10:00,-1152.31,132013.1099999999,129507.50999999997,2505.599999999933
5919,2022-02-24 15:15:00,288.17,132301.2799999999,129507.50999999997,2793.769999999946
5920,2022-02-24 15:20:00,-855.24,131446.03999999992,129507.50999999997,1938.5299999999552
5921,2022-02-24 15:25:00,969.9,132415.93999999992,129507.50999999997,2908.4299999999494
5922,2022-02-24 15:30:00,-682.86,131733.07999999993,129507.50999999997,2225.5699999999633
5923,2022-02-24 15:35:00,1387.85,133120.92999999993,129507.50999999997,3613.419999999969
5924,2022-02-24 15:40:00,1852.78,134973.70999999993,129507.50999999997,5466.199999999968
5925,2022-02-24 15:45:00,637.96,135611.66999999993,129507.50999999997,6104.15999999996
5926,2022-02-24 15:50:00,1187.28,136798.94999999992,129507.50999999997,7291.439999999959
5927,2022-02-24 15:55:00,-1377.84,135421.10999999993,129507.50999999997,5913.599999999962
5928,2022-02-24 16:00:00,-1703.59,133717.51999999993,129507.50999999997,4210.009999999966
5929,2022-02-24 16:05:00,-232.26,133485.25999999992,129507.50999999997,3977.7499999999563
5930,2022-02-24 16:10:00,-1171.38,132313.87999999992,129507.50999999997,2806.3699999999517
5931,2022-02-24 16:15:00,-774.48,131539.3999999999,129507.50999999997,2031.8899999999412
5932,2022-02-24 16:20:00,1097.76,132637.15999999992,129507.50999999997,3129.6499999999505
5933,2022-02-24 16:25:00,-778.14,131859.0199999999,129507.50999999997,2351.5099999999366
5934,2022-02-24 16:30:00,-1796.83,130062.1899999999,129507.50999999997,554.6799999999348
5935,2022-02-24 16:35:00,1563.72,131625.9099999999,129507.50999999997,2118.3999999999214
5936,2022-02-24 16:40:00,928.13,132554.0399999999,129507.50999999997,3046.529999999926
5937,2022-02-24 16:45:00,-159.55,132394.4899999999,129507.50999999997,2886.9799999999377
5938,2022-02-24 16:50:00,518.23,132912.7199999999,129507.50999999997,3405.209999999948
5939,2022-02-24 16:55:00,2.77,132915.4899999999,129507.50999999997,3407.9799999999377
5940,2022-02-25 08:00:00,1927.3,134842.7899999999,132915.4899999999,1927.2999999999884
5941,2022-02-25 08:05:00,1854.82,136697.6099999999,132915.4899999999,3782.1199999999953
5942,2022-02-25 08:10:00,-1107.94,135589.6699999999,132915.4899999999,2674.179999999993
5943,2022-02-25 08:15:00,-1054.3,134535.3699999999,132915.4899999999,1619.8800000000047
5944,2022-02-25 08:20:00,-1094.42,133440.9499999999,132915.4899999999,525.4599999999919
5945,2022-02-25 08:25:00,-1778.26,131662.6899999999,132915.4899999999,-1252.8000000000175
5946,2022-02-25 08:30:00,-1989.34,129673.34999999989,132915.4899999999,-3242.140000000014
5947,2022-02-25 08:35:00,-725.81,128947.53999999989,132915.4899999999,-3967.9500000000116
5948,2022-02-25 08:40:00,204.5,129152.03999999989,132915.4899999999,-3763.4500000000116
5949,2022-02-25 08:45:00,561.74,129713.7799999999,132915.4899999999,-3201.7100000000064
5950,2022-02-25 08:50:00,-1310.93,128402.8499999999,132915.4899999999,-4512.639999999999
5951,2022-02-25 08:55:00,-163.86,128238.9899999999,132915.4899999999,-4676.5
5952,2022-02-25 09:00:00,726.32,128965.30999999991,132915.4899999999,-3950.179999999993
5953,2022-02-25 09:05:00,-327.62,128637.68999999992,132915.4899999999,-4277.799999999988
5954,2022-02-25 09:10:00,1393.27,130030.95999999992,132915.4899999999,-2884.5299999999843
5955,2022-02-25 09:15:00,468.22,130499.17999999992,132915.4899999999,-2416.309999999983
5956,2022-02-25 09:20:00,-633.87,129865.30999999992,132915.4899999999,-3050.1799999999785
5957,2022-02-25 09:25:00,-686.98,129178.32999999993,132915.4899999999,-3737.1599999999744
5958,2022-02-25 09:30:00,-1691.43,127486.89999999994,132915.4899999999,-5428.589999999967
5959,2022-02-25 09:35:00,-587.51,126899.38999999994,132915.4899999999,-6016.099999999962
5960,2022-02-25 09:40:00,-673.21,126226.17999999993,132915.4899999999,-6689.309999999969
5961,2022-02-25 09:45:00,-1503.45,124722.72999999994,132915.4899999999,-8192.759999999966
5962,2022-02-25 09:50:00,454.63,125177.35999999994,132915.4899999999,-7738.129999999961
5963,2022-02-25 09:55:00,-1985.16,123192.19999999994,132915.4899999999,-9723.289999999964
5964,2022-02-25 10:00:00,482.42,123674.61999999994,132915.4899999999,-9240.869999999966
5965,2022-02-25 10:05:00,206.71,123881.32999999994,132915.4899999999,-9034.15999999996
5966,2022-02-25 10:10:00,-377.38,123503.94999999994,132915.4899999999,-9411.539999999964
5967,2022-02-25 10:15:00,-201.26,123302.68999999994,132915.4899999999,-9612.79999999996
5968,2022-02-25 10:20:00,-120.92,123181.76999999995,132915.4899999999,-9733.719999999958
5969,2022-02-25 10:25:00,186.59,123368.35999999994,132915.4899999999,-9547.129999999961
5970,2022-02-25 10:30:00,-319.09,123049.26999999995,132915.4899999999,-9866.219999999958
5971,2022-02-25 10:35:00,-823.41,122225.85999999994,132915.4899999999,-10689.629999999961
5972,2022-02-25 10:40:00,1354.53,123580.38999999994,132915.4899999999,-9335.099999999962
5973,2022-02-25 10:45:00,776.17,124356.55999999994,132915.4899999999,-8558.929999999964
5974,2022-02-25 10:50:00,-908.08,123448.47999999994,132915.4899999999,-9467.009999999966
5975,2022-02-25 10:55:00,746.85,124195.32999999994,132915.4899999999,-8720.15999999996
5976,2022-02-25 11:00:00,-44.94,124150.38999999994,132915.4899999999,-8765.099999999962
5977,2022-02-25 11:05:00,-1877.68,122272.70999999995,132915.4899999999,-10642.779999999955
5978,2022-02-25 11:10:00,-285.72,121986.98999999995,132915.4899999999,-10928.499999999956
5979,2022-02-25 11:15:00,676.61,122663.59999999995,132915.4899999999,-10251.889999999956
5980,2022-02-25 11:20:00,868.79,123532.38999999994,132915.4899999999,-9383.099999999962
5981,2022-02-25 11:25:00,-1477.7,122054.68999999994,132915.4899999999,-10860.79999999996
5982,2022-02-25 11:30:00,247.94,122302.62999999995,132915.4899999999,-10612.859999999957
5983,2022-02-25 11:35:00,457.43,122760.05999999994,132915.4899999999,-10155.429999999964
5984,2022-02-25 11:40:00,399.24,123159.29999999994,132915.4899999999,-9756.189999999959
5985,2022-02-25 11:45:00,1828.65,124987.94999999994,132915.4899999999,-7927.5399999999645
5986,2022-02-25 11:50:00,-592.76,124395.18999999994,132915.4899999999,-8520.29999999996
5987,2022-02-25 11:55:00,742.73,125137.91999999994,132915.4899999999,-7777.569999999963
5988,2022-02-25 12:00:00,1247.82,126385.73999999995,132915.4899999999,-6529.749999999956
5989,2022-02-25 12:05:00,1667.64,128053.37999999995,132915.4899999999,-4862.109999999957
5990,2022-02-25 12:10:00,1715.41,129768.78999999995,132915.4899999999,-3146.6999999999534
5991,2022-02-25 12:15:00,-1421.88,128346.90999999995,132915.4899999999,-4568.579999999958
5992,2022-02-25 12:20:00,-203.32,128143.58999999994,132915.4899999999,-4771.899999999965
5993,2022-02-25 12:25:00,1346.04,129489.62999999993,132915.4899999999,-3425.8599999999715
5994,2022-02-25 12:30:00,-1466.99,128022.63999999993,132915.4899999999,-4892.849999999977
5995,2022-02-25 12:35:00,-1542.8,126479.83999999992,132915.4899999999,-6435.64999999998
5996,2022-02-25 12:40:00,-611.02,125868.81999999992,132915.4899999999,-7046.669999999984
5997,2022-02-25 12:45:00,-737.86,125130.95999999992,132915.4899999999,-7784.529999999984
5998,2022-02-25 12:50:00,411.63,125542.58999999992,132915.4899999999,-7372.89999999998
5999,2022-02-25 12:55:00,-539.66,125002.92999999992,132915.4899999999,-7912.559999999983
6000,2022-02-25 13:00:00,1813.53,126816.45999999992,132915.4899999999,-6099.029999999984
6001,2022-02-25 13:05:00,1275.99,128092.44999999992,132915.4899999999,-4823.039999999979
6002,2022-02-25 13:10:00,-278.97,127813.47999999992,132915.4899999999,-5102.00999999998
6003,2022-02-25 13:15:00,221.93,128035.40999999992,132915.4899999999,-4880.079999999987
6004,2022-02-25 13:20:00,-1994.56,126040.84999999992,132915.4899999999,-6874.639999999985
6005,2022-02-25 13:25:00,-1244.26,124796.58999999992,132915.4899999999,-8118.89999999998
6006,2022-02-25 13:30:00,-698.4,124098.18999999993,132915.4899999999,-8817.299999999974
6007,2022-02-25 13:35:00,-852.08,123246.10999999993,132915.4899999999,-9669.379999999976
6008,2022-02-25 13:40:00,-1146.02,122100.08999999992,132915.4899999999,-10815.39999999998
6009,2022-02-25 13:45:00,-1057.92,121042.16999999993,132915.4899999999,-11873.319999999978
6010,2022-02-25 13:50:00,-697.05,120345.11999999992,132915.4899999999,-12570.36999999998
6011,2022-02-25 13:55:00,-100.83,120244.28999999992,132915.4899999999,-12671.199999999983
6012,2022-02-25 14:00:00,767.07,121011.35999999993,132915.4899999999,-11904.129999999976
6013,2022-02-25 14:05:00,-245.63,120765.72999999992,132915.4899999999,-12149.75999999998
6014,2022-02-25 14:10:00,226.5,120992.22999999992,132915.4899999999,-11923.25999999998
6015,2022-02-25 14:15:00,-1456.71,119535.51999999992,132915.4899999999,-13379.969999999987
6016,2022-02-25 14:20:00,1229.69,120765.20999999992,132915.4899999999,-12150.279999999984
6017,2022-02-25 14:25:00,-1919.2,118846.00999999992,132915.4899999999,-14069.479999999981
6018,2022-02-25 14:30:00,-881.87,117964.13999999993,132915.4899999999,-14951.349999999977
6019,2022-02-25 14:35:00,-985.43,116978.70999999993,132915.4899999999,-15936.77999999997
6020,2022-02-25 14:40:00,-1240.33,115738.37999999993,132915.4899999999,-17177.10999999997
6021,2022-02-25 14:45:00,1956.06,117694.43999999993,132915.4899999999,-15221.049999999974
6022,2022-02-25 14:50:00,1006.58,118701.01999999993,132915.4899999999,-14214.469999999972
6023,2022-02-25 14:55:00,1138.25,119839.26999999993,132915.4899999999,-13076.219999999972
6024,2022-02-25 15:00:00,-384.32,119454.94999999992,132915.4899999999,-13460.539999999979
6025,2022-02-25 15:05:00,1944.98,121399.92999999992,132915.4899999999,-11515.559999999983
6026,2022-02-25 15:10:00,958.21,122358.13999999993,132915.4899999999,-10557.349999999977
6027,2022-02-25 15:15:00,1222.85,123580.98999999993,132915.4899999999,-9334.49999999997
6028,2022-02-25 15:20:00,1611.18,125192.16999999993,132915.4899999999,-7723.319999999978
6029,2022-02-25 15:25:00,1298.7,126490.86999999992,132915.4899999999,-6424.619999999981
6030,2022-02-25 15:30:00,-82.44,126408.42999999992,132915.4899999999,-6507.059999999983
6031,2022-02-25 15:35:00,1248.21,127656.63999999993,132915.4899999999,-5258.849999999977
6032,2022-02-25 15:40:00,-500.37,127156.26999999993,132915.4899999999,-5759.219999999972
6033,2022-02-25 15:45:00,-917.23,126239.03999999994,132915.4899999999,-6676.449999999968
6034,2022-02-25 15:50:00,1529.25,127768.28999999994,132915.4899999999,-5147.199999999968
6035,2022-02-25 15:55:00,298.09,128066.37999999993,132915.4899999999,-4849.1099999999715
6036,2022-02-25 16:00:00,-319.3,127747.07999999993,132915.4899999999,-5168.409999999974
6037,2022-02-25 16:05:00,-1792.22,125954.85999999993,132915.4899999999,-6960.629999999976
6038,2022-02-25 16:10:00,-509.39,125445.46999999993,132915.4899999999,-7470.019999999975
6039,2022-02-25 16:15:00,-1848.26,123597.20999999993,132915.4899999999,-9318.27999999997
6040,2022-02-25 16:20:00,-1806.46,121790.74999999993,132915.4899999999,-11124.739999999976
6041,2022-02-25 16:25:00,-1999.86,119790.88999999993,132915.4899999999,-13124.599999999977
6042,2022-02-25 16:30:00,-1001.71,118789.17999999992,132915.4899999999,-14126.309999999983
6043,2022-02-25 16:35:00,840.76,119629.93999999992,132915.4899999999,-13285.549999999988
6044,2022-02-25 16:40:00,-916.17,118713.76999999992,132915.4899999999,-14201.719999999987
6045,2022-02-25 16:45:00,1907.83,120621.59999999992,132915.4899999999,-12293.889999999985
6046,2022-02-25 16:50:00,-463.09,120158.50999999992,132915.4899999999,-12756.979999999981
6047,2022-02-25 16:55:00,-458.65,119699.85999999993,132915.4899999999,-13215.629999999976
6048,2022-02-26 08:00:00,-1590.05,118109.80999999992,119699.85999999993,-1590.050000000003
6049,2022-02-26 08:05:00,-389.13,117720.67999999992,119699.85999999993,-1979.1800000000076
6050,2022-02-26 08:10:00,-965.92,116754.75999999992,119699.85999999993,-2945.100000000006
6051,2022-02-26 08:15:00,1019.05,117773.80999999992,119699.85999999993,-1926.050000000003
6052,2022-02-26 08:20:00,-573.67,117200.13999999993,119699.85999999993,-2499.720000000001
6053,2022-02-26 08:25:00,503.98,117704.11999999992,119699.85999999993,-1995.7400000000052
6054,2022-02-26 08:30:00,-1799.17,115904.94999999992,119699.85999999993,-3794.9100000000035
6055,2022-02-26 08:35:00,-220.46,115684.48999999992,119699.85999999993,-4015.37000000001
6056,2022-02-26 08:40:00,283.95,115968.43999999992,119699.85999999993,-3731.420000000013
6057,2022-02-26 08:45:00,1298.25,117266.68999999992,119699.85999999993,-2433.170000000013
6058,2022-02-26 08:50:00,-1665.34,115601.34999999992,119699.85999999993,-4098.510000000009
6059,2022-02-26 08:55:00,849.85,116451.19999999992,119699.85999999993,-3248.6600000000035
6060,2022-02-26 09:00:00,266.16,116717.35999999993,119699.85999999993,-2982.5
6061,2022-02-26 09:05:00,-546.78,116170.57999999993,119699.85999999993,-3529.279999999999
6062,2022-02-26 09:10:00,1808.07,117978.64999999994,119699.85999999993,-1721.2099999999919
6063,2022-02-26 09:15:00,937.99,118916.63999999994,119699.85999999993,-783.2199999999866
6064,2022-02-26 09:20:00,410.63,119327.26999999995,119699.85999999993,-372.58999999998196
6065,2022-02-26 09:25:00,1472.27,120799.53999999995,119699.85999999993,1099.6800000000221
6066,2022-02-26 09:30:00,-970.48,119829.05999999995,119699.85999999993,129.2000000000262
6067,2022-02-26 09:35:00,-420.69,119408.36999999995,119699.85999999993,-291.48999999997613
6068,2022-02-26 09:40:00,982.85,120391.21999999996,119699.85999999993,691.3600000000297
6069,2022-02-26 09:45:00,-1770.1,118621.11999999995,119699.85999999993,-1078.7399999999761
6070,2022-02-26 09:50:00,1464.77,120085.88999999996,119699.85999999993,386.03000000002794
6071,2022-02-26 09:55:00,-1922.08,118163.80999999995,119699.85999999993,-1536.0499999999738
6072,2022-02-26 10:00:00,-1831.56,116332.24999999996,119699.85999999993,-3367.6099999999715
6073,2022-02-26 10:05:00,-1768.35,114563.89999999995,119699.85999999993,-5135.959999999977
6074,2022-02-26 10:10:00,-1040.21,113523.68999999994,119699.85999999993,-6176.169999999984
6075,2022-02-26 10:15:00,994.27,114517.95999999995,119699.85999999993,-5181.89999999998
6076,2022-02-26 10:20:00,-977.68,113540.27999999996,119699.85999999993,-6159.579999999973
6077,2022-02-26 10:25:00,1586.41,115126.68999999996,119699.85999999993,-4573.169999999969
6078,2022-02-26 10:30:00,-1793.95,113332.73999999996,119699.85999999993,-6367.119999999966
6079,2022-02-26 10:35:00,-1665.79,111666.94999999997,119699.85999999993,-8032.90999999996
6080,2022-02-26 10:40:00,-1543.02,110123.92999999996,119699.85999999993,-9575.929999999964
6081,2022-02-26 10:45:00,1828.56,111952.48999999996,119699.85999999993,-7747.369999999966
6082,2022-02-26 10:50:00,1623.24,113575.72999999997,119699.85999999993,-6124.129999999961
6083,2022-02-26 10:55:00,1910.02,115485.74999999997,119699.85999999993,-4214.109999999957
6084,2022-02-26 11:00:00,-1865.84,113619.90999999997,119699.85999999993,-6079.949999999953
6085,2022-02-26 11:05:00,-1579.45,112040.45999999998,119699.85999999993,-7659.3999999999505
6086,2022-02-26 11:10:00,1658.73,113699.18999999997,119699.85999999993,-6000.669999999955
6087,2022-02-26 11:15:00,-1336.27,112362.91999999997,119699.85999999993,-7336.939999999959
6088,2022-02-26 11:20:00,-894.19,111468.72999999997,119699.85999999993,-8231.129999999961
6089,2022-02-26 11:25:00,-906.66,110562.06999999996,119699.85999999993,-9137.789999999964
6090,2022-02-26 11:30:00,-1794.73,108767.33999999997,119699.85999999993,-10932.51999999996
6091,2022-02-26 11:35:00,291.16,109058.49999999997,119699.85999999993,-10641.359999999957
6092,2022-02-26 11:40:00,-100.64,108957.85999999997,119699.85999999993,-10741.999999999956
6093,2022-02-26 11:45:00,-523.46,108434.39999999997,119699.85999999993,-11265.459999999963
6094,2022-02-26 11:50:00,1084.25,109518.64999999997,119699.85999999993,-10181.209999999963
6095,2022-02-26 11:55:00,-1128.64,108390.00999999997,119699.85999999993,-11309.849999999962
6096,2022-02-26 12:00:00,1640.52,110030.52999999997,119699.85999999993,-9669.329999999958
6097,2022-02-26 12:05:00,798.94,110829.46999999997,119699.85999999993,-8870.389999999956
6098,2022-02-26 12:10:00,-579.63,110249.83999999997,119699.85999999993,-9450.01999999996
6099,2022-02-26 12:15:00,353.99,110603.82999999997,119699.85999999993,-9096.029999999955
6100,2022-02-26 12:20:00,629.18,111233.00999999997,119699.85999999993,-8466.849999999962
6101,2022-02-26 12:25:00,1727.31,112960.31999999996,119699.85999999993,-6739.5399999999645
6102,2022-02-26 12:30:00,1942.8,114903.11999999997,119699.85999999993,-4796.739999999962
6103,2022-02-26 12:35:00,-238.76,114664.35999999997,119699.85999999993,-5035.499999999956
6104,2022-02-26 12:40:00,226.05,114890.40999999997,119699.85999999993,-4809.449999999953
6105,2022-02-26 12:45:00,1875.67,116766.07999999997,119699.85999999993,-2933.779999999955
6106,2022-02-26 12:50:00,-1779.47,114986.60999999997,119699.85999999993,-4713.249999999956
6107,2022-02-26 12:55:00,1586.01,116572.61999999997,119699.85999999993,-3127.2399999999616
6108,2022-02-26 13:00:00,-1879.94,114692.67999999996,119699.85999999993,-5007.179999999964
6109,2022-02-26 13:05:00,-137.49,114555.18999999996,119699.85999999993,-5144.669999999969
6110,2022-02-26 13:10:00,-1736.61,112818.57999999996,119699.85999999993,-6881.27999999997
6111,2022-02-26 13:15:00,-1186.52,111632.05999999995,119699.85999999993,-8067.799999999974
6112,2022-02-26 13:20:00,1574.32,113206.37999999996,119699.85999999993,-6493.479999999967
6113,2022-02-26 13:25:00,-75.46,113130.91999999995,119699.85999999993,-6568.939999999973
6114,2022-02-26 13:30:00,592.45,113723.36999999995,119699.85999999993,-5976.489999999976
6115,2022-02-26 13:35:00,935.54,114658.90999999995,119699.85999999993,-5040.9499999999825
6116,2022-02-26 13:40:00,262.38,114921.28999999995,119699.85999999993,-4778.569999999978
6117,2022-02-26 13:45:00,-31.94,114889.34999999995,119699.85999999993,-4810.50999999998
6118,2022-02-26 13:50:00,916.14,115805.48999999995,119699.85999999993,-3894.369999999981
6119,2022-02-26 13:55:00,1922.82,117728.30999999995,119699.85999999993,-1971.5499999999738
6120,2022-02-26 14:00:00,169.09,117897.39999999995,119699.85999999993,-1802.4599999999773
6121,2022-02-26 14:05:00,986.12,118883.51999999995,119699.85999999993,-816.339999999982
6122,2022-02-26 14:10:00,155.97,119039.48999999995,119699.85999999993,-660.3699999999808
6123,2022-02-26 14:15:00,1260.58,120300.06999999995,119699.85999999993,600.210000000021
6124,2022-02-26 14:20:00,-337.5,119962.56999999995,119699.85999999993,262.71000000002095
6125,2022-02-26 14:25:00,1981.69,121944.25999999995,119699.85999999993,2244.4000000000233
6126,2022-02-26 14:30:00,-560.71,121383.54999999994,119699.85999999993,1683.6900000000169
6127,2022-02-26 14:35:00,465.19,121848.73999999995,119699.85999999993,2148.880000000019
6128,2022-02-26 14:40:00,-1745.51,120103.22999999995,119699.85999999993,403.37000000002445
6129,2022-02-26 14:45:00,-1440.05,118663.17999999995,119699.85999999993,-1036.6799999999785
6130,2022-02-26 14:50:00,1052.47,119715.64999999995,119699.85999999993,15.790000000022701
6131,2022-02-26 14:55:00,-256.78,119458.86999999995,119699.85999999993,-240.98999999997613
6132,2022-02-26 15:00:00,1998.19,121457.05999999995,119699.85999999993,1757.2000000000262
6133,2022-02-26 15:05:00,1108.77,122565.82999999996,119699.85999999993,2865.9700000000303
6134,2022-02-26 15:10:00,1901.72,124467.54999999996,119699.85999999993,4767.690000000031
6135,2022-02-26 15:15:00,1855.55,126323.09999999996,119699.85999999993,6623.240000000034
6136,2022-02-26 15:20:00,432.7,126755.79999999996,119699.85999999993,7055.940000000031
6137,2022-02-26 15:25:00,1157.63,127913.42999999996,119699.85999999993,8213.570000000036
6138,2022-02-26 15:30:00,-726.21,127187.21999999996,119699.85999999993,7487.36000000003
6139,2022-02-26 15:35:00,-1389.91,125797.30999999995,119699.85999999993,6097.450000000026
6140,2022-02-26 15:40:00,-1501.37,124295.93999999996,119699.85999999993,4596.080000000031
6141,2022-02-26 15:45:00,1765.94,126061.87999999996,119699.85999999993,6362.020000000033
6142,2022-02-26 15:50:00,-551.17,125510.70999999996,119699.85999999993,5810.850000000035
6143,2022-02-26 15:55:00,-1625.94,123884.76999999996,119699.85999999993,4184.910000000033
6144,2022-02-26 16:00:00,-1052.73,122832.03999999996,119699.85999999993,3132.1800000000367
6145,2022-02-26 16:05:00,-1428.92,121403.11999999997,119699.85999999993,1703.2600000000384
6146,2022-02-26 16:10:00,966.85,122369.96999999997,119699.85999999993,2670.1100000000442
6147,2022-02-26 16:15:00,-1422.66,120947.30999999997,119699.85999999993,1247.4500000000407
6148,2022-02-26 16:20:00,1774.53,122721.83999999997,119699.85999999993,3021.9800000000396
6149,2022-02-26 16:25:00,-289.16,122432.67999999996,119699.85999999993,2732.820000000036
6150,2022-02-26 16:30:00,1761.35,124194.02999999997,119699.85999999993,4494.170000000042
6151,2022-02-26 16:35:00,92.48,124286.50999999997,119699.85999999993,4586.650000000038
6152,2022-02-26 16:40:00,1993.53,126280.03999999996,119699.85999999993,6580.180000000037
6153,2022-02-26 16:45:00,-505.4,125774.63999999997,119699.85999999993,6074.7800000000425
6154,2022-02-26 16:50:00,-584.3,125190.33999999997,119699.85999999993,5490.48000000004
6155,2022-02-26 16:55:00,1777.71,126968.04999999997,119699.85999999993,7268.190000000046
6156,2022-02-27 08:00:00,-809.33,126158.71999999997,126968.04999999997,-809.3300000000017
6157,2022-02-27 08:05:00,1748.49,127907.20999999998,126968.04999999997,939.1600000000035
6158,2022-02-27 08:10:00,798.19,128705.39999999998,126968.04999999997,1737.3500000000058
6159,2022-02-27 08:15:00,-487.38,128218.01999999997,126968.04999999997,1249.9700000000012
6160,2022-02-27 08:20:00,219.42,128437.43999999997,126968.04999999997,1469.3899999999994
6161,2022-02-27 08:25:00,282.96,128720.39999999998,126968.04999999997,1752.3500000000058
6162,2022-02-27 08:30:00,347.48,129067.87999999998,126968.04999999997,2099.8300000000017
6163,2022-02-27 08:35:00,-604.33,128463.54999999997,126968.04999999997,1495.5
6164,2022-02-27 08:40:00,398.44,128861.98999999998,126968.04999999997,1893.9400000000023
6165,2022-02-27 08:45:00,-807.21,128054.77999999997,126968.04999999997,1086.729999999996
6166,2022-02-27 08:50:00,793.45,128848.22999999997,126968.04999999997,1880.179999999993
6167,2022-02-27 08:55:00,1034.75,129882.97999999997,126968.04999999997,2914.929999999993
6168,2022-02-27 09:00:00,-1033.83,128849.14999999997,126968.04999999997,1881.0999999999913
6169,2022-02-27 09:05:00,217.89,129067.03999999996,126968.04999999997,2098.9899999999907
6170,2022-02-27 09:10:00,864.15,129931.18999999996,126968.04999999997,2963.139999999985
6171,2022-02-27 09:15:00,-1773.32,128157.86999999995,126968.04999999997,1189.8199999999779
6172,2022-02-27 09:20:00,-590.62,127567.24999999996,126968.04999999997,599.1999999999825
6173,2022-02-27 09:25:00,494.16,128061.40999999996,126968.04999999997,1093.359999999986
6174,2022-02-27 09:30:00,-662.35,127399.05999999995,126968.04999999997,431.0099999999802
6175,2022-02-27 09:35:00,-1871.5,125527.55999999995,126968.04999999997,-1440.4900000000198
6176,2022-02-27 09:40:00,-977.74,124549.81999999995,126968.04999999997,-2418.230000000025
6177,2022-02-27 09:45:00,1155.85,125705.66999999995,126968.04999999997,-1262.3800000000192
6178,2022-02-27 09:50:00,-1902.0,123803.66999999995,126968.04999999997,-3164.380000000019
6179,2022-02-27 09:55:00,1459.18,125262.84999999995,126968.04999999997,-1705.2000000000262
6180,2022-02-27 10:00:00,-811.83,124451.01999999995,126968.04999999997,-2517.030000000028
6181,2022-02-27 10:05:00,-328.19,124122.82999999994,126968.04999999997,-2845.2200000000303
6182,2022-02-27 10:10:00,154.43,124277.25999999994,126968.04999999997,-2690.7900000000373
6183,2022-02-27 10:15:00,-1453.6,122823.65999999993,126968.04999999997,-4144.390000000043
6184,2022-02-27 10:20:00,175.84,122999.49999999993,126968.04999999997,-3968.5500000000466
6185,2022-02-27 10:25:00,-1147.94,121851.55999999992,126968.04999999997,-5116.490000000049
6186,2022-02-27 10:30:00,413.25,122264.80999999992,126968.04999999997,-4703.240000000049
6187,2022-02-27 10:35:00,-1306.26,120958.54999999993,126968.04999999997,-6009.500000000044
6188,2022-02-27 10:40:00,1013.14,121971.68999999993,126968.04999999997,-4996.360000000044
6189,2022-02-27 10:45:00,169.7,122141.38999999993,126968.04999999997,-4826.660000000047
6190,2022-02-27 10:50:00,545.71,122687.09999999993,126968.04999999997,-4280.950000000041
6191,2022-02-27 10:55:00,1859.38,124546.47999999994,126968.04999999997,-2421.570000000036
6192,2022-02-27 11:00:00,-590.5,123955.97999999994,126968.04999999997,-3012.070000000036
6193,2022-02-27 11:05:00,-646.03,123309.94999999994,126968.04999999997,-3658.100000000035
6194,2022-02-27 11:10:00,1263.51,124573.45999999993,126968.04999999997,-2394.59000000004
6195,2022-02-27 11:15:00,1899.2,126472.65999999993,126968.04999999997,-495.3900000000431
6196,2022-02-27 11:20:00,1823.76,128296.41999999993,126968.04999999997,1328.3699999999517
6197,2022-02-27 11:25:00,1380.91,129677.32999999993,126968.04999999997,2709.279999999955
6198,2022-02-27 11:30:00,112.89,129790.21999999993,126968.04999999997,2822.1699999999546
6199,2022-02-27 11:35:00,-1591.41,128198.80999999992,126968.04999999997,1230.759999999951
6200,2022-02-27 11:40:00,-331.5,127867.30999999992,126968.04999999997,899.2599999999511
6201,2022-02-27 11:45:00,1127.59,128994.89999999992,126968.04999999997,2026.8499999999476
6202,2022-02-27 11:50:00,1030.95,130025.84999999992,126968.04999999997,3057.7999999999447
6203,2022-02-27 11:55:00,300.95,130326.79999999992,126968.04999999997,3358.749999999942
6204,2022-02-27 12:00:00,-1741.18,128585.61999999992,126968.04999999997,1617.5699999999488
6205,2022-02-27 12:05:00,-1635.28,126950.33999999992,126968.04999999997,-17.71000000005006
6206,2022-02-27 12:10:00,-413.54,126536.79999999993,126968.04999999997,-431.25000000004366
6207,2022-02-27 12:15:00,1981.94,128518.73999999993,126968.04999999997,1550.6899999999587
6208,2022-02-27 12:20:00,-1412.52,127106.21999999993,126968.04999999997,138.1699999999546
6209,2022-02-27 12:25:00,-1493.49,125612.72999999992,126968.04999999997,-1355.3200000000506
6210,2022-02-27 12:30:00,1201.19,126813.91999999993,126968.04999999997,-154.1300000000483
6211,2022-02-27 12:35:00,-932.97,125880.94999999992,126968.04999999997,-1087.1000000000495
6212,2022-02-27 12:40:00,1356.73,127237.67999999992,126968.04999999997,269.62999999994645
6213,2022-02-27 12:45:00,-676.37,126561.30999999992,126968.04999999997,-406.7400000000489
6214,2022-02-27 12:50:00,-1941.28,124620.02999999993,126968.04999999997,-2348.0200000000477
6215,2022-02-27 12:55:00,791.98,125412.00999999992,126968.04999999997,-1556.0400000000518
6216,2022-02-27 13:00:00,-980.99,124431.01999999992,126968.04999999997,-2537.030000000057
6217,2022-02-27 13:05:00,586.8,125017.81999999992,126968.04999999997,-1950.2300000000541
6218,2022-02-27 13:10:00,1009.38,126027.19999999992,126968.04999999997,-940.8500000000495
6219,2022-02-27 13:15:00,1932.17,127959.36999999992,126968.04999999997,991.3199999999488
6220,2022-02-27 13:20:00,-1881.11,126078.25999999992,126968.04999999997,-889.7900000000518
6221,2022-02-27 13:25:00,1579.41,127657.66999999993,126968.04999999997,689.6199999999517
6222,2022-02-27 13:30:00,515.4,128173.06999999992,126968.04999999997,1205.0199999999459
6223,2022-02-27 13:35:00,-1006.75,127166.31999999992,126968.04999999997,198.26999999994587
6224,2022-02-27 13:40:00,-1710.63,125455.68999999992,126968.04999999997,-1512.3600000000588
6225,2022-02-27 13:45:00,-1378.02,124077.66999999991,126968.04999999997,-2890.380000000063
6226,2022-02-27 13:50:00,-1339.86,122737.80999999991,126968.04999999997,-4230.240000000063
6227,2022-02-27 13:55:00,-859.28,121878.52999999991,126968.04999999997,-5089.520000000062
6228,2022-02-27 14:00:00,-478.37,121400.15999999992,126968.04999999997,-5567.890000000058
6229,2022-02-27 14:05:00,628.3,122028.45999999992,126968.04999999997,-4939.590000000055
6230,2022-02-27 14:10:00,-1440.16,120588.29999999992,126968.04999999997,-6379.750000000058
6231,2022-02-27 14:15:00,1491.1,122079.39999999992,126968.04999999997,-4888.650000000052
6232,2022-02-27 14:20:00,68.71,122148.10999999993,126968.04999999997,-4819.940000000046
6233,2022-02-27 14:25:00,755.17,122903.27999999993,126968.04999999997,-4064.7700000000477
6234,2022-02-27 14:30:00,-1610.25,121293.02999999993,126968.04999999997,-5675.020000000048
6235,2022-02-27 14:35:00,465.65,121758.67999999992,126968.04999999997,-5209.370000000054
6236,2022-02-27 14:40:00,-1157.82,120600.85999999991,126968.04999999997,-6367.1900000000605
6237,2022-02-27 14:45:00,1878.96,122479.81999999992,126968.04999999997,-4488.230000000054
6238,2022-02-27 14:50:00,-1630.1,120849.71999999991,126968.04999999997,-6118.33000000006
6239,2022-02-27 14:55:00,837.2,121686.91999999991,126968.04999999997,-5281.130000000063
6240,2022-02-27 15:00:00,313.22,122000.13999999991,126968.04999999997,-4967.910000000062
6241,2022-02-27 15:05:00,-1535.01,120465.12999999992,126968.04999999997,-6502.9200000000565
6242,2022-02-27 15:10:00,-462.2,120002.92999999992,126968.04999999997,-6965.120000000054
6243,2022-02-27 15:15:00,921.01,120923.93999999992,126968.04999999997,-6044.110000000059
6244,2022-02-27 15:20:00,-1067.09,119856.84999999992,126968.04999999997,-7111.200000000055
6245,2022-02-27 15:25:00,980.13,120836.97999999992,126968.04999999997,-6131.070000000051
6246,2022-02-27 15:30:00,1330.55,122167.52999999993,126968.04999999997,-4800.520000000048
6247,2022-02-27 15:35:00,-646.26,121521.26999999993,126968.04999999997,-5446.7800000000425
6248,2022-02-27 15:40:00,-1842.06,119679.20999999993,126968.04999999997,-7288.84000000004
6249,2022-02-27 15:45:00,1889.88,121569.08999999994,126968.04999999997,-5398.9600000000355
6250,2022-02-27 15:50:00,1769.25,123338.33999999994,126968.04999999997,-3629.7100000000355
6251,2022-02-27 15:55:00,400.82,123739.15999999995,126968.04999999997,-3228.8900000000285
6252,2022-02-27 16:00:00,-1527.81,122211.34999999995,126968.04999999997,-4756.700000000026
6253,2022-02-27 16:05:00,610.27,122821.61999999995,126968.04999999997,-4146.430000000022
6254,2022-02-27 16:10:00,1029.65,123851.26999999995,126968.04999999997,-3116.780000000028
6255,2022-02-27 16:15:00,433.39,124284.65999999995,126968.04999999997,-2683.3900000000285
6256,2022-02-27 16:20:00,-109.5,124175.15999999995,126968.04999999997,-2792.8900000000285
6257,2022-02-27 16:25:00,672.48,124847.63999999994,126968.04999999997,-2120.4100000000326
6258,2022-02-27 16:30:00,1944.07,126791.70999999995,126968.04999999997,-176.3400000000256
6259,2022-02-27 16:35:00,-403.6,126388.10999999994,126968.04999999997,-579.9400000000314
6260,2022-02-27 16:40:00,908.4,127296.50999999994,126968.04999999997,328.45999999996275
6261,2022-02-27 16:45:00,-1867.36,125429.14999999994,126968.04999999997,-1538.9000000000378
6262,2022-02-27 16:50:00,30.69,125459.83999999994,126968.04999999997,-1508.2100000000355
6263,2022-02-27 16:55:00,-400.28,125059.55999999994,126968.04999999997,-1908.4900000000343
6264,2022-02-28 08:00:00,-1665.37,123394.18999999994,125059.55999999994,-1665.3699999999953
6265,2022-02-28 08:05:00,-1642.35,121751.83999999994,125059.55999999994,-3307.720000000001
6266,2022-02-28 08:10:00,1456.97,123208.80999999994,125059.55999999994,-1850.75
6267,2022-02-28 08:15:00,-929.64,122279.16999999994,125059.55999999994,-2780.3899999999994
6268,2022-02-28 08:20:00,715.32,122994.48999999995,125059.55999999994,-2065.0699999999924
6269,2022-02-28 08:25:00,-910.17,122084.31999999995,125059.55999999994,-2975.2399999999907
6270,2022-02-28 08:30:00,-180.14,121904.17999999995,125059.55999999994,-3155.37999999999
6271,2022-02-28 08:35:00,-446.63,121457.54999999994,125059.55999999994,-3602.0099999999948
6272,2022-02-28 08:40:00,-1820.37,119637.17999999995,125059.55999999994,-5422.37999999999
6273,2022-02-28 08:45:00,289.34,119926.51999999995,125059.55999999994,-5133.039999999994
6274,2022-02-28 08:50:00,1159.02,121085.53999999995,125059.55999999994,-3974.0199999999895
6275,2022-02-28 08:55:00,391.29,121476.82999999994,125059.55999999994,-3582.729999999996
6276,2022-02-28 09:00:00,-985.44,120491.38999999994,125059.55999999994,-4568.169999999998
6277,2022-02-28 09:05:00,921.86,121413.24999999994,125059.55999999994,-3646.3099999999977
6278,2022-02-28 09:10:00,-835.07,120578.17999999993,125059.55999999994,-4481.380000000005
6279,2022-02-28 09:15:00,1361.5,121939.67999999993,125059.55999999994,-3119.8800000000047
6280,2022-02-28 09:20:00,359.83,122299.50999999994,125059.55999999994,-2760.050000000003
6281,2022-02-28 09:25:00,384.09,122683.59999999993,125059.55999999994,-2375.9600000000064
6282,2022-02-28 09:30:00,1272.63,123956.22999999994,125059.55999999994,-1103.3300000000017
6283,2022-02-28 09:35:00,-1388.45,122567.77999999994,125059.55999999994,-2491.779999999999
6284,2022-02-28 09:40:00,-1051.69,121516.08999999994,125059.55999999994,-3543.470000000001
6285,2022-02-28 09:45:00,-1391.08,120125.00999999994,125059.55999999994,-4934.550000000003
6286,2022-02-28 09:50:00,-1245.05,118879.95999999993,125059.55999999994,-6179.600000000006
6287,2022-02-28 09:55:00,204.5,119084.45999999993,125059.55999999994,-5975.100000000006
6288,2022-02-28 10:00:00,-985.88,118098.57999999993,125059.55999999994,-6960.9800000000105
6289,2022-02-28 10:05:00,477.05,118575.62999999993,125059.55999999994,-6483.930000000008
6290,2022-02-28 10:10:00,-247.35,118328.27999999993,125059.55999999994,-6731.280000000013
6291,2022-02-28 10:15:00,-1593.81,116734.46999999993,125059.55999999994,-8325.090000000011
6292,2022-02-28 10:20:00,24.51,116758.97999999992,125059.55999999994,-8300.580000000016
6293,2022-02-28 10:25:00,-1879.22,114879.75999999992,125059.55999999994,-10179.800000000017
6294,2022-02-28 10:30:00,1606.27,116486.02999999993,125059.55999999994,-8573.530000000013
6295,2022-02-28 10:35:00,1270.47,117756.49999999993,125059.55999999994,-7303.060000000012
6296,2022-02-28 10:40:00,-1697.16,116059.33999999992,125059.55999999994,-9000.220000000016
6297,2022-02-28 10:45:00,-1655.51,114403.82999999993,125059.55999999994,-10655.73000000001
6298,2022-02-28 10:50:00,-942.85,113460.97999999992,125059.55999999994,-11598.580000000016
6299,2022-02-28 10:55:00,856.21,114317.18999999993,125059.55999999994,-10742.37000000001
6300,2022-02-28 11:00:00,1865.01,116182.19999999992,125059.55999999994,-8877.360000000015
6301,2022-02-28 11:05:00,-355.04,115827.15999999993,125059.55999999994,-9232.400000000009
6302,2022-02-28 11:10:00,805.11,116632.26999999993,125059.55999999994,-8427.290000000008
6303,2022-02-28 11:15:00,1718.84,118351.10999999993,125059.55999999994,-6708.450000000012
6304,2022-02-28 11:20:00,992.98,119344.08999999992,125059.55999999994,-5715.470000000016
6305,2022-02-28 11:25:00,1544.11,120888.19999999992,125059.55999999994,-4171.360000000015
6306,2022-02-28 11:30:00,-679.95,120208.24999999993,125059.55999999994,-4851.310000000012
6307,2022-02-28 11:35:00,-300.52,119907.72999999992,125059.55999999994,-5151.830000000016
6308,2022-02-28 11:40:00,-200.13,119707.59999999992,125059.55999999994,-5351.960000000021
6309,2022-02-28 11:45:00,-781.43,118926.16999999993,125059.55999999994,-6133.390000000014
6310,2022-02-28 11:50:00,1985.0,120911.16999999993,125059.55999999994,-4148.390000000014
6311,2022-02-28 11:55:00,1481.34,122392.50999999992,125059.55999999994,-2667.0500000000175
6312,2022-02-28 12:00:00,-960.69,121431.81999999992,125059.55999999994,-3627.74000000002
6313,2022-02-28 12:05:00,-1936.79,119495.02999999993,125059.55999999994,-5564.530000000013
6314,2022-02-28 12:10:00,-994.1,118500.92999999992,125059.55999999994,-6558.630000000019
6315,2022-02-28 12:15:00,1565.25,120066.17999999992,125059.55999999994,-4993.380000000019
6316,2022-02-28 12:20:00,1044.1,121110.27999999993,125059.55999999994,-3949.2800000000134
6317,2022-02-28 12:25:00,-1416.14,119694.13999999993,125059.55999999994,-5365.420000000013
6318,2022-02-28 12:30:00,1598.12,121292.25999999992,125059.55999999994,-3767.3000000000175
6319,2022-02-28 12:35:00,1172.0,122464.25999999992,125059.55999999994,-2595.3000000000175
6320,2022-02-28 12:40:00,-1802.24,120662.01999999992,125059.55999999994,-4397.540000000023
6321,2022-02-28 12:45:00,-278.44,120383.57999999991,125059.55999999994,-4675.980000000025
6322,2022-02-28 12:50:00,-285.5,120098.07999999991,125059.55999999994,-4961.480000000025
6323,2022-02-28 12:55:00,836.23,120934.30999999991,125059.55999999994,-4125.250000000029
6324,2022-02-28 13:00:00,558.23,121492.5399999999,125059.55999999994,-3567.020000000033
6325,2022-02-28 13:05:00,-1965.07,119527.4699999999,125059.55999999994,-5532.09000000004
6326,2022-02-28 13:10:00,-1653.91,117873.5599999999,125059.55999999994,-7186.000000000044
6327,2022-02-28 13:15:00,-817.04,117056.5199999999,125059.55999999994,-8003.040000000037
6328,2022-02-28 13:20:00,-1470.9,115585.61999999991,125059.55999999994,-9473.940000000031
6329,2022-02-28 13:25:00,1016.39,116602.00999999991,125059.55999999994,-8457.550000000032
6330,2022-02-28 13:30:00,1686.7,118288.7099999999,125059.55999999994,-6770.850000000035
6331,2022-02-28 13:35:00,508.86,118797.5699999999,125059.55999999994,-6261.990000000034
6332,2022-02-28 13:40:00,420.06,119217.6299999999,125059.55999999994,-5841.930000000037
6333,2022-02-28 13:45:00,-566.65,118650.97999999991,125059.55999999994,-6408.580000000031
6334,2022-02-28 13:50:00,-1509.56,117141.41999999991,125059.55999999994,-7918.1400000000285
6335,2022-02-28 13:55:00,941.36,118082.77999999991,125059.55999999994,-6976.780000000028
6336,2022-02-28 14:00:00,319.97,118402.74999999991,125059.55999999994,-6656.810000000027
6337,2022-02-28 14:05:00,-147.39,118255.35999999991,125059.55999999994,-6804.200000000026
6338,2022-02-28 14:10:00,-1783.98,116471.37999999992,125059.55999999994,-8588.180000000022
6339,2022-02-28 14:15:00,-1389.83,115081.54999999992,125059.55999999994,-9978.010000000024
6340,2022-02-28 14:20:00,1942.49,117024.03999999992,125059.55999999994,-8035.520000000019
6341,2022-02-28 14:25:00,-499.63,116524.40999999992,125059.55999999994,-8535.150000000023
6342,2022-02-28 14:30:00,218.55,116742.95999999992,125059.55999999994,-8316.60000000002
6343,2022-02-28 14:35:00,-1130.1,115612.85999999991,125059.55999999994,-9446.700000000026
6344,2022-02-28 14:40:00,732.02,116344.87999999992,125059.55999999994,-8714.680000000022
6345,2022-02-28 14:45:00,67.89,116412.76999999992,125059.55999999994,-8646.790000000023
6346,2022-02-28 14:50:00,520.62,116933.38999999991,125059.55999999994,-8126.170000000027
6347,2022-02-28 14:55:00,-476.04,116457.34999999992,125059.55999999994,-8602.210000000021
6348,2022-02-28 15:00:00,-1087.12,115370.22999999992,125059.55999999994,-9689.330000000016
6349,2022-02-28 15:05:00,-1628.14,113742.08999999992,125059.55999999994,-11317.470000000016
6350,2022-02-28 15:10:00,-133.2,113608.88999999993,125059.55999999994,-11450.670000000013
6351,2022-02-28 15:15:00,1319.54,114928.42999999992,125059.55999999994,-10131.13000000002
6352,2022-02-28 15:20:00,1219.01,116147.43999999992,125059.55999999994,-8912.120000000024
6353,2022-02-28 15:25:00,-737.18,115410.25999999992,125059.55999999994,-9649.300000000017
6354,2022-02-28 15:30:00,1319.13,116729.38999999993,125059.55999999994,-8330.170000000013
6355,2022-02-28 15:35:00,1606.56,118335.94999999992,125059.55999999994,-6723.610000000015
6356,2022-02-28 15:40:00,-1137.46,117198.48999999992,125059.55999999994,-7861.0700000000215
6357,2022-02-28 15:45:00,1118.51,118316.99999999991,125059.55999999994,-6742.560000000027
6358,2022-02-28 15:50:00,-1600.13,116716.86999999991,125059.55999999994,-8342.690000000031
6359,2022-02-28 15:55:00,-1994.63,114722.2399999999,125059.55999999994,-10337.320000000036
6360,2022-02-28 16:00:00,430.71,115152.94999999991,125059.55999999994,-9906.61000000003
6361,2022-02-28 16:05:00,-1481.87,113671.07999999991,125059.55999999994,-11388.480000000025
6362,2022-02-28 16:10:00,-1059.3,112611.77999999991,125059.55999999994,-12447.780000000028
6363,2022-02-28 16:15:00,-955.93,111655.84999999992,125059.55999999994,-13403.710000000021
6364,2022-02-28 16:20:00,58.11,111713.95999999992,125059.55999999994,-13345.60000000002
6365,2022-02-28 16:25:00,-1860.9,109853.05999999992,125059.55999999994,-15206.500000000015
6366,2022-02-28 16:30:00,237.24,110090.29999999993,125059.55999999994,-14969.26000000001
6367,2022-02-28 16:35:00,204.96,110295.25999999994,125059.55999999994,-14764.300000000003
6368,2022-02-28 16:40:00,-1446.21,108849.04999999993,125059.55999999994,-16210.51000000001
6369,2022-02-28 16:45:00,9.69,108858.73999999993,125059.55999999994,-16200.820000000007
6370,2022-02-28 16:50:00,1285.49,110144.22999999994,125059.55999999994,-14915.330000000002
6371,2022-02-28 16:55:00,330.53,110474.75999999994,125059.55999999994,-14584.800000000003
6372,2022-03-01 08:00:00,-1485.08,108989.67999999993,110474.75999999994,-1485.0800000000017
6373,2022-03-01 08:05:00,-85.99,108903.68999999993,110474.75999999994,-1571.070000000007
6374,2022-03-01 08:10:00,-678.91,108224.77999999993,110474.75999999994,-2249.9800000000105
6375,2022-03-01 08:15:00,-118.0,108106.77999999993,110474.75999999994,-2367.9800000000105
6376,2022-03-01 08:20:00,-332.57,107774.20999999992,110474.75999999994,-2700.5500000000175
6377,2022-03-01 08:25:00,-775.14,106999.06999999992,110474.75999999994,-3475.690000000017
6378,2022-03-01 08:30:00,1365.57,108364.63999999993,110474.75999999994,-2110.12000000001
6379,2022-03-01 08:35:00,-1534.06,106830.57999999993,110474.75999999994,-3644.1800000000076
6380,2022-03-01 08:40:00,1272.68,108103.25999999992,110474.75999999994,-2371.5000000000146
6381,2022-03-01 08:45:00,-34.11,108069.14999999992,110474.75999999994,-2405.610000000015
6382,2022-03-01 08:50:00,1756.1,109825.24999999993,110474.75999999994,-649.5100000000093
6383,2022-03-01 08:55:00,1848.6,111673.84999999993,110474.75999999994,1199.0899999999965
6384,2022-03-01 09:00:00,-289.2,111384.64999999994,110474.75999999994,909.8899999999994
6385,2022-03-01 09:05:00,1689.56,113074.20999999993,110474.75999999994,2599.449999999997
6386,2022-03-01 09:10:00,1320.19,114394.39999999994,110474.75999999994,3919.6399999999994
6387,2022-03-01 09:15:00,997.6,115391.99999999994,110474.75999999994,4917.240000000005
6388,2022-03-01 09:20:00,-1168.05,114223.94999999994,110474.75999999994,3749.1900000000023
6389,2022-03-01 09:25:00,-782.4,113441.54999999994,110474.75999999994,2966.790000000008
6390,2022-03-01 09:30:00,-1604.75,111836.79999999994,110474.75999999994,1362.0400000000081
6391,2022-03-01 09:35:00,1764.81,113601.60999999994,110474.75999999994,3126.850000000006
6392,2022-03-01 09:40:00,-300.37,113301.23999999995,110474.75999999994,2826.4800000000105
6393,2022-03-01 09:45:00,1780.49,115081.72999999995,110474.75999999994,4606.970000000016
6394,2022-03-01 09:50:00,-63.39,115018.33999999995,110474.75999999994,4543.580000000016
6395,2022-03-01 09:55:00,1973.21,116991.54999999996,110474.75999999994,6516.790000000023
6396,2022-03-01 10:00:00,489.38,117480.92999999996,110474.75999999994,7006.170000000027
6397,2022-03-01 10:05:00,-349.75,117131.17999999996,110474.75999999994,6656.420000000027
6398,2022-03-01 10:10:00,46.67,117177.84999999996,110474.75999999994,6703.090000000026
6399,2022-03-01 10:15:00,197.53,117375.37999999996,110474.75999999994,6900.620000000024
6400,2022-03-01 10:20:00,-689.45,116685.92999999996,110474.75999999994,6211.170000000027
6401,2022-03-01 10:25:00,-1345.83,115340.09999999996,110474.75999999994,4865.340000000026
6402,2022-03-01 10:30:00,282.49,115622.58999999997,110474.75999999994,5147.830000000031
6403,2022-03-01 10:35:00,-871.08,114751.50999999997,110474.75999999994,4276.750000000029
6404,2022-03-01 10:40:00,-45.21,114706.29999999996,110474.75999999994,4231.540000000023
6405,2022-03-01 10:45:00,238.21,114944.50999999997,110474.75999999994,4469.750000000029
6406,2022-03-01 10:50:00,-673.65,114270.85999999997,110474.75999999994,3796.100000000035
6407,2022-03-01 10:55:00,-1156.74,113114.11999999997,110474.75999999994,2639.3600000000297
6408,2022-03-01 11:00:00,-788.64,112325.47999999997,110474.75999999994,1850.7200000000303
6409,2022-03-01 11:05:00,994.08,113319.55999999997,110474.75999999994,2844.800000000032
6410,2022-03-01 11:10:00,-784.58,112534.97999999997,110474.75999999994,2060.2200000000303
6411,2022-03-01 11:15:00,-468.17,112066.80999999997,110474.75999999994,1592.050000000032
6412,2022-03-01 11:20:00,525.92,112592.72999999997,110474.75999999994,2117.9700000000303
6413,2022-03-01 11:25:00,-1473.82,111118.90999999996,110474.75999999994,644.1500000000233
6414,2022-03-01 11:30:00,329.61,111448.51999999996,110474.75999999994,973.7600000000239
6415,2022-03-01 11:35:00,-34.61,111413.90999999996,110474.75999999994,939.1500000000233
6416,2022-03-01 11:40:00,-1622.35,109791.55999999995,110474.75999999994,-683.1999999999825
6417,2022-03-01 11:45:00,-1888.69,107902.86999999995,110474.75999999994,-2571.889999999985
6418,2022-03-01 11:50:00,-1641.07,106261.79999999994,110474.75999999994,-4212.959999999992
6419,2022-03-01 11:55:00,-1299.53,104962.26999999995,110474.75999999994,-5512.489999999991
6420,2022-03-01 12:00:00,1469.12,106431.38999999994,110474.75999999994,-4043.3699999999953
6421,2022-03-01 12:05:00,1640.27,108071.65999999995,110474.75999999994,-2403.0999999999913
6422,2022-03-01 12:10:00,605.46,108677.11999999995,110474.75999999994,-1797.6399999999849
6423,2022-03-01 12:15:00,-1432.28,107244.83999999995,110474.75999999994,-3229.9199999999837
6424,2022-03-01 12:20:00,-1955.68,105289.15999999996,110474.75999999994,-5185.599999999977
6425,2022-03-01 12:25:00,-1014.8,104274.35999999996,110474.75999999994,-6200.39999999998
6426,2022-03-01 12:30:00,-1081.93,103192.42999999996,110474.75999999994,-7282.329999999973
6427,2022-03-01 12:35:00,-1075.07,102117.35999999996,110474.75999999994,-8357.39999999998
6428,2022-03-01 12:40:00,-882.22,101235.13999999996,110474.75999999994,-9239.61999999998
6429,2022-03-01 12:45:00,-1231.37,100003.76999999996,110474.75999999994,-10470.989999999976
6430,2022-03-01 12:50:00,-1427.05,98576.71999999996,110474.75999999994,-11898.039999999979
6431,2022-03-01 12:55:00,1465.77,100042.48999999996,110474.75999999994,-10432.269999999975
6432,2022-03-01 13:00:00,1048.9,101091.38999999996,110474.75999999994,-9383.36999999998
6433,2022-03-01 13:05:00,-508.45,100582.93999999996,110474.75999999994,-9891.819999999978
6434,2022-03-01 13:10:00,1950.58,102533.51999999996,110474.75999999994,-7941.239999999976
6435,2022-03-01 13:15:00,1882.89,104416.40999999996,110474.75999999994,-6058.349999999977
6436,2022-03-01 13:20:00,1139.02,105555.42999999996,110474.75999999994,-4919.329999999973
6437,2022-03-01 13:25:00,528.85,106084.27999999997,110474.75999999994,-4390.479999999967
6438,2022-03-01 13:30:00,557.51,106641.78999999996,110474.75999999994,-3832.969999999972
6439,2022-03-01 13:35:00,-629.22,106012.56999999996,110474.75999999994,-4462.189999999973
6440,2022-03-01 13:40:00,179.23,106191.79999999996,110474.75999999994,-4282.959999999977
6441,2022-03-01 13:45:00,1885.87,108077.66999999995,110474.75999999994,-2397.089999999982
6442,2022-03-01 13:50:00,-219.42,107858.24999999996,110474.75999999994,-2616.50999999998
6443,2022-03-01 13:55:00,73.49,107931.73999999996,110474.75999999994,-2543.019999999975
6444,2022-03-01 14:00:00,-1165.89,106765.84999999996,110474.75999999994,-3708.9099999999744
6445,2022-03-01 14:05:00,-261.9,106503.94999999997,110474.75999999994,-3970.8099999999686
6446,2022-03-01 14:10:00,-313.77,106190.17999999996,110474.75999999994,-4284.579999999973
6447,2022-03-01 14:15:00,709.97,106900.14999999997,110474.75999999994,-3574.6099999999715
6448,2022-03-01 14:20:00,1018.11,107918.25999999997,110474.75999999994,-2556.499999999971
6449,2022-03-01 14:25:00,1839.21,109757.46999999997,110474.75999999994,-717.2899999999645
6450,2022-03-01 14:30:00,934.47,110691.93999999997,110474.75999999994,217.18000000003667
6451,2022-03-01 14:35:00,1805.62,112497.55999999997,110474.75999999994,2022.800000000032
6452,2022-03-01 14:40:00,1844.19,114341.74999999997,110474.75999999994,3866.9900000000343
6453,2022-03-01 14:45:00,258.9,114600.64999999997,110474.75999999994,4125.8900000000285
6454,2022-03-01 14:50:00,-1880.48,112720.16999999997,110474.75999999994,2245.4100000000326
6455,2022-03-01 14:55:00,1108.36,113828.52999999997,110474.75999999994,3353.770000000033
6456,2022-03-01 15:00:00,-786.36,113042.16999999997,110474.75999999994,2567.4100000000326
6457,2022-03-01 15:05:00,-809.23,112232.93999999997,110474.75999999994,1758.1800000000367
6458,2022-03-01 15:10:00,432.48,112665.41999999997,110474.75999999994,2190.6600000000326
6459,2022-03-01 15:15:00,-1928.9,110736.51999999997,110474.75999999994,261.7600000000384
6460,2022-03-01 15:20:00,-1382.75,109353.76999999997,110474.75999999994,-1120.9899999999616
6461,2022-03-01 15:25:00,1714.8,111068.56999999998,110474.75999999994,593.8100000000413
6462,2022-03-01 15:30:00,1233.66,112302.22999999998,110474.75999999994,1827.4700000000448
6463,2022-03-01 15:35:00,664.43,112966.65999999997,110474.75999999994,2491.900000000038
6464,2022-03-01 15:40:00,1170.04,114136.69999999997,110474.75999999994,3661.9400000000314
6465,2022-03-01 15:45:00,805.91,114942.60999999997,110474.75999999994,4467.850000000035
6466,2022-03-01 15:50:00,-39.43,114903.17999999998,110474.75999999994,4428.420000000042
6467,2022-03-01 15:55:00,43.2,114946.37999999998,110474.75999999994,4471.620000000039
6468,2022-03-01 16:00:00,-640.2,114306.17999999998,110474.75999999994,3831.420000000042
6469,2022-03-01 16:05:00,1156.08,115462.25999999998,110474.75999999994,4987.500000000044
6470,2022-03-01 16:10:00,-564.33,114897.92999999998,110474.75999999994,4423.170000000042
6471,2022-03-01 16:15:00,-269.54,114628.38999999998,110474.75999999994,4153.630000000048
6472,2022-03-01 16:20:00,-1688.77,112939.61999999998,110474.75999999994,2464.8600000000442
6473,2022-03-01 16:25:00,-731.45,112208.16999999998,110474.75999999994,1733.4100000000471
6474,2022-03-01 16:30:00,-887.67,111320.49999999999,110474.75999999994,845.7400000000489
6475,2022-03-01 16:35:00,1635.33,112955.82999999999,110474.75999999994,2481.0700000000506
6476,2022-03-01 16:40:00,-748.94,112206.88999999998,110474.75999999994,1732.1300000000483
6477,2022-03-01 16:45:00,-1224.54,110982.34999999999,110474.75999999994,507.5900000000547
6478,2022-03-01 16:50:00,-418.33,110564.01999999999,110474.75999999994,89.26000000005297
6479,2022-03-01 16:55:00,-934.0,109630.01999999999,110474.75999999994,-844.739999999947
6480,2022-03-02 08:00:00,-1152.79,108477.23,109630.01999999999,-1152.7899999999936
6481,2022-03-02 08:05:00,-1341.91,107135.31999999999,109630.01999999999,-2494.699999999997
6482,2022-03-02 08:10:00,548.46,107683.78,109630.01999999999,-1946.2399999999907
6483,2022-03-02 08:15:00,-1588.29,106095.49,109630.01999999999,-3534.5299999999843
6484,2022-03-02 08:20:00,-1068.6,105026.89,109630.01999999999,-4603.12999999999
6485,2022-03-02 08:25:00,-969.03,104057.86,109630.01999999999,-5572.159999999989
6486,2022-03-02 08:30:00,1273.38,105331.24,109630.01999999999,-4298.779999999984
6487,2022-03-02 08:35:00,-1707.52,103623.72,109630.01999999999,-6006.299999999988
6488,2022-03-02 08:40:00,-364.02,103259.7,109630.01999999999,-6370.319999999992
6489,2022-03-02 08:45:00,1241.85,104501.55,109630.01999999999,-5128.469999999987
6490,2022-03-02 08:50:00,1286.24,105787.79000000001,109630.01999999999,-3842.2299999999814
6491,2022-03-02 08:55:00,-1911.34,103876.45000000001,109630.01999999999,-5753.569999999978
6492,2022-03-02 09:00:00,1394.44,105270.89000000001,109630.01999999999,-4359.129999999976
6493,2022-03-02 09:05:00,628.03,105898.92000000001,109630.01999999999,-3731.0999999999767
6494,2022-03-02 09:10:00,-1294.27,104604.65000000001,109630.01999999999,-5025.369999999981
6495,2022-03-02 09:15:00,1583.75,106188.40000000001,109630.01999999999,-3441.619999999981
6496,2022-03-02 09:20:00,-1387.21,104801.19,109630.01999999999,-4828.829999999987
6497,2022-03-02 09:25:00,-632.3,104168.89,109630.01999999999,-5461.12999999999
6498,2022-03-02 09:30:00,1439.52,105608.41,109630.01999999999,-4021.609999999986
6499,2022-03-02 09:35:00,1525.05,107133.46,109630.01999999999,-2496.559999999983
6500,2022-03-02 09:40:00,-1569.59,105563.87000000001,109630.01999999999,-4066.1499999999796
6501,2022-03-02 09:45:00,-73.08,105490.79000000001,109630.01999999999,-4139.229999999981
6502,2022-03-02 09:50:00,1220.12,106710.91,109630.01999999999,-2919.109999999986
6503,2022-03-02 09:55:00,1633.56,108344.47,109630.01999999999,-1285.5499999999884
6504,2022-03-02 10:00:00,934.5,109278.97,109630.01999999999,-351.04999999998836
6505,2022-03-02 10:05:00,-983.08,108295.89,109630.01999999999,-1334.12999999999
6506,2022-03-02 10:10:00,923.55,109219.44,109630.01999999999,-410.5799999999872
6507,2022-03-02 10:15:00,-1667.27,107552.17,109630.01999999999,-2077.8499999999913
6508,2022-03-02 10:20:00,443.79,107995.95999999999,109630.01999999999,-1634.0599999999977
6509,2022-03-02 10:25:00,1232.46,109228.42,109630.01999999999,-401.59999999999127
6510,2022-03-02 10:30:00,1980.53,111208.95,109630.01999999999,1578.9300000000076
6511,2022-03-02 10:35:00,-23.35,111185.59999999999,109630.01999999999,1555.5800000000017
6512,2022-03-02 10:40:00,1860.18,113045.77999999998,109630.01999999999,3415.7599999999948
6513,2022-03-02 10:45:00,-489.06,112556.71999999999,109630.01999999999,2926.699999999997
6514,2022-03-02 10:50:00,448.05,113004.76999999999,109630.01999999999,3374.75
6515,2022-03-02 10:55:00,1878.78,114883.54999999999,109630.01999999999,5253.529999999999
6516,2022-03-02 11:00:00,-1509.0,113374.54999999999,109630.01999999999,3744.529999999999
6517,2022-03-02 11:05:00,-900.74,112473.80999999998,109630.01999999999,2843.7899999999936
6518,2022-03-02 11:10:00,235.59,112709.39999999998,109630.01999999999,3079.37999999999
6519,2022-03-02 11:15:00,-824.41,111884.98999999998,109630.01999999999,2254.9699999999866
6520,2022-03-02 11:20:00,-1046.49,110838.49999999997,109630.01999999999,1208.4799999999814
6521,2022-03-02 11:25:00,-1942.56,108895.93999999997,109630.01999999999,-734.0800000000163
6522,2022-03-02 11:30:00,1739.83,110635.76999999997,109630.01999999999,1005.7499999999854
6523,2022-03-02 11:35:00,-722.18,109913.58999999998,109630.01999999999,283.56999999999243
6524,2022-03-02 11:40:00,-659.12,109254.46999999999,109630.01999999999,-375.5500000000029
6525,2022-03-02 11:45:00,684.15,109938.61999999998,109630.01999999999,308.59999999999127
6526,2022-03-02 11:50:00,369.79,110308.40999999997,109630.01999999999,678.3899999999849
6527,2022-03-02 11:55:00,-1974.36,108334.04999999997,109630.01999999999,-1295.9700000000157
6528,2022-03-02 12:00:00,-1207.88,107126.16999999997,109630.01999999999,-2503.8500000000204
6529,2022-03-02 12:05:00,-353.99,106772.17999999996,109630.01999999999,-2857.8400000000256
6530,2022-03-02 12:10:00,845.62,107617.79999999996,109630.01999999999,-2012.2200000000303
6531,2022-03-02 12:15:00,-1736.41,105881.38999999996,109630.01999999999,-3748.6300000000338
6532,2022-03-02 12:20:00,1853.55,107734.93999999996,109630.01999999999,-1895.0800000000309
6533,2022-03-02 12:25:00,1887.24,109622.17999999996,109630.01999999999,-7.840000000025611
6534,2022-03-02 12:30:00,-381.12,109241.05999999997,109630.01999999999,-388.96000000002095
6535,2022-03-02 12:35:00,-1893.67,107347.38999999997,109630.01999999999,-2282.630000000019
6536,2022-03-02 12:40:00,1990.95,109338.33999999997,109630.01999999999,-291.6800000000221
6537,2022-03-02 12:45:00,353.09,109691.42999999996,109630.01999999999,61.40999999997439
6538,2022-03-02 12:50:00,1886.61,111578.03999999996,109630.01999999999,1948.019999999975
6539,2022-03-02 12:55:00,-1054.75,110523.28999999996,109630.01999999999,893.269999999975
6540,2022-03-02 13:00:00,901.49,111424.77999999997,109630.01999999999,1794.7599999999802
6541,2022-03-02 13:05:00,426.26,111851.03999999996,109630.01999999999,2221.019999999975
6542,2022-03-02 13:10:00,1925.39,113776.42999999996,109630.01999999999,4146.409999999974
6543,2022-03-02 13:15:00,-1788.32,111988.10999999996,109630.01999999999,2358.0899999999674
6544,2022-03-02 13:20:00,-1169.48,110818.62999999996,109630.01999999999,1188.6099999999715
6545,2022-03-02 13:25:00,746.47,111565.09999999996,109630.01999999999,1935.0799999999726
6546,2022-03-02 13:30:00,-56.39,111508.70999999996,109630.01999999999,1878.6899999999732
6547,2022-03-02 13:35:00,1217.6,112726.30999999997,109630.01999999999,3096.289999999979
6548,2022-03-02 13:40:00,-1563.12,111163.18999999997,109630.01999999999,1533.1699999999837
6549,2022-03-02 13:45:00,490.74,111653.92999999998,109630.01999999999,2023.909999999989
6550,2022-03-02 13:50:00,-26.22,111627.70999999998,109630.01999999999,1997.6899999999878
6551,2022-03-02 13:55:00,618.18,112245.88999999997,109630.01999999999,2615.869999999981
6552,2022-03-02 14:00:00,-1773.22,110472.66999999997,109630.01999999999,842.6499999999796
6553,2022-03-02 14:05:00,1716.99,112189.65999999997,109630.01999999999,2559.639999999985
6554,2022-03-02 14:10:00,1096.42,113286.07999999997,109630.01999999999,3656.059999999983
6555,2022-03-02 14:15:00,-1384.91,111901.16999999997,109630.01999999999,2271.1499999999796
6556,2022-03-02 14:20:00,391.05,112292.21999999997,109630.01999999999,2662.1999999999825
6557,2022-03-02 14:25:00,-1291.77,111000.44999999997,109630.01999999999,1370.4299999999785
6558,2022-03-02 14:30:00,1031.48,112031.92999999996,109630.01999999999,2401.9099999999744
6559,2022-03-02 14:35:00,-1362.66,110669.26999999996,109630.01999999999,1039.249999999971
6560,2022-03-02 14:40:00,243.35,110912.61999999997,109630.01999999999,1282.5999999999767
6561,2022-03-02 14:45:00,1689.18,112601.79999999996,109630.01999999999,2971.7799999999697
6562,2022-03-02 14:50:00,-428.58,112173.21999999996,109630.01999999999,2543.199999999968
6563,2022-03-02 14:55:00,-528.82,111644.39999999995,109630.01999999999,2014.379999999961
6564,2022-03-02 15:00:00,1800.56,113444.95999999995,109630.01999999999,3814.9399999999587
6565,2022-03-02 15:05:00,-1898.02,111546.93999999994,109630.01999999999,1916.9199999999546
6566,2022-03-02 15:10:00,-670.3,110876.63999999994,109630.01999999999,1246.6199999999517
6567,2022-03-02 15:15:00,1828.3,112704.93999999994,109630.01999999999,3074.9199999999546
6568,2022-03-02 15:20:00,236.15,112941.08999999994,109630.01999999999,3311.069999999949
6569,2022-03-02 15:25:00,1181.66,114122.74999999994,109630.01999999999,4492.729999999952
6570,2022-03-02 15:30:00,864.08,114986.82999999994,109630.01999999999,5356.809999999954
6571,2022-03-02 15:35:00,119.41,115106.23999999995,109630.01999999999,5476.2199999999575
6572,2022-03-02 15:40:00,1871.85,116978.08999999995,109630.01999999999,7348.069999999963
6573,2022-03-02 15:45:00,-1575.73,115402.35999999996,109630.01999999999,5772.339999999967
6574,2022-03-02 15:50:00,912.05,116314.40999999996,109630.01999999999,6684.38999999997
6575,2022-03-02 15:55:00,-403.89,115910.51999999996,109630.01999999999,6280.499999999971
6576,2022-03-02 16:00:00,-1167.33,114743.18999999996,109630.01999999999,5113.169999999969
6577,2022-03-02 16:05:00,-0.31,114742.87999999996,109630.01999999999,5112.8599999999715
6578,2022-03-02 16:10:00,-919.32,113823.55999999995,109630.01999999999,4193.5399999999645
6579,2022-03-02 16:15:00,-851.74,112971.81999999995,109630.01999999999,3341.7999999999593
6580,2022-03-02 16:20:00,1069.37,114041.18999999994,109630.01999999999,4411.169999999955
6581,2022-03-02 16:25:00,1785.17,115826.35999999994,109630.01999999999,6196.339999999953
6582,2022-03-02 16:30:00,-430.99,115395.36999999994,109630.01999999999,5765.349999999948
6583,2022-03-02 16:35:00,1711.71,117107.07999999994,109630.01999999999,7477.059999999954
6584,2022-03-02 16:40:00,1185.56,118292.63999999994,109630.01999999999,8662.619999999952
6585,2022-03-02 16:45:00,1591.93,119884.56999999993,109630.01999999999,10254.549999999945
6586,2022-03-02 16:50:00,1980.17,121864.73999999993,109630.01999999999,12234.719999999943
6587,2022-03-02 16:55:00,-164.9,121699.83999999994,109630.01999999999,12069.819999999949
6588,2022-03-03 08:00:00,1767.3,123467.13999999994,121699.83999999994,1767.300000000003
6589,2022-03-03 08:05:00,-637.62,122829.51999999995,121699.83999999994,1129.6800000000076
6590,2022-03-03 08:10:00,1059.64,123889.15999999995,121699.83999999994,2189.320000000007
6591,2022-03-03 08:15:00,609.31,124498.46999999994,121699.83999999994,2798.6300000000047
6592,2022-03-03 08:20:00,-1351.7,123146.76999999995,121699.83999999994,1446.9300000000076
6593,2022-03-03 08:25:00,1112.38,124259.14999999995,121699.83999999994,2559.310000000012
6594,2022-03-03 08:30:00,-753.37,123505.77999999996,121699.83999999994,1805.9400000000169
6595,2022-03-03 08:35:00,1284.55,124790.32999999996,121699.83999999994,3090.49000000002
6596,2022-03-03 08:40:00,222.52,125012.84999999996,121699.83999999994,3313.010000000024
6597,2022-03-03 08:45:00,-1085.95,123926.89999999997,121699.83999999994,2227.060000000027
6598,2022-03-03 08:50:00,1529.24,125456.13999999997,121699.83999999994,3756.300000000032
6599,2022-03-03 08:55:00,1120.75,126576.88999999997,121699.83999999994,4877.050000000032
6600,2022-03-03 09:00:00,-497.64,126079.24999999997,121699.83999999994,4379.410000000033
6601,2022-03-03 09:05:00,1491.22,127570.46999999997,121699.83999999994,5870.630000000034
6602,2022-03-03 09:10:00,-1079.51,126490.95999999998,121699.83999999994,4791.120000000039
6603,2022-03-03 09:15:00,1918.16,128409.11999999998,121699.83999999994,6709.2800000000425
6604,2022-03-03 09:20:00,-1128.05,127281.06999999998,121699.83999999994,5581.23000000004
6605,2022-03-03 09:25:00,998.31,128279.37999999998,121699.83999999994,6579.540000000037
6606,2022-03-03 09:30:00,-1830.46,126448.91999999997,121699.83999999994,4749.080000000031
6607,2022-03-03 09:35:00,1875.79,128324.70999999996,121699.83999999994,6624.870000000024
6608,2022-03-03 09:40:00,53.74,128378.44999999997,121699.83999999994,6678.61000000003
6609,2022-03-03 09:45:00,-1974.77,126403.67999999996,121699.83999999994,4703.840000000026
6610,2022-03-03 09:50:00,-785.13,125618.54999999996,121699.83999999994,3918.710000000021
6611,2022-03-03 09:55:00,337.25,125955.79999999996,121699.83999999994,4255.960000000021
6612,2022-03-03 10:00:00,562.36,126518.15999999996,121699.83999999994,4818.3200000000215
6613,2022-03-03 10:05:00,1049.46,127567.61999999997,121699.83999999994,5867.780000000028
6614,2022-03-03 10:10:00,1868.41,129436.02999999997,121699.83999999994,7736.190000000031
6615,2022-03-03 10:15:00,-129.38,129306.64999999997,121699.83999999994,7606.810000000027
6616,2022-03-03 10:20:00,1053.1,130359.74999999997,121699.83999999994,8659.910000000033
6617,2022-03-03 10:25:00,189.0,130548.74999999997,121699.83999999994,8848.910000000033
6618,2022-03-03 10:30:00,1535.98,132084.72999999998,121699.83999999994,10384.890000000043
6619,2022-03-03 10:35:00,1764.0,133848.72999999998,121699.83999999994,12148.890000000043
6620,2022-03-03 10:40:00,-1618.66,132230.06999999998,121699.83999999994,10530.23000000004
6621,2022-03-03 10:45:00,-1233.29,130996.77999999998,121699.83999999994,9296.940000000046
6622,2022-03-03 10:50:00,375.13,131371.90999999997,121699.83999999994,9672.070000000036
6623,2022-03-03 10:55:00,82.14,131454.05,121699.83999999994,9754.21000000005
6624,2022-03-03 11:00:00,492.77,131946.81999999998,121699.83999999994,10246.98000000004
6625,2022-03-03 11:05:00,991.73,132938.55,121699.83999999994,11238.71000000005
6626,2022-03-03 11:10:00,1532.82,134471.37,121699.83999999994,12771.530000000057
6627,2022-03-03 11:15:00,528.61,134999.97999999998,121699.83999999994,13300.140000000043
6628,2022-03-03 11:20:00,920.68,135920.65999999997,121699.83999999994,14220.820000000036
6629,2022-03-03 11:25:00,-1836.12,134084.53999999998,121699.83999999994,12384.70000000004
6630,2022-03-03 11:30:00,-1091.8,132992.74,121699.83999999994,11292.900000000052
6631,2022-03-03 11:35:00,192.96,133185.69999999998,121699.83999999994,11485.860000000044
6632,2022-03-03 11:40:00,-107.45,133078.24999999997,121699.83999999994,11378.410000000033
6633,2022-03-03 11:45:00,31.41,133109.65999999997,121699.83999999994,11409.820000000036
6634,2022-03-03 11:50:00,593.8,133703.45999999996,121699.83999999994,12003.620000000024
6635,2022-03-03 11:55:00,1811.3,135514.75999999995,121699.83999999994,13814.920000000013
6636,2022-03-03 12:00:00,-1048.17,134466.58999999994,121699.83999999994,12766.75
6637,2022-03-03 12:05:00,78.55,134545.13999999993,121699.83999999994,12845.299999999988
6638,2022-03-03 12:10:00,-826.39,133718.7499999999,121699.83999999994,12018.909999999974
6639,2022-03-03 12:15:00,-425.97,133292.7799999999,121699.83999999994,11592.939999999973
6640,2022-03-03 12:20:00,-338.53,132954.2499999999,121699.83999999994,11254.409999999974
6641,2022-03-03 12:25:00,263.56,133217.8099999999,121699.83999999994,11517.969999999972
6642,2022-03-03 12:30:00,1353.45,134571.25999999992,121699.83999999994,12871.419999999984
6643,2022-03-03 12:35:00,648.63,135219.88999999993,121699.83999999994,13520.049999999988
6644,2022-03-03 12:40:00,-1431.75,133788.13999999993,121699.83999999994,12088.299999999988
6645,2022-03-03 12:45:00,-1716.24,132071.89999999994,121699.83999999994,10372.059999999998
6646,2022-03-03 12:50:00,984.99,133056.88999999993,121699.83999999994,11357.049999999988
6647,2022-03-03 12:55:00,1819.13,134876.01999999993,121699.83999999994,13176.179999999993
6648,2022-03-03 13:00:00,1764.76,136640.77999999994,121699.83999999994,14940.940000000002
6649,2022-03-03 13:05:00,1852.13,138492.90999999995,121699.83999999994,16793.070000000007
6650,2022-03-03 13:10:00,-798.88,137694.02999999994,121699.83999999994,15994.190000000002
6651,2022-03-03 13:15:00,1735.29,139429.31999999995,121699.83999999994,17729.48000000001
6652,2022-03-03 13:20:00,-1553.25,137876.06999999995,121699.83999999994,16176.23000000001
6653,2022-03-03 13:25:00,-1586.88,136289.18999999994,121699.83999999994,14589.350000000006
6654,2022-03-03 13:30:00,-123.49,136165.69999999995,121699.83999999994,14465.860000000015
6655,2022-03-03 13:35:00,-802.14,135363.55999999994,121699.83999999994,13663.720000000001
6656,2022-03-03 13:40:00,498.98,135862.53999999995,121699.83999999994,14162.700000000012
6657,2022-03-03 13:45:00,327.68,136190.21999999994,121699.83999999994,14490.380000000005
6658,2022-03-03 13:50:00,-1332.11,134858.10999999996,121699.83999999994,13158.270000000019
6659,2022-03-03 13:55:00,120.24,134978.34999999995,121699.83999999994,13278.51000000001
6660,2022-03-03 14:00:00,723.05,135701.39999999994,121699.83999999994,14001.559999999998
6661,2022-03-03 14:05:00,-1638.07,134063.32999999993,121699.83999999994,12363.48999999999
6662,2022-03-03 14:10:00,-1849.28,132214.04999999993,121699.83999999994,10514.209999999992
6663,2022-03-03 14:15:00,695.98,132910.02999999994,121699.83999999994,11210.190000000002
6664,2022-03-03 14:20:00,-520.42,132389.60999999993,121699.83999999994,10689.76999999999
6665,2022-03-03 14:25:00,-168.07,132221.53999999992,121699.83999999994,10521.699999999983
6666,2022-03-03 14:30:00,756.94,132978.47999999992,121699.83999999994,11278.639999999985
6667,2022-03-03 14:35:00,-871.12,132107.35999999993,121699.83999999994,10407.51999999999
6668,2022-03-03 14:40:00,946.27,133053.62999999992,121699.83999999994,11353.789999999979
6669,2022-03-03 14:45:00,1371.87,134425.4999999999,121699.83999999994,12725.659999999974
6670,2022-03-03 14:50:00,-225.36,134200.13999999993,121699.83999999994,12500.299999999988
6671,2022-03-03 14:55:00,-1130.75,133069.38999999993,121699.83999999994,11369.549999999988
6672,2022-03-03 15:00:00,1855.79,134925.17999999993,121699.83999999994,13225.339999999997
6673,2022-03-03 15:05:00,-194.91,134730.26999999993,121699.83999999994,13030.429999999993
6674,2022-03-03 15:10:00,48.13,134778.39999999994,121699.83999999994,13078.559999999998
6675,2022-03-03 15:15:00,461.8,135240.19999999992,121699.83999999994,13540.359999999986
6676,2022-03-03 15:20:00,1406.6,136646.79999999993,121699.83999999994,14946.959999999992
6677,2022-03-03 15:25:00,1752.65,138399.44999999992,121699.83999999994,16699.609999999986
6678,2022-03-03 15:30:00,-1521.86,136877.58999999994,121699.83999999994,15177.75
6679,2022-03-03 15:35:00,1844.14,138721.72999999995,121699.83999999994,17021.890000000014
6680,2022-03-03 15:40:00,-836.24,137885.48999999996,121699.83999999994,16185.650000000023
6681,2022-03-03 15:45:00,223.17,138108.65999999997,121699.83999999994,16408.820000000036
6682,2022-03-03 15:50:00,-914.19,137194.46999999997,121699.83999999994,15494.630000000034
6683,2022-03-03 15:55:00,328.05,137522.51999999996,121699.83999999994,15822.680000000022
6684,2022-03-03 16:00:00,565.84,138088.35999999996,121699.83999999994,16388.52000000002
6685,2022-03-03 16:05:00,1937.79,140026.14999999997,121699.83999999994,18326.310000000027
6686,2022-03-03 16:10:00,1384.03,141410.17999999996,121699.83999999994,19710.340000000026
6687,2022-03-03 16:15:00,-1055.06,140355.11999999997,121699.83999999994,18655.280000000028
6688,2022-03-03 16:20:00,286.81,140641.92999999996,121699.83999999994,18942.090000000026
6689,2022-03-03 16:25:00,-1381.31,139260.61999999997,121699.83999999994,17560.780000000028
6690,2022-03-03 16:30:00,464.38,139724.99999999997,121699.83999999994,18025.160000000033
6691,2022-03-03 16:35:00,-153.31,139571.68999999997,121699.83999999994,17871.850000000035
6692,2022-03-03 16:40:00,520.84,140092.52999999997,121699.83999999994,18392.69000000003
6693,2022-03-03 16:45:00,1924.98,142017.50999999998,121699.83999999994,20317.670000000042
6694,2022-03-03 16:50:00,924.46,142941.96999999997,121699.83999999994,21242.130000000034
6695,2022-03-03 16:55:00,1505.98,144447.94999999998,121699.83999999994,22748.110000000044
6696,2022-03-04 08:00:00,1456.59,145904.53999999998,144447.94999999998,1456.5899999999965
6697,2022-03-04 08:05:00,1295.3,147199.83999999997,144447.94999999998,2751.889999999985
6698,2022-03-04 08:10:00,1038.95,148238.78999999998,144447.94999999998,3790.8399999999965
6699,2022-03-04 08:15:00,-1244.2,146994.58999999997,144447.94999999998,2546.639999999985
6700,2022-03-04 08:20:00,-1765.75,145228.83999999997,144447.94999999998,780.8899999999849
6701,2022-03-04 08:25:00,-666.78,144562.05999999997,144447.94999999998,114.10999999998603
6702,2022-03-04 08:30:00,974.43,145536.48999999996,144447.94999999998,1088.539999999979
6703,2022-03-04 08:35:00,-142.08,145394.40999999997,144447.94999999998,946.4599999999919
6704,2022-03-04 08:40:00,355.69,145750.09999999998,144447.94999999998,1302.1499999999942
6705,2022-03-04 08:45:00,-747.52,145002.58,144447.94999999998,554.6300000000047
6706,2022-03-04 08:50:00,229.39,145231.97,144447.94999999998,784.0200000000186
6707,2022-03-04 08:55:00,1872.25,147104.22,144447.94999999998,2656.2700000000186
6708,2022-03-04 09:00:00,-1442.74,145661.48,144447.94999999998,1213.530000000028
6709,2022-03-04 09:05:00,535.7,146197.18000000002,144447.94999999998,1749.2300000000396
6710,2022-03-04 09:10:00,-254.98,145942.2,144447.94999999998,1494.250000000029
6711,2022-03-04 09:15:00,-1478.27,144463.93000000002,144447.94999999998,15.980000000039581
6712,2022-03-04 09:20:00,115.34,144579.27000000002,144447.94999999998,131.3200000000361
6713,2022-03-04 09:25:00,1110.02,145689.29,144447.94999999998,1241.3400000000256
6714,2022-03-04 09:30:00,-382.2,145307.09,144447.94999999998,859.140000000014
6715,2022-03-04 09:35:00,658.72,145965.81,144447.94999999998,1517.8600000000151
6716,2022-03-04 09:40:00,-1201.96,144763.85,144447.94999999998,315.9000000000233
6717,2022-03-04 09:45:00,185.4,144949.25,144447.94999999998,501.30000000001746
6718,2022-03-04 09:50:00,-698.51,144250.74,144447.94999999998,-197.20999999999185
6719,2022-03-04 09:55:00,-1844.73,142406.00999999998,144447.94999999998,-2041.9400000000023
6720,2022-03-04 10:00:00,-1671.84,140734.16999999998,144447.94999999998,-3713.779999999999
6721,2022-03-04 10:05:00,-974.77,139759.4,144447.94999999998,-4688.549999999988
6722,2022-03-04 10:10:00,-1033.09,138726.31,144447.94999999998,-5721.639999999985
6723,2022-03-04 10:15:00,-476.37,138249.94,144447.94999999998,-6198.00999999998
6724,2022-03-04 10:20:00,24.9,138274.84,144447.94999999998,-6173.109999999986
6725,2022-03-04 10:25:00,1703.18,139978.02,144447.94999999998,-4469.929999999993
6726,2022-03-04 10:30:00,1579.26,141557.28,144447.94999999998,-2890.6699999999837
6727,2022-03-04 10:35:00,-390.75,141166.53,144447.94999999998,-3281.4199999999837
6728,2022-03-04 10:40:00,1848.08,143014.61,144447.94999999998,-1433.3399999999965
6729,2022-03-04 10:45:00,749.94,143764.55,144447.94999999998,-683.3999999999942
6730,2022-03-04 10:50:00,-881.81,142882.74,144447.94999999998,-1565.2099999999919
6731,2022-03-04 10:55:00,-1957.51,140925.22999999998,144447.94999999998,-3522.720000000001
6732,2022-03-04 11:00:00,573.63,141498.86,144447.94999999998,-2949.0899999999965
6733,2022-03-04 11:05:00,417.16,141916.02,144447.94999999998,-2531.929999999993
6734,2022-03-04 11:10:00,-191.31,141724.71,144447.94999999998,-2723.2399999999907
6735,2022-03-04 11:15:00,-1283.0,140441.71,144447.94999999998,-4006.2399999999907
6736,2022-03-04 11:20:00,45.3,140487.00999999998,144447.94999999998,-3960.9400000000023
6737,2022-03-04 11:25:00,-247.81,140239.19999999998,144447.94999999998,-4208.75
6738,2022-03-04 11:30:00,-1236.16,139003.03999999998,144447.94999999998,-5444.9100000000035
6739,2022-03-04 11:35:00,-861.33,138141.71,144447.94999999998,-6306.239999999991
6740,2022-03-04 11:40:00,-383.24,137758.47,144447.94999999998,-6689.479999999981
6741,2022-03-04 11:45:00,-1298.01,136460.46,144447.94999999998,-7987.489999999991
6742,2022-03-04 11:50:00,-327.36,136133.1,144447.94999999998,-8314.849999999977
6743,2022-03-04 11:55:00,1693.2,137826.30000000002,144447.94999999998,-6621.649999999965
6744,2022-03-04 12:00:00,-784.71,137041.59000000003,144447.94999999998,-7406.359999999957
6745,2022-03-04 12:05:00,681.13,137722.72000000003,144447.94999999998,-6725.229999999952
6746,2022-03-04 12:10:00,355.87,138078.59000000003,144447.94999999998,-6369.359999999957
6747,2022-03-04 12:15:00,-1043.49,137035.10000000003,144447.94999999998,-7412.849999999948
6748,2022-03-04 12:20:00,-1096.97,135938.13000000003,144447.94999999998,-8509.819999999949
6749,2022-03-04 12:25:00,1740.88,137679.01000000004,144447.94999999998,-6768.939999999944
6750,2022-03-04 12:30:00,1820.85,139499.86000000004,144447.94999999998,-4948.089999999938
6751,2022-03-04 12:35:00,618.8,140118.66000000003,144447.94999999998,-4329.28999999995
6752,2022-03-04 12:40:00,-1649.43,138469.23000000004,144447.94999999998,-5978.719999999943
6753,2022-03-04 12:45:00,1865.96,140335.19000000003,144447.94999999998,-4112.759999999951
6754,2022-03-04 12:50:00,1903.18,142238.37000000002,144447.94999999998,-2209.579999999958
6755,2022-03-04 12:55:00,-1529.87,140708.50000000003,144447.94999999998,-3739.4499999999534
6756,2022-03-04 13:00:00,1349.18,142057.68000000002,144447.94999999998,-2390.2699999999604
6757,2022-03-04 13:05:00,-1823.18,140234.50000000003,144447.94999999998,-4213.449999999953
6758,2022-03-04 13:10:00,1336.27,141570.77000000002,144447.94999999998,-2877.179999999964
6759,2022-03-04 13:15:00,-257.17,141313.6,144447.94999999998,-3134.3499999999767
6760,2022-03-04 13:20:00,-138.44,141175.16,144447.94999999998,-3272.789999999979
6761,2022-03-04 13:25:00,-144.36,141030.80000000002,144447.94999999998,-3417.149999999965
6762,2022-03-04 13:30:00,-1645.76,139385.04,144447.94999999998,-5062.909999999974
6763,2022-03-04 13:35:00,1614.13,140999.17,144447.94999999998,-3448.7799999999697
6764,2022-03-04 13:40:00,1630.1,142629.27000000002,144447.94999999998,-1818.679999999964
6765,2022-03-04 13:45:00,-1674.82,140954.45,144447.94999999998,-3493.499999999971
6766,2022-03-04 13:50:00,800.6,141755.05000000002,144447.94999999998,-2692.899999999965
6767,2022-03-04 13:55:00,714.67,142469.72000000003,144447.94999999998,-1978.2299999999523
6768,2022-03-04 14:00:00,-492.58,141977.14000000004,144447.94999999998,-2470.8099999999395
6769,2022-03-04 14:05:00,-854.0,141123.14000000004,144447.94999999998,-3324.8099999999395
6770,2022-03-04 14:10:00,1358.04,142481.18000000005,144447.94999999998,-1966.7699999999313
6771,2022-03-04 14:15:00,412.74,142893.92000000004,144447.94999999998,-1554.0299999999406
6772,2022-03-04 14:20:00,242.32,143136.24000000005,144447.94999999998,-1311.7099999999336
6773,2022-03-04 14:25:00,1586.92,144723.16000000006,144447.94999999998,275.21000000007916
6774,2022-03-04 14:30:00,-35.05,144688.11000000007,144447.94999999998,240.1600000000908
6775,2022-03-04 14:35:00,900.74,145588.85000000006,144447.94999999998,1140.9000000000815
6776,2022-03-04 14:40:00,-1946.97,143641.88000000006,144447.94999999998,-806.0699999999197
6777,2022-03-04 14:45:00,-1747.71,141894.17000000007,144447.94999999998,-2553.7799999999115
6778,2022-03-04 14:50:00,1916.15,143810.32000000007,144447.94999999998,-637.6299999999173
6779,2022-03-04 14:55:00,1670.04,145480.36000000007,144447.94999999998,1032.4100000000908
6780,2022-03-04 15:00:00,579.55,146059.91000000006,144447.94999999998,1611.9600000000792
6781,2022-03-04 15:05:00,884.11,146944.02000000005,144447.94999999998,2496.070000000065
6782,2022-03-04 15:10:00,-994.36,145949.66000000006,144447.94999999998,1501.7100000000792
6783,2022-03-04 15:15:00,-1084.54,144865.12000000005,144447.94999999998,417.170000000071
6784,2022-03-04 15:20:00,238.95,145104.07000000007,144447.94999999998,656.1200000000827
6785,2022-03-04 15:25:00,-1426.33,143677.74000000008,144447.94999999998,-770.2099999999045
6786,2022-03-04 15:30:00,229.09,143906.83000000007,144447.94999999998,-541.119999999908
6787,2022-03-04 15:35:00,1868.09,145774.92000000007,144447.94999999998,1326.9700000000885
6788,2022-03-04 15:40:00,656.92,146431.84000000008,144447.94999999998,1983.8900000001013
6789,2022-03-04 15:45:00,1765.58,148197.42000000007,144447.94999999998,3749.4700000000885
6790,2022-03-04 15:50:00,-657.07,147540.35000000006,144447.94999999998,3092.4000000000815
6791,2022-03-04 15:55:00,1022.31,148562.66000000006,144447.94999999998,4114.710000000079
6792,2022-03-04 16:00:00,946.34,149509.00000000006,144447.94999999998,5061.050000000076
6793,2022-03-04 16:05:00,-94.47,149414.53000000006,144447.94999999998,4966.5800000000745
6794,2022-03-04 16:10:00,-1487.21,147927.32000000007,144447.94999999998,3479.3700000000827
6795,2022-03-04 16:15:00,-1117.49,146809.83000000007,144447.94999999998,2361.880000000092
6796,2022-03-04 16:20:00,-1307.49,145502.34000000008,144447.94999999998,1054.3900000001013
6797,2022-03-04 16:25:00,496.28,145998.62000000008,144447.94999999998,1550.6700000001001
6798,2022-03-04 16:30:00,876.23,146874.8500000001,144447.94999999998,2426.9000000001106
6799,2022-03-04 16:35:00,1546.31,148421.1600000001,144447.94999999998,3973.2100000001083
6800,2022-03-04 16:40:00,1350.53,149771.6900000001,144447.94999999998,5323.740000000107
6801,2022-03-04 16:45:00,1654.93,151426.62000000008,144447.94999999998,6978.6700000001
6802,2022-03-04 16:50:00,-1417.89,150008.73000000007,144447.94999999998,5560.780000000086
6803,2022-03-04 16:55:00,-1221.34,148787.39000000007,144447.94999999998,4339.44000000009
6804,2022-03-05 08:00:00,995.08,149782.47000000006,148787.39000000007,995.0799999999872
6805,2022-03-05 08:05:00,1645.55,151428.02000000005,148787.39000000007,2640.6299999999756
6806,2022-03-05 08:10:00,762.01,152190.03000000006,148787.39000000007,3402.639999999985
6807,2022-03-05 08:15:00,1693.31,153883.34000000005,148787.39000000007,5095.9499999999825
6808,2022-03-05 08:20:00,1475.19,155358.53000000006,148787.39000000007,6571.139999999985
6809,2022-03-05 08:25:00,111.39,155469.92000000007,148787.39000000007,6682.529999999999
6810,2022-03-05 08:30:00,1303.89,156773.81000000008,148787.39000000007,7986.420000000013
6811,2022-03-05 08:35:00,1710.67,158484.4800000001,148787.39000000007,9697.090000000026
6812,2022-03-05 08:40:00,-306.17,158178.31000000008,148787.39000000007,9390.920000000013
6813,2022-03-05 08:45:00,-507.32,157670.99000000008,148787.39000000007,8883.600000000006
6814,2022-03-05 08:50:00,1624.65,159295.64000000007,148787.39000000007,10508.25
6815,2022-03-05 08:55:00,517.62,159813.26000000007,148787.39000000007,11025.869999999995
6816,2022-03-05 09:00:00,-844.94,158968.32000000007,148787.39000000007,10180.929999999993
6817,2022-03-05 09:05:00,-785.23,158183.09000000005,148787.39000000007,9395.699999999983
6818,2022-03-05 09:10:00,-388.63,157794.46000000005,148787.39000000007,9007.069999999978
6819,2022-03-05 09:15:00,-1682.26,156112.20000000004,148787.39000000007,7324.809999999969
6820,2022-03-05 09:20:00,1021.56,157133.76000000004,148787.39000000007,8346.369999999966
6821,2022-03-05 09:25:00,711.0,157844.76000000004,148787.39000000007,9057.369999999966
6822,2022-03-05 09:30:00,207.07,158051.83000000005,148787.39000000007,9264.439999999973
6823,2022-03-05 09:35:00,498.49,158550.32000000004,148787.39000000007,9762.929999999964
6824,2022-03-05 09:40:00,1902.94,160453.26000000004,148787.39000000007,11665.869999999966
6825,2022-03-05 09:45:00,1543.09,161996.35000000003,148787.39000000007,13208.959999999963
6826,2022-03-05 09:50:00,-457.8,161538.55000000005,148787.39000000007,12751.159999999974
6827,2022-03-05 09:55:00,982.07,162520.62000000005,148787.39000000007,13733.229999999981
6828,2022-03-05 10:00:00,1652.36,164172.98000000004,148787.39000000007,15385.589999999967
6829,2022-03-05 10:05:00,1371.74,165544.72000000003,148787.39000000007,16757.329999999958
6830,2022-03-05 10:10:00,-1903.29,163641.43000000002,148787.39000000007,14854.03999999995
6831,2022-03-05 10:15:00,-1078.92,162562.51,148787.39000000007,13775.119999999937
6832,2022-03-05 10:20:00,315.02,162877.53,148787.39000000007,14090.139999999927
6833,2022-03-05 10:25:00,648.6,163526.13,148787.39000000007,14738.739999999932
6834,2022-03-05 10:30:00,-1833.57,161692.56,148787.39000000007,12905.169999999925
6835,2022-03-05 10:35:00,-280.38,161412.18,148787.39000000007,12624.78999999992
6836,2022-03-05 10:40:00,-119.91,161292.27,148787.39000000007,12504.879999999917
6837,2022-03-05 10:45:00,-325.04,160967.22999999998,148787.39000000007,12179.83999999991
6838,2022-03-05 10:50:00,778.41,161745.63999999998,148787.39000000007,12958.249999999913
6839,2022-03-05 10:55:00,1923.43,163669.06999999998,148787.39000000007,14881.679999999906
6840,2022-03-05 11:00:00,-1295.71,162373.36,148787.39000000007,13585.969999999914
6841,2022-03-05 11:05:00,-821.38,161551.97999999998,148787.39000000007,12764.58999999991
6842,2022-03-05 11:10:00,1066.43,162618.40999999997,148787.39000000007,13831.019999999902
6843,2022-03-05 11:15:00,1454.53,164072.93999999997,148787.39000000007,15285.549999999901
6844,2022-03-05 11:20:00,820.33,164893.26999999996,148787.39000000007,16105.879999999888
6845,2022-03-05 11:25:00,-1006.47,163886.79999999996,148787.39000000007,15099.409999999887
6846,2022-03-05 11:30:00,-134.29,163752.50999999995,148787.39000000007,14965.119999999879
6847,2022-03-05 11:35:00,1991.58,165744.08999999994,148787.39000000007,16956.699999999866
6848,2022-03-05 11:40:00,-1997.76,163746.32999999993,148787.39000000007,14958.939999999857
6849,2022-03-05 11:45:00,733.5,164479.82999999993,148787.39000000007,15692.439999999857
6850,2022-03-05 11:50:00,449.3,164929.12999999992,148787.39000000007,16141.739999999845
6851,2022-03-05 11:55:00,1182.67,166111.79999999993,148787.39000000007,17324.409999999858
6852,2022-03-05 12:00:00,1996.5,168108.29999999993,148787.39000000007,19320.909999999858
6853,2022-03-05 12:05:00,1668.79,169777.08999999994,148787.39000000007,20989.699999999866
6854,2022-03-05 12:10:00,-732.83,169044.25999999995,148787.39000000007,20256.86999999988
6855,2022-03-05 12:15:00,1312.95,170357.20999999996,148787.39000000007,21569.81999999989
6856,2022-03-05 12:20:00,-1771.49,168585.71999999997,148787.39000000007,19798.3299999999
6857,2022-03-05 12:25:00,902.8,169488.51999999996,148787.39000000007,20701.12999999989
6858,2022-03-05 12:30:00,1235.26,170723.77999999997,148787.39000000007,21936.389999999898
6859,2022-03-05 12:35:00,-1328.42,169395.35999999996,148787.39000000007,20607.969999999885
6860,2022-03-05 12:40:00,1318.16,170713.51999999996,148787.39000000007,21926.12999999989
6861,2022-03-05 12:45:00,1692.16,172405.67999999996,148787.39000000007,23618.28999999989
6862,2022-03-05 12:50:00,-152.83,172252.84999999998,148787.39000000007,23465.459999999905
6863,2022-03-05 12:55:00,-1681.38,170571.46999999997,148787.39000000007,21784.0799999999
6864,2022-03-05 13:00:00,464.08,171035.54999999996,148787.39000000007,22248.159999999887
6865,2022-03-05 13:05:00,1458.8,172494.34999999995,148787.39000000007,23706.959999999875
6866,2022-03-05 13:10:00,1835.85,174330.19999999995,148787.39000000007,25542.80999999988
6867,2022-03-05 13:15:00,-1553.3,172776.89999999997,148787.39000000007,23989.509999999893
6868,2022-03-05 13:20:00,-768.46,172008.43999999997,148787.39000000007,23221.0499999999
6869,2022-03-05 13:25:00,-1908.24,170100.19999999998,148787.39000000007,21312.80999999991
6870,2022-03-05 13:30:00,539.5,170639.69999999998,148787.39000000007,21852.30999999991
6871,2022-03-05 13:35:00,686.16,171325.86,148787.39000000007,22538.469999999914
6872,2022-03-05 13:40:00,894.19,172220.05,148787.39000000007,23432.659999999916
6873,2022-03-05 13:45:00,-1424.42,170795.62999999998,148787.39000000007,22008.239999999903
6874,2022-03-05 13:50:00,-1576.08,169219.55,148787.39000000007,20432.159999999916
6875,2022-03-05 13:55:00,1714.41,170933.96,148787.39000000007,22146.56999999992
6876,2022-03-05 14:00:00,1993.97,172927.93,148787.39000000007,24140.53999999992
6877,2022-03-05 14:05:00,-225.08,172702.85,148787.39000000007,23915.459999999934
6878,2022-03-05 14:10:00,1032.01,173734.86000000002,148787.39000000007,24947.469999999943
6879,2022-03-05 14:15:00,634.23,174369.09000000003,148787.39000000007,25581.699999999953
6880,2022-03-05 14:20:00,1819.37,176188.46000000002,148787.39000000007,27401.06999999995
6881,2022-03-05 14:25:00,-674.31,175514.15000000002,148787.39000000007,26726.75999999995
6882,2022-03-05 14:30:00,-561.07,174953.08000000002,148787.39000000007,26165.689999999944
6883,2022-03-05 14:35:00,738.01,175691.09000000003,148787.39000000007,26903.699999999953
6884,2022-03-05 14:40:00,-965.27,174725.82000000004,148787.39000000007,25938.429999999964
6885,2022-03-05 14:45:00,-265.24,174460.58000000005,148787.39000000007,25673.189999999973
6886,2022-03-05 14:50:00,270.69,174731.27000000005,148787.39000000007,25943.879999999976
6887,2022-03-05 14:55:00,1342.1,176073.37000000005,148787.39000000007,27285.97999999998
6888,2022-03-05 15:00:00,3.09,176076.46000000005,148787.39000000007,27289.069999999978
6889,2022-03-05 15:05:00,1655.22,177731.68000000005,148787.39000000007,28944.28999999998
6890,2022-03-05 15:10:00,1951.96,179683.64000000004,148787.39000000007,30896.24999999997
6891,2022-03-05 15:15:00,1920.83,181604.47000000003,148787.39000000007,32817.07999999996
6892,2022-03-05 15:20:00,-832.87,180771.60000000003,148787.39000000007,31984.209999999963
6893,2022-03-05 15:25:00,1182.83,181954.43000000002,148787.39000000007,33167.03999999995
6894,2022-03-05 15:30:00,-641.22,181313.21000000002,148787.39000000007,32525.81999999995
6895,2022-03-05 15:35:00,1094.18,182407.39,148787.39000000007,33619.99999999994
6896,2022-03-05 15:40:00,1116.91,183524.30000000002,148787.39000000007,34736.909999999945
6897,2022-03-05 15:45:00,-103.83,183420.47000000003,148787.39000000007,34633.07999999996
6898,2022-03-05 15:50:00,938.85,184359.32000000004,148787.39000000007,35571.929999999964
6899,2022-03-05 15:55:00,-389.83,183969.49000000005,148787.39000000007,35182.09999999998
6900,2022-03-05 16:00:00,491.77,184461.26000000004,148787.39000000007,35673.869999999966
6901,2022-03-05 16:05:00,-1697.92,182763.34000000003,148787.39000000007,33975.94999999995
6902,2022-03-05 16:10:00,-8.13,182755.21000000002,148787.39000000007,33967.81999999995
6903,2022-03-05 16:15:00,1037.07,183792.28000000003,148787.39000000007,35004.889999999956
6904,2022-03-05 16:20:00,-586.96,183205.32000000004,148787.39000000007,34417.929999999964
6905,2022-03-05 16:25:00,-1346.71,181858.61000000004,148787.39000000007,33071.21999999997
6906,2022-03-05 16:30:00,-624.7,181233.91000000003,148787.39000000007,32446.51999999996
6907,2022-03-05 16:35:00,898.06,182131.97000000003,148787.39000000007,33344.57999999996
6908,2022-03-05 16:40:00,-1953.11,180178.86000000004,148787.39000000007,31391.469999999972
6909,2022-03-05 16:45:00,1248.71,181427.57000000004,148787.39000000007,32640.179999999964
6910,2022-03-05 16:50:00,-442.15,180985.42000000004,148787.39000000007,32198.02999999997
6911,2022-03-05 16:55:00,1411.18,182396.60000000003,148787.39000000007,33609.20999999996
6912,2022-03-06 08:00:00,987.28,183383.88000000003,182396.60000000003,987.2799999999988
6913,2022-03-06 08:05:00,954.48,184338.36000000004,182396.60000000003,1941.7600000000093
6914,2022-03-06 08:10:00,-302.73,184035.63000000003,182396.60000000003,1639.0299999999988
6915,2022-03-06 08:15:00,743.87,184779.50000000003,182396.60000000003,2382.899999999994
6916,2022-03-06 08:20:00,-1635.38,183144.12000000002,182396.60000000003,747.5199999999895
6917,2022-03-06 08:25:00,-193.73,182950.39,182396.60000000003,553.789999999979
6918,2022-03-06 08:30:00,-735.28,182215.11000000002,182396.60000000003,-181.4900000000198
6919,2022-03-06 08:35:00,-917.21,181297.90000000002,182396.60000000003,-1098.7000000000116
6920,2022-03-06 08:40:00,-695.06,180602.84000000003,182396.60000000003,-1793.7600000000093
6921,2022-03-06 08:45:00,656.53,181259.37000000002,182396.60000000003,-1137.2300000000105
6922,2022-03-06 08:50:00,728.96,181988.33000000002,182396.60000000003,-408.2700000000186
6923,2022-03-06 08:55:00,1780.99,183769.32,182396.60000000003,1372.719999999972
6924,2022-03-06 09:00:00,-1786.45,181982.87,182396.60000000003,-413.7300000000396
6925,2022-03-06 09:05:00,-251.31,181731.56,182396.60000000003,-665.0400000000373
6926,2022-03-06 09:10:00,-1.42,181730.13999999998,182396.60000000003,-666.4600000000501
6927,2022-03-06 09:15:00,169.99,181900.12999999998,182396.60000000003,-496.4700000000594
6928,2022-03-06 09:20:00,1415.39,183315.52,182396.60000000003,918.9199999999546
6929,2022-03-06 09:25:00,-1535.34,181780.18,182396.60000000003,-616.4200000000419
6930,2022-03-06 09:30:00,-1580.44,180199.74,182396.60000000003,-2196.8600000000442
6931,2022-03-06 09:35:00,-132.48,180067.25999999998,182396.60000000003,-2329.3400000000547
6932,2022-03-06 09:40:00,264.73,180331.99,182396.60000000003,-2064.6100000000442
6933,2022-03-06 09:45:00,1740.35,182072.34,182396.60000000003,-324.2600000000384
6934,2022-03-06 09:50:00,175.54,182247.88,182396.60000000003,-148.72000000003027
6935,2022-03-06 09:55:00,-327.15,181920.73,182396.60000000003,-475.87000000002445
6936,2022-03-06 10:00:00,369.1,182289.83000000002,182396.60000000003,-106.77000000001863
6937,2022-03-06 10:05:00,1454.57,183744.40000000002,182396.60000000003,1347.7999999999884
6938,2022-03-06 10:10:00,1931.17,185675.57000000004,182396.60000000003,3278.970000000001
6939,2022-03-06 10:15:00,-114.33,185561.24000000005,182396.60000000003,3164.640000000014
6940,2022-03-06 10:20:00,821.48,186382.72000000006,182396.60000000003,3986.1200000000244
6941,2022-03-06 10:25:00,1878.69,188261.41000000006,182396.60000000003,5864.810000000027
6942,2022-03-06 10:30:00,31.55,188292.96000000005,182396.60000000003,5896.360000000015
6943,2022-03-06 10:35:00,-965.31,187327.65000000005,182396.60000000003,4931.0500000000175
6944,2022-03-06 10:40:00,-1294.71,186032.94000000006,182396.60000000003,3636.3400000000256
6945,2022-03-06 10:45:00,1468.4,187501.34000000005,182396.60000000003,5104.74000000002
6946,2022-03-06 10:50:00,851.65,188352.99000000005,182396.60000000003,5956.390000000014
6947,2022-03-06 10:55:00,1268.84,189621.83000000005,182396.60000000003,7225.2300000000105
6948,2022-03-06 11:00:00,589.97,190211.80000000005,182396.60000000003,7815.200000000012
6949,2022-03-06 11:05:00,-63.7,190148.10000000003,182396.60000000003,7751.5
6950,2022-03-06 11:10:00,-1657.38,188490.72000000003,182396.60000000003,6094.119999999995
6951,2022-03-06 11:15:00,794.84,189285.56000000003,182396.60000000003,6888.959999999992
6952,2022-03-06 11:20:00,387.26,189672.82000000004,182396.60000000003,7276.220000000001
6953,2022-03-06 11:25:00,900.7,190573.52000000005,182396.60000000003,8176.920000000013
6954,2022-03-06 11:30:00,1344.58,191918.10000000003,182396.60000000003,9521.5
6955,2022-03-06 11:35:00,-415.33,191502.77000000005,182396.60000000003,9106.170000000013
6956,2022-03-06 11:40:00,509.54,192012.31000000006,182396.60000000003,9615.710000000021
6957,2022-03-06 11:45:00,1219.99,193232.30000000005,182396.60000000003,10835.700000000012
6958,2022-03-06 11:50:00,872.46,194104.76000000004,182396.60000000003,11708.160000000003
6959,2022-03-06 11:55:00,1774.03,195878.79000000004,182396.60000000003,13482.190000000002
6960,2022-03-06 12:00:00,1671.77,197550.56000000003,182396.60000000003,15153.959999999992
6961,2022-03-06 12:05:00,1599.04,199149.60000000003,182396.60000000003,16753.0
6962,2022-03-06 12:10:00,289.25,199438.85000000003,182396.60000000003,17042.25
6963,2022-03-06 12:15:00,-1092.39,198346.46000000002,182396.60000000003,15949.859999999986
6964,2022-03-06 12:20:00,1560.58,199907.04,182396.60000000003,17510.439999999973
6965,2022-03-06 12:25:00,-300.57,199606.47,182396.60000000003,17209.869999999966
6966,2022-03-06 12:30:00,-1510.85,198095.62,182396.60000000003,15699.01999999996
6967,2022-03-06 12:35:00,326.26,198421.88,182396.60000000003,16025.27999999997
6968,2022-03-06 12:40:00,-625.61,197796.27000000002,182396.60000000003,15399.669999999984
6969,2022-03-06 12:45:00,-602.27,197194.00000000003,182396.60000000003,14797.399999999994
6970,2022-03-06 12:50:00,1879.31,199073.31000000003,182396.60000000003,16676.709999999992
6971,2022-03-06 12:55:00,1100.33,200173.64,182396.60000000003,17777.03999999998
6972,2022-03-06 13:00:00,-1903.82,198269.82,182396.60000000003,15873.219999999972
6973,2022-03-06 13:05:00,1679.73,199949.55000000002,182396.60000000003,17552.949999999983
6974,2022-03-06 13:10:00,-559.96,199389.59000000003,182396.60000000003,16992.98999999999
6975,2022-03-06 13:15:00,-785.25,198604.34000000003,182396.60000000003,16207.73999999999
6976,2022-03-06 13:20:00,1927.95,200532.29000000004,182396.60000000003,18135.690000000002
6977,2022-03-06 13:25:00,-1955.95,198576.34000000003,182396.60000000003,16179.73999999999
6978,2022-03-06 13:30:00,369.05,198945.39,182396.60000000003,16548.78999999998
6979,2022-03-06 13:35:00,1401.52,200346.91,182396.60000000003,17950.30999999997
6980,2022-03-06 13:40:00,-926.38,199420.53,182396.60000000003,17023.929999999964
6981,2022-03-06 13:45:00,1750.34,201170.87,182396.60000000003,18774.26999999996
6982,2022-03-06 13:50:00,-1587.53,199583.34,182396.60000000003,17186.73999999996
6983,2022-03-06 13:55:00,-757.65,198825.69,182396.60000000003,16429.089999999967
6984,2022-03-06 14:00:00,-553.57,198272.12,182396.60000000003,15875.51999999996
6985,2022-03-06 14:05:00,-1247.47,197024.65,182396.60000000003,14628.04999999996
6986,2022-03-06 14:10:00,1104.75,198129.4,182396.60000000003,15732.79999999996
6987,2022-03-06 14:15:00,1736.45,199865.85,182396.60000000003,17469.24999999997
6988,2022-03-06 14:20:00,-619.42,199246.43,182396.60000000003,16849.829999999958
6989,2022-03-06 14:25:00,-1078.44,198167.99,182396.60000000003,15771.389999999956
6990,2022-03-06 14:30:00,1444.37,199612.36,182396.60000000003,17215.75999999995
6991,2022-03-06 14:35:00,-1682.38,197929.97999999998,182396.60000000003,15533.379999999946
6992,2022-03-06 14:40:00,1091.69,199021.66999999998,182396.60000000003,16625.06999999995
6993,2022-03-06 14:45:00,-1145.38,197876.28999999998,182396.60000000003,15479.689999999944
6994,2022-03-06 14:50:00,-1076.41,196799.87999999998,182396.60000000003,14403.27999999994
6995,2022-03-06 14:55:00,-1714.56,195085.31999999998,182396.60000000003,12688.719999999943
6996,2022-03-06 15:00:00,1087.94,196173.25999999998,182396.60000000003,13776.659999999945
6997,2022-03-06 15:05:00,835.57,197008.83,182396.60000000003,14612.229999999952
6998,2022-03-06 15:10:00,-63.47,196945.36,182396.60000000003,14548.759999999951
6999,2022-03-06 15:15:00,1391.59,198336.94999999998,182396.60000000003,15940.349999999948
7000,2022-03-06 15:20:00,-729.4,197607.55,182396.60000000003,15210.949999999953
7001,2022-03-06 15:25:00,-1659.33,195948.22,182396.60000000003,13551.619999999966
7002,2022-03-06 15:30:00,-974.45,194973.77,182396.60000000003,12577.169999999955
7003,2022-03-06 15:35:00,491.36,195465.12999999998,182396.60000000003,13068.52999999994
7004,2022-03-06 15:40:00,580.0,196045.12999999998,182396.60000000003,13648.52999999994
7005,2022-03-06 15:45:00,-1275.05,194770.08,182396.60000000003,12373.479999999952
7006,2022-03-06 15:50:00,254.54,195024.62,182396.60000000003,12628.01999999996
7007,2022-03-06 15:55:00,726.73,195751.35,182396.60000000003,13354.74999999997
7008,2022-03-06 16:00:00,-686.94,195064.41,182396.60000000003,12667.809999999969
7009,2022-03-06 16:05:00,-1673.57,193390.84,182396.60000000003,10994.239999999962
7010,2022-03-06 16:10:00,349.42,193740.26,182396.60000000003,11343.659999999974
7011,2022-03-06 16:15:00,1778.52,195518.78,182396.60000000003,13122.179999999964
7012,2022-03-06 16:20:00,-1386.89,194131.88999999998,182396.60000000003,11735.28999999995
7013,2022-03-06 16:25:00,-436.5,193695.38999999998,182396.60000000003,11298.78999999995
7014,2022-03-06 16:30:00,1081.33,194776.71999999997,182396.60000000003,12380.119999999937
7015,2022-03-06 16:35:00,-1866.55,192910.16999999998,182396.60000000003,10513.569999999949
7016,2022-03-06 16:40:00,-819.12,192091.05,182396.60000000003,9694.449999999953
7017,2022-03-06 16:45:00,-1275.57,190815.47999999998,182396.60000000003,8418.879999999946
7018,2022-03-06 16:50:00,1626.03,192441.50999999998,182396.60000000003,10044.909999999945
7019,2022-03-06 16:55:00,-1073.6,191367.90999999997,182396.60000000003,8971.30999999994
7020,2022-03-07 08:00:00,1226.43,192594.33999999997,191367.90999999997,1226.429999999993
7021,2022-03-07 08:05:00,-1044.53,191549.80999999997,191367.90999999997,181.89999999999418
7022,2022-03-07 08:10:00,1549.76,193099.56999999998,191367.90999999997,1731.6600000000035
7023,2022-03-07 08:15:00,544.89,193644.46,191367.90999999997,2276.5500000000175
7024,2022-03-07 08:20:00,-69.64,193574.81999999998,191367.90999999997,2206.9100000000035
7025,2022-03-07 08:25:00,1303.36,194878.17999999996,191367.90999999997,3510.2699999999895
7026,2022-03-07 08:30:00,-267.66,194610.51999999996,191367.90999999997,3242.609999999986
7027,2022-03-07 08:35:00,1330.63,195941.14999999997,191367.90999999997,4573.239999999991
7028,2022-03-07 08:40:00,-1575.09,194366.05999999997,191367.90999999997,2998.149999999994
7029,2022-03-07 08:45:00,-366.79,193999.26999999996,191367.90999999997,2631.359999999986
7030,2022-03-07 08:50:00,-960.08,193039.18999999997,191367.90999999997,1671.2799999999988
7031,2022-03-07 08:55:00,-273.05,192766.13999999998,191367.90999999997,1398.2300000000105
7032,2022-03-07 09:00:00,-204.33,192561.81,191367.90999999997,1193.9000000000233
7033,2022-03-07 09:05:00,1733.98,194295.79,191367.90999999997,2927.8800000000338
7034,2022-03-07 09:10:00,1610.41,195906.2,191367.90999999997,4538.290000000037
7035,2022-03-07 09:15:00,-671.54,195234.66,191367.90999999997,3866.750000000029
7036,2022-03-07 09:20:00,-154.81,195079.85,191367.90999999997,3711.9400000000314
7037,2022-03-07 09:25:00,1641.73,196721.58000000002,191367.90999999997,5353.670000000042
7038,2022-03-07 09:30:00,-1871.12,194850.46000000002,191367.90999999997,3482.5500000000466
7039,2022-03-07 09:35:00,159.42,195009.88000000003,191367.90999999997,3641.9700000000594
7040,2022-03-07 09:40:00,1279.97,196289.85000000003,191367.90999999997,4921.9400000000605
7041,2022-03-07 09:45:00,-249.52,196040.33000000005,191367.90999999997,4672.420000000071
7042,2022-03-07 09:50:00,396.11,196436.44000000003,191367.90999999997,5068.530000000057
7043,2022-03-07 09:55:00,1746.16,198182.60000000003,191367.90999999997,6814.6900000000605
7044,2022-03-07 10:00:00,-1980.92,196201.68000000002,191367.90999999997,4833.770000000048
7045,2022-03-07 10:05:00,1765.4,197967.08000000002,191367.90999999997,6599.170000000042
7046,2022-03-07 10:10:00,1244.12,199211.2,191367.90999999997,7843.290000000037
7047,2022-03-07 10:15:00,1094.83,200306.03,191367.90999999997,8938.120000000024
7048,2022-03-07 10:20:00,1309.67,201615.7,191367.90999999997,10247.790000000037
7049,2022-03-07 10:25:00,1078.52,202694.22,191367.90999999997,11326.310000000027
7050,2022-03-07 10:30:00,-862.53,201831.69,191367.90999999997,10463.780000000028
7051,2022-03-07 10:35:00,-1917.95,199913.74,191367.90999999997,8545.830000000016
7052,2022-03-07 10:40:00,-22.1,199891.63999999998,191367.90999999997,8523.73000000001
7053,2022-03-07 10:45:00,-604.27,199287.37,191367.90999999997,7919.460000000021
7054,2022-03-07 10:50:00,-420.41,198866.96,191367.90999999997,7499.0500000000175
7055,2022-03-07 10:55:00,-1600.15,197266.81,191367.90999999997,5898.900000000023
7056,2022-03-07 11:00:00,1330.34,198597.15,191367.90999999997,7229.24000000002
7057,2022-03-07 11:05:00,476.15,199073.3,191367.90999999997,7705.390000000014
7058,2022-03-07 11:10:00,1713.45,200786.75,191367.90999999997,9418.840000000026
7059,2022-03-07 11:15:00,1742.74,202529.49,191367.90999999997,11161.580000000016
7060,2022-03-07 11:20:00,-1158.91,201370.58,191367.90999999997,10002.670000000013
7061,2022-03-07 11:25:00,666.79,202037.37,191367.90999999997,10669.460000000021
7062,2022-03-07 11:30:00,-1860.72,200176.65,191367.90999999997,8808.74000000002
7063,2022-03-07 11:35:00,2.93,200179.58,191367.90999999997,8811.670000000013
7064,2022-03-07 11:40:00,-982.17,199197.40999999997,191367.90999999997,7829.5
7065,2022-03-07 11:45:00,-1287.11,197910.3,191367.90999999997,6542.390000000014
7066,2022-03-07 11:50:00,18.85,197929.15,191367.90999999997,6561.24000000002
7067,2022-03-07 11:55:00,1076.05,199005.19999999998,191367.90999999997,7637.290000000008
7068,2022-03-07 12:00:00,1195.7,200200.9,191367.90999999997,8832.99000000002
7069,2022-03-07 12:05:00,686.11,200887.00999999998,191367.90999999997,9519.100000000006
7070,2022-03-07 12:10:00,282.74,201169.74999999997,191367.90999999997,9801.839999999997
7071,2022-03-07 12:15:00,-337.88,200831.86999999997,191367.90999999997,9463.959999999992
7072,2022-03-07 12:20:00,669.18,201501.04999999996,191367.90999999997,10133.139999999985
7073,2022-03-07 12:25:00,-1766.35,199734.69999999995,191367.90999999997,8366.789999999979
7074,2022-03-07 12:30:00,-1040.96,198693.73999999996,191367.90999999997,7325.829999999987
7075,2022-03-07 12:35:00,-685.32,198008.41999999995,191367.90999999997,6640.50999999998
7076,2022-03-07 12:40:00,-1968.11,196040.30999999997,191367.90999999997,4672.399999999994
7077,2022-03-07 12:45:00,-1574.16,194466.14999999997,191367.90999999997,3098.2399999999907
7078,2022-03-07 12:50:00,72.8,194538.94999999995,191367.90999999997,3171.039999999979
7079,2022-03-07 12:55:00,-1237.64,193301.30999999994,191367.90999999997,1933.399999999965
7080,2022-03-07 13:00:00,-267.52,193033.78999999995,191367.90999999997,1665.8799999999756
7081,2022-03-07 13:05:00,723.65,193757.43999999994,191367.90999999997,2389.5299999999697
7082,2022-03-07 13:10:00,1358.56,195115.99999999994,191367.90999999997,3748.0899999999674
7083,2022-03-07 13:15:00,-733.01,194382.98999999993,191367.90999999997,3015.079999999958
7084,2022-03-07 13:20:00,713.16,195096.14999999994,191367.90999999997,3728.2399999999616
7085,2022-03-07 13:25:00,1978.63,197074.77999999994,191367.90999999997,5706.869999999966
7086,2022-03-07 13:30:00,1699.75,198774.52999999994,191367.90999999997,7406.619999999966
7087,2022-03-07 13:35:00,690.88,199465.40999999995,191367.90999999997,8097.499999999971
7088,2022-03-07 13:40:00,-1225.62,198239.78999999995,191367.90999999997,6871.879999999976
7089,2022-03-07 13:45:00,1593.48,199833.26999999996,191367.90999999997,8465.359999999986
7090,2022-03-07 13:50:00,-836.42,198996.84999999995,191367.90999999997,7628.939999999973
7091,2022-03-07 13:55:00,111.57,199108.41999999995,191367.90999999997,7740.50999999998
7092,2022-03-07 14:00:00,-781.09,198327.32999999996,191367.90999999997,6959.419999999984
7093,2022-03-07 14:05:00,-260.57,198066.75999999995,191367.90999999997,6698.849999999977
7094,2022-03-07 14:10:00,302.92,198369.67999999996,191367.90999999997,7001.7699999999895
7095,2022-03-07 14:15:00,-414.07,197955.60999999996,191367.90999999997,6587.6999999999825
7096,2022-03-07 14:20:00,1153.61,199109.21999999994,191367.90999999997,7741.309999999969
7097,2022-03-07 14:25:00,484.56,199593.77999999994,191367.90999999997,8225.869999999966
7098,2022-03-07 14:30:00,1213.64,200807.41999999995,191367.90999999997,9439.50999999998
7099,2022-03-07 14:35:00,407.29,201214.70999999996,191367.90999999997,9846.799999999988
7100,2022-03-07 14:40:00,454.87,201669.57999999996,191367.90999999997,10301.669999999984
7101,2022-03-07 14:45:00,998.16,202667.73999999996,191367.90999999997,11299.829999999987
7102,2022-03-07 14:50:00,-1965.16,200702.57999999996,191367.90999999997,9334.669999999984
7103,2022-03-07 14:55:00,-1276.67,199425.90999999995,191367.90999999997,8057.999999999971
7104,2022-03-07 15:00:00,1413.71,200839.61999999994,191367.90999999997,9471.709999999963
7105,2022-03-07 15:05:00,-84.11,200755.50999999995,191367.90999999997,9387.599999999977
7106,2022-03-07 15:10:00,-646.81,200108.69999999995,191367.90999999997,8740.789999999979
7107,2022-03-07 15:15:00,-1240.32,198868.37999999995,191367.90999999997,7500.469999999972
7108,2022-03-07 15:20:00,1556.56,200424.93999999994,191367.90999999997,9057.02999999997
7109,2022-03-07 15:25:00,1712.3,202137.23999999993,191367.90999999997,10769.329999999958
7110,2022-03-07 15:30:00,393.11,202530.34999999992,191367.90999999997,11162.439999999944
7111,2022-03-07 15:35:00,1892.25,204422.59999999992,191367.90999999997,13054.689999999944
7112,2022-03-07 15:40:00,385.01,204807.60999999993,191367.90999999997,13439.699999999953
7113,2022-03-07 15:45:00,298.8,205106.40999999992,191367.90999999997,13738.499999999942
7114,2022-03-07 15:50:00,1328.41,206434.81999999992,191367.90999999997,15066.909999999945
7115,2022-03-07 15:55:00,688.9,207123.7199999999,191367.90999999997,15755.80999999994
7116,2022-03-07 16:00:00,-1505.95,205617.7699999999,191367.90999999997,14249.859999999928
7117,2022-03-07 16:05:00,284.44,205902.2099999999,191367.90999999997,14534.29999999993
7118,2022-03-07 16:10:00,751.07,206653.2799999999,191367.90999999997,15285.369999999937
7119,2022-03-07 16:15:00,-1799.69,204853.5899999999,191367.90999999997,13485.679999999935
7120,2022-03-07 16:20:00,-275.56,204578.0299999999,191367.90999999997,13210.119999999937
7121,2022-03-07 16:25:00,1264.57,205842.59999999992,191367.90999999997,14474.689999999944
7122,2022-03-07 16:30:00,654.74,206497.3399999999,191367.90999999997,15129.429999999935
7123,2022-03-07 16:35:00,-1645.13,204852.2099999999,191367.90999999997,13484.29999999993
7124,2022-03-07 16:40:00,-1319.81,203532.3999999999,191367.90999999997,12164.489999999932
7125,2022-03-07 16:45:00,1358.98,204891.37999999992,191367.90999999997,13523.469999999943
7126,2022-03-07 16:50:00,1971.28,206862.65999999992,191367.90999999997,15494.749999999942
7127,2022-03-07 16:55:00,1896.37,208759.0299999999,191367.90999999997,17391.119999999937
7128,2022-03-08 08:00:00,221.27,208980.2999999999,208759.0299999999,221.26999999998952
7129,2022-03-08 08:05:00,582.9,209563.1999999999,208759.0299999999,804.1699999999837
7130,2022-03-08 08:10:00,-623.55,208939.6499999999,208759.0299999999,180.61999999999534
7131,2022-03-08 08:15:00,-303.0,208636.6499999999,208759.0299999999,-122.38000000000466
7132,2022-03-08 08:20:00,-730.57,207906.0799999999,208759.0299999999,-852.9500000000116
7133,2022-03-08 08:25:00,1735.01,209641.0899999999,208759.0299999999,882.0599999999977
7134,2022-03-08 08:30:00,-891.55,208749.53999999992,208759.0299999999,-9.489999999990687
7135,2022-03-08 08:35:00,-1271.01,207478.5299999999,208759.0299999999,-1280.5
7136,2022-03-08 08:40:00,-528.8,206949.72999999992,208759.0299999999,-1809.2999999999884
7137,2022-03-08 08:45:00,-1422.75,205526.97999999992,208759.0299999999,-3232.0499999999884
7138,2022-03-08 08:50:00,1318.93,206845.90999999992,208759.0299999999,-1913.1199999999953
7139,2022-03-08 08:55:00,1949.27,208795.1799999999,208759.0299999999,36.14999999999418
7140,2022-03-08 09:00:00,1380.91,210176.0899999999,208759.0299999999,1417.0599999999977
7141,2022-03-08 09:05:00,-1100.53,209075.5599999999,208759.0299999999,316.52999999999884
7142,2022-03-08 09:10:00,-1798.08,207277.47999999992,208759.0299999999,-1481.5499999999884
7143,2022-03-08 09:15:00,1681.45,208958.92999999993,208759.0299999999,199.90000000002328
7144,2022-03-08 09:20:00,-1230.08,207728.84999999995,208759.0299999999,-1030.179999999964
7145,2022-03-08 09:25:00,-503.88,207224.96999999994,208759.0299999999,-1534.0599999999686
7146,2022-03-08 09:30:00,592.96,207817.92999999993,208759.0299999999,-941.0999999999767
7147,2022-03-08 09:35:00,1553.85,209371.77999999994,208759.0299999999,612.7500000000291
7148,2022-03-08 09:40:00,-37.29,209334.48999999993,208759.0299999999,575.460000000021
7149,2022-03-08 09:45:00,855.41,210189.89999999994,208759.0299999999,1430.8700000000244
7150,2022-03-08 09:50:00,-112.36,210077.53999999995,208759.0299999999,1318.5100000000384
7151,2022-03-08 09:55:00,1320.06,211397.59999999995,208759.0299999999,2638.570000000036
7152,2022-03-08 10:00:00,-460.12,210937.47999999995,208759.0299999999,2178.4500000000407
7153,2022-03-08 10:05:00,934.17,211871.64999999997,208759.0299999999,3112.6200000000536
7154,2022-03-08 10:10:00,1758.82,213630.46999999997,208759.0299999999,4871.4400000000605
7155,2022-03-08 10:15:00,-1869.62,211760.84999999998,208759.0299999999,3001.820000000065
7156,2022-03-08 10:20:00,-235.13,211525.71999999997,208759.0299999999,2766.6900000000605
7157,2022-03-08 10:25:00,-385.23,211140.48999999996,208759.0299999999,2381.46000000005
7158,2022-03-08 10:30:00,421.94,211562.42999999996,208759.0299999999,2803.4000000000524
7159,2022-03-08 10:35:00,-949.74,210612.68999999997,208759.0299999999,1853.6600000000617
7160,2022-03-08 10:40:00,-608.58,210004.11,208759.0299999999,1245.0800000000745
7161,2022-03-08 10:45:00,-388.04,209616.06999999998,208759.0299999999,857.0400000000664
7162,2022-03-08 10:50:00,45.34,209661.40999999997,208759.0299999999,902.3800000000629
7163,2022-03-08 10:55:00,212.43,209873.83999999997,208759.0299999999,1114.8100000000559
7164,2022-03-08 11:00:00,-1852.46,208021.37999999998,208759.0299999999,-737.649999999936
7165,2022-03-08 11:05:00,-1393.66,206627.71999999997,208759.0299999999,-2131.3099999999395
7166,2022-03-08 11:10:00,940.6,207568.31999999998,208759.0299999999,-1190.7099999999336
7167,2022-03-08 11:15:00,1727.09,209295.40999999997,208759.0299999999,536.3800000000629
7168,2022-03-08 11:20:00,-72.9,209222.50999999998,208759.0299999999,463.4800000000687
7169,2022-03-08 11:25:00,333.6,209556.11,208759.0299999999,797.0800000000745
7170,2022-03-08 11:30:00,29.82,209585.93,208759.0299999999,826.9000000000815
7171,2022-03-08 11:35:00,-1694.27,207891.66,208759.0299999999,-867.369999999908
7172,2022-03-08 11:40:00,854.05,208745.71,208759.0299999999,-13.319999999919673
7173,2022-03-08 11:45:00,870.09,209615.8,208759.0299999999,856.7700000000768
7174,2022-03-08 11:50:00,730.34,210346.13999999998,208759.0299999999,1587.1100000000733
7175,2022-03-08 11:55:00,-1872.03,208474.11,208759.0299999999,-284.9199999999255
7176,2022-03-08 12:00:00,1482.17,209956.28,208759.0299999999,1197.2500000000873
7177,2022-03-08 12:05:00,502.61,210458.88999999998,208759.0299999999,1699.8600000000733
7178,2022-03-08 12:10:00,-1650.45,208808.43999999997,208759.0299999999,49.4100000000617
7179,2022-03-08 12:15:00,573.42,209381.86,208759.0299999999,622.8300000000745
7180,2022-03-08 12:20:00,-154.39,209227.46999999997,208759.0299999999,468.44000000006054
7181,2022-03-08 12:25:00,1147.99,210375.45999999996,208759.0299999999,1616.4300000000512
7182,2022-03-08 12:30:00,-1434.46,208940.99999999997,208759.0299999999,181.97000000005937
7183,2022-03-08 12:35:00,637.6,209578.59999999998,208759.0299999999,819.5700000000652
7184,2022-03-08 12:40:00,-736.3,208842.3,208759.0299999999,83.27000000007683
7185,2022-03-08 12:45:00,-1432.48,207409.81999999998,208759.0299999999,-1349.2099999999336
7186,2022-03-08 12:50:00,570.85,207980.66999999998,208759.0299999999,-778.3599999999278
7187,2022-03-08 12:55:00,-455.64,207525.02999999997,208759.0299999999,-1233.9999999999418
7188,2022-03-08 13:00:00,952.01,208477.03999999998,208759.0299999999,-281.9899999999325
7189,2022-03-08 13:05:00,310.68,208787.71999999997,208759.0299999999,28.690000000060536
7190,2022-03-08 13:10:00,1819.67,210607.38999999998,208759.0299999999,1848.3600000000733
7191,2022-03-08 13:15:00,621.38,211228.77,208759.0299999999,2469.740000000078
7192,2022-03-08 13:20:00,1785.78,213014.55,208759.0299999999,4255.520000000077
7193,2022-03-08 13:25:00,-219.19,212795.36,208759.0299999999,4036.3300000000745
7194,2022-03-08 13:30:00,560.46,213355.81999999998,208759.0299999999,4596.790000000066
7195,2022-03-08 13:35:00,1836.28,215192.09999999998,208759.0299999999,6433.070000000065
7196,2022-03-08 13:40:00,1438.96,216631.05999999997,208759.0299999999,7872.030000000057
7197,2022-03-08 13:45:00,-516.7,216114.35999999996,208759.0299999999,7355.330000000045
7198,2022-03-08 13:50:00,-1917.72,214196.63999999996,208759.0299999999,5437.610000000044
7199,2022-03-08 13:55:00,-1729.44,212467.19999999995,208759.0299999999,3708.170000000042
7200,2022-03-08 14:00:00,-1064.64,211402.55999999994,208759.0299999999,2643.530000000028
7201,2022-03-08 14:05:00,1631.89,213034.44999999995,208759.0299999999,4275.420000000042
7202,2022-03-08 14:10:00,1209.45,214243.89999999997,208759.0299999999,5484.870000000054
7203,2022-03-08 14:15:00,1684.2,215928.09999999998,208759.0299999999,7169.070000000065
7204,2022-03-08 14:20:00,1944.83,217872.92999999996,208759.0299999999,9113.900000000052
7205,2022-03-08 14:25:00,1646.84,219519.76999999996,208759.0299999999,10760.740000000049
7206,2022-03-08 14:30:00,-254.68,219265.08999999997,208759.0299999999,10506.060000000056
7207,2022-03-08 14:35:00,1811.25,221076.33999999997,208759.0299999999,12317.310000000056
7208,2022-03-08 14:40:00,639.31,221715.64999999997,208759.0299999999,12956.620000000054
7209,2022-03-08 14:45:00,-232.12,221483.52999999997,208759.0299999999,12724.500000000058
7210,2022-03-08 14:50:00,-785.11,220698.41999999998,208759.0299999999,11939.390000000072
7211,2022-03-08 14:55:00,78.2,220776.62,208759.0299999999,12017.590000000084
7212,2022-03-08 15:00:00,1759.0,222535.62,208759.0299999999,13776.590000000084
7213,2022-03-08 15:05:00,-1466.7,221068.91999999998,208759.0299999999,12309.890000000072
7214,2022-03-08 15:10:00,1003.4,222072.31999999998,208759.0299999999,13313.290000000066
7215,2022-03-08 15:15:00,-371.99,221700.33,208759.0299999999,12941.300000000076
7216,2022-03-08 15:20:00,-12.75,221687.58,208759.0299999999,12928.550000000076
7217,2022-03-08 15:25:00,586.36,222273.93999999997,208759.0299999999,13514.910000000062
7218,2022-03-08 15:30:00,-863.61,221410.33,208759.0299999999,12651.300000000076
7219,2022-03-08 15:35:00,61.69,221472.02,208759.0299999999,12712.990000000078
7220,2022-03-08 15:40:00,1630.98,223103.0,208759.0299999999,14343.970000000088
7221,2022-03-08 15:45:00,835.08,223938.08,208759.0299999999,15179.050000000076
7222,2022-03-08 15:50:00,-983.83,222954.25,208759.0299999999,14195.220000000088
7223,2022-03-08 15:55:00,-672.89,222281.36,208759.0299999999,13522.330000000075
7224,2022-03-08 16:00:00,-738.41,221542.94999999998,208759.0299999999,12783.920000000071
7225,2022-03-08 16:05:00,1863.65,223406.59999999998,208759.0299999999,14647.570000000065
7226,2022-03-08 16:10:00,1037.52,224444.11999999997,208759.0299999999,15685.090000000055
7227,2022-03-08 16:15:00,1728.16,226172.27999999997,208759.0299999999,17413.25000000006
7228,2022-03-08 16:20:00,152.54,226324.81999999998,208759.0299999999,17565.790000000066
7229,2022-03-08 16:25:00,-898.87,225425.94999999998,208759.0299999999,16666.92000000007
7230,2022-03-08 16:30:00,-1941.17,223484.77999999997,208759.0299999999,14725.750000000058
7231,2022-03-08 16:35:00,-1059.75,222425.02999999997,208759.0299999999,13666.000000000058
7232,2022-03-08 16:40:00,1870.55,224295.57999999996,208759.0299999999,15536.550000000047
7233,2022-03-08 16:45:00,1468.57,225764.14999999997,208759.0299999999,17005.120000000054
7234,2022-03-08 16:50:00,-1290.76,224473.38999999996,208759.0299999999,15714.360000000044
7235,2022-03-08 16:55:00,-1561.56,222911.82999999996,208759.0299999999,14152.800000000047
7236,2022-03-09 08:00:00,268.3,223180.12999999995,222911.82999999996,268.29999999998836
7237,2022-03-09 08:05:00,628.98,223809.10999999996,222911.82999999996,897.2799999999988
7238,2022-03-09 08:10:00,-1386.04,222423.06999999995,222911.82999999996,-488.7600000000093
7239,2022-03-09 08:15:00,1874.38,224297.44999999995,222911.82999999996,1385.6199999999953
7240,2022-03-09 08:20:00,1115.62,225413.06999999995,222911.82999999996,2501.2399999999907
7241,2022-03-09 08:25:00,1181.46,226594.52999999994,222911.82999999996,3682.6999999999825
7242,2022-03-09 08:30:00,-774.55,225819.97999999995,222911.82999999996,2908.149999999994
7243,2022-03-09 08:35:00,372.92,226192.89999999997,222911.82999999996,3281.070000000007
7244,2022-03-09 08:40:00,1138.95,227331.84999999998,222911.82999999996,4420.020000000019
7245,2022-03-09 08:45:00,163.71,227495.55999999997,222911.82999999996,4583.7300000000105
7246,2022-03-09 08:50:00,1331.25,228826.80999999997,222911.82999999996,5914.9800000000105
7247,2022-03-09 08:55:00,1276.07,230102.87999999998,222911.82999999996,7191.0500000000175
7248,2022-03-09 09:00:00,-274.02,229828.86,222911.82999999996,6917.030000000028
7249,2022-03-09 09:05:00,-1686.78,228142.08,222911.82999999996,5230.250000000029
7250,2022-03-09 09:10:00,-1299.09,226842.99,222911.82999999996,3931.1600000000326
7251,2022-03-09 09:15:00,-1148.06,225694.93,222911.82999999996,2783.100000000035
7252,2022-03-09 09:20:00,-1921.1,223773.83,222911.82999999996,862.0000000000291
7253,2022-03-09 09:25:00,-1284.67,222489.15999999997,222911.82999999996,-422.6699999999837
7254,2022-03-09 09:30:00,-1784.67,220704.48999999996,222911.82999999996,-2207.3399999999965
7255,2022-03-09 09:35:00,-1169.91,219534.57999999996,222911.82999999996,-3377.25
7256,2022-03-09 09:40:00,617.23,220151.80999999997,222911.82999999996,-2760.0199999999895
7257,2022-03-09 09:45:00,249.72,220401.52999999997,222911.82999999996,-2510.2999999999884
7258,2022-03-09 09:50:00,249.44,220650.96999999997,222911.82999999996,-2260.859999999986
7259,2022-03-09 09:55:00,1075.61,221726.57999999996,222911.82999999996,-1185.25
7260,2022-03-09 10:00:00,1745.41,223471.98999999996,222911.82999999996,560.1600000000035
7261,2022-03-09 10:05:00,589.84,224061.82999999996,222911.82999999996,1150.0
7262,2022-03-09 10:10:00,567.5,224629.32999999996,222911.82999999996,1717.5
7263,2022-03-09 10:15:00,1454.25,226083.57999999996,222911.82999999996,3171.75
7264,2022-03-09 10:20:00,783.06,226866.63999999996,222911.82999999996,3954.8099999999977
7265,2022-03-09 10:25:00,-1568.45,225298.18999999994,222911.82999999996,2386.359999999986
7266,2022-03-09 10:30:00,-665.44,224632.74999999994,222911.82999999996,1720.9199999999837
7267,2022-03-09 10:35:00,1634.22,226266.96999999994,222911.82999999996,3355.139999999985
7268,2022-03-09 10:40:00,-520.83,225746.13999999996,222911.82999999996,2834.3099999999977
7269,2022-03-09 10:45:00,-1421.72,224324.41999999995,222911.82999999996,1412.5899999999965
7270,2022-03-09 10:50:00,1602.43,225926.84999999995,222911.82999999996,3015.0199999999895
7271,2022-03-09 10:55:00,-1292.64,224634.20999999993,222911.82999999996,1722.3799999999756
7272,2022-03-09 11:00:00,-1939.52,222694.68999999994,222911.82999999996,-217.14000000001397
7273,2022-03-09 11:05:00,1959.05,224653.73999999993,222911.82999999996,1741.9099999999744
7274,2022-03-09 11:10:00,1618.61,226272.34999999992,222911.82999999996,3360.5199999999604
7275,2022-03-09 11:15:00,-118.82,226153.5299999999,222911.82999999996,3241.6999999999534
7276,2022-03-09 11:20:00,1876.74,228030.2699999999,222911.82999999996,5118.439999999944
7277,2022-03-09 11:25:00,1608.65,229638.9199999999,222911.82999999996,6727.089999999938
7278,2022-03-09 11:30:00,-1129.44,228509.4799999999,222911.82999999996,5597.649999999936
7279,2022-03-09 11:35:00,-1139.78,227369.6999999999,222911.82999999996,4457.869999999937
7280,2022-03-09 11:40:00,-630.84,226738.8599999999,222911.82999999996,3827.0299999999406
7281,2022-03-09 11:45:00,106.39,226845.2499999999,222911.82999999996,3933.4199999999546
7282,2022-03-09 11:50:00,-628.78,226216.4699999999,222911.82999999996,3304.6399999999558
7283,2022-03-09 11:55:00,968.28,227184.7499999999,222911.82999999996,4272.919999999955
7284,2022-03-09 12:00:00,-1310.47,225874.2799999999,222911.82999999996,2962.4499999999534
7285,2022-03-09 12:05:00,1799.29,227673.56999999992,222911.82999999996,4761.739999999962
7286,2022-03-09 12:10:00,1483.8,229157.3699999999,222911.82999999996,6245.53999999995
7287,2022-03-09 12:15:00,-563.48,228593.8899999999,222911.82999999996,5682.0599999999395
7288,2022-03-09 12:20:00,1777.83,230371.71999999988,222911.82999999996,7459.889999999927
7289,2022-03-09 12:25:00,346.35,230718.0699999999,222911.82999999996,7806.2399999999325
7290,2022-03-09 12:30:00,154.08,230872.14999999988,222911.82999999996,7960.31999999992
7291,2022-03-09 12:35:00,1304.64,232176.7899999999,222911.82999999996,9264.959999999934
7292,2022-03-09 12:40:00,-933.27,231243.5199999999,222911.82999999996,8331.689999999944
7293,2022-03-09 12:45:00,1513.09,232756.6099999999,222911.82999999996,9844.77999999994
7294,2022-03-09 12:50:00,1012.55,233769.1599999999,222911.82999999996,10857.329999999929
7295,2022-03-09 12:55:00,-140.42,233628.73999999987,222911.82999999996,10716.909999999916
7296,2022-03-09 13:00:00,-895.55,232733.1899999999,222911.82999999996,9821.359999999928
7297,2022-03-09 13:05:00,1216.2,233949.3899999999,222911.82999999996,11037.55999999994
7298,2022-03-09 13:10:00,1474.21,235423.5999999999,222911.82999999996,12511.769999999931
7299,2022-03-09 13:15:00,-1077.88,234345.71999999988,222911.82999999996,11433.889999999927
7300,2022-03-09 13:20:00,-334.1,234011.61999999988,222911.82999999996,11099.78999999992
7301,2022-03-09 13:25:00,-1054.1,232957.51999999987,222911.82999999996,10045.689999999915
7302,2022-03-09 13:30:00,521.81,233479.32999999987,222911.82999999996,10567.499999999913
7303,2022-03-09 13:35:00,-272.21,233207.11999999988,222911.82999999996,10295.28999999992
7304,2022-03-09 13:40:00,-1576.11,231631.0099999999,222911.82999999996,8719.179999999935
7305,2022-03-09 13:45:00,-1645.4,229985.6099999999,222911.82999999996,7073.779999999941
7306,2022-03-09 13:50:00,1688.06,231673.6699999999,222911.82999999996,8761.839999999938
7307,2022-03-09 13:55:00,748.17,232421.8399999999,222911.82999999996,9510.009999999951
7308,2022-03-09 14:00:00,454.65,232876.4899999999,222911.82999999996,9964.659999999945
7309,2022-03-09 14:05:00,-65.81,232810.6799999999,222911.82999999996,9898.849999999948
7310,2022-03-09 14:10:00,-1558.74,231251.93999999992,222911.82999999996,8340.109999999957
7311,2022-03-09 14:15:00,-1305.73,229946.2099999999,222911.82999999996,7034.379999999946
7312,2022-03-09 14:20:00,918.89,230865.09999999992,222911.82999999996,7953.26999999996
7313,2022-03-09 14:25:00,-1892.76,228972.3399999999,222911.82999999996,6060.509999999951
7314,2022-03-09 14:30:00,-974.32,227998.0199999999,222911.82999999996,5086.189999999944
7315,2022-03-09 14:35:00,1994.53,229992.5499999999,222911.82999999996,7080.719999999943
7316,2022-03-09 14:40:00,-1021.45,228971.0999999999,222911.82999999996,6059.269999999931
7317,2022-03-09 14:45:00,-1808.77,227162.3299999999,222911.82999999996,4250.499999999942
7318,2022-03-09 14:50:00,481.98,227644.3099999999,222911.82999999996,4732.479999999952
7319,2022-03-09 14:55:00,-1132.52,226511.78999999992,222911.82999999996,3599.9599999999627
7320,2022-03-09 15:00:00,1727.57,228239.35999999993,222911.82999999996,5327.52999999997
7321,2022-03-09 15:05:00,-608.89,227630.4699999999,222911.82999999996,4718.639999999956
7322,2022-03-09 15:10:00,1663.21,229293.6799999999,222911.82999999996,6381.849999999948
7323,2022-03-09 15:15:00,-1176.79,228116.8899999999,222911.82999999996,5205.0599999999395
7324,2022-03-09 15:20:00,-832.75,227284.1399999999,222911.82999999996,4372.3099999999395
7325,2022-03-09 15:25:00,179.98,227464.1199999999,222911.82999999996,4552.28999999995
7326,2022-03-09 15:30:00,-1668.97,225795.1499999999,222911.82999999996,2883.319999999949
7327,2022-03-09 15:35:00,675.58,226470.7299999999,222911.82999999996,3558.899999999936
7328,2022-03-09 15:40:00,-797.32,225673.4099999999,222911.82999999996,2761.579999999929
7329,2022-03-09 15:45:00,-188.13,225485.27999999988,222911.82999999996,2573.4499999999243
7330,2022-03-09 15:50:00,1765.79,227251.0699999999,222911.82999999996,4339.2399999999325
7331,2022-03-09 15:55:00,1839.59,229090.6599999999,222911.82999999996,6178.829999999929
7332,2022-03-09 16:00:00,-1656.93,227433.7299999999,222911.82999999996,4521.899999999936
7333,2022-03-09 16:05:00,475.37,227909.0999999999,222911.82999999996,4997.269999999931
7334,2022-03-09 16:10:00,-479.46,227429.6399999999,222911.82999999996,4517.8099999999395
7335,2022-03-09 16:15:00,-114.5,227315.1399999999,222911.82999999996,4403.3099999999395
7336,2022-03-09 16:20:00,-1216.07,226099.0699999999,222911.82999999996,3187.2399999999325
7337,2022-03-09 16:25:00,-704.93,225394.1399999999,222911.82999999996,2482.3099999999395
7338,2022-03-09 16:30:00,-787.65,224606.4899999999,222911.82999999996,1694.6599999999453
7339,2022-03-09 16:35:00,1490.53,226097.0199999999,222911.82999999996,3185.189999999944
7340,2022-03-09 16:40:00,736.54,226833.5599999999,222911.82999999996,3921.7299999999523
7341,2022-03-09 16:45:00,-1479.41,225354.1499999999,222911.82999999996,2442.319999999949
7342,2022-03-09 16:50:00,1898.07,227252.2199999999,222911.82999999996,4340.389999999956
7343,2022-03-09 16:55:00,-813.39,226438.8299999999,222911.82999999996,3526.999999999942
7344,2022-03-10 08:00:00,-1348.95,225089.8799999999,226438.8299999999,-1348.9500000000116
7345,2022-03-10 08:05:00,-1083.9,224005.9799999999,226438.8299999999,-2432.850000000006
7346,2022-03-10 08:10:00,1088.94,225094.9199999999,226438.8299999999,-1343.9100000000035
7347,2022-03-10 08:15:00,-825.35,224269.5699999999,226438.8299999999,-2169.2600000000093
7348,2022-03-10 08:20:00,1775.59,226045.1599999999,226438.8299999999,-393.6700000000128
7349,2022-03-10 08:25:00,1805.94,227851.0999999999,226438.8299999999,1412.2699999999895
7350,2022-03-10 08:30:00,-1195.78,226655.3199999999,226438.8299999999,216.4899999999907
7351,2022-03-10 08:35:00,122.23,226777.5499999999,226438.8299999999,338.72000000000116
7352,2022-03-10 08:40:00,-1342.11,225435.43999999992,226438.8299999999,-1003.3899999999849
7353,2022-03-10 08:45:00,-416.84,225018.59999999992,226438.8299999999,-1420.2299999999814
7354,2022-03-10 08:50:00,1281.95,226300.54999999993,226438.8299999999,-138.27999999996973
7355,2022-03-10 08:55:00,-1266.03,225034.51999999993,226438.8299999999,-1404.3099999999686
7356,2022-03-10 09:00:00,220.03,225254.54999999993,226438.8299999999,-1184.2799999999697
7357,2022-03-10 09:05:00,-1196.44,224058.10999999993,226438.8299999999,-2380.719999999972
7358,2022-03-10 09:10:00,-1016.53,223041.57999999993,226438.8299999999,-3397.249999999971
7359,2022-03-10 09:15:00,-513.98,222527.59999999992,226438.8299999999,-3911.2299999999814
7360,2022-03-10 09:20:00,-1086.04,221441.5599999999,226438.8299999999,-4997.2699999999895
7361,2022-03-10 09:25:00,-1672.73,219768.8299999999,226438.8299999999,-6670.0
7362,2022-03-10 09:30:00,-691.19,219077.6399999999,226438.8299999999,-7361.190000000002
7363,2022-03-10 09:35:00,1229.73,220307.3699999999,226438.8299999999,-6131.459999999992
7364,2022-03-10 09:40:00,340.72,220648.0899999999,226438.8299999999,-5790.739999999991
7365,2022-03-10 09:45:00,-1971.55,218676.53999999992,226438.8299999999,-7762.289999999979
7366,2022-03-10 09:50:00,-437.74,218238.79999999993,226438.8299999999,-8200.02999999997
7367,2022-03-10 09:55:00,-717.22,217521.57999999993,226438.8299999999,-8917.24999999997
7368,2022-03-10 10:00:00,-50.23,217471.34999999992,226438.8299999999,-8967.479999999981
7369,2022-03-10 10:05:00,1041.97,218513.31999999992,226438.8299999999,-7925.50999999998
7370,2022-03-10 10:10:00,1932.93,220446.2499999999,226438.8299999999,-5992.579999999987
7371,2022-03-10 10:15:00,-1576.81,218869.43999999992,226438.8299999999,-7569.389999999985
7372,2022-03-10 10:20:00,1877.66,220747.09999999992,226438.8299999999,-5691.729999999981
7373,2022-03-10 10:25:00,-1757.88,218989.2199999999,226438.8299999999,-7449.609999999986
7374,2022-03-10 10:30:00,-929.1,218060.1199999999,226438.8299999999,-8378.709999999992
7375,2022-03-10 10:35:00,-1041.63,217018.4899999999,226438.8299999999,-9420.339999999997
7376,2022-03-10 10:40:00,-765.12,216253.3699999999,226438.8299999999,-10185.459999999992
7377,2022-03-10 10:45:00,-112.23,216141.1399999999,226438.8299999999,-10297.690000000002
7378,2022-03-10 10:50:00,-2.15,216138.9899999999,226438.8299999999,-10299.839999999997
7379,2022-03-10 10:55:00,-1620.14,214518.8499999999,226438.8299999999,-11919.98000000001
7380,2022-03-10 11:00:00,-1019.98,213498.86999999988,226438.8299999999,-12939.960000000021
7381,2022-03-10 11:05:00,1142.34,214641.20999999988,226438.8299999999,-11797.620000000024
7382,2022-03-10 11:10:00,-644.01,213997.19999999987,226438.8299999999,-12441.630000000034
7383,2022-03-10 11:15:00,-136.38,213860.81999999986,226438.8299999999,-12578.010000000038
7384,2022-03-10 11:20:00,-899.49,212961.32999999987,226438.8299999999,-13477.50000000003
7385,2022-03-10 11:25:00,-1246.27,211715.05999999988,226438.8299999999,-14723.770000000019
7386,2022-03-10 11:30:00,612.99,212328.04999999987,226438.8299999999,-14110.780000000028
7387,2022-03-10 11:35:00,-1194.59,211133.45999999988,226438.8299999999,-15305.370000000024
7388,2022-03-10 11:40:00,-8.47,211124.98999999987,226438.8299999999,-15313.840000000026
7389,2022-03-10 11:45:00,1166.38,212291.36999999988,226438.8299999999,-14147.460000000021
7390,2022-03-10 11:50:00,710.79,213002.1599999999,226438.8299999999,-13436.670000000013
7391,2022-03-10 11:55:00,1375.18,214377.33999999988,226438.8299999999,-12061.49000000002
7392,2022-03-10 12:00:00,-1178.61,213198.7299999999,226438.8299999999,-13240.100000000006
7393,2022-03-10 12:05:00,-1019.62,212179.1099999999,226438.8299999999,-14259.720000000001
7394,2022-03-10 12:10:00,1150.04,213329.1499999999,226438.8299999999,-13109.679999999993
7395,2022-03-10 12:15:00,1498.86,214828.0099999999,226438.8299999999,-11610.820000000007
7396,2022-03-10 12:20:00,1534.86,216362.86999999988,226438.8299999999,-10075.960000000021
7397,2022-03-10 12:25:00,1779.17,218142.0399999999,226438.8299999999,-8296.790000000008
7398,2022-03-10 12:30:00,-142.57,217999.46999999988,226438.8299999999,-8439.360000000015
7399,2022-03-10 12:35:00,1142.5,219141.96999999988,226438.8299999999,-7296.860000000015
7400,2022-03-10 12:40:00,202.4,219344.36999999988,226438.8299999999,-7094.460000000021
7401,2022-03-10 12:45:00,1871.77,221216.13999999987,226438.8299999999,-5222.690000000031
7402,2022-03-10 12:50:00,-681.32,220534.81999999986,226438.8299999999,-5904.010000000038
7403,2022-03-10 12:55:00,900.03,221434.84999999986,226438.8299999999,-5003.98000000004
7404,2022-03-10 13:00:00,-1115.13,220319.71999999986,226438.8299999999,-6119.110000000044
7405,2022-03-10 13:05:00,-1285.42,219034.29999999984,226438.8299999999,-7404.530000000057
7406,2022-03-10 13:10:00,-1361.14,217673.15999999983,226438.8299999999,-8765.670000000071
7407,2022-03-10 13:15:00,1668.37,219341.52999999982,226438.8299999999,-7097.300000000076
7408,2022-03-10 13:20:00,-1604.41,217737.11999999982,226438.8299999999,-8701.71000000008
7409,2022-03-10 13:25:00,-470.59,217266.52999999982,226438.8299999999,-9172.300000000076
7410,2022-03-10 13:30:00,-193.75,217072.77999999982,226438.8299999999,-9366.050000000076
7411,2022-03-10 13:35:00,-1593.86,215478.91999999984,226438.8299999999,-10959.910000000062
7412,2022-03-10 13:40:00,-1334.3,214144.61999999985,226438.8299999999,-12294.21000000005
7413,2022-03-10 13:45:00,-948.35,213196.26999999984,226438.8299999999,-13242.560000000056
7414,2022-03-10 13:50:00,1246.57,214442.83999999985,226438.8299999999,-11995.990000000049
7415,2022-03-10 13:55:00,-1833.74,212609.09999999986,226438.8299999999,-13829.73000000004
7416,2022-03-10 14:00:00,870.95,213480.04999999987,226438.8299999999,-12958.780000000028
7417,2022-03-10 14:05:00,20.37,213500.41999999987,226438.8299999999,-12938.410000000033
7418,2022-03-10 14:10:00,1316.67,214817.08999999988,226438.8299999999,-11621.74000000002
7419,2022-03-10 14:15:00,-1943.88,212873.20999999988,226438.8299999999,-13565.620000000024
7420,2022-03-10 14:20:00,-1114.72,211758.48999999987,226438.8299999999,-14680.340000000026
7421,2022-03-10 14:25:00,-1039.36,210719.1299999999,226438.8299999999,-15719.700000000012
7422,2022-03-10 14:30:00,1125.36,211844.48999999987,226438.8299999999,-14594.340000000026
7423,2022-03-10 14:35:00,-1553.46,210291.02999999988,226438.8299999999,-16147.800000000017
7424,2022-03-10 14:40:00,597.22,210888.24999999988,226438.8299999999,-15550.580000000016
7425,2022-03-10 14:45:00,-1141.74,209746.5099999999,226438.8299999999,-16692.320000000007
7426,2022-03-10 14:50:00,-1071.11,208675.3999999999,226438.8299999999,-17763.429999999993
7427,2022-03-10 14:55:00,-479.5,208195.8999999999,226438.8299999999,-18242.929999999993
7428,2022-03-10 15:00:00,-152.5,208043.3999999999,226438.8299999999,-18395.429999999993
7429,2022-03-10 15:05:00,-922.58,207120.81999999992,226438.8299999999,-19318.00999999998
7430,2022-03-10 15:10:00,-800.05,206320.76999999993,226438.8299999999,-20118.05999999997
7431,2022-03-10 15:15:00,-1897.81,204422.95999999993,226438.8299999999,-22015.869999999966
7432,2022-03-10 15:20:00,-1164.62,203258.33999999994,226438.8299999999,-23180.48999999996
7433,2022-03-10 15:25:00,-225.25,203033.08999999994,226438.8299999999,-23405.73999999996
7434,2022-03-10 15:30:00,-111.14,202921.94999999992,226438.8299999999,-23516.879999999976
7435,2022-03-10 15:35:00,1226.06,204148.00999999992,226438.8299999999,-22290.819999999978
7436,2022-03-10 15:40:00,-598.46,203549.54999999993,226438.8299999999,-22889.27999999997
7437,2022-03-10 15:45:00,881.86,204431.40999999992,226438.8299999999,-22007.419999999984
7438,2022-03-10 15:50:00,-830.54,203600.8699999999,226438.8299999999,-22837.959999999992
7439,2022-03-10 15:55:00,981.93,204582.7999999999,226438.8299999999,-21856.03
7440,2022-03-10 16:00:00,-1120.69,203462.1099999999,226438.8299999999,-22976.72
7441,2022-03-10 16:05:00,749.08,204211.1899999999,226438.8299999999,-22227.640000000014
7442,2022-03-10 16:10:00,7.32,204218.5099999999,226438.8299999999,-22220.320000000007
7443,2022-03-10 16:15:00,-526.17,203692.33999999988,226438.8299999999,-22746.49000000002
7444,2022-03-10 16:20:00,-466.03,203226.30999999988,226438.8299999999,-23212.52000000002
7445,2022-03-10 16:25:00,841.25,204067.55999999988,226438.8299999999,-22371.27000000002
7446,2022-03-10 16:30:00,355.67,204423.2299999999,226438.8299999999,-22015.600000000006
7447,2022-03-10 16:35:00,-1905.12,202518.1099999999,226438.8299999999,-23920.72
7448,2022-03-10 16:40:00,-689.42,201828.6899999999,226438.8299999999,-24610.140000000014
7449,2022-03-10 16:45:00,68.58,201897.26999999987,226438.8299999999,-24541.560000000027
7450,2022-03-10 16:50:00,-1311.52,200585.74999999988,226438.8299999999,-25853.080000000016
7451,2022-03-10 16:55:00,447.64,201033.3899999999,226438.8299999999,-25405.440000000002
7452,2022-03-11 08:00:00,-1354.66,199678.7299999999,201033.3899999999,-1354.6600000000035
7453,2022-03-11 08:05:00,-282.15,199396.5799999999,201033.3899999999,-1636.8099999999977
7454,2022-03-11 08:10:00,-151.41,199245.1699999999,201033.3899999999,-1788.2200000000012
7455,2022-03-11 08:15:00,-1168.31,198076.8599999999,201033.3899999999,-2956.529999999999
7456,2022-03-11 08:20:00,-57.07,198019.7899999999,201033.3899999999,-3013.600000000006
7457,2022-03-11 08:25:00,-1439.06,196580.7299999999,201033.3899999999,-4452.6600000000035
7458,2022-03-11 08:30:00,1713.58,198294.30999999988,201033.3899999999,-2739.0800000000163
7459,2022-03-11 08:35:00,1857.26,200151.5699999999,201033.3899999999,-881.820000000007
7460,2022-03-11 08:40:00,1281.96,201433.52999999988,201033.3899999999,400.13999999998487
7461,2022-03-11 08:45:00,-1185.46,200248.0699999999,201033.3899999999,-785.320000000007
7462,2022-03-11 08:50:00,1778.05,202026.11999999988,201033.3899999999,992.7299999999814
7463,2022-03-11 08:55:00,-274.47,201751.64999999988,201033.3899999999,718.2599999999802
7464,2022-03-11 09:00:00,1814.04,203565.6899999999,201033.3899999999,2532.2999999999884
7465,2022-03-11 09:05:00,159.5,203725.1899999999,201033.3899999999,2691.7999999999884
7466,2022-03-11 09:10:00,-501.0,203224.1899999999,201033.3899999999,2190.7999999999884
7467,2022-03-11 09:15:00,-1407.86,201816.3299999999,201033.3899999999,782.9400000000023
7468,2022-03-11 09:20:00,813.19,202629.5199999999,201033.3899999999,1596.1300000000047
7469,2022-03-11 09:25:00,-722.24,201907.2799999999,201033.3899999999,873.890000000014
7470,2022-03-11 09:30:00,-1758.48,200148.7999999999,201033.3899999999,-884.5899999999965
7471,2022-03-11 09:35:00,-1166.26,198982.5399999999,201033.3899999999,-2050.850000000006
7472,2022-03-11 09:40:00,1926.55,200909.08999999988,201033.3899999999,-124.30000000001746
7473,2022-03-11 09:45:00,-15.08,200894.0099999999,201033.3899999999,-139.38000000000466
7474,2022-03-11 09:50:00,-174.63,200719.3799999999,201033.3899999999,-314.0100000000093
7475,2022-03-11 09:55:00,-403.46,200315.9199999999,201033.3899999999,-717.4700000000012
7476,2022-03-11 10:00:00,-557.72,199758.1999999999,201033.3899999999,-1275.1900000000023
7477,2022-03-11 10:05:00,-1574.09,198184.1099999999,201033.3899999999,-2849.279999999999
7478,2022-03-11 10:10:00,1161.04,199345.1499999999,201033.3899999999,-1688.2399999999907
7479,2022-03-11 10:15:00,-383.74,198961.40999999992,201033.3899999999,-2071.9799999999814
7480,2022-03-11 10:20:00,-1714.06,197247.34999999992,201033.3899999999,-3786.039999999979
7481,2022-03-11 10:25:00,1783.48,199030.82999999993,201033.3899999999,-2002.5599999999686
7482,2022-03-11 10:30:00,-3.81,199027.01999999993,201033.3899999999,-2006.3699999999662
7483,2022-03-11 10:35:00,925.55,199952.56999999992,201033.3899999999,-1080.8199999999779
7484,2022-03-11 10:40:00,1560.94,201513.50999999992,201033.3899999999,480.12000000002445
7485,2022-03-11 10:45:00,-204.41,201309.09999999992,201033.3899999999,275.71000000002095
7486,2022-03-11 10:50:00,-1907.35,199401.7499999999,201033.3899999999,-1631.6399999999849
7487,2022-03-11 10:55:00,-1924.92,197476.8299999999,201033.3899999999,-3556.5599999999977
7488,2022-03-11 11:00:00,1570.65,199047.4799999999,201033.3899999999,-1985.9100000000035
7489,2022-03-11 11:05:00,-69.86,198977.6199999999,201033.3899999999,-2055.7699999999895
7490,2022-03-11 11:10:00,376.44,199354.0599999999,201033.3899999999,-1679.3299999999872
7491,2022-03-11 11:15:00,1412.92,200766.97999999992,201033.3899999999,-266.4099999999744
7492,2022-03-11 11:20:00,776.27,201543.2499999999,201033.3899999999,509.86000000001513
7493,2022-03-11 11:25:00,289.72,201832.9699999999,201033.3899999999,799.5800000000163
7494,2022-03-11 11:30:00,1086.19,202919.15999999992,201033.3899999999,1885.7700000000186
7495,2022-03-11 11:35:00,-768.89,202150.2699999999,201033.3899999999,1116.8800000000047
7496,2022-03-11 11:40:00,1556.37,203706.6399999999,201033.3899999999,2673.25
7497,2022-03-11 11:45:00,1131.28,204837.9199999999,201033.3899999999,3804.529999999999
7498,2022-03-11 11:50:00,1093.14,205931.0599999999,201033.3899999999,4897.670000000013
7499,2022-03-11 11:55:00,-981.57,204949.4899999999,201033.3899999999,3916.100000000006
7500,2022-03-11 12:00:00,539.27,205488.7599999999,201033.3899999999,4455.369999999995
7501,2022-03-11 12:05:00,1841.01,207329.7699999999,201033.3899999999,6296.380000000005
7502,2022-03-11 12:10:00,105.58,207435.3499999999,201033.3899999999,6401.959999999992
7503,2022-03-11 12:15:00,-651.35,206783.99999999988,201033.3899999999,5750.609999999986
7504,2022-03-11 12:20:00,171.75,206955.74999999988,201033.3899999999,5922.359999999986
7505,2022-03-11 12:25:00,1473.18,208428.92999999988,201033.3899999999,7395.539999999979
7506,2022-03-11 12:30:00,485.31,208914.23999999987,201033.3899999999,7880.849999999977
7507,2022-03-11 12:35:00,1632.36,210546.59999999986,201033.3899999999,9513.209999999963
7508,2022-03-11 12:40:00,-1687.72,208858.87999999986,201033.3899999999,7825.489999999962
7509,2022-03-11 12:45:00,-1674.35,207184.52999999985,201033.3899999999,6151.139999999956
7510,2022-03-11 12:50:00,-64.94,207119.58999999985,201033.3899999999,6086.199999999953
7511,2022-03-11 12:55:00,111.87,207231.45999999985,201033.3899999999,6198.069999999949
7512,2022-03-11 13:00:00,-1914.36,205317.09999999986,201033.3899999999,4283.709999999963
7513,2022-03-11 13:05:00,1735.07,207052.16999999987,201033.3899999999,6018.77999999997
7514,2022-03-11 13:10:00,1615.64,208667.80999999988,201033.3899999999,7634.419999999984
7515,2022-03-11 13:15:00,1498.5,210166.30999999988,201033.3899999999,9132.919999999984
7516,2022-03-11 13:20:00,69.24,210235.54999999987,201033.3899999999,9202.159999999974
7517,2022-03-11 13:25:00,1619.07,211854.61999999988,201033.3899999999,10821.229999999981
7518,2022-03-11 13:30:00,-935.37,210919.24999999988,201033.3899999999,9885.859999999986
7519,2022-03-11 13:35:00,1107.37,212026.61999999988,201033.3899999999,10993.229999999981
7520,2022-03-11 13:40:00,-1649.15,210377.46999999988,201033.3899999999,9344.079999999987
7521,2022-03-11 13:45:00,-955.86,209421.6099999999,201033.3899999999,8388.220000000001
7522,2022-03-11 13:50:00,-1046.68,208374.9299999999,201033.3899999999,7341.540000000008
7523,2022-03-11 13:55:00,712.36,209087.2899999999,201033.3899999999,8053.899999999994
7524,2022-03-11 14:00:00,-666.22,208421.0699999999,201033.3899999999,7387.679999999993
7525,2022-03-11 14:05:00,970.71,209391.77999999988,201033.3899999999,8358.389999999985
7526,2022-03-11 14:10:00,-324.67,209067.10999999987,201033.3899999999,8033.719999999972
7527,2022-03-11 14:15:00,873.19,209940.29999999987,201033.3899999999,8906.909999999974
7528,2022-03-11 14:20:00,1198.0,211138.29999999987,201033.3899999999,10104.909999999974
7529,2022-03-11 14:25:00,-1758.96,209379.33999999988,201033.3899999999,8345.949999999983
7530,2022-03-11 14:30:00,-161.12,209218.21999999988,201033.3899999999,8184.829999999987
7531,2022-03-11 14:35:00,405.94,209624.1599999999,201033.3899999999,8590.76999999999
7532,2022-03-11 14:40:00,-73.52,209550.6399999999,201033.3899999999,8517.25
7533,2022-03-11 14:45:00,1920.9,211471.5399999999,201033.3899999999,10438.149999999994
7534,2022-03-11 14:50:00,655.15,212126.6899999999,201033.3899999999,11093.299999999988
7535,2022-03-11 14:55:00,-1545.3,210581.3899999999,201033.3899999999,9548.0
7536,2022-03-11 15:00:00,257.86,210839.24999999988,201033.3899999999,9805.859999999986
7537,2022-03-11 15:05:00,1355.01,212194.2599999999,201033.3899999999,11160.869999999995
7538,2022-03-11 15:10:00,-135.18,212059.0799999999,201033.3899999999,11025.690000000002
7539,2022-03-11 15:15:00,1273.42,213332.4999999999,201033.3899999999,12299.110000000015
7540,2022-03-11 15:20:00,1134.1,214466.59999999992,201033.3899999999,13433.210000000021
7541,2022-03-11 15:25:00,-295.84,214170.75999999992,201033.3899999999,13137.370000000024
7542,2022-03-11 15:30:00,-202.39,213968.3699999999,201033.3899999999,12934.98000000001
7543,2022-03-11 15:35:00,1294.07,215262.43999999992,201033.3899999999,14229.050000000017
7544,2022-03-11 15:40:00,96.53,215358.9699999999,201033.3899999999,14325.580000000016
7545,2022-03-11 15:45:00,1727.28,217086.2499999999,201033.3899999999,16052.860000000015
7546,2022-03-11 15:50:00,-741.38,216344.8699999999,201033.3899999999,15311.48000000001
7547,2022-03-11 15:55:00,-928.62,215416.2499999999,201033.3899999999,14382.860000000015
7548,2022-03-11 16:00:00,854.62,216270.8699999999,201033.3899999999,15237.48000000001
7549,2022-03-11 16:05:00,302.92,216573.78999999992,201033.3899999999,15540.400000000023
7550,2022-03-11 16:10:00,916.69,217490.47999999992,201033.3899999999,16457.090000000026
7551,2022-03-11 16:15:00,-123.46,217367.01999999993,201033.3899999999,16333.630000000034
7552,2022-03-11 16:20:00,1278.46,218645.47999999992,201033.3899999999,17612.090000000026
7553,2022-03-11 16:25:00,-950.13,217695.34999999992,201033.3899999999,16661.96000000002
7554,2022-03-11 16:30:00,722.78,218418.12999999992,201033.3899999999,17384.74000000002
7555,2022-03-11 16:35:00,-166.69,218251.43999999992,201033.3899999999,17218.050000000017
7556,2022-03-11 16:40:00,-1192.47,217058.9699999999,201033.3899999999,16025.580000000016
7557,2022-03-11 16:45:00,65.51,217124.47999999992,201033.3899999999,16091.090000000026
7558,2022-03-11 16:50:00,-1138.01,215986.4699999999,201033.3899999999,14953.080000000016
7559,2022-03-11 16:55:00,-628.77,215357.69999999992,201033.3899999999,14324.310000000027
7560,2022-03-12 08:00:00,-58.19,215299.50999999992,215357.69999999992,-58.19000000000233
7561,2022-03-12 08:05:00,985.86,216285.3699999999,215357.69999999992,927.6699999999837
7562,2022-03-12 08:10:00,601.06,216886.4299999999,215357.69999999992,1528.7299999999814
7563,2022-03-12 08:15:00,-663.08,216223.34999999992,215357.69999999992,865.6499999999942
7564,2022-03-12 08:20:00,580.6,216803.94999999992,215357.69999999992,1446.25
7565,2022-03-12 08:25:00,-1173.03,215630.91999999993,215357.69999999992,273.22000000000116
7566,2022-03-12 08:30:00,-1141.34,214489.57999999993,215357.69999999992,-868.1199999999953
7567,2022-03-12 08:35:00,8.21,214497.78999999992,215357.69999999992,-859.9100000000035
7568,2022-03-12 08:40:00,-256.92,214240.8699999999,215357.69999999992,-1116.8300000000163
7569,2022-03-12 08:45:00,481.28,214722.1499999999,215357.69999999992,-635.5500000000175
7570,2022-03-12 08:50:00,-1695.54,213026.6099999999,215357.69999999992,-2331.0900000000256
7571,2022-03-12 08:55:00,411.02,213437.6299999999,215357.69999999992,-1920.070000000036
7572,2022-03-12 09:00:00,-1581.12,211856.5099999999,215357.69999999992,-3501.1900000000314
7573,2022-03-12 09:05:00,-358.28,211498.2299999999,215357.69999999992,-3859.4700000000303
7574,2022-03-12 09:10:00,-1812.29,209685.9399999999,215357.69999999992,-5671.760000000038
7575,2022-03-12 09:15:00,1432.89,211118.8299999999,215357.69999999992,-4238.870000000024
7576,2022-03-12 09:20:00,-680.94,210437.8899999999,215357.69999999992,-4919.810000000027
7577,2022-03-12 09:25:00,-991.26,209446.6299999999,215357.69999999992,-5911.070000000036
7578,2022-03-12 09:30:00,-1429.72,208016.9099999999,215357.69999999992,-7340.790000000037
7579,2022-03-12 09:35:00,-480.6,207536.30999999988,215357.69999999992,-7821.390000000043
7580,2022-03-12 09:40:00,-1300.15,206236.1599999999,215357.69999999992,-9121.540000000037
7581,2022-03-12 09:45:00,-1120.36,205115.7999999999,215357.69999999992,-10241.900000000023
7582,2022-03-12 09:50:00,335.92,205451.7199999999,215357.69999999992,-9905.98000000001
7583,2022-03-12 09:55:00,-1721.27,203730.44999999992,215357.69999999992,-11627.25
7584,2022-03-12 10:00:00,438.56,204169.00999999992,215357.69999999992,-11188.690000000002
7585,2022-03-12 10:05:00,129.09,204298.09999999992,215357.69999999992,-11059.600000000006
7586,2022-03-12 10:10:00,-1311.21,202986.88999999993,215357.69999999992,-12370.809999999998
7587,2022-03-12 10:15:00,-1031.83,201955.05999999994,215357.69999999992,-13402.639999999985
7588,2022-03-12 10:20:00,1129.69,203084.74999999994,215357.69999999992,-12272.949999999983
7589,2022-03-12 10:25:00,-1417.94,201666.80999999994,215357.69999999992,-13690.889999999985
7590,2022-03-12 10:30:00,376.65,202043.45999999993,215357.69999999992,-13314.23999999999
7591,2022-03-12 10:35:00,1125.95,203169.40999999995,215357.69999999992,-12188.289999999979
7592,2022-03-12 10:40:00,323.85,203493.25999999995,215357.69999999992,-11864.439999999973
7593,2022-03-12 10:45:00,-1314.78,202178.47999999995,215357.69999999992,-13179.219999999972
7594,2022-03-12 10:50:00,795.16,202973.63999999996,215357.69999999992,-12384.059999999969
7595,2022-03-12 10:55:00,-167.3,202806.33999999997,215357.69999999992,-12551.359999999957
7596,2022-03-12 11:00:00,-984.33,201822.00999999998,215357.69999999992,-13535.689999999944
7597,2022-03-12 11:05:00,-1347.74,200474.27,215357.69999999992,-14883.429999999935
7598,2022-03-12 11:10:00,-225.94,200248.33,215357.69999999992,-15109.369999999937
7599,2022-03-12 11:15:00,1110.48,201358.81,215357.69999999992,-13998.889999999927
7600,2022-03-12 11:20:00,1862.58,203221.38999999998,215357.69999999992,-12136.30999999994
7601,2022-03-12 11:25:00,1334.07,204555.46,215357.69999999992,-10802.239999999932
7602,2022-03-12 11:30:00,-1076.11,203479.35,215357.69999999992,-11878.349999999919
7603,2022-03-12 11:35:00,-1810.09,201669.26,215357.69999999992,-13688.439999999915
7604,2022-03-12 11:40:00,414.85,202084.11000000002,215357.69999999992,-13273.58999999991
7605,2022-03-12 11:45:00,-1874.64,200209.47,215357.69999999992,-15148.229999999923
7606,2022-03-12 11:50:00,-681.48,199527.99,215357.69999999992,-15829.709999999934
7607,2022-03-12 11:55:00,291.39,199819.38,215357.69999999992,-15538.31999999992
7608,2022-03-12 12:00:00,730.04,200549.42,215357.69999999992,-14808.279999999912
7609,2022-03-12 12:05:00,155.7,200705.12000000002,215357.69999999992,-14652.5799999999
7610,2022-03-12 12:10:00,-189.97,200515.15000000002,215357.69999999992,-14842.549999999901
7611,2022-03-12 12:15:00,-480.79,200034.36000000002,215357.69999999992,-15323.33999999991
7612,2022-03-12 12:20:00,244.95,200279.31000000003,215357.69999999992,-15078.389999999898
7613,2022-03-12 12:25:00,476.73,200756.04000000004,215357.69999999992,-14601.659999999887
7614,2022-03-12 12:30:00,-1283.78,199472.26000000004,215357.69999999992,-15885.439999999886
7615,2022-03-12 12:35:00,1950.62,201422.88000000003,215357.69999999992,-13934.81999999989
7616,2022-03-12 12:40:00,-1254.2,200168.68000000002,215357.69999999992,-15189.019999999902
7617,2022-03-12 12:45:00,260.62,200429.30000000002,215357.69999999992,-14928.399999999907
7618,2022-03-12 12:50:00,-365.21,200064.09000000003,215357.69999999992,-15293.609999999899
7619,2022-03-12 12:55:00,622.51,200686.60000000003,215357.69999999992,-14671.09999999989
7620,2022-03-12 13:00:00,-683.46,200003.14000000004,215357.69999999992,-15354.559999999881
7621,2022-03-12 13:05:00,665.89,200669.03000000006,215357.69999999992,-14688.669999999867
7622,2022-03-12 13:10:00,1385.37,202054.40000000005,215357.69999999992,-13303.299999999872
7623,2022-03-12 13:15:00,1345.18,203399.58000000005,215357.69999999992,-11958.119999999879
7624,2022-03-12 13:20:00,-537.42,202862.16000000003,215357.69999999992,-12495.539999999892
7625,2022-03-12 13:25:00,1027.18,203889.34000000003,215357.69999999992,-11468.359999999899
7626,2022-03-12 13:30:00,1710.5,205599.84000000003,215357.69999999992,-9757.859999999899
7627,2022-03-12 13:35:00,-1059.9,204539.94000000003,215357.69999999992,-10817.759999999893
7628,2022-03-12 13:40:00,-968.83,203571.11000000004,215357.69999999992,-11786.58999999988
7629,2022-03-12 13:45:00,1949.3,205520.41000000003,215357.69999999992,-9837.289999999892
7630,2022-03-12 13:50:00,-1323.83,204196.58000000005,215357.69999999992,-11161.119999999879
7631,2022-03-12 13:55:00,-1655.17,202541.41000000003,215357.69999999992,-12816.289999999892
7632,2022-03-12 14:00:00,-118.59,202422.82000000004,215357.69999999992,-12934.879999999888
7633,2022-03-12 14:05:00,1233.52,203656.34000000003,215357.69999999992,-11701.359999999899
7634,2022-03-12 14:10:00,-82.99,203573.35000000003,215357.69999999992,-11784.34999999989
7635,2022-03-12 14:15:00,90.75,203664.10000000003,215357.69999999992,-11693.59999999989
7636,2022-03-12 14:20:00,-700.05,202964.05000000005,215357.69999999992,-12393.649999999878
7637,2022-03-12 14:25:00,-1796.91,201167.14000000004,215357.69999999992,-14190.559999999881
7638,2022-03-12 14:30:00,-877.89,200289.25000000003,215357.69999999992,-15068.449999999895
7639,2022-03-12 14:35:00,-983.49,199305.76000000004,215357.69999999992,-16051.939999999886
7640,2022-03-12 14:40:00,-412.7,198893.06000000003,215357.69999999992,-16464.639999999898
7641,2022-03-12 14:45:00,1745.34,200638.40000000002,215357.69999999992,-14719.299999999901
7642,2022-03-12 14:50:00,-514.75,200123.65000000002,215357.69999999992,-15234.049999999901
7643,2022-03-12 14:55:00,-1548.68,198574.97000000003,215357.69999999992,-16782.729999999894
7644,2022-03-12 15:00:00,33.01,198607.98000000004,215357.69999999992,-16749.719999999885
7645,2022-03-12 15:05:00,1834.34,200442.32000000004,215357.69999999992,-14915.379999999888
7646,2022-03-12 15:10:00,1403.47,201845.79000000004,215357.69999999992,-13511.909999999887
7647,2022-03-12 15:15:00,-741.58,201104.21000000005,215357.69999999992,-14253.489999999874
7648,2022-03-12 15:20:00,1951.47,203055.68000000005,215357.69999999992,-12302.019999999873
7649,2022-03-12 15:25:00,-1482.29,201573.39000000004,215357.69999999992,-13784.309999999881
7650,2022-03-12 15:30:00,1242.29,202815.68000000005,215357.69999999992,-12542.019999999873
7651,2022-03-12 15:35:00,36.55,202852.23000000004,215357.69999999992,-12505.469999999885
7652,2022-03-12 15:40:00,142.08,202994.31000000003,215357.69999999992,-12363.389999999898
7653,2022-03-12 15:45:00,-462.33,202531.98000000004,215357.69999999992,-12825.719999999885
7654,2022-03-12 15:50:00,-56.7,202475.28000000003,215357.69999999992,-12882.419999999896
7655,2022-03-12 15:55:00,-1327.99,201147.29000000004,215357.69999999992,-14210.409999999887
7656,2022-03-12 16:00:00,-400.5,200746.79000000004,215357.69999999992,-14610.909999999887
7657,2022-03-12 16:05:00,1555.13,202301.92000000004,215357.69999999992,-13055.779999999882
7658,2022-03-12 16:10:00,-1093.63,201208.29000000004,215357.69999999992,-14149.409999999887
7659,2022-03-12 16:15:00,-1482.07,199726.22000000003,215357.69999999992,-15631.479999999894
7660,2022-03-12 16:20:00,-1471.8,198254.42000000004,215357.69999999992,-17103.279999999882
7661,2022-03-12 16:25:00,1854.64,200109.06000000006,215357.69999999992,-15248.639999999868
7662,2022-03-12 16:30:00,-829.26,199279.80000000005,215357.69999999992,-16077.899999999878
7663,2022-03-12 16:35:00,-541.12,198738.68000000005,215357.69999999992,-16619.019999999873
7664,2022-03-12 16:40:00,971.27,199709.95000000004,215357.69999999992,-15647.749999999884
7665,2022-03-12 16:45:00,1418.47,201128.42000000004,215357.69999999992,-14229.279999999882
7666,2022-03-12 16:50:00,-932.36,200196.06000000006,215357.69999999992,-15161.639999999868
7667,2022-03-12 16:55:00,1916.13,202112.19000000006,215357.69999999992,-13245.509999999864
7668,2022-03-13 08:00:00,1057.61,203169.80000000005,202112.19000000006,1057.609999999986
7669,2022-03-13 08:05:00,337.34,203507.14000000004,202112.19000000006,1394.9499999999825
7670,2022-03-13 08:10:00,-1662.84,201844.30000000005,202112.19000000006,-267.89000000001397
7671,2022-03-13 08:15:00,680.55,202524.85000000003,202112.19000000006,412.6599999999744
7672,2022-03-13 08:20:00,736.56,203261.41000000003,202112.19000000006,1149.219999999972
7673,2022-03-13 08:25:00,-1167.31,202094.10000000003,202112.19000000006,-18.09000000002561
7674,2022-03-13 08:30:00,-1266.73,200827.37000000002,202112.19000000006,-1284.820000000036
7675,2022-03-13 08:35:00,-1341.99,199485.38000000003,202112.19000000006,-2626.810000000027
7676,2022-03-13 08:40:00,589.46,200074.84000000003,202112.19000000006,-2037.350000000035
7677,2022-03-13 08:45:00,1790.0,201864.84000000003,202112.19000000006,-247.35000000003492
7678,2022-03-13 08:50:00,1329.65,203194.49000000002,202112.19000000006,1082.2999999999593
7679,2022-03-13 08:55:00,1891.66,205086.15000000002,202112.19000000006,2973.9599999999627
7680,2022-03-13 09:00:00,1339.05,206425.2,202112.19000000006,4313.009999999951
7681,2022-03-13 09:05:00,162.5,206587.7,202112.19000000006,4475.509999999951
7682,2022-03-13 09:10:00,1341.73,207929.43000000002,202112.19000000006,5817.239999999962
7683,2022-03-13 09:15:00,758.17,208687.60000000003,202112.19000000006,6575.409999999974
7684,2022-03-13 09:20:00,321.38,209008.98000000004,202112.19000000006,6896.789999999979
7685,2022-03-13 09:25:00,1992.54,211001.52000000005,202112.19000000006,8889.329999999987
7686,2022-03-13 09:30:00,1894.56,212896.08000000005,202112.19000000006,10783.889999999985
7687,2022-03-13 09:35:00,-1994.23,210901.85000000003,202112.19000000006,8789.659999999974
7688,2022-03-13 09:40:00,303.08,211204.93000000002,202112.19000000006,9092.739999999962
7689,2022-03-13 09:45:00,349.59,211554.52000000002,202112.19000000006,9442.329999999958
7690,2022-03-13 09:50:00,-1042.62,210511.90000000002,202112.19000000006,8399.709999999963
7691,2022-03-13 09:55:00,-803.41,209708.49000000002,202112.19000000006,7596.299999999959
7692,2022-03-13 10:00:00,660.36,210368.85,202112.19000000006,8256.659999999945
7693,2022-03-13 10:05:00,-232.04,210136.81,202112.19000000006,8024.619999999937
7694,2022-03-13 10:10:00,-865.99,209270.82,202112.19000000006,7158.629999999946
7695,2022-03-13 10:15:00,1404.71,210675.53,202112.19000000006,8563.339999999938
7696,2022-03-13 10:20:00,-1813.24,208862.29,202112.19000000006,6750.099999999948
7697,2022-03-13 10:25:00,-1161.8,207700.49000000002,202112.19000000006,5588.299999999959
7698,2022-03-13 10:30:00,-770.15,206930.34000000003,202112.19000000006,4818.149999999965
7699,2022-03-13 10:35:00,-1803.48,205126.86000000002,202112.19000000006,3014.6699999999546
7700,2022-03-13 10:40:00,1258.97,206385.83000000002,202112.19000000006,4273.639999999956
7701,2022-03-13 10:45:00,1181.51,207567.34000000003,202112.19000000006,5455.149999999965
7702,2022-03-13 10:50:00,651.53,208218.87000000002,202112.19000000006,6106.679999999964
7703,2022-03-13 10:55:00,978.17,209197.04000000004,202112.19000000006,7084.849999999977
7704,2022-03-13 11:00:00,-1594.27,207602.77000000005,202112.19000000006,5490.579999999987
7705,2022-03-13 11:05:00,-1876.0,205726.77000000005,202112.19000000006,3614.579999999987
7706,2022-03-13 11:10:00,382.84,206109.61000000004,202112.19000000006,3997.4199999999837
7707,2022-03-13 11:15:00,-1376.3,204733.31000000006,202112.19000000006,2621.1199999999953
7708,2022-03-13 11:20:00,1277.1,206010.41000000006,202112.19000000006,3898.220000000001
7709,2022-03-13 11:25:00,1585.71,207596.12000000005,202112.19000000006,5483.929999999993
7710,2022-03-13 11:30:00,-1814.76,205781.36000000004,202112.19000000006,3669.1699999999837
7711,2022-03-13 11:35:00,-1323.7,204457.66000000003,202112.19000000006,2345.469999999972
7712,2022-03-13 11:40:00,1998.75,206456.41000000003,202112.19000000006,4344.219999999972
7713,2022-03-13 11:45:00,-597.62,205858.79000000004,202112.19000000006,3746.5999999999767
7714,2022-03-13 11:50:00,1943.07,207801.86000000004,202112.19000000006,5689.669999999984
7715,2022-03-13 11:55:00,1528.93,209330.79000000004,202112.19000000006,7218.599999999977
7716,2022-03-13 12:00:00,524.5,209855.29000000004,202112.19000000006,7743.099999999977
7717,2022-03-13 12:05:00,-337.32,209517.97000000003,202112.19000000006,7405.77999999997
7718,2022-03-13 12:10:00,-672.77,208845.20000000004,202112.19000000006,6733.00999999998
7719,2022-03-13 12:15:00,-115.6,208729.60000000003,202112.19000000006,6617.409999999974
7720,2022-03-13 12:20:00,1557.07,210286.67000000004,202112.19000000006,8174.479999999981
7721,2022-03-13 12:25:00,1379.79,211666.46000000005,202112.19000000006,9554.26999999999
7722,2022-03-13 12:30:00,-1030.62,210635.84000000005,202112.19000000006,8523.649999999994
7723,2022-03-13 12:35:00,-1790.07,208845.77000000005,202112.19000000006,6733.579999999987
7724,2022-03-13 12:40:00,-362.96,208482.81000000006,202112.19000000006,6370.619999999995
7725,2022-03-13 12:45:00,-822.18,207660.63000000006,202112.19000000006,5548.440000000002
7726,2022-03-13 12:50:00,-91.88,207568.75000000006,202112.19000000006,5456.559999999998
7727,2022-03-13 12:55:00,-643.74,206925.01000000007,202112.19000000006,4812.820000000007
7728,2022-03-13 13:00:00,-92.47,206832.54000000007,202112.19000000006,4720.350000000006
7729,2022-03-13 13:05:00,1854.56,208687.10000000006,202112.19000000006,6574.9100000000035
7730,2022-03-13 13:10:00,-798.26,207888.84000000005,202112.19000000006,5776.649999999994
7731,2022-03-13 13:15:00,908.74,208797.58000000005,202112.19000000006,6685.389999999985
7732,2022-03-13 13:20:00,1314.2,210111.78000000006,202112.19000000006,7999.5899999999965
7733,2022-03-13 13:25:00,-1593.8,208517.98000000007,202112.19000000006,6405.790000000008
7734,2022-03-13 13:30:00,-981.08,207536.90000000008,202112.19000000006,5424.710000000021
7735,2022-03-13 13:35:00,1840.42,209377.3200000001,202112.19000000006,7265.130000000034
7736,2022-03-13 13:40:00,138.27,209515.59000000008,202112.19000000006,7403.400000000023
7737,2022-03-13 13:45:00,462.05,209977.64000000007,202112.19000000006,7865.450000000012
7738,2022-03-13 13:50:00,-203.19,209774.45000000007,202112.19000000006,7662.260000000009
7739,2022-03-13 13:55:00,1530.93,211305.38000000006,202112.19000000006,9193.190000000002
7740,2022-03-13 14:00:00,1696.04,213001.42000000007,202112.19000000006,10889.23000000001
7741,2022-03-13 14:05:00,-1894.49,211106.93000000008,202112.19000000006,8994.74000000002
7742,2022-03-13 14:10:00,-734.52,210372.4100000001,202112.19000000006,8260.22000000003
7743,2022-03-13 14:15:00,1590.53,211962.9400000001,202112.19000000006,9850.75000000003
7744,2022-03-13 14:20:00,1754.15,213717.09000000008,202112.19000000006,11604.900000000023
7745,2022-03-13 14:25:00,-1987.67,211729.42000000007,202112.19000000006,9617.23000000001
7746,2022-03-13 14:30:00,-17.76,211711.66000000006,202112.19000000006,9599.470000000001
7747,2022-03-13 14:35:00,1980.42,213692.08000000007,202112.19000000006,11579.890000000014
7748,2022-03-13 14:40:00,-500.0,213192.08000000007,202112.19000000006,11079.890000000014
7749,2022-03-13 14:45:00,-475.44,212716.64000000007,202112.19000000006,10604.450000000012
7750,2022-03-13 14:50:00,1542.92,214259.56000000008,202112.19000000006,12147.370000000024
7751,2022-03-13 14:55:00,134.14,214393.7000000001,202112.19000000006,12281.510000000038
7752,2022-03-13 15:00:00,470.85,214864.5500000001,202112.19000000006,12752.360000000044
7753,2022-03-13 15:05:00,1092.79,215957.3400000001,202112.19000000006,13845.150000000052
7754,2022-03-13 15:10:00,-1279.92,214677.4200000001,202112.19000000006,12565.23000000004
7755,2022-03-13 15:15:00,1935.98,216613.4000000001,202112.19000000006,14501.21000000005
7756,2022-03-13 15:20:00,781.16,217394.5600000001,202112.19000000006,15282.370000000054
7757,2022-03-13 15:25:00,833.37,218227.9300000001,202112.19000000006,16115.740000000049
7758,2022-03-13 15:30:00,-1841.91,216386.0200000001,202112.19000000006,14273.830000000045
7759,2022-03-13 15:35:00,-1365.68,215020.3400000001,202112.19000000006,12908.150000000052
7760,2022-03-13 15:40:00,947.75,215968.0900000001,202112.19000000006,13855.900000000052
7761,2022-03-13 15:45:00,-708.04,215260.0500000001,202112.19000000006,13147.860000000044
7762,2022-03-13 15:50:00,-842.42,214417.6300000001,202112.19000000006,12305.440000000031
7763,2022-03-13 15:55:00,-1339.03,213078.6000000001,202112.19000000006,10966.410000000033
7764,2022-03-13 16:00:00,863.55,213942.15000000008,202112.19000000006,11829.960000000021
7765,2022-03-13 16:05:00,-1953.68,211988.4700000001,202112.19000000006,9876.280000000028
7766,2022-03-13 16:10:00,-1817.14,210171.33000000007,202112.19000000006,8059.140000000014
7767,2022-03-13 16:15:00,1137.53,211308.86000000007,202112.19000000006,9196.670000000013
7768,2022-03-13 16:20:00,1244.32,212553.18000000008,202112.19000000006,10440.99000000002
7769,2022-03-13 16:25:00,511.48,213064.6600000001,202112.19000000006,10952.47000000003
7770,2022-03-13 16:30:00,857.25,213921.9100000001,202112.19000000006,11809.72000000003
7771,2022-03-13 16:35:00,705.83,214627.74000000008,202112.19000000006,12515.550000000017
7772,2022-03-13 16:40:00,-309.33,214318.4100000001,202112.19000000006,12206.22000000003
7773,2022-03-13 16:45:00,-485.41,213833.0000000001,202112.19000000006,11720.810000000027
7774,2022-03-13 16:50:00,-1267.09,212565.9100000001,202112.19000000006,10453.72000000003
7775,2022-03-13 16:55:00,1869.19,214435.1000000001,202112.19000000006,12322.910000000033
7776,2022-03-14 08:00:00,416.96,214852.06000000008,214435.1000000001,416.95999999999185
7777,2022-03-14 08:05:00,-289.59,214562.4700000001,214435.1000000001,127.36999999999534
7778,2022-03-14 08:10:00,-1430.22,213132.2500000001,214435.1000000001,-1302.8500000000058
7779,2022-03-14 08:15:00,968.35,214100.6000000001,214435.1000000001,-334.5
7780,2022-03-14 08:20:00,1717.47,215818.0700000001,214435.1000000001,1382.9700000000012
7781,2022-03-14 08:25:00,-1239.97,214578.1000000001,214435.1000000001,143.0
7782,2022-03-14 08:30:00,331.45,214909.5500000001,214435.1000000001,474.45000000001164
7783,2022-03-14 08:35:00,1037.05,215946.6000000001,214435.1000000001,1511.5
7784,2022-03-14 08:40:00,194.03,216140.6300000001,214435.1000000001,1705.5299999999988
7785,2022-03-14 08:45:00,121.82,216262.4500000001,214435.1000000001,1827.3500000000058
7786,2022-03-14 08:50:00,1693.0,217955.4500000001,214435.1000000001,3520.350000000006
7787,2022-03-14 08:55:00,211.5,218166.9500000001,214435.1000000001,3731.850000000006
7788,2022-03-14 09:00:00,-1506.22,216660.7300000001,214435.1000000001,2225.6300000000047
7789,2022-03-14 09:05:00,746.19,217406.9200000001,214435.1000000001,2971.820000000007
7790,2022-03-14 09:10:00,1930.14,219337.0600000001,214435.1000000001,4901.960000000021
7791,2022-03-14 09:15:00,1433.92,220770.98000000013,214435.1000000001,6335.880000000034
7792,2022-03-14 09:20:00,1905.11,222676.0900000001,214435.1000000001,8240.99000000002
7793,2022-03-14 09:25:00,1649.27,224325.3600000001,214435.1000000001,9890.26000000001
7794,2022-03-14 09:30:00,934.39,225259.75000000012,214435.1000000001,10824.650000000023
7795,2022-03-14 09:35:00,50.55,225310.3000000001,214435.1000000001,10875.200000000012
7796,2022-03-14 09:40:00,-127.75,225182.5500000001,214435.1000000001,10747.450000000012
7797,2022-03-14 09:45:00,-1079.19,224103.3600000001,214435.1000000001,9668.26000000001
7798,2022-03-14 09:50:00,-435.59,223667.7700000001,214435.1000000001,9232.670000000013
7799,2022-03-14 09:55:00,1386.4,225054.1700000001,214435.1000000001,10619.070000000007
7800,2022-03-14 10:00:00,1786.63,226840.8000000001,214435.1000000001,12405.700000000012
7801,2022-03-14 10:05:00,144.43,226985.2300000001,214435.1000000001,12550.130000000005
7802,2022-03-14 10:10:00,1863.49,228848.7200000001,214435.1000000001,14413.619999999995
7803,2022-03-14 10:15:00,-1520.45,227328.27000000008,214435.1000000001,12893.169999999984
7804,2022-03-14 10:20:00,-1145.27,226183.0000000001,214435.1000000001,11747.899999999994
7805,2022-03-14 10:25:00,850.43,227033.43000000008,214435.1000000001,12598.329999999987
7806,2022-03-14 10:30:00,-565.08,226468.3500000001,214435.1000000001,12033.25
7807,2022-03-14 10:35:00,-1080.97,225387.3800000001,214435.1000000001,10952.279999999999
7808,2022-03-14 10:40:00,-866.31,224521.0700000001,214435.1000000001,10085.970000000001
7809,2022-03-14 10:45:00,1017.99,225539.06000000008,214435.1000000001,11103.959999999992
7810,2022-03-14 10:50:00,561.74,226100.80000000008,214435.1000000001,11665.699999999983
7811,2022-03-14 10:55:00,-1148.17,224952.63000000006,214435.1000000001,10517.52999999997
7812,2022-03-14 11:00:00,107.69,225060.32000000007,214435.1000000001,10625.219999999972
7813,2022-03-14 11:05:00,-395.12,224665.20000000007,214435.1000000001,10230.099999999977
7814,2022-03-14 11:10:00,-1952.38,222712.82000000007,214435.1000000001,8277.719999999972
7815,2022-03-14 11:15:00,-1891.26,220821.56000000006,214435.1000000001,6386.459999999963
7816,2022-03-14 11:20:00,-467.6,220353.96000000005,214435.1000000001,5918.859999999957
7817,2022-03-14 11:25:00,291.88,220645.84000000005,214435.1000000001,6210.739999999962
7818,2022-03-14 11:30:00,1935.87,222581.71000000005,214435.1000000001,8146.609999999957
7819,2022-03-14 11:35:00,1835.27,224416.98000000004,214435.1000000001,9981.879999999946
7820,2022-03-14 11:40:00,-704.16,223712.82000000004,214435.1000000001,9277.719999999943
7821,2022-03-14 11:45:00,-1024.36,222688.46000000005,214435.1000000001,8253.359999999957
7822,2022-03-14 11:50:00,1403.38,224091.84000000005,214435.1000000001,9656.739999999962
7823,2022-03-14 11:55:00,-438.44,223653.40000000005,214435.1000000001,9218.29999999996
7824,2022-03-14 12:00:00,-1444.41,222208.99000000005,214435.1000000001,7773.889999999956
7825,2022-03-14 12:05:00,-1029.97,221179.02000000005,214435.1000000001,6743.919999999955
7826,2022-03-14 12:10:00,-7.52,221171.50000000006,214435.1000000001,6736.399999999965
7827,2022-03-14 12:15:00,1776.59,222948.09000000005,214435.1000000001,8512.989999999962
7828,2022-03-14 12:20:00,-1705.15,221242.94000000006,214435.1000000001,6807.839999999967
7829,2022-03-14 12:25:00,1990.24,223233.18000000005,214435.1000000001,8798.079999999958
7830,2022-03-14 12:30:00,97.18,223330.36000000004,214435.1000000001,8895.259999999951
7831,2022-03-14 12:35:00,-58.19,223272.17000000004,214435.1000000001,8837.069999999949
7832,2022-03-14 12:40:00,899.34,224171.51000000004,214435.1000000001,9736.409999999945
7833,2022-03-14 12:45:00,-192.64,223978.87000000002,214435.1000000001,9543.769999999931
7834,2022-03-14 12:50:00,-1512.72,222466.15000000002,214435.1000000001,8031.04999999993
7835,2022-03-14 12:55:00,543.66,223009.81000000003,214435.1000000001,8574.709999999934
7836,2022-03-14 13:00:00,1177.65,224187.46000000002,214435.1000000001,9752.359999999928
7837,2022-03-14 13:05:00,-1678.21,222509.25000000003,214435.1000000001,8074.149999999936
7838,2022-03-14 13:10:00,932.37,223441.62000000002,214435.1000000001,9006.519999999931
7839,2022-03-14 13:15:00,355.47,223797.09000000003,214435.1000000001,9361.989999999932
7840,2022-03-14 13:20:00,1668.63,225465.72000000003,214435.1000000001,11030.619999999937
7841,2022-03-14 13:25:00,-594.34,224871.38000000003,214435.1000000001,10436.27999999994
7842,2022-03-14 13:30:00,-1237.33,223634.05000000005,214435.1000000001,9198.949999999953
7843,2022-03-14 13:35:00,-1510.1,222123.95000000004,214435.1000000001,7688.849999999948
7844,2022-03-14 13:40:00,1489.2,223613.15000000005,214435.1000000001,9178.04999999996
7845,2022-03-14 13:45:00,333.57,223946.72000000006,214435.1000000001,9511.619999999966
7846,2022-03-14 13:50:00,742.12,224688.84000000005,214435.1000000001,10253.739999999962
7847,2022-03-14 13:55:00,-1235.39,223453.45000000004,214435.1000000001,9018.349999999948
7848,2022-03-14 14:00:00,-1225.48,222227.97000000003,214435.1000000001,7792.869999999937
7849,2022-03-14 14:05:00,54.77,222282.74000000002,214435.1000000001,7847.639999999927
7850,2022-03-14 14:10:00,1343.97,223626.71000000002,214435.1000000001,9191.609999999928
7851,2022-03-14 14:15:00,1487.54,225114.25000000003,214435.1000000001,10679.149999999936
7852,2022-03-14 14:20:00,249.96,225364.21000000002,214435.1000000001,10929.109999999928
7853,2022-03-14 14:25:00,-1548.52,223815.69000000003,214435.1000000001,9380.589999999938
7854,2022-03-14 14:30:00,-1204.73,222610.96000000002,214435.1000000001,8175.859999999928
7855,2022-03-14 14:35:00,-530.15,222080.81000000003,214435.1000000001,7645.709999999934
7856,2022-03-14 14:40:00,-736.24,221344.57000000004,214435.1000000001,6909.469999999943
7857,2022-03-14 14:45:00,-1064.74,220279.83000000005,214435.1000000001,5844.729999999952
7858,2022-03-14 14:50:00,-735.71,219544.12000000005,214435.1000000001,5109.01999999996
7859,2022-03-14 14:55:00,-452.51,219091.61000000004,214435.1000000001,4656.509999999951
7860,2022-03-14 15:00:00,-430.82,218660.79000000004,214435.1000000001,4225.689999999944
7861,2022-03-14 15:05:00,220.46,218881.25000000003,214435.1000000001,4446.149999999936
7862,2022-03-14 15:10:00,-1293.38,217587.87000000002,214435.1000000001,3152.7699999999313
7863,2022-03-14 15:15:00,-25.68,217562.19000000003,214435.1000000001,3127.0899999999383
7864,2022-03-14 15:20:00,-460.23,217101.96000000002,214435.1000000001,2666.859999999928
7865,2022-03-14 15:25:00,-1124.16,215977.80000000002,214435.1000000001,1542.6999999999243
7866,2022-03-14 15:30:00,1518.53,217496.33000000002,214435.1000000001,3061.229999999923
7867,2022-03-14 15:35:00,1644.83,219141.16,214435.1000000001,4706.05999999991
7868,2022-03-14 15:40:00,-1501.74,217639.42,214435.1000000001,3204.3199999999197
7869,2022-03-14 15:45:00,432.51,218071.93000000002,214435.1000000001,3636.829999999929
7870,2022-03-14 15:50:00,1388.77,219460.7,214435.1000000001,5025.5999999999185
7871,2022-03-14 15:55:00,-15.44,219445.26,214435.1000000001,5010.159999999916
7872,2022-03-14 16:00:00,-1579.2,217866.06,214435.1000000001,3430.9599999999045
7873,2022-03-14 16:05:00,326.43,218192.49,214435.1000000001,3757.3899999998976
7874,2022-03-14 16:10:00,-548.86,217643.63,214435.1000000001,3208.5299999999115
7875,2022-03-14 16:15:00,1676.99,219320.62,214435.1000000001,4885.519999999902
7876,2022-03-14 16:20:00,1303.08,220623.69999999998,214435.1000000001,6188.599999999889
7877,2022-03-14 16:25:00,-500.22,220123.47999999998,214435.1000000001,5688.379999999888
7878,2022-03-14 16:30:00,1899.52,222022.99999999997,214435.1000000001,7587.899999999878
7879,2022-03-14 16:35:00,437.17,222460.16999999998,214435.1000000001,8025.069999999891
7880,2022-03-14 16:40:00,-543.96,221916.21,214435.1000000001,7481.109999999899
7881,2022-03-14 16:45:00,720.79,222637.0,214435.1000000001,8201.899999999907
7882,2022-03-14 16:50:00,-965.83,221671.17,214435.1000000001,7236.06999999992
7883,2022-03-14 16:55:00,-1391.11,220280.06000000003,214435.1000000001,5844.959999999934
7884,2022-03-15 08:00:00,1046.85,221326.91000000003,220280.06000000003,1046.8500000000058
7885,2022-03-15 08:05:00,1744.55,223071.46000000002,220280.06000000003,2791.399999999994
7886,2022-03-15 08:10:00,1320.58,224392.04,220280.06000000003,4111.979999999981
7887,2022-03-15 08:15:00,-1125.49,223266.55000000002,220280.06000000003,2986.4899999999907
7888,2022-03-15 08:20:00,-1988.5,221278.05000000002,220280.06000000003,997.9899999999907
7889,2022-03-15 08:25:00,-684.29,220593.76,220280.06000000003,313.69999999998254
7890,2022-03-15 08:30:00,-1527.1,219066.66,220280.06000000003,-1213.4000000000233
7891,2022-03-15 08:35:00,-832.94,218233.72,220280.06000000003,-2046.3400000000256
7892,2022-03-15 08:40:00,-1830.06,216403.66,220280.06000000003,-3876.4000000000233
7893,2022-03-15 08:45:00,-317.6,216086.06,220280.06000000003,-4194.000000000029
7894,2022-03-15 08:50:00,1547.51,217633.57,220280.06000000003,-2646.49000000002
7895,2022-03-15 08:55:00,-1251.66,216381.91,220280.06000000003,-3898.1500000000233
7896,2022-03-15 09:00:00,-1345.22,215036.69,220280.06000000003,-5243.370000000024
7897,2022-03-15 09:05:00,-296.87,214739.82,220280.06000000003,-5540.24000000002
7898,2022-03-15 09:10:00,-1210.57,213529.25,220280.06000000003,-6750.810000000027
7899,2022-03-15 09:15:00,1117.0,214646.25,220280.06000000003,-5633.810000000027
7900,2022-03-15 09:20:00,-416.84,214229.41,220280.06000000003,-6050.650000000023
7901,2022-03-15 09:25:00,-470.74,213758.67,220280.06000000003,-6521.390000000014
7902,2022-03-15 09:30:00,1182.64,214941.31000000003,220280.06000000003,-5338.75
7903,2022-03-15 09:35:00,1188.84,216130.15000000002,220280.06000000003,-4149.9100000000035
7904,2022-03-15 09:40:00,441.81,216571.96000000002,220280.06000000003,-3708.100000000006
7905,2022-03-15 09:45:00,-335.23,216236.73,220280.06000000003,-4043.3300000000163
7906,2022-03-15 09:50:00,303.35,216540.08000000002,220280.06000000003,-3739.9800000000105
7907,2022-03-15 09:55:00,1776.2,218316.28000000003,220280.06000000003,-1963.7799999999988
7908,2022-03-15 10:00:00,-1913.5,216402.78000000003,220280.06000000003,-3877.279999999999
7909,2022-03-15 10:05:00,-523.87,215878.91000000003,220280.06000000003,-4401.149999999994
7910,2022-03-15 10:10:00,1273.99,217152.90000000002,220280.06000000003,-3127.1600000000035
7911,2022-03-15 10:15:00,1029.3,218182.2,220280.06000000003,-2097.860000000015
7912,2022-03-15 10:20:00,677.06,218859.26,220280.06000000003,-1420.8000000000175
7913,2022-03-15 10:25:00,1556.44,220415.7,220280.06000000003,135.63999999998487
7914,2022-03-15 10:30:00,-589.01,219826.69,220280.06000000003,-453.37000000002445
7915,2022-03-15 10:35:00,-576.39,219250.3,220280.06000000003,-1029.7600000000384
7916,2022-03-15 10:40:00,-1482.64,217767.65999999997,220280.06000000003,-2512.4000000000524
7917,2022-03-15 10:45:00,-473.96,217293.69999999998,220280.06000000003,-2986.3600000000442
7918,2022-03-15 10:50:00,348.11,217641.80999999997,220280.06000000003,-2638.250000000058
7919,2022-03-15 10:55:00,-573.64,217068.16999999995,220280.06000000003,-3211.890000000072
7920,2022-03-15 11:00:00,471.58,217539.74999999994,220280.06000000003,-2740.310000000085
7921,2022-03-15 11:05:00,-750.78,216788.96999999994,220280.06000000003,-3491.090000000084
7922,2022-03-15 11:10:00,-1021.59,215767.37999999995,220280.06000000003,-4512.68000000008
7923,2022-03-15 11:15:00,1232.44,216999.81999999995,220280.06000000003,-3280.240000000078
7924,2022-03-15 11:20:00,495.76,217495.57999999996,220280.06000000003,-2784.4800000000687
7925,2022-03-15 11:25:00,-1941.36,215554.21999999997,220280.06000000003,-4725.840000000055
7926,2022-03-15 11:30:00,-226.68,215327.53999999998,220280.06000000003,-4952.520000000048
7927,2022-03-15 11:35:00,-669.94,214657.59999999998,220280.06000000003,-5622.46000000005
7928,2022-03-15 11:40:00,-932.09,213725.50999999998,220280.06000000003,-6554.550000000047
7929,2022-03-15 11:45:00,1201.12,214926.62999999998,220280.06000000003,-5353.430000000051
7930,2022-03-15 11:50:00,582.49,215509.11999999997,220280.06000000003,-4770.9400000000605
7931,2022-03-15 11:55:00,-968.0,214541.11999999997,220280.06000000003,-5738.9400000000605
7932,2022-03-15 12:00:00,219.62,214760.73999999996,220280.06000000003,-5519.320000000065
7933,2022-03-15 12:05:00,-1413.76,213346.97999999995,220280.06000000003,-6933.0800000000745
7934,2022-03-15 12:10:00,1249.71,214596.68999999994,220280.06000000003,-5683.370000000083
7935,2022-03-15 12:15:00,-1135.38,213461.30999999994,220280.06000000003,-6818.750000000087
7936,2022-03-15 12:20:00,1667.98,215129.28999999995,220280.06000000003,-5150.770000000077
7937,2022-03-15 12:25:00,1733.17,216862.45999999996,220280.06000000003,-3417.600000000064
7938,2022-03-15 12:30:00,-1823.34,215039.11999999997,220280.06000000003,-5240.9400000000605
7939,2022-03-15 12:35:00,942.37,215981.48999999996,220280.06000000003,-4298.570000000065
7940,2022-03-15 12:40:00,772.82,216754.30999999997,220280.06000000003,-3525.750000000058
7941,2022-03-15 12:45:00,-804.53,215949.77999999997,220280.06000000003,-4330.280000000057
7942,2022-03-15 12:50:00,216.2,216165.97999999998,220280.06000000003,-4114.080000000045
7943,2022-03-15 12:55:00,-256.87,215909.11,220280.06000000003,-4370.950000000041
7944,2022-03-15 13:00:00,-1465.94,214443.16999999998,220280.06000000003,-5836.890000000043
7945,2022-03-15 13:05:00,-551.3,213891.87,220280.06000000003,-6388.190000000031
7946,2022-03-15 13:10:00,1989.95,215881.82,220280.06000000003,-4398.24000000002
7947,2022-03-15 13:15:00,157.94,216039.76,220280.06000000003,-4240.3000000000175
7948,2022-03-15 13:20:00,589.43,216629.19,220280.06000000003,-3650.8700000000244
7949,2022-03-15 13:25:00,-1506.71,215122.48,220280.06000000003,-5157.580000000016
7950,2022-03-15 13:30:00,-1060.05,214062.43000000002,220280.06000000003,-6217.630000000005
7951,2022-03-15 13:35:00,924.25,214986.68000000002,220280.06000000003,-5293.380000000005
7952,2022-03-15 13:40:00,42.77,215029.45,220280.06000000003,-5250.610000000015
7953,2022-03-15 13:45:00,1609.26,216638.71000000002,220280.06000000003,-3641.350000000006
7954,2022-03-15 13:50:00,-1912.14,214726.57,220280.06000000003,-5553.49000000002
7955,2022-03-15 13:55:00,-1895.87,212830.7,220280.06000000003,-7449.360000000015
7956,2022-03-15 14:00:00,-1482.44,211348.26,220280.06000000003,-8931.800000000017
7957,2022-03-15 14:05:00,-1577.06,209771.2,220280.06000000003,-10508.860000000015
7958,2022-03-15 14:10:00,-1175.52,208595.68000000002,220280.06000000003,-11684.380000000005
7959,2022-03-15 14:15:00,-1.62,208594.06000000003,220280.06000000003,-11686.0
7960,2022-03-15 14:20:00,-199.09,208394.97000000003,220280.06000000003,-11885.089999999997
7961,2022-03-15 14:25:00,-593.26,207801.71000000002,220280.06000000003,-12478.350000000006
7962,2022-03-15 14:30:00,-652.09,207149.62000000002,220280.06000000003,-13130.440000000002
7963,2022-03-15 14:35:00,-738.3,206411.32000000004,220280.06000000003,-13868.73999999999
7964,2022-03-15 14:40:00,1811.19,208222.51000000004,220280.06000000003,-12057.549999999988
7965,2022-03-15 14:45:00,29.66,208252.17000000004,220280.06000000003,-12027.889999999985
7966,2022-03-15 14:50:00,991.18,209243.35000000003,220280.06000000003,-11036.709999999992
7967,2022-03-15 14:55:00,144.8,209388.15000000002,220280.06000000003,-10891.910000000003
7968,2022-03-15 15:00:00,-309.64,209078.51,220280.06000000003,-11201.550000000017
7969,2022-03-15 15:05:00,-327.02,208751.49000000002,220280.06000000003,-11528.570000000007
7970,2022-03-15 15:10:00,433.48,209184.97000000003,220280.06000000003,-11095.089999999997
7971,2022-03-15 15:15:00,-1818.85,207366.12000000002,220280.06000000003,-12913.940000000002
7972,2022-03-15 15:20:00,-569.45,206796.67,220280.06000000003,-13483.390000000014
7973,2022-03-15 15:25:00,-1510.52,205286.15000000002,220280.06000000003,-14993.910000000003
7974,2022-03-15 15:30:00,1623.92,206910.07000000004,220280.06000000003,-13369.98999999999
7975,2022-03-15 15:35:00,762.11,207672.18000000002,220280.06000000003,-12607.880000000005
7976,2022-03-15 15:40:00,-1154.36,206517.82000000004,220280.06000000003,-13762.23999999999
7977,2022-03-15 15:45:00,-1260.39,205257.43000000002,220280.06000000003,-15022.630000000005
7978,2022-03-15 15:50:00,-1987.97,203269.46000000002,220280.06000000003,-17010.600000000006
7979,2022-03-15 15:55:00,-802.2,202467.26,220280.06000000003,-17812.800000000017
7980,2022-03-15 16:00:00,-1445.81,201021.45,220280.06000000003,-19258.610000000015
7981,2022-03-15 16:05:00,-1021.37,200000.08000000002,220280.06000000003,-20279.98000000001
7982,2022-03-15 16:10:00,1087.3,201087.38,220280.06000000003,-19192.680000000022
7983,2022-03-15 16:15:00,945.23,202032.61000000002,220280.06000000003,-18247.45000000001
7984,2022-03-15 16:20:00,1493.44,203526.05000000002,220280.06000000003,-16754.01000000001
7985,2022-03-15 16:25:00,1348.37,204874.42,220280.06000000003,-15405.640000000014
7986,2022-03-15 16:30:00,277.64,205152.06000000003,220280.06000000003,-15128.0
7987,2022-03-15 16:35:00,1048.58,206200.64,220280.06000000003,-14079.420000000013
7988,2022-03-15 16:40:00,754.8,206955.44,220280.06000000003,-13324.620000000024
7989,2022-03-15 16:45:00,946.1,207901.54,220280.06000000003,-12378.520000000019
7990,2022-03-15 16:50:00,1682.87,209584.41,220280.06000000003,-10695.650000000023
7991,2022-03-15 16:55:00,1136.43,210720.84,220280.06000000003,-9559.22000000003
7992,2022-03-16 08:00:00,1753.55,212474.38999999998,210720.84,1753.5499999999884
7993,2022-03-16 08:05:00,856.13,213330.52,210720.84,2609.679999999993
7994,2022-03-16 08:10:00,1900.64,215231.16,210720.84,4510.320000000007
7995,2022-03-16 08:15:00,-288.17,214942.99,210720.84,4222.149999999994
7996,2022-03-16 08:20:00,-1361.18,213581.81,210720.84,2860.970000000001
7997,2022-03-16 08:25:00,-987.55,212594.26,210720.84,1873.4200000000128
7998,2022-03-16 08:30:00,-529.39,212064.87,210720.84,1344.0299999999988
7999,2022-03-16 08:35:00,-1130.83,210934.04,210720.84,213.20000000001164
8000,2022-03-16 08:40:00,-1899.41,209034.63,210720.84,-1686.2099999999919
8001,2022-03-16 08:45:00,-484.53,208550.1,210720.84,-2170.7399999999907
8002,2022-03-16 08:50:00,-645.15,207904.95,210720.84,-2815.889999999985
8003,2022-03-16 08:55:00,-789.51,207115.44,210720.84,-3605.399999999994
8004,2022-03-16 09:00:00,-587.78,206527.66,210720.84,-4193.179999999993
8005,2022-03-16 09:05:00,-1674.15,204853.51,210720.84,-5867.329999999987
8006,2022-03-16 09:10:00,-1037.63,203815.88,210720.84,-6904.959999999992
8007,2022-03-16 09:15:00,-1764.01,202051.87,210720.84,-8668.970000000001
8008,2022-03-16 09:20:00,-251.65,201800.22,210720.84,-8920.619999999995
8009,2022-03-16 09:25:00,-1997.15,199803.07,210720.84,-10917.76999999999
8010,2022-03-16 09:30:00,1782.26,201585.33000000002,210720.84,-9135.50999999998
8011,2022-03-16 09:35:00,-1383.73,200201.6,210720.84,-10519.23999999999
8012,2022-03-16 09:40:00,1345.33,201546.93,210720.84,-9173.910000000003
8013,2022-03-16 09:45:00,1795.95,203342.88,210720.84,-7377.959999999992
8014,2022-03-16 09:50:00,110.06,203452.94,210720.84,-7267.899999999994
8015,2022-03-16 09:55:00,1683.32,205136.26,210720.84,-5584.579999999987
8016,2022-03-16 10:00:00,1366.61,206502.87,210720.84,-4217.970000000001
8017,2022-03-16 10:05:00,1292.93,207795.8,210720.84,-2925.040000000008
8018,2022-03-16 10:10:00,-86.49,207709.31,210720.84,-3011.529999999999
8019,2022-03-16 10:15:00,-1046.48,206662.83,210720.84,-4058.0100000000093
8020,2022-03-16 10:20:00,453.11,207115.93999999997,210720.84,-3604.9000000000233
8021,2022-03-16 10:25:00,158.35,207274.28999999998,210720.84,-3446.5500000000175
8022,2022-03-16 10:30:00,1820.28,209094.56999999998,210720.84,-1626.2700000000186
8023,2022-03-16 10:35:00,-1812.43,207282.13999999998,210720.84,-3438.7000000000116
8024,2022-03-16 10:40:00,1671.06,208953.19999999998,210720.84,-1767.640000000014
8025,2022-03-16 10:45:00,-942.87,208010.33,210720.84,-2710.5100000000093
8026,2022-03-16 10:50:00,1582.71,209593.03999999998,210720.84,-1127.8000000000175
8027,2022-03-16 10:55:00,-1471.65,208121.38999999998,210720.84,-2599.4500000000116
8028,2022-03-16 11:00:00,-1124.33,206997.06,210720.84,-3723.779999999999
8029,2022-03-16 11:05:00,-1728.56,205268.5,210720.84,-5452.3399999999965
8030,2022-03-16 11:10:00,-1590.46,203678.04,210720.84,-7042.799999999988
8031,2022-03-16 11:15:00,-1414.1,202263.94,210720.84,-8456.899999999994
8032,2022-03-16 11:20:00,1046.43,203310.37,210720.84,-7410.470000000001
8033,2022-03-16 11:25:00,-1582.59,201727.78,210720.84,-8993.059999999998
8034,2022-03-16 11:30:00,-245.31,201482.47,210720.84,-9238.369999999995
8035,2022-03-16 11:35:00,-1093.89,200388.58,210720.84,-10332.26000000001
8036,2022-03-16 11:40:00,484.83,200873.40999999997,210720.84,-9847.430000000022
8037,2022-03-16 11:45:00,319.71,201193.11999999997,210720.84,-9527.72000000003
8038,2022-03-16 11:50:00,845.61,202038.72999999995,210720.84,-8682.110000000044
8039,2022-03-16 11:55:00,-719.78,201318.94999999995,210720.84,-9401.890000000043
8040,2022-03-16 12:00:00,-1809.82,199509.12999999995,210720.84,-11211.71000000005
8041,2022-03-16 12:05:00,507.65,200016.77999999994,210720.84,-10704.060000000056
8042,2022-03-16 12:10:00,322.94,200339.71999999994,210720.84,-10381.120000000054
8043,2022-03-16 12:15:00,-1148.29,199191.42999999993,210720.84,-11529.410000000062
8044,2022-03-16 12:20:00,-792.41,198399.01999999993,210720.84,-12321.820000000065
8045,2022-03-16 12:25:00,-1582.3,196816.71999999994,210720.84,-13904.120000000054
8046,2022-03-16 12:30:00,1256.99,198073.70999999993,210720.84,-12647.130000000063
8047,2022-03-16 12:35:00,831.52,198905.22999999992,210720.84,-11815.610000000073
8048,2022-03-16 12:40:00,-594.86,198310.36999999994,210720.84,-12410.47000000006
8049,2022-03-16 12:45:00,1932.25,200242.61999999994,210720.84,-10478.22000000006
8050,2022-03-16 12:50:00,1679.69,201922.30999999994,210720.84,-8798.530000000057
8051,2022-03-16 12:55:00,-1304.36,200617.94999999995,210720.84,-10102.890000000043
8052,2022-03-16 13:00:00,1592.95,202210.89999999997,210720.84,-8509.940000000031
8053,2022-03-16 13:05:00,-1324.56,200886.33999999997,210720.84,-9834.50000000003
8054,2022-03-16 13:10:00,-451.93,200434.40999999997,210720.84,-10286.430000000022
8055,2022-03-16 13:15:00,-1588.87,198845.53999999998,210720.84,-11875.300000000017
8056,2022-03-16 13:20:00,348.89,199194.43,210720.84,-11526.410000000003
8057,2022-03-16 13:25:00,-399.59,198794.84,210720.84,-11926.0
8058,2022-03-16 13:30:00,37.59,198832.43,210720.84,-11888.410000000003
8059,2022-03-16 13:35:00,-1251.79,197580.63999999998,210720.84,-13140.200000000012
8060,2022-03-16 13:40:00,-1124.37,196456.27,210720.84,-14264.570000000007
8061,2022-03-16 13:45:00,596.78,197053.05,210720.84,-13667.790000000008
8062,2022-03-16 13:50:00,326.57,197379.62,210720.84,-13341.220000000001
8063,2022-03-16 13:55:00,1295.03,198674.65,210720.84,-12046.190000000002
8064,2022-03-16 14:00:00,872.05,199546.69999999998,210720.84,-11174.140000000014
8065,2022-03-16 14:05:00,1682.17,201228.87,210720.84,-9491.970000000001
8066,2022-03-16 14:10:00,598.72,201827.59,210720.84,-8893.25
8067,2022-03-16 14:15:00,-219.98,201607.61,210720.84,-9113.23000000001
8068,2022-03-16 14:20:00,-508.76,201098.84999999998,210720.84,-9621.99000000002
8069,2022-03-16 14:25:00,903.54,202002.38999999998,210720.84,-8718.450000000012
8070,2022-03-16 14:30:00,1503.72,203506.11,210720.84,-7214.7300000000105
8071,2022-03-16 14:35:00,-837.85,202668.25999999998,210720.84,-8052.580000000016
8072,2022-03-16 14:40:00,1231.8,203900.05999999997,210720.84,-6820.780000000028
8073,2022-03-16 14:45:00,31.78,203931.83999999997,210720.84,-6789.000000000029
8074,2022-03-16 14:50:00,-995.11,202936.72999999998,210720.84,-7784.110000000015
8075,2022-03-16 14:55:00,-115.99,202820.74,210720.84,-7900.100000000006
8076,2022-03-16 15:00:00,-1455.79,201364.94999999998,210720.84,-9355.890000000014
8077,2022-03-16 15:05:00,1802.89,203167.84,210720.84,-7553.0
8078,2022-03-16 15:10:00,-823.07,202344.77,210720.84,-8376.070000000007
8079,2022-03-16 15:15:00,-1563.03,200781.74,210720.84,-9939.100000000006
8080,2022-03-16 15:20:00,-1778.3,199003.44,210720.84,-11717.399999999994
8081,2022-03-16 15:25:00,149.85,199153.29,210720.84,-11567.549999999988
8082,2022-03-16 15:30:00,-719.8,198433.49000000002,210720.84,-12287.349999999977
8083,2022-03-16 15:35:00,-1724.47,196709.02000000002,210720.84,-14011.819999999978
8084,2022-03-16 15:40:00,-1049.14,195659.88,210720.84,-15060.959999999992
8085,2022-03-16 15:45:00,-704.5,194955.38,210720.84,-15765.459999999992
8086,2022-03-16 15:50:00,-1027.61,193927.77000000002,210720.84,-16793.069999999978
8087,2022-03-16 15:55:00,-163.39,193764.38,210720.84,-16956.459999999992
8088,2022-03-16 16:00:00,-1121.78,192642.6,210720.84,-18078.23999999999
8089,2022-03-16 16:05:00,-647.75,191994.85,210720.84,-18725.98999999999
8090,2022-03-16 16:10:00,1255.88,193250.73,210720.84,-17470.109999999986
8091,2022-03-16 16:15:00,-1112.81,192137.92,210720.84,-18582.919999999984
8092,2022-03-16 16:20:00,-682.7,191455.22,210720.84,-19265.619999999995
8093,2022-03-16 16:25:00,-1679.88,189775.34,210720.84,-20945.5
8094,2022-03-16 16:30:00,1181.99,190957.33,210720.84,-19763.51000000001
8095,2022-03-16 16:35:00,-796.48,190160.84999999998,210720.84,-20559.99000000002
8096,2022-03-16 16:40:00,1162.67,191323.52,210720.84,-19397.320000000007
8097,2022-03-16 16:45:00,106.95,191430.47,210720.84,-19290.369999999995
8098,2022-03-16 16:50:00,1422.91,192853.38,210720.84,-17867.459999999992
8099,2022-03-16 16:55:00,-788.84,192064.54,210720.84,-18656.29999999999
8100,2022-03-17 08:00:00,1826.32,193890.86000000002,192064.54,1826.320000000007
8101,2022-03-17 08:05:00,1588.84,195479.7,192064.54,3415.1600000000035
8102,2022-03-17 08:10:00,114.47,195594.17,192064.54,3529.6300000000047
8103,2022-03-17 08:15:00,-1889.11,193705.06000000003,192064.54,1640.5200000000186
8104,2022-03-17 08:20:00,-1514.92,192190.14,192064.54,125.60000000000582
8105,2022-03-17 08:25:00,-1640.3,190549.84000000003,192064.54,-1514.6999999999825
8106,2022-03-17 08:30:00,1260.2,191810.04000000004,192064.54,-254.4999999999709
8107,2022-03-17 08:35:00,1393.04,193203.08000000005,192064.54,1138.5400000000373
8108,2022-03-17 08:40:00,-440.11,192762.97000000006,192064.54,698.4300000000512
8109,2022-03-17 08:45:00,-1112.4,191650.57000000007,192064.54,-413.96999999994296
8110,2022-03-17 08:50:00,1174.27,192824.84000000005,192064.54,760.3000000000466
8111,2022-03-17 08:55:00,1623.11,194447.95000000004,192064.54,2383.4100000000326
8112,2022-03-17 09:00:00,560.94,195008.89000000004,192064.54,2944.350000000035
8113,2022-03-17 09:05:00,466.5,195475.39000000004,192064.54,3410.850000000035
8114,2022-03-17 09:10:00,1324.54,196799.93000000005,192064.54,4735.390000000043
8115,2022-03-17 09:15:00,536.23,197336.16000000006,192064.54,5271.620000000054
8116,2022-03-17 09:20:00,417.72,197753.88000000006,192064.54,5689.340000000055
8117,2022-03-17 09:25:00,1514.9,199268.78000000006,192064.54,7204.240000000049
8118,2022-03-17 09:30:00,30.18,199298.96000000005,192064.54,7234.420000000042
8119,2022-03-17 09:35:00,525.92,199824.88000000006,192064.54,7760.340000000055
8120,2022-03-17 09:40:00,9.57,199834.45000000007,192064.54,7769.910000000062
8121,2022-03-17 09:45:00,-52.94,199781.51000000007,192064.54,7716.970000000059
8122,2022-03-17 09:50:00,1872.96,201654.47000000006,192064.54,9589.930000000051
8123,2022-03-17 09:55:00,-57.48,201596.99000000005,192064.54,9532.45000000004
8124,2022-03-17 10:00:00,839.32,202436.31000000006,192064.54,10371.770000000048
8125,2022-03-17 10:05:00,1252.68,203688.99000000005,192064.54,11624.45000000004
8126,2022-03-17 10:10:00,707.02,204396.01000000004,192064.54,12331.47000000003
8127,2022-03-17 10:15:00,1648.14,206044.15000000005,192064.54,13979.610000000044
8128,2022-03-17 10:20:00,125.83,206169.98000000004,192064.54,14105.440000000031
8129,2022-03-17 10:25:00,230.7,206400.68000000005,192064.54,14336.140000000043
8130,2022-03-17 10:30:00,408.38,206809.06000000006,192064.54,14744.520000000048
8131,2022-03-17 10:35:00,1839.22,208648.28000000006,192064.54,16583.74000000005
8132,2022-03-17 10:40:00,-1144.84,207503.44000000006,192064.54,15438.900000000052
8133,2022-03-17 10:45:00,212.46,207715.90000000005,192064.54,15651.360000000044
8134,2022-03-17 10:50:00,1738.54,209454.44000000006,192064.54,17389.900000000052
8135,2022-03-17 10:55:00,-1082.79,208371.65000000005,192064.54,16307.110000000044
8136,2022-03-17 11:00:00,-427.51,207944.14000000004,192064.54,15879.600000000035
8137,2022-03-17 11:05:00,-1938.22,206005.92000000004,192064.54,13941.380000000034
8138,2022-03-17 11:10:00,-652.8,205353.12000000005,192064.54,13288.580000000045
8139,2022-03-17 11:15:00,-1329.66,204023.46000000005,192064.54,11958.920000000042
8140,2022-03-17 11:20:00,-1742.47,202280.99000000005,192064.54,10216.45000000004
8141,2022-03-17 11:25:00,-715.81,201565.18000000005,192064.54,9500.640000000043
8142,2022-03-17 11:30:00,-1575.07,199990.11000000004,192064.54,7925.570000000036
8143,2022-03-17 11:35:00,265.81,200255.92000000004,192064.54,8191.380000000034
8144,2022-03-17 11:40:00,427.68,200683.60000000003,192064.54,8619.060000000027
8145,2022-03-17 11:45:00,1223.57,201907.17000000004,192064.54,9842.630000000034
8146,2022-03-17 11:50:00,-1562.38,200344.79000000004,192064.54,8280.25000000003
8147,2022-03-17 11:55:00,309.29,200654.08000000005,192064.54,8589.540000000037
8148,2022-03-17 12:00:00,-1928.2,198725.88000000003,192064.54,6661.340000000026
8149,2022-03-17 12:05:00,-52.62,198673.26000000004,192064.54,6608.72000000003
8150,2022-03-17 12:10:00,-1250.89,197422.37000000002,192064.54,5357.830000000016
8151,2022-03-17 12:15:00,680.27,198102.64,192064.54,6038.100000000006
8152,2022-03-17 12:20:00,909.44,199012.08000000002,192064.54,6947.540000000008
8153,2022-03-17 12:25:00,-1930.08,197082.00000000003,192064.54,5017.460000000021
8154,2022-03-17 12:30:00,-1244.29,195837.71000000002,192064.54,3773.170000000013
8155,2022-03-17 12:35:00,1718.18,197555.89,192064.54,5491.350000000006
8156,2022-03-17 12:40:00,-859.13,196696.76,192064.54,4632.220000000001
8157,2022-03-17 12:45:00,456.46,197153.22,192064.54,5088.679999999993
8158,2022-03-17 12:50:00,-732.46,196420.76,192064.54,4356.220000000001
8159,2022-03-17 12:55:00,1473.3,197894.06,192064.54,5829.5199999999895
8160,2022-03-17 13:00:00,1293.57,199187.63,192064.54,7123.0899999999965
8161,2022-03-17 13:05:00,1756.94,200944.57,192064.54,8880.029999999999
8162,2022-03-17 13:10:00,-1986.65,198957.92,192064.54,6893.380000000005
8163,2022-03-17 13:15:00,1196.38,200154.30000000002,192064.54,8089.760000000009
8164,2022-03-17 13:20:00,-1338.12,198816.18000000002,192064.54,6751.640000000014
8165,2022-03-17 13:25:00,1057.74,199873.92,192064.54,7809.380000000005
8166,2022-03-17 13:30:00,961.73,200835.65000000002,192064.54,8771.110000000015
8167,2022-03-17 13:35:00,-167.21,200668.44000000003,192064.54,8603.900000000023
8168,2022-03-17 13:40:00,1955.23,202623.67000000004,192064.54,10559.130000000034
8169,2022-03-17 13:45:00,701.04,203324.71000000005,192064.54,11260.170000000042
8170,2022-03-17 13:50:00,-1920.28,201404.43000000005,192064.54,9339.890000000043
8171,2022-03-17 13:55:00,-510.56,200893.87000000005,192064.54,8829.330000000045
8172,2022-03-17 14:00:00,-303.61,200590.26000000007,192064.54,8525.72000000006
8173,2022-03-17 14:05:00,1685.43,202275.69000000006,192064.54,10211.150000000052
8174,2022-03-17 14:10:00,107.54,202383.23000000007,192064.54,10318.69000000006
8175,2022-03-17 14:15:00,-1410.2,200973.03000000006,192064.54,8908.490000000049
8176,2022-03-17 14:20:00,1478.54,202451.57000000007,192064.54,10387.030000000057
8177,2022-03-17 14:25:00,-1346.66,201104.91000000006,192064.54,9040.370000000054
8178,2022-03-17 14:30:00,-1133.71,199971.20000000007,192064.54,7906.660000000062
8179,2022-03-17 14:35:00,287.37,200258.57000000007,192064.54,8194.030000000057
8180,2022-03-17 14:40:00,24.28,200282.85000000006,192064.54,8218.310000000056
8181,2022-03-17 14:45:00,-1221.05,199061.80000000008,192064.54,6997.2600000000675
8182,2022-03-17 14:50:00,1927.47,200989.27000000008,192064.54,8924.730000000069
8183,2022-03-17 14:55:00,-698.16,200291.11000000007,192064.54,8226.570000000065
8184,2022-03-17 15:00:00,-1574.66,198716.45000000007,192064.54,6651.910000000062
8185,2022-03-17 15:05:00,1878.58,200595.03000000006,192064.54,8530.490000000049
8186,2022-03-17 15:10:00,1718.6,202313.63000000006,192064.54,10249.090000000055
8187,2022-03-17 15:15:00,138.74,202452.37000000005,192064.54,10387.830000000045
8188,2022-03-17 15:20:00,-1920.07,200532.30000000005,192064.54,8467.760000000038
8189,2022-03-17 15:25:00,-214.58,200317.72000000006,192064.54,8253.180000000051
8190,2022-03-17 15:30:00,-1650.52,198667.20000000007,192064.54,6602.660000000062
8191,2022-03-17 15:35:00,-398.42,198268.78000000006,192064.54,6204.240000000049
8192,2022-03-17 15:40:00,1039.51,199308.29000000007,192064.54,7243.750000000058
8193,2022-03-17 15:45:00,1918.84,201227.13000000006,192064.54,9162.590000000055
8194,2022-03-17 15:50:00,543.47,201770.60000000006,192064.54,9706.060000000056
8195,2022-03-17 15:55:00,757.09,202527.69000000006,192064.54,10463.150000000052
8196,2022-03-17 16:00:00,-1553.72,200973.97000000006,192064.54,8909.430000000051
8197,2022-03-17 16:05:00,-63.7,200910.27000000005,192064.54,8845.73000000004
8198,2022-03-17 16:10:00,-1749.11,199161.16000000006,192064.54,7096.620000000054
8199,2022-03-17 16:15:00,1061.89,200223.05000000008,192064.54,8158.5100000000675
8200,2022-03-17 16:20:00,745.93,200968.98000000007,192064.54,8904.44000000006
8201,2022-03-17 16:25:00,-1412.35,199556.63000000006,192064.54,7492.090000000055
8202,2022-03-17 16:30:00,-148.45,199408.18000000005,192064.54,7343.640000000043
8203,2022-03-17 16:35:00,1815.52,201223.70000000004,192064.54,9159.160000000033
8204,2022-03-17 16:40:00,791.1,202014.80000000005,192064.54,9950.260000000038
8205,2022-03-17 16:45:00,-1113.12,200901.68000000005,192064.54,8837.140000000043
8206,2022-03-17 16:50:00,-597.91,200303.77000000005,192064.54,8239.23000000004
8207,2022-03-17 16:55:00,-508.48,199795.29000000004,192064.54,7730.750000000029
8208,2022-03-18 08:00:00,45.81,199841.10000000003,199795.29000000004,45.80999999999767
8209,2022-03-18 08:05:00,-373.59,199467.51000000004,199795.29000000004,-327.77999999999884
8210,2022-03-18 08:10:00,-231.66,199235.85000000003,199795.29000000004,-559.4400000000023
8211,2022-03-18 08:15:00,-39.78,199196.07000000004,199795.29000000004,-599.2200000000012
8212,2022-03-18 08:20:00,-1653.74,197542.33000000005,199795.29000000004,-2252.959999999992
8213,2022-03-18 08:25:00,527.91,198070.24000000005,199795.29000000004,-1725.0499999999884
8214,2022-03-18 08:30:00,1526.84,199597.08000000005,199795.29000000004,-198.20999999999185
8215,2022-03-18 08:35:00,1228.25,200825.33000000005,199795.29000000004,1030.0400000000081
8216,2022-03-18 08:40:00,27.15,200852.48000000004,199795.29000000004,1057.1900000000023
8217,2022-03-18 08:45:00,1233.28,202085.76000000004,199795.29000000004,2290.470000000001
8218,2022-03-18 08:50:00,-1676.92,200408.84000000003,199795.29000000004,613.5499999999884
8219,2022-03-18 08:55:00,-1197.05,199211.79000000004,199795.29000000004,-583.5
8220,2022-03-18 09:00:00,-1250.21,197961.58000000005,199795.29000000004,-1833.7099999999919
8221,2022-03-18 09:05:00,1061.72,199023.30000000005,199795.29000000004,-771.9899999999907
8222,2022-03-18 09:10:00,555.17,199578.47000000006,199795.29000000004,-216.81999999997788
8223,2022-03-18 09:15:00,469.57,200048.04000000007,199795.29000000004,252.7500000000291
8224,2022-03-18 09:20:00,566.06,200614.10000000006,199795.29000000004,818.8100000000268
8225,2022-03-18 09:25:00,127.85,200741.95000000007,199795.29000000004,946.6600000000326
8226,2022-03-18 09:30:00,100.4,200842.35000000006,199795.29000000004,1047.0600000000268
8227,2022-03-18 09:35:00,-1515.48,199326.87000000005,199795.29000000004,-468.4199999999837
8228,2022-03-18 09:40:00,166.74,199493.61000000004,199795.29000000004,-301.679999999993
8229,2022-03-18 09:45:00,-1824.65,197668.96000000005,199795.29000000004,-2126.329999999987
8230,2022-03-18 09:50:00,719.51,198388.47000000006,199795.29000000004,-1406.8199999999779
8231,2022-03-18 09:55:00,173.97,198562.44000000006,199795.29000000004,-1232.8499999999767
8232,2022-03-18 10:00:00,-587.44,197975.00000000006,199795.29000000004,-1820.289999999979
8233,2022-03-18 10:05:00,532.42,198507.42000000007,199795.29000000004,-1287.8699999999662
8234,2022-03-18 10:10:00,-127.76,198379.66000000006,199795.29000000004,-1415.6299999999756
8235,2022-03-18 10:15:00,-481.3,197898.36000000007,199795.29000000004,-1896.929999999964
8236,2022-03-18 10:20:00,912.8,198811.16000000006,199795.29000000004,-984.1299999999756
8237,2022-03-18 10:25:00,1189.86,200001.02000000005,199795.29000000004,205.73000000001048
8238,2022-03-18 10:30:00,1951.42,201952.44000000006,199795.29000000004,2157.1500000000233
8239,2022-03-18 10:35:00,-1947.54,200004.90000000005,199795.29000000004,209.61000000001513
8240,2022-03-18 10:40:00,839.23,200844.13000000006,199795.29000000004,1048.8400000000256
8241,2022-03-18 10:45:00,1620.79,202464.92000000007,199795.29000000004,2669.6300000000338
8242,2022-03-18 10:50:00,396.36,202861.28000000006,199795.29000000004,3065.99000000002
8243,2022-03-18 10:55:00,407.37,203268.65000000005,199795.29000000004,3473.360000000015
8244,2022-03-18 11:00:00,-1395.94,201872.71000000005,199795.29000000004,2077.420000000013
8245,2022-03-18 11:05:00,-1920.29,199952.42000000004,199795.29000000004,157.13000000000466
8246,2022-03-18 11:10:00,751.95,200704.37000000005,199795.29000000004,909.0800000000163
8247,2022-03-18 11:15:00,1003.32,201707.69000000006,199795.29000000004,1912.4000000000233
8248,2022-03-18 11:20:00,1451.7,203159.39000000007,199795.29000000004,3364.100000000035
8249,2022-03-18 11:25:00,-1503.72,201655.67000000007,199795.29000000004,1860.3800000000338
8250,2022-03-18 11:30:00,-935.44,200720.23000000007,199795.29000000004,924.9400000000314
8251,2022-03-18 11:35:00,-1739.51,198980.72000000006,199795.29000000004,-814.5699999999779
8252,2022-03-18 11:40:00,-122.12,198858.60000000006,199795.29000000004,-936.6899999999732
8253,2022-03-18 11:45:00,-522.72,198335.88000000006,199795.29000000004,-1459.4099999999744
8254,2022-03-18 11:50:00,1975.16,200311.04000000007,199795.29000000004,515.7500000000291
8255,2022-03-18 11:55:00,-311.02,200000.02000000008,199795.29000000004,204.73000000003958
8256,2022-03-18 12:00:00,-1380.3,198619.7200000001,199795.29000000004,-1175.5699999999488
8257,2022-03-18 12:05:00,1310.0,199929.7200000001,199795.29000000004,134.43000000005122
8258,2022-03-18 12:10:00,1454.61,201384.33000000007,199795.29000000004,1589.0400000000373
8259,2022-03-18 12:15:00,-1449.52,199934.81000000008,199795.29000000004,139.52000000004773
8260,2022-03-18 12:20:00,149.77,200084.58000000007,199795.29000000004,289.29000000003725
8261,2022-03-18 12:25:00,-304.78,199779.80000000008,199795.29000000004,-15.489999999961583
8262,2022-03-18 12:30:00,-1416.9,198362.90000000008,199795.29000000004,-1432.3899999999558
8263,2022-03-18 12:35:00,205.98,198568.8800000001,199795.29000000004,-1226.4099999999453
8264,2022-03-18 12:40:00,-828.17,197740.71000000008,199795.29000000004,-2054.579999999958
8265,2022-03-18 12:45:00,976.95,198717.6600000001,199795.29000000004,-1077.6299999999464
8266,2022-03-18 12:50:00,-1756.8,196960.8600000001,199795.29000000004,-2834.429999999935
8267,2022-03-18 12:55:00,-192.85,196768.0100000001,199795.29000000004,-3027.2799999999406
8268,2022-03-18 13:00:00,-207.71,196560.3000000001,199795.29000000004,-3234.9899999999325
8269,2022-03-18 13:05:00,-1716.75,194843.5500000001,199795.29000000004,-4951.7399999999325
8270,2022-03-18 13:10:00,-483.44,194360.1100000001,199795.29000000004,-5435.179999999935
8271,2022-03-18 13:15:00,-460.46,193899.6500000001,199795.29000000004,-5895.639999999927
8272,2022-03-18 13:20:00,1289.96,195189.6100000001,199795.29000000004,-4605.679999999935
8273,2022-03-18 13:25:00,1949.31,197138.9200000001,199795.29000000004,-2656.369999999937
8274,2022-03-18 13:30:00,-535.6,196603.3200000001,199795.29000000004,-3191.969999999943
8275,2022-03-18 13:35:00,-557.64,196045.68000000008,199795.29000000004,-3749.609999999957
8276,2022-03-18 13:40:00,1593.92,197639.6000000001,199795.29000000004,-2155.689999999944
8277,2022-03-18 13:45:00,195.3,197834.90000000008,199795.29000000004,-1960.3899999999558
8278,2022-03-18 13:50:00,-1689.81,196145.09000000008,199795.29000000004,-3650.1999999999534
8279,2022-03-18 13:55:00,-1209.15,194935.9400000001,199795.29000000004,-4859.349999999948
8280,2022-03-18 14:00:00,-1353.9,193582.0400000001,199795.29000000004,-6213.249999999942
8281,2022-03-18 14:05:00,-1896.81,191685.2300000001,199795.29000000004,-8110.0599999999395
8282,2022-03-18 14:10:00,-1318.38,190366.8500000001,199795.29000000004,-9428.439999999944
8283,2022-03-18 14:15:00,-128.13,190238.7200000001,199795.29000000004,-9556.569999999949
8284,2022-03-18 14:20:00,-761.5,189477.2200000001,199795.29000000004,-10318.069999999949
8285,2022-03-18 14:25:00,-1485.12,187992.1000000001,199795.29000000004,-11803.189999999944
8286,2022-03-18 14:30:00,-698.23,187293.87000000008,199795.29000000004,-12501.419999999955
8287,2022-03-18 14:35:00,646.72,187940.59000000008,199795.29000000004,-11854.699999999953
8288,2022-03-18 14:40:00,1286.54,189227.1300000001,199795.29000000004,-10568.159999999945
8289,2022-03-18 14:45:00,-1855.31,187371.8200000001,199795.29000000004,-12423.469999999943
8290,2022-03-18 14:50:00,-948.98,186422.84000000008,199795.29000000004,-13372.449999999953
8291,2022-03-18 14:55:00,-524.11,185898.7300000001,199795.29000000004,-13896.55999999994
8292,2022-03-18 15:00:00,-1662.13,184236.6000000001,199795.29000000004,-15558.689999999944
8293,2022-03-18 15:05:00,1600.69,185837.2900000001,199795.29000000004,-13957.999999999942
8294,2022-03-18 15:10:00,1846.77,187684.06000000008,199795.29000000004,-12111.229999999952
8295,2022-03-18 15:15:00,-1514.37,186169.6900000001,199795.29000000004,-13625.599999999948
8296,2022-03-18 15:20:00,1901.55,188071.24000000008,199795.29000000004,-11724.04999999996
8297,2022-03-18 15:25:00,-1939.4,186131.84000000008,199795.29000000004,-13663.449999999953
8298,2022-03-18 15:30:00,-1853.77,184278.0700000001,199795.29000000004,-15517.219999999943
8299,2022-03-18 15:35:00,-1629.48,182648.59000000008,199795.29000000004,-17146.699999999953
8300,2022-03-18 15:40:00,13.08,182661.67000000007,199795.29000000004,-17133.619999999966
8301,2022-03-18 15:45:00,615.74,183277.41000000006,199795.29000000004,-16517.879999999976
8302,2022-03-18 15:50:00,-1973.24,181304.17000000007,199795.29000000004,-18491.119999999966
8303,2022-03-18 15:55:00,1153.38,182457.55000000008,199795.29000000004,-17337.73999999996
8304,2022-03-18 16:00:00,1414.79,183872.34000000008,199795.29000000004,-15922.949999999953
8305,2022-03-18 16:05:00,1046.83,184919.17000000007,199795.29000000004,-14876.119999999966
8306,2022-03-18 16:10:00,-1323.35,183595.82000000007,199795.29000000004,-16199.469999999972
8307,2022-03-18 16:15:00,1041.65,184637.47000000006,199795.29000000004,-15157.819999999978
8308,2022-03-18 16:20:00,-1180.67,183456.80000000005,199795.29000000004,-16338.48999999999
8309,2022-03-18 16:25:00,608.31,184065.11000000004,199795.29000000004,-15730.179999999993
8310,2022-03-18 16:30:00,90.51,184155.62000000005,199795.29000000004,-15639.669999999984
8311,2022-03-18 16:35:00,-1069.79,183085.83000000005,199795.29000000004,-16709.459999999992
8312,2022-03-18 16:40:00,1024.34,184110.17000000004,199795.29000000004,-15685.119999999995
8313,2022-03-18 16:45:00,-1004.19,183105.98000000004,199795.29000000004,-16689.309999999998
8314,2022-03-18 16:50:00,-463.9,182642.08000000005,199795.29000000004,-17153.209999999992
8315,2022-03-18 16:55:00,-898.94,181743.14000000004,199795.29000000004,-18052.149999999994
8316,2022-03-19 08:00:00,-238.25,181504.89000000004,181743.14000000004,-238.25
8317,2022-03-19 08:05:00,-1792.04,179712.85000000003,181743.14000000004,-2030.2900000000081
8318,2022-03-19 08:10:00,-468.95,179243.90000000002,181743.14000000004,-2499.24000000002
8319,2022-03-19 08:15:00,982.65,180226.55000000002,181743.14000000004,-1516.5900000000256
8320,2022-03-19 08:20:00,-901.13,179325.42,181743.14000000004,-2417.7200000000303
8321,2022-03-19 08:25:00,-715.17,178610.25,181743.14000000004,-3132.890000000043
8322,2022-03-19 08:30:00,-631.5,177978.75,181743.14000000004,-3764.390000000043
8323,2022-03-19 08:35:00,778.83,178757.58,181743.14000000004,-2985.560000000056
8324,2022-03-19 08:40:00,1987.05,180744.62999999998,181743.14000000004,-998.5100000000675
8325,2022-03-19 08:45:00,115.28,180859.90999999997,181743.14000000004,-883.2300000000687
8326,2022-03-19 08:50:00,14.05,180873.95999999996,181743.14000000004,-869.1800000000803
8327,2022-03-19 08:55:00,1408.9,182282.85999999996,181743.14000000004,539.7199999999139
8328,2022-03-19 09:00:00,-13.8,182269.05999999997,181743.14000000004,525.9199999999255
8329,2022-03-19 09:05:00,-476.46,181792.59999999998,181743.14000000004,49.45999999993364
8330,2022-03-19 09:10:00,-318.28,181474.31999999998,181743.14000000004,-268.8200000000652
8331,2022-03-19 09:15:00,1381.19,182855.50999999998,181743.14000000004,1112.3699999999371
8332,2022-03-19 09:20:00,-955.31,181900.19999999998,181743.14000000004,157.05999999993946
8333,2022-03-19 09:25:00,-821.47,181078.72999999998,181743.14000000004,-664.4100000000617
8334,2022-03-19 09:30:00,553.31,181632.03999999998,181743.14000000004,-111.10000000006403
8335,2022-03-19 09:35:00,196.71,181828.74999999997,181743.14000000004,85.60999999992782
8336,2022-03-19 09:40:00,161.27,181990.01999999996,181743.14000000004,246.87999999991735
8337,2022-03-19 09:45:00,506.92,182496.93999999997,181743.14000000004,753.7999999999302
8338,2022-03-19 09:50:00,-1370.81,181126.12999999998,181743.14000000004,-617.0100000000675
8339,2022-03-19 09:55:00,427.71,181553.83999999997,181743.14000000004,-189.30000000007567
8340,2022-03-19 10:00:00,1708.68,183262.51999999996,181743.14000000004,1519.3799999999173
8341,2022-03-19 10:05:00,-1177.07,182085.44999999995,181743.14000000004,342.30999999991036
8342,2022-03-19 10:10:00,-1723.34,180362.10999999996,181743.14000000004,-1381.0300000000861
8343,2022-03-19 10:15:00,-1683.98,178678.12999999995,181743.14000000004,-3065.0100000000966
8344,2022-03-19 10:20:00,1853.32,180531.44999999995,181743.14000000004,-1211.6900000000896
8345,2022-03-19 10:25:00,1351.88,181883.32999999996,181743.14000000004,140.18999999991502
8346,2022-03-19 10:30:00,767.56,182650.88999999996,181743.14000000004,907.7499999999127
8347,2022-03-19 10:35:00,-1749.52,180901.36999999997,181743.14000000004,-841.7700000000768
8348,2022-03-19 10:40:00,-1096.57,179804.79999999996,181743.14000000004,-1938.3400000000838
8349,2022-03-19 10:45:00,1247.46,181052.25999999995,181743.14000000004,-690.880000000092
8350,2022-03-19 10:50:00,-1356.97,179695.28999999995,181743.14000000004,-2047.8500000000931
8351,2022-03-19 10:55:00,894.47,180589.75999999995,181743.14000000004,-1153.380000000092
8352,2022-03-19 11:00:00,-677.02,179912.73999999996,181743.14000000004,-1830.4000000000815
8353,2022-03-19 11:05:00,851.66,180764.39999999997,181743.14000000004,-978.740000000078
8354,2022-03-19 11:10:00,1619.32,182383.71999999997,181743.14000000004,640.579999999929
8355,2022-03-19 11:15:00,1380.1,183763.81999999998,181743.14000000004,2020.6799999999348
8356,2022-03-19 11:20:00,1452.78,185216.59999999998,181743.14000000004,3473.4599999999336
8357,2022-03-19 11:25:00,-1804.66,183411.93999999997,181743.14000000004,1668.7999999999302
8358,2022-03-19 11:30:00,-1410.25,182001.68999999997,181743.14000000004,258.54999999993015
8359,2022-03-19 11:35:00,-830.01,181171.67999999996,181743.14000000004,-571.4600000000792
8360,2022-03-19 11:40:00,-320.33,180851.34999999998,181743.14000000004,-891.7900000000664
8361,2022-03-19 11:45:00,337.04,181188.38999999998,181743.14000000004,-554.7500000000582
8362,2022-03-19 11:50:00,1650.12,182838.50999999998,181743.14000000004,1095.3699999999371
8363,2022-03-19 11:55:00,1350.11,184188.61999999997,181743.14000000004,2445.479999999923
8364,2022-03-19 12:00:00,-1273.13,182915.48999999996,181743.14000000004,1172.3499999999185
8365,2022-03-19 12:05:00,-1800.62,181114.86999999997,181743.14000000004,-628.2700000000768
8366,2022-03-19 12:10:00,-833.78,180281.08999999997,181743.14000000004,-1462.0500000000757
8367,2022-03-19 12:15:00,-823.52,179457.56999999998,181743.14000000004,-2285.570000000065
8368,2022-03-19 12:20:00,1035.39,180492.96,181743.14000000004,-1250.1800000000512
8369,2022-03-19 12:25:00,1700.85,182193.81,181743.14000000004,450.6699999999546
8370,2022-03-19 12:30:00,727.63,182921.44,181743.14000000004,1178.2999999999593
8371,2022-03-19 12:35:00,1155.63,184077.07,181743.14000000004,2333.929999999964
8372,2022-03-19 12:40:00,687.62,184764.69,181743.14000000004,3021.5499999999593
8373,2022-03-19 12:45:00,-1082.61,183682.08000000002,181743.14000000004,1938.9399999999732
8374,2022-03-19 12:50:00,-800.69,182881.39,181743.14000000004,1138.249999999971
8375,2022-03-19 12:55:00,361.17,183242.56000000003,181743.14000000004,1499.4199999999837
8376,2022-03-19 13:00:00,-1708.47,181534.09000000003,181743.14000000004,-209.05000000001746
8377,2022-03-19 13:05:00,117.42,181651.51000000004,181743.14000000004,-91.63000000000466
8378,2022-03-19 13:10:00,-301.42,181350.09000000003,181743.14000000004,-393.05000000001746
8379,2022-03-19 13:15:00,-792.96,180557.13000000003,181743.14000000004,-1186.0100000000093
8380,2022-03-19 13:20:00,-886.9,179670.23000000004,181743.14000000004,-2072.9100000000035
8381,2022-03-19 13:25:00,494.14,180164.37000000005,181743.14000000004,-1578.7699999999895
8382,2022-03-19 13:30:00,284.25,180448.62000000005,181743.14000000004,-1294.5199999999895
8383,2022-03-19 13:35:00,-780.54,179668.08000000005,181743.14000000004,-2075.0599999999977
8384,2022-03-19 13:40:00,-812.65,178855.43000000005,181743.14000000004,-2887.709999999992
8385,2022-03-19 13:45:00,1509.35,180364.78000000006,181743.14000000004,-1378.359999999986
8386,2022-03-19 13:50:00,-1816.01,178548.77000000005,181743.14000000004,-3194.3699999999953
8387,2022-03-19 13:55:00,107.32,178656.09000000005,181743.14000000004,-3087.0499999999884
8388,2022-03-19 14:00:00,1159.31,179815.40000000005,181743.14000000004,-1927.7399999999907
8389,2022-03-19 14:05:00,1360.04,181175.44000000006,181743.14000000004,-567.6999999999825
8390,2022-03-19 14:10:00,438.72,181614.16000000006,181743.14000000004,-128.97999999998137
8391,2022-03-19 14:15:00,-420.1,181194.06000000006,181743.14000000004,-549.0799999999872
8392,2022-03-19 14:20:00,-1303.57,179890.49000000005,181743.14000000004,-1852.6499999999942
8393,2022-03-19 14:25:00,1396.34,181286.83000000005,181743.14000000004,-456.3099999999977
8394,2022-03-19 14:30:00,1717.85,183004.68000000005,181743.14000000004,1261.5400000000081
8395,2022-03-19 14:35:00,90.14,183094.82000000007,181743.14000000004,1351.6800000000221
8396,2022-03-19 14:40:00,1512.98,184607.80000000008,181743.14000000004,2864.6600000000326
8397,2022-03-19 14:45:00,-1559.67,183048.13000000006,181743.14000000004,1304.9900000000198
8398,2022-03-19 14:50:00,-1412.69,181635.44000000006,181743.14000000004,-107.69999999998254
8399,2022-03-19 14:55:00,-1465.63,180169.81000000006,181743.14000000004,-1573.3299999999872
8400,2022-03-19 15:00:00,-1304.08,178865.73000000007,181743.14000000004,-2877.4099999999744
8401,2022-03-19 15:05:00,-897.96,177967.77000000008,181743.14000000004,-3775.3699999999662
8402,2022-03-19 15:10:00,-258.76,177709.01000000007,181743.14000000004,-4034.1299999999756
8403,2022-03-19 15:15:00,934.14,178643.15000000008,181743.14000000004,-3099.9899999999616
8404,2022-03-19 15:20:00,-1351.05,177292.1000000001,181743.14000000004,-4451.03999999995
8405,2022-03-19 15:25:00,1426.28,178718.3800000001,181743.14000000004,-3024.759999999951
8406,2022-03-19 15:30:00,56.57,178774.9500000001,181743.14000000004,-2968.189999999944
8407,2022-03-19 15:35:00,320.73,179095.6800000001,181743.14000000004,-2647.4599999999336
8408,2022-03-19 15:40:00,-658.76,178436.9200000001,181743.14000000004,-3306.219999999943
8409,2022-03-19 15:45:00,-109.57,178327.3500000001,181743.14000000004,-3415.78999999995
8410,2022-03-19 15:50:00,-1273.34,177054.0100000001,181743.14000000004,-4689.129999999946
8411,2022-03-19 15:55:00,-1194.2,175859.81000000008,181743.14000000004,-5883.329999999958
8412,2022-03-19 16:00:00,699.91,176559.7200000001,181743.14000000004,-5183.419999999955
8413,2022-03-19 16:05:00,-210.74,176348.9800000001,181743.14000000004,-5394.159999999945
8414,2022-03-19 16:10:00,1077.54,177426.5200000001,181743.14000000004,-4316.619999999937
8415,2022-03-19 16:15:00,162.71,177589.2300000001,181743.14000000004,-4153.909999999945
8416,2022-03-19 16:20:00,1123.21,178712.4400000001,181743.14000000004,-3030.6999999999534
8417,2022-03-19 16:25:00,1441.59,180154.0300000001,181743.14000000004,-1589.109999999957
8418,2022-03-19 16:30:00,-1571.77,178582.2600000001,181743.14000000004,-3160.8799999999464
8419,2022-03-19 16:35:00,-839.55,177742.7100000001,181743.14000000004,-4000.429999999935
8420,2022-03-19 16:40:00,-1010.72,176731.9900000001,181743.14000000004,-5011.149999999936
8421,2022-03-19 16:45:00,1994.22,178726.2100000001,181743.14000000004,-3016.929999999935
8422,2022-03-19 16:50:00,56.24,178782.4500000001,181743.14000000004,-2960.689999999944
8423,2022-03-19 16:55:00,1230.75,180013.2000000001,181743.14000000004,-1729.9399999999441
8424,2022-03-20 08:00:00,-1495.98,178517.2200000001,180013.2000000001,-1495.9800000000105
8425,2022-03-20 08:05:00,-1166.68,177350.5400000001,180013.2000000001,-2662.6600000000035
8426,2022-03-20 08:10:00,272.45,177622.9900000001,180013.2000000001,-2390.209999999992
8427,2022-03-20 08:15:00,673.63,178296.6200000001,180013.2000000001,-1716.5799999999872
8428,2022-03-20 08:20:00,255.52,178552.1400000001,180013.2000000001,-1461.0599999999977
8429,2022-03-20 08:25:00,1270.73,179822.8700000001,180013.2000000001,-190.3299999999872
8430,2022-03-20 08:30:00,-582.03,179240.8400000001,180013.2000000001,-772.359999999986
8431,2022-03-20 08:35:00,-275.39,178965.4500000001,180013.2000000001,-1047.75
8432,2022-03-20 08:40:00,1573.7,180539.1500000001,180013.2000000001,525.9500000000116
8433,2022-03-20 08:45:00,-1878.28,178660.8700000001,180013.2000000001,-1352.3299999999872
8434,2022-03-20 08:50:00,-1437.35,177223.5200000001,180013.2000000001,-2789.679999999993
8435,2022-03-20 08:55:00,-635.5,176588.0200000001,180013.2000000001,-3425.179999999993
8436,2022-03-20 09:00:00,637.71,177225.7300000001,180013.2000000001,-2787.470000000001
8437,2022-03-20 09:05:00,1026.6,178252.3300000001,180013.2000000001,-1760.8699999999953
8438,2022-03-20 09:10:00,-1079.88,177172.4500000001,180013.2000000001,-2840.75
8439,2022-03-20 09:15:00,-1007.66,176164.7900000001,180013.2000000001,-3848.4100000000035
8440,2022-03-20 09:20:00,-317.69,175847.1000000001,180013.2000000001,-4166.100000000006
8441,2022-03-20 09:25:00,-925.61,174921.4900000001,180013.2000000001,-5091.709999999992
8442,2022-03-20 09:30:00,1037.74,175959.2300000001,180013.2000000001,-4053.970000000001
8443,2022-03-20 09:35:00,-945.86,175013.3700000001,180013.2000000001,-4999.829999999987
8444,2022-03-20 09:40:00,-1239.43,173773.94000000012,180013.2000000001,-6239.25999999998
8445,2022-03-20 09:45:00,388.49,174162.4300000001,180013.2000000001,-5850.7699999999895
8446,2022-03-20 09:50:00,-1126.3,173036.13000000012,180013.2000000001,-6977.069999999978
8447,2022-03-20 09:55:00,-1267.52,171768.61000000013,180013.2000000001,-8244.589999999967
8448,2022-03-20 10:00:00,-1629.12,170139.49000000014,180013.2000000001,-9873.709999999963
8449,2022-03-20 10:05:00,1090.09,171229.58000000013,180013.2000000001,-8783.619999999966
8450,2022-03-20 10:10:00,-171.16,171058.42000000013,180013.2000000001,-8954.77999999997
8451,2022-03-20 10:15:00,-1416.29,169642.13000000012,180013.2000000001,-10371.069999999978
8452,2022-03-20 10:20:00,-1595.28,168046.85000000012,180013.2000000001,-11966.349999999977
8453,2022-03-20 10:25:00,-1351.07,166695.78000000012,180013.2000000001,-13317.419999999984
8454,2022-03-20 10:30:00,-696.42,165999.3600000001,180013.2000000001,-14013.839999999997
8455,2022-03-20 10:35:00,13.71,166013.0700000001,180013.2000000001,-14000.130000000005
8456,2022-03-20 10:40:00,1805.89,167818.9600000001,180013.2000000001,-12194.23999999999
8457,2022-03-20 10:45:00,-714.3,167104.66000000012,180013.2000000001,-12908.539999999979
8458,2022-03-20 10:50:00,1950.48,169055.14000000013,180013.2000000001,-10958.059999999969
8459,2022-03-20 10:55:00,538.04,169593.18000000014,180013.2000000001,-10420.01999999996
8460,2022-03-20 11:00:00,-555.28,169037.90000000014,180013.2000000001,-10975.29999999996
8461,2022-03-20 11:05:00,364.84,169402.74000000014,180013.2000000001,-10610.459999999963
8462,2022-03-20 11:10:00,588.05,169990.79000000012,180013.2000000001,-10022.409999999974
8463,2022-03-20 11:15:00,-251.01,169739.78000000012,180013.2000000001,-10273.419999999984
8464,2022-03-20 11:20:00,-199.61,169540.17000000013,180013.2000000001,-10473.02999999997
8465,2022-03-20 11:25:00,707.33,170247.50000000012,180013.2000000001,-9765.699999999983
8466,2022-03-20 11:30:00,-704.59,169542.91000000012,180013.2000000001,-10470.289999999979
8467,2022-03-20 11:35:00,1859.76,171402.67000000013,180013.2000000001,-8610.52999999997
8468,2022-03-20 11:40:00,-1560.73,169841.94000000012,180013.2000000001,-10171.25999999998
8469,2022-03-20 11:45:00,308.9,170150.8400000001,180013.2000000001,-9862.359999999986
8470,2022-03-20 11:50:00,1182.18,171333.0200000001,180013.2000000001,-8680.179999999993
8471,2022-03-20 11:55:00,-1026.18,170306.8400000001,180013.2000000001,-9706.359999999986
8472,2022-03-20 12:00:00,-580.47,169726.3700000001,180013.2000000001,-10286.829999999987
8473,2022-03-20 12:05:00,-1271.53,168454.8400000001,180013.2000000001,-11558.359999999986
8474,2022-03-20 12:10:00,1694.55,170149.3900000001,180013.2000000001,-9863.809999999998
8475,2022-03-20 12:15:00,1259.22,171408.6100000001,180013.2000000001,-8604.589999999997
8476,2022-03-20 12:20:00,-538.43,170870.1800000001,180013.2000000001,-9143.01999999999
8477,2022-03-20 12:25:00,310.59,171180.7700000001,180013.2000000001,-8832.429999999993
8478,2022-03-20 12:30:00,-1151.34,170029.4300000001,180013.2000000001,-9983.76999999999
8479,2022-03-20 12:35:00,1522.03,171551.4600000001,180013.2000000001,-8461.73999999999
8480,2022-03-20 12:40:00,1238.88,172790.3400000001,180013.2000000001,-7222.859999999986
8481,2022-03-20 12:45:00,276.8,173067.1400000001,180013.2000000001,-6946.059999999998
8482,2022-03-20 12:50:00,654.64,173721.78000000012,180013.2000000001,-6291.419999999984
8483,2022-03-20 12:55:00,-1436.8,172284.98000000013,180013.2000000001,-7728.219999999972
8484,2022-03-20 13:00:00,-1406.46,170878.52000000014,180013.2000000001,-9134.679999999964
8485,2022-03-20 13:05:00,1522.41,172400.93000000014,180013.2000000001,-7612.26999999996
8486,2022-03-20 13:10:00,-1009.62,171391.31000000014,180013.2000000001,-8621.889999999956
8487,2022-03-20 13:15:00,-933.39,170457.92000000013,180013.2000000001,-9555.27999999997
8488,2022-03-20 13:20:00,-754.32,169703.60000000012,180013.2000000001,-10309.599999999977
8489,2022-03-20 13:25:00,435.0,170138.60000000012,180013.2000000001,-9874.599999999977
8490,2022-03-20 13:30:00,1087.33,171225.9300000001,180013.2000000001,-8787.26999999999
8491,2022-03-20 13:35:00,1770.65,172996.5800000001,180013.2000000001,-7016.619999999995
8492,2022-03-20 13:40:00,1707.63,174704.2100000001,180013.2000000001,-5308.989999999991
8493,2022-03-20 13:45:00,482.19,175186.4000000001,180013.2000000001,-4826.799999999988
8494,2022-03-20 13:50:00,1944.34,177130.7400000001,180013.2000000001,-2882.459999999992
8495,2022-03-20 13:55:00,-645.08,176485.66000000012,180013.2000000001,-3527.539999999979
8496,2022-03-20 14:00:00,651.2,177136.86000000013,180013.2000000001,-2876.3399999999674
8497,2022-03-20 14:05:00,73.97,177210.83000000013,180013.2000000001,-2802.3699999999662
8498,2022-03-20 14:10:00,106.63,177317.46000000014,180013.2000000001,-2695.7399999999616
8499,2022-03-20 14:15:00,290.81,177608.27000000014,180013.2000000001,-2404.929999999964
8500,2022-03-20 14:20:00,-360.87,177247.40000000014,180013.2000000001,-2765.7999999999593
8501,2022-03-20 14:25:00,-1694.47,175552.93000000014,180013.2000000001,-4460.26999999996
8502,2022-03-20 14:30:00,778.08,176331.01000000013,180013.2000000001,-3682.189999999973
8503,2022-03-20 14:35:00,-1494.75,174836.26000000013,180013.2000000001,-5176.939999999973
8504,2022-03-20 14:40:00,-258.96,174577.30000000013,180013.2000000001,-5435.899999999965
8505,2022-03-20 14:45:00,1162.33,175739.63000000012,180013.2000000001,-4273.569999999978
8506,2022-03-20 14:50:00,-693.21,175046.42000000013,180013.2000000001,-4966.77999999997
8507,2022-03-20 14:55:00,-261.57,174784.85000000012,180013.2000000001,-5228.349999999977
8508,2022-03-20 15:00:00,647.79,175432.64000000013,180013.2000000001,-4580.559999999969
8509,2022-03-20 15:05:00,-291.18,175141.46000000014,180013.2000000001,-4871.739999999962
8510,2022-03-20 15:10:00,-692.84,174448.62000000014,180013.2000000001,-5564.579999999958
8511,2022-03-20 15:15:00,65.29,174513.91000000015,180013.2000000001,-5499.28999999995
8512,2022-03-20 15:20:00,1538.04,176051.95000000016,180013.2000000001,-3961.249999999942
8513,2022-03-20 15:25:00,-1378.6,174673.35000000015,180013.2000000001,-5339.849999999948
8514,2022-03-20 15:30:00,885.41,175558.76000000015,180013.2000000001,-4454.439999999944
8515,2022-03-20 15:35:00,-470.44,175088.32000000015,180013.2000000001,-4924.879999999946
8516,2022-03-20 15:40:00,1168.33,176256.65000000014,180013.2000000001,-3756.5499999999593
8517,2022-03-20 15:45:00,1176.12,177432.77000000014,180013.2000000001,-2580.429999999964
8518,2022-03-20 15:50:00,1130.49,178563.26000000013,180013.2000000001,-1449.9399999999732
8519,2022-03-20 15:55:00,134.0,178697.26000000013,180013.2000000001,-1315.9399999999732
8520,2022-03-20 16:00:00,-560.59,178136.67000000013,180013.2000000001,-1876.5299999999697
8521,2022-03-20 16:05:00,-1980.61,176156.06000000014,180013.2000000001,-3857.1399999999558
8522,2022-03-20 16:10:00,-1442.33,174713.73000000016,180013.2000000001,-5299.469999999943
8523,2022-03-20 16:15:00,606.99,175320.72000000015,180013.2000000001,-4692.479999999952
8524,2022-03-20 16:20:00,-197.22,175123.50000000015,180013.2000000001,-4889.699999999953
8525,2022-03-20 16:25:00,-1106.12,174017.38000000015,180013.2000000001,-5995.819999999949
8526,2022-03-20 16:30:00,-965.84,173051.54000000015,180013.2000000001,-6961.659999999945
8527,2022-03-20 16:35:00,1537.93,174589.47000000015,180013.2000000001,-5423.729999999952
8528,2022-03-20 16:40:00,-231.14,174358.33000000013,180013.2000000001,-5654.869999999966
8529,2022-03-20 16:45:00,191.58,174549.91000000012,180013.2000000001,-5463.289999999979
8530,2022-03-20 16:50:00,1539.13,176089.04000000012,180013.2000000001,-3924.1599999999744
8531,2022-03-20 16:55:00,412.93,176501.97000000012,180013.2000000001,-3511.2299999999814
8532,2022-03-21 08:00:00,-1760.32,174741.6500000001,176501.97000000012,-1760.320000000007
8533,2022-03-21 08:05:00,-4.35,174737.3000000001,176501.97000000012,-1764.6700000000128
8534,2022-03-21 08:10:00,1840.97,176578.2700000001,176501.97000000012,76.29999999998836
8535,2022-03-21 08:15:00,1778.12,178356.3900000001,176501.97000000012,1854.4199999999837
8536,2022-03-21 08:20:00,986.04,179342.4300000001,176501.97000000012,2840.459999999992
8537,2022-03-21 08:25:00,1783.8,181126.2300000001,176501.97000000012,4624.25999999998
8538,2022-03-21 08:30:00,-1326.18,179800.0500000001,176501.97000000012,3298.079999999987
8539,2022-03-21 08:35:00,-1678.02,178122.03000000012,176501.97000000012,1620.0599999999977
8540,2022-03-21 08:40:00,1754.01,179876.04000000012,176501.97000000012,3374.070000000007
8541,2022-03-21 08:45:00,691.86,180567.9000000001,176501.97000000012,4065.929999999993
8542,2022-03-21 08:50:00,-1146.48,179421.4200000001,176501.97000000012,2919.4499999999825
8543,2022-03-21 08:55:00,803.13,180224.5500000001,176501.97000000012,3722.579999999987
8544,2022-03-21 09:00:00,1452.4,181676.9500000001,176501.97000000012,5174.979999999981
8545,2022-03-21 09:05:00,-803.32,180873.6300000001,176501.97000000012,4371.659999999974
8546,2022-03-21 09:10:00,-443.8,180429.8300000001,176501.97000000012,3927.859999999986
8547,2022-03-21 09:15:00,-1945.05,178484.78000000012,176501.97000000012,1982.8099999999977
8548,2022-03-21 09:20:00,-1029.72,177455.0600000001,176501.97000000012,953.0899999999965
8549,2022-03-21 09:25:00,615.85,178070.91000000012,176501.97000000012,1568.9400000000023
8550,2022-03-21 09:30:00,178.35,178249.26000000013,176501.97000000012,1747.2900000000081
8551,2022-03-21 09:35:00,1437.6,179686.86000000013,176501.97000000012,3184.890000000014
8552,2022-03-21 09:40:00,788.86,180475.72000000012,176501.97000000012,3973.75
8553,2022-03-21 09:45:00,-1263.73,179211.9900000001,176501.97000000012,2710.0199999999895
8554,2022-03-21 09:50:00,-464.83,178747.16000000012,176501.97000000012,2245.1900000000023
8555,2022-03-21 09:55:00,-1843.08,176904.08000000013,176501.97000000012,402.11000000001513
8556,2022-03-21 10:00:00,-681.9,176222.18000000014,176501.97000000012,-279.78999999997905
8557,2022-03-21 10:05:00,-165.83,176056.35000000015,176501.97000000012,-445.61999999996624
8558,2022-03-21 10:10:00,1607.66,177664.01000000015,176501.97000000012,1162.0400000000373
8559,2022-03-21 10:15:00,1531.71,179195.72000000015,176501.97000000012,2693.750000000029
8560,2022-03-21 10:20:00,-823.2,178372.52000000014,176501.97000000012,1870.5500000000175
8561,2022-03-21 10:25:00,808.64,179181.16000000015,176501.97000000012,2679.1900000000314
8562,2022-03-21 10:30:00,624.02,179805.18000000014,176501.97000000012,3303.210000000021
8563,2022-03-21 10:35:00,-764.99,179040.19000000015,176501.97000000012,2538.2200000000303
8564,2022-03-21 10:40:00,-1095.08,177945.11000000016,176501.97000000012,1443.140000000043
8565,2022-03-21 10:45:00,-1594.96,176350.15000000017,176501.97000000012,-151.81999999994878
8566,2022-03-21 10:50:00,1554.63,177904.78000000017,176501.97000000012,1402.8100000000559
8567,2022-03-21 10:55:00,-623.26,177281.52000000016,176501.97000000012,779.5500000000466
8568,2022-03-21 11:00:00,874.68,178156.20000000016,176501.97000000012,1654.2300000000396
8569,2022-03-21 11:05:00,12.15,178168.35000000015,176501.97000000012,1666.3800000000338
8570,2022-03-21 11:10:00,-600.26,177568.09000000014,176501.97000000012,1066.1200000000244
8571,2022-03-21 11:15:00,709.92,178278.01000000015,176501.97000000012,1776.0400000000373
8572,2022-03-21 11:20:00,-1043.9,177234.11000000016,176501.97000000012,732.1400000000431
8573,2022-03-21 11:25:00,-327.46,176906.65000000017,176501.97000000012,404.6800000000512
8574,2022-03-21 11:30:00,263.43,177170.08000000016,176501.97000000012,668.1100000000442
8575,2022-03-21 11:35:00,89.59,177259.67000000016,176501.97000000012,757.7000000000407
8576,2022-03-21 11:40:00,1995.84,179255.51000000015,176501.97000000012,2753.5400000000373
8577,2022-03-21 11:45:00,-24.9,179230.61000000016,176501.97000000012,2728.640000000043
8578,2022-03-21 11:50:00,401.26,179631.87000000017,176501.97000000012,3129.9000000000524
8579,2022-03-21 11:55:00,775.46,180407.33000000016,176501.97000000012,3905.3600000000442
8580,2022-03-21 12:00:00,-1292.77,179114.56000000017,176501.97000000012,2612.5900000000547
8581,2022-03-21 12:05:00,-947.93,178166.63000000018,176501.97000000012,1664.6600000000617
8582,2022-03-21 12:10:00,500.22,178666.85000000018,176501.97000000012,2164.880000000063
8583,2022-03-21 12:15:00,-379.12,178287.73000000019,176501.97000000012,1785.7600000000675
8584,2022-03-21 12:20:00,1602.99,179890.72000000018,176501.97000000012,3388.750000000058
8585,2022-03-21 12:25:00,1027.02,180917.74000000017,176501.97000000012,4415.770000000048
8586,2022-03-21 12:30:00,-644.16,180273.58000000016,176501.97000000012,3771.6100000000442
8587,2022-03-21 12:35:00,1271.11,181544.69000000015,176501.97000000012,5042.72000000003
8588,2022-03-21 12:40:00,-1799.53,179745.16000000015,176501.97000000012,3243.1900000000314
8589,2022-03-21 12:45:00,-1233.42,178511.74000000014,176501.97000000012,2009.7700000000186
8590,2022-03-21 12:50:00,1877.49,180389.23000000013,176501.97000000012,3887.2600000000093
8591,2022-03-21 12:55:00,-683.45,179705.78000000012,176501.97000000012,3203.8099999999977
8592,2022-03-21 13:00:00,-622.24,179083.54000000012,176501.97000000012,2581.570000000007
8593,2022-03-21 13:05:00,-1400.41,177683.13000000012,176501.97000000012,1181.1600000000035
8594,2022-03-21 13:10:00,-1200.26,176482.8700000001,176501.97000000012,-19.10000000000582
8595,2022-03-21 13:15:00,-105.72,176377.1500000001,176501.97000000012,-124.82000000000698
8596,2022-03-21 13:20:00,79.28,176456.4300000001,176501.97000000012,-45.54000000000815
8597,2022-03-21 13:25:00,1417.34,177873.7700000001,176501.97000000012,1371.7999999999884
8598,2022-03-21 13:30:00,184.47,178058.2400000001,176501.97000000012,1556.2699999999895
8599,2022-03-21 13:35:00,-801.09,177257.1500000001,176501.97000000012,755.179999999993
8600,2022-03-21 13:40:00,-170.06,177087.0900000001,176501.97000000012,585.1199999999953
8601,2022-03-21 13:45:00,683.62,177770.7100000001,176501.97000000012,1268.7399999999907
8602,2022-03-21 13:50:00,-1296.14,176474.5700000001,176501.97000000012,-27.400000000023283
8603,2022-03-21 13:55:00,541.14,177015.7100000001,176501.97000000012,513.7399999999907
8604,2022-03-21 14:00:00,-1251.26,175764.4500000001,176501.97000000012,-737.5200000000186
8605,2022-03-21 14:05:00,1267.08,177031.5300000001,176501.97000000012,529.5599999999686
8606,2022-03-21 14:10:00,870.62,177902.15000000008,176501.97000000012,1400.179999999964
8607,2022-03-21 14:15:00,1050.13,178952.2800000001,176501.97000000012,2450.3099999999686
8608,2022-03-21 14:20:00,62.49,179014.77000000008,176501.97000000012,2512.7999999999593
8609,2022-03-21 14:25:00,437.41,179452.18000000008,176501.97000000012,2950.2099999999627
8610,2022-03-21 14:30:00,-1819.76,177632.42000000007,176501.97000000012,1130.4499999999534
8611,2022-03-21 14:35:00,1464.52,179096.94000000006,176501.97000000012,2594.969999999943
8612,2022-03-21 14:40:00,10.44,179107.38000000006,176501.97000000012,2605.4099999999453
8613,2022-03-21 14:45:00,-1974.88,177132.50000000006,176501.97000000012,630.5299999999406
8614,2022-03-21 14:50:00,-475.26,176657.24000000005,176501.97000000012,155.26999999993131
8615,2022-03-21 14:55:00,1358.48,178015.72000000006,176501.97000000012,1513.7499999999418
8616,2022-03-21 15:00:00,-1330.75,176684.97000000006,176501.97000000012,182.9999999999418
8617,2022-03-21 15:05:00,-60.77,176624.20000000007,176501.97000000012,122.22999999995227
8618,2022-03-21 15:10:00,1820.02,178444.22000000006,176501.97000000012,1942.2499999999418
8619,2022-03-21 15:15:00,1515.07,179959.29000000007,176501.97000000012,3457.319999999949
8620,2022-03-21 15:20:00,-22.74,179936.55000000008,176501.97000000012,3434.579999999958
8621,2022-03-21 15:25:00,790.75,180727.30000000008,176501.97000000012,4225.329999999958
8622,2022-03-21 15:30:00,-1581.16,179146.14000000007,176501.97000000012,2644.1699999999546
8623,2022-03-21 15:35:00,-670.26,178475.88000000006,176501.97000000012,1973.9099999999453
8624,2022-03-21 15:40:00,-1822.9,176652.98000000007,176501.97000000012,151.0099999999511
8625,2022-03-21 15:45:00,-413.33,176239.65000000008,176501.97000000012,-262.3200000000361
8626,2022-03-21 15:50:00,-533.19,175706.46000000008,176501.97000000012,-795.5100000000384
8627,2022-03-21 15:55:00,680.69,176387.15000000008,176501.97000000012,-114.82000000003609
8628,2022-03-21 16:00:00,-1381.87,175005.2800000001,176501.97000000012,-1496.6900000000314
8629,2022-03-21 16:05:00,-289.97,174715.31000000008,176501.97000000012,-1786.6600000000326
8630,2022-03-21 16:10:00,-1493.02,173222.2900000001,176501.97000000012,-3279.680000000022
8631,2022-03-21 16:15:00,-1898.74,171323.5500000001,176501.97000000012,-5178.420000000013
8632,2022-03-21 16:20:00,-452.36,170871.19000000012,176501.97000000012,-5630.779999999999
8633,2022-03-21 16:25:00,-1620.94,169250.25000000012,176501.97000000012,-7251.720000000001
8634,2022-03-21 16:30:00,-1861.03,167389.22000000012,176501.97000000012,-9112.75
8635,2022-03-21 16:35:00,-751.25,166637.97000000012,176501.97000000012,-9864.0
8636,2022-03-21 16:40:00,58.32,166696.29000000012,176501.97000000012,-9805.679999999993
8637,2022-03-21 16:45:00,-782.75,165913.54000000012,176501.97000000012,-10588.429999999993
8638,2022-03-21 16:50:00,-432.0,165481.54000000012,176501.97000000012,-11020.429999999993
8639,2022-03-21 16:55:00,1428.14,166909.68000000014,176501.97000000012,-9592.289999999979
8640,2022-03-22 08:00:00,1500.52,168410.20000000013,166909.68000000014,1500.5199999999895
8641,2022-03-22 08:05:00,444.12,168854.32000000012,166909.68000000014,1944.6399999999849
8642,2022-03-22 08:10:00,1542.99,170397.3100000001,166909.68000000014,3487.6299999999756
8643,2022-03-22 08:15:00,118.39,170515.70000000013,166909.68000000014,3606.0199999999895
8644,2022-03-22 08:20:00,952.72,171468.42000000013,166909.68000000014,4558.739999999991
8645,2022-03-22 08:25:00,1681.62,173150.04000000012,166909.68000000014,6240.359999999986
8646,2022-03-22 08:30:00,872.05,174022.0900000001,166909.68000000014,7112.409999999974
8647,2022-03-22 08:35:00,1893.97,175916.0600000001,166909.68000000014,9006.379999999976
8648,2022-03-22 08:40:00,814.65,176730.7100000001,166909.68000000014,9821.02999999997
8649,2022-03-22 08:45:00,92.32,176823.03000000012,166909.68000000014,9913.349999999977
8650,2022-03-22 08:50:00,821.19,177644.22000000012,166909.68000000014,10734.539999999979
8651,2022-03-22 08:55:00,-552.92,177091.3000000001,166909.68000000014,10181.619999999966
8652,2022-03-22 09:00:00,1839.24,178930.5400000001,166909.68000000014,12020.859999999957
8653,2022-03-22 09:05:00,-489.52,178441.0200000001,166909.68000000014,11531.339999999967
8654,2022-03-22 09:10:00,1262.55,179703.5700000001,166909.68000000014,12793.889999999956
8655,2022-03-22 09:15:00,-1780.07,177923.5000000001,166909.68000000014,11013.819999999949
8656,2022-03-22 09:20:00,-1353.63,176569.87000000008,166909.68000000014,9660.189999999944
8657,2022-03-22 09:25:00,1813.9,178383.77000000008,166909.68000000014,11474.089999999938
8658,2022-03-22 09:30:00,998.83,179382.60000000006,166909.68000000014,12472.919999999925
8659,2022-03-22 09:35:00,-1719.17,177663.43000000005,166909.68000000014,10753.749999999913
8660,2022-03-22 09:40:00,-347.79,177315.64000000004,166909.68000000014,10405.959999999905
8661,2022-03-22 09:45:00,-1157.95,176157.69000000003,166909.68000000014,9248.009999999893
8662,2022-03-22 09:50:00,1765.13,177922.82000000004,166909.68000000014,11013.139999999898
8663,2022-03-22 09:55:00,478.41,178401.23000000004,166909.68000000014,11491.549999999901
8664,2022-03-22 10:00:00,-649.49,177751.74000000005,166909.68000000014,10842.05999999991
8665,2022-03-22 10:05:00,-1185.51,176566.23000000004,166909.68000000014,9656.549999999901
8666,2022-03-22 10:10:00,953.15,177519.38000000003,166909.68000000014,10609.699999999895
8667,2022-03-22 10:15:00,-1734.75,175784.63000000003,166909.68000000014,8874.949999999895
8668,2022-03-22 10:20:00,164.96,175949.59000000003,166909.68000000014,9039.909999999887
8669,2022-03-22 10:25:00,-245.12,175704.47000000003,166909.68000000014,8794.789999999892
8670,2022-03-22 10:30:00,359.74,176064.21000000002,166909.68000000014,9154.529999999882
8671,2022-03-22 10:35:00,1736.31,177800.52000000002,166909.68000000014,10890.83999999988
8672,2022-03-22 10:40:00,1095.54,178896.06000000003,166909.68000000014,11986.379999999888
8673,2022-03-22 10:45:00,-1341.55,177554.51000000004,166909.68000000014,10644.8299999999
8674,2022-03-22 10:50:00,924.31,178478.82000000004,166909.68000000014,11569.139999999898
8675,2022-03-22 10:55:00,1800.32,180279.14000000004,166909.68000000014,13369.459999999905
8676,2022-03-22 11:00:00,980.36,181259.50000000003,166909.68000000014,14349.81999999989
8677,2022-03-22 11:05:00,-1965.31,179294.19000000003,166909.68000000014,12384.509999999893
8678,2022-03-22 11:10:00,-1455.01,177839.18000000002,166909.68000000014,10929.499999999884
8679,2022-03-22 11:15:00,21.81,177860.99000000002,166909.68000000014,10951.309999999881
8680,2022-03-22 11:20:00,-1044.11,176816.88000000003,166909.68000000014,9907.199999999895
8681,2022-03-22 11:25:00,662.29,177479.17000000004,166909.68000000014,10569.489999999903
8682,2022-03-22 11:30:00,1186.39,178665.56000000006,166909.68000000014,11755.879999999917
8683,2022-03-22 11:35:00,85.32,178750.88000000006,166909.68000000014,11841.199999999924
8684,2022-03-22 11:40:00,323.47,179074.35000000006,166909.68000000014,12164.669999999925
8685,2022-03-22 11:45:00,1113.46,180187.81000000006,166909.68000000014,13278.129999999917
8686,2022-03-22 11:50:00,995.92,181183.73000000007,166909.68000000014,14274.04999999993
8687,2022-03-22 11:55:00,384.59,181568.32000000007,166909.68000000014,14658.639999999927
8688,2022-03-22 12:00:00,-44.47,181523.85000000006,166909.68000000014,14614.169999999925
8689,2022-03-22 12:05:00,-951.48,180572.37000000005,166909.68000000014,13662.689999999915
8690,2022-03-22 12:10:00,-445.2,180127.17000000004,166909.68000000014,13217.489999999903
8691,2022-03-22 12:15:00,-1618.16,178509.01000000004,166909.68000000014,11599.3299999999
8692,2022-03-22 12:20:00,-1118.22,177390.79000000004,166909.68000000014,10481.109999999899
8693,2022-03-22 12:25:00,-1314.35,176076.44000000003,166909.68000000014,9166.759999999893
8694,2022-03-22 12:30:00,573.73,176650.17000000004,166909.68000000014,9740.489999999903
8695,2022-03-22 12:35:00,1024.9,177675.07000000004,166909.68000000014,10765.389999999898
8696,2022-03-22 12:40:00,-1352.87,176322.20000000004,166909.68000000014,9412.519999999902
8697,2022-03-22 12:45:00,724.58,177046.78000000003,166909.68000000014,10137.09999999989
8698,2022-03-22 12:50:00,-1096.88,175949.90000000002,166909.68000000014,9040.219999999885
8699,2022-03-22 12:55:00,1047.8,176997.7,166909.68000000014,10088.019999999873
8700,2022-03-22 13:00:00,263.92,177261.62000000002,166909.68000000014,10351.939999999886
8701,2022-03-22 13:05:00,-904.25,176357.37000000002,166909.68000000014,9447.689999999886
8702,2022-03-22 13:10:00,-299.15,176058.22000000003,166909.68000000014,9148.539999999892
8703,2022-03-22 13:15:00,1628.58,177686.80000000002,166909.68000000014,10777.119999999879
8704,2022-03-22 13:20:00,1889.12,179575.92,166909.68000000014,12666.239999999874
8705,2022-03-22 13:25:00,-1292.14,178283.78,166909.68000000014,11374.09999999986
8706,2022-03-22 13:30:00,-227.37,178056.41,166909.68000000014,11146.729999999865
8707,2022-03-22 13:35:00,-633.9,177422.51,166909.68000000014,10512.82999999987
8708,2022-03-22 13:40:00,-1564.72,175857.79,166909.68000000014,8948.10999999987
8709,2022-03-22 13:45:00,1906.45,177764.24000000002,166909.68000000014,10854.559999999881
8710,2022-03-22 13:50:00,-176.56,177587.68000000002,166909.68000000014,10677.999999999884
8711,2022-03-22 13:55:00,-1253.89,176333.79,166909.68000000014,9424.10999999987
8712,2022-03-22 14:00:00,1989.59,178323.38,166909.68000000014,11413.699999999866
8713,2022-03-22 14:05:00,-749.18,177574.2,166909.68000000014,10664.519999999873
8714,2022-03-22 14:10:00,-675.98,176898.22,166909.68000000014,9988.539999999863
8715,2022-03-22 14:15:00,161.46,177059.68,166909.68000000014,10149.999999999854
8716,2022-03-22 14:20:00,418.78,177478.46,166909.68000000014,10568.779999999853
8717,2022-03-22 14:25:00,-1514.5,175963.96,166909.68000000014,9054.279999999853
8718,2022-03-22 14:30:00,325.74,176289.69999999998,166909.68000000014,9380.019999999844
8719,2022-03-22 14:35:00,-285.86,176003.84,166909.68000000014,9094.159999999858
8720,2022-03-22 14:40:00,-1339.43,174664.41,166909.68000000014,7754.729999999865
8721,2022-03-22 14:45:00,715.58,175379.99,166909.68000000014,8470.309999999852
8722,2022-03-22 14:50:00,-689.97,174690.02,166909.68000000014,7780.339999999851
8723,2022-03-22 14:55:00,1028.18,175718.19999999998,166909.68000000014,8808.519999999844
8724,2022-03-22 15:00:00,626.8,176344.99999999997,166909.68000000014,9435.319999999832
8725,2022-03-22 15:05:00,-823.84,175521.15999999997,166909.68000000014,8611.479999999836
8726,2022-03-22 15:10:00,1543.15,177064.30999999997,166909.68000000014,10154.62999999983
8727,2022-03-22 15:15:00,-130.21,176934.09999999998,166909.68000000014,10024.419999999838
8728,2022-03-22 15:20:00,-727.17,176206.92999999996,166909.68000000014,9297.249999999825
8729,2022-03-22 15:25:00,1974.11,178181.03999999995,166909.68000000014,11271.359999999811
8730,2022-03-22 15:30:00,-924.79,177256.24999999994,166909.68000000014,10346.569999999803
8731,2022-03-22 15:35:00,-87.88,177168.36999999994,166909.68000000014,10258.689999999799
8732,2022-03-22 15:40:00,1124.43,178292.79999999993,166909.68000000014,11383.119999999792
8733,2022-03-22 15:45:00,1372.96,179665.75999999992,166909.68000000014,12756.079999999783
8734,2022-03-22 15:50:00,-1478.58,178187.17999999993,166909.68000000014,11277.499999999796
8735,2022-03-22 15:55:00,-1046.88,177140.29999999993,166909.68000000014,10230.619999999792
8736,2022-03-22 16:00:00,-954.16,176186.13999999993,166909.68000000014,9276.459999999788
8737,2022-03-22 16:05:00,1350.17,177536.30999999994,166909.68000000014,10626.629999999801
8738,2022-03-22 16:10:00,-1010.24,176526.06999999995,166909.68000000014,9616.38999999981
8739,2022-03-22 16:15:00,687.99,177214.05999999994,166909.68000000014,10304.379999999801
8740,2022-03-22 16:20:00,-29.28,177184.77999999994,166909.68000000014,10275.099999999802
8741,2022-03-22 16:25:00,-1802.39,175382.38999999993,166909.68000000014,8472.709999999788
8742,2022-03-22 16:30:00,24.22,175406.60999999993,166909.68000000014,8496.92999999979
8743,2022-03-22 16:35:00,-978.82,174427.78999999992,166909.68000000014,7518.109999999782
8744,2022-03-22 16:40:00,515.86,174943.6499999999,166909.68000000014,8033.969999999768
8745,2022-03-22 16:45:00,-795.7,174147.9499999999,166909.68000000014,7238.269999999757
8746,2022-03-22 16:50:00,-1518.02,172629.9299999999,166909.68000000014,5720.249999999767
8747,2022-03-22 16:55:00,-88.77,172541.15999999992,166909.68000000014,5631.479999999778
8748,2022-03-23 08:00:00,353.11,172894.2699999999,172541.15999999992,353.10999999998603
8749,2022-03-23 08:05:00,-151.7,172742.5699999999,172541.15999999992,201.4099999999744
8750,2022-03-23 08:10:00,-1674.91,171067.6599999999,172541.15999999992,-1473.500000000029
8751,2022-03-23 08:15:00,-94.02,170973.6399999999,172541.15999999992,-1567.5200000000186
8752,2022-03-23 08:20:00,115.57,171089.2099999999,172541.15999999992,-1451.9500000000116
8753,2022-03-23 08:25:00,340.57,171429.7799999999,172541.15999999992,-1111.3800000000047
8754,2022-03-23 08:30:00,-315.49,171114.28999999992,172541.15999999992,-1426.8699999999953
8755,2022-03-23 08:35:00,229.99,171344.2799999999,172541.15999999992,-1196.8800000000047
8756,2022-03-23 08:40:00,1555.61,172899.8899999999,172541.15999999992,358.7299999999814
8757,2022-03-23 08:45:00,50.98,172950.8699999999,172541.15999999992,409.70999999999185
8758,2022-03-23 08:50:00,-1589.78,171361.0899999999,172541.15999999992,-1180.070000000007
8759,2022-03-23 08:55:00,-144.03,171217.0599999999,172541.15999999992,-1324.1000000000058
8760,2022-03-23 09:00:00,1155.78,172372.8399999999,172541.15999999992,-168.32000000000698
8761,2022-03-23 09:05:00,-718.73,171654.1099999999,172541.15999999992,-887.0500000000175
8762,2022-03-23 09:10:00,108.11,171762.21999999988,172541.15999999992,-778.9400000000314
8763,2022-03-23 09:15:00,-284.19,171478.02999999988,172541.15999999992,-1063.1300000000338
8764,2022-03-23 09:20:00,-1411.54,170066.48999999987,172541.15999999992,-2474.670000000042
8765,2022-03-23 09:25:00,-1271.4,168795.08999999988,172541.15999999992,-3746.070000000036
8766,2022-03-23 09:30:00,-1281.33,167513.7599999999,172541.15999999992,-5027.400000000023
8767,2022-03-23 09:35:00,-1273.48,166240.27999999988,172541.15999999992,-6300.880000000034
8768,2022-03-23 09:40:00,1374.64,167614.9199999999,172541.15999999992,-4926.24000000002
8769,2022-03-23 09:45:00,-1982.11,165632.8099999999,172541.15999999992,-6908.350000000006
8770,2022-03-23 09:50:00,-1384.54,164248.2699999999,172541.15999999992,-8292.890000000014
8771,2022-03-23 09:55:00,820.59,165068.8599999999,172541.15999999992,-7472.3000000000175
8772,2022-03-23 10:00:00,-691.3,164377.5599999999,172541.15999999992,-8163.600000000006
8773,2022-03-23 10:05:00,803.07,165180.62999999992,172541.15999999992,-7360.529999999999
8774,2022-03-23 10:10:00,-152.68,165027.94999999992,172541.15999999992,-7513.209999999992
8775,2022-03-23 10:15:00,1216.85,166244.79999999993,172541.15999999992,-6296.359999999986
8776,2022-03-23 10:20:00,152.05,166396.84999999992,172541.15999999992,-6144.309999999998
8777,2022-03-23 10:25:00,-366.39,166030.4599999999,172541.15999999992,-6510.700000000012
8778,2022-03-23 10:30:00,621.91,166652.3699999999,172541.15999999992,-5888.790000000008
8779,2022-03-23 10:35:00,819.47,167471.8399999999,172541.15999999992,-5069.320000000007
8780,2022-03-23 10:40:00,246.56,167718.3999999999,172541.15999999992,-4822.760000000009
8781,2022-03-23 10:45:00,1282.71,169001.1099999999,172541.15999999992,-3540.0500000000175
8782,2022-03-23 10:50:00,346.06,169347.1699999999,172541.15999999992,-3193.99000000002
8783,2022-03-23 10:55:00,100.17,169447.3399999999,172541.15999999992,-3093.820000000007
8784,2022-03-23 11:00:00,1777.66,171224.9999999999,172541.15999999992,-1316.1600000000035
8785,2022-03-23 11:05:00,37.1,171262.09999999992,172541.15999999992,-1279.0599999999977
8786,2022-03-23 11:10:00,-459.55,170802.54999999993,172541.15999999992,-1738.609999999986
8787,2022-03-23 11:15:00,-155.35,170647.19999999992,172541.15999999992,-1893.9599999999919
8788,2022-03-23 11:20:00,-600.6,170046.59999999992,172541.15999999992,-2494.5599999999977
8789,2022-03-23 11:25:00,-518.16,169528.43999999992,172541.15999999992,-3012.720000000001
8790,2022-03-23 11:30:00,948.88,170477.31999999992,172541.15999999992,-2063.8399999999965
8791,2022-03-23 11:35:00,1068.42,171545.73999999993,172541.15999999992,-995.4199999999837
8792,2022-03-23 11:40:00,-359.28,171186.45999999993,172541.15999999992,-1354.6999999999825
8793,2022-03-23 11:45:00,-1756.24,169430.21999999994,172541.15999999992,-3110.939999999973
8794,2022-03-23 11:50:00,989.02,170419.23999999993,172541.15999999992,-2121.9199999999837
8795,2022-03-23 11:55:00,1332.74,171751.97999999992,172541.15999999992,-789.179999999993
8796,2022-03-23 12:00:00,-1353.84,170398.13999999993,172541.15999999992,-2143.0199999999895
8797,2022-03-23 12:05:00,-1974.09,168424.04999999993,172541.15999999992,-4117.109999999986
8798,2022-03-23 12:10:00,583.07,169007.11999999994,172541.15999999992,-3534.039999999979
8799,2022-03-23 12:15:00,785.87,169792.98999999993,172541.15999999992,-2748.1699999999837
8800,2022-03-23 12:20:00,1979.55,171772.53999999992,172541.15999999992,-768.6199999999953
8801,2022-03-23 12:25:00,855.25,172627.78999999992,172541.15999999992,86.63000000000466
8802,2022-03-23 12:30:00,-1153.18,171474.60999999993,172541.15999999992,-1066.5499999999884
8803,2022-03-23 12:35:00,-179.47,171295.13999999993,172541.15999999992,-1246.0199999999895
8804,2022-03-23 12:40:00,1689.02,172984.15999999992,172541.15999999992,443.0
8805,2022-03-23 12:45:00,1571.08,174555.2399999999,172541.15999999992,2014.0799999999872
8806,2022-03-23 12:50:00,-1903.16,172652.0799999999,172541.15999999992,110.9199999999837
8807,2022-03-23 12:55:00,-61.71,172590.3699999999,172541.15999999992,49.20999999999185
8808,2022-03-23 13:00:00,-444.19,172146.1799999999,172541.15999999992,-394.9800000000105
8809,2022-03-23 13:05:00,23.76,172169.93999999992,172541.15999999992,-371.22000000000116
8810,2022-03-23 13:10:00,-1839.35,170330.5899999999,172541.15999999992,-2210.570000000007
8811,2022-03-23 13:15:00,-1252.31,169078.2799999999,172541.15999999992,-3462.8800000000047
8812,2022-03-23 13:20:00,-1832.65,167245.62999999992,172541.15999999992,-5295.529999999999
8813,2022-03-23 13:25:00,1722.84,168968.4699999999,172541.15999999992,-3572.6900000000023
8814,2022-03-23 13:30:00,-1567.5,167400.9699999999,172541.15999999992,-5140.190000000002
8815,2022-03-23 13:35:00,-233.04,167167.9299999999,172541.15999999992,-5373.2300000000105
8816,2022-03-23 13:40:00,593.95,167761.87999999992,172541.15999999992,-4779.279999999999
8817,2022-03-23 13:45:00,-1088.02,166673.85999999993,172541.15999999992,-5867.299999999988
8818,2022-03-23 13:50:00,1681.79,168355.64999999994,172541.15999999992,-4185.50999999998
8819,2022-03-23 13:55:00,210.52,168566.16999999993,172541.15999999992,-3974.9899999999907
8820,2022-03-23 14:00:00,-1192.15,167374.01999999993,172541.15999999992,-5167.139999999985
8821,2022-03-23 14:05:00,-565.8,166808.21999999994,172541.15999999992,-5732.939999999973
8822,2022-03-23 14:10:00,888.38,167696.59999999995,172541.15999999992,-4844.559999999969
8823,2022-03-23 14:15:00,66.83,167763.42999999993,172541.15999999992,-4777.729999999981
8824,2022-03-23 14:20:00,-583.06,167180.36999999994,172541.15999999992,-5360.789999999979
8825,2022-03-23 14:25:00,-141.16,167039.20999999993,172541.15999999992,-5501.9499999999825
8826,2022-03-23 14:30:00,-1728.06,165311.14999999994,172541.15999999992,-7230.00999999998
8827,2022-03-23 14:35:00,-372.42,164938.72999999992,172541.15999999992,-7602.429999999993
8828,2022-03-23 14:40:00,902.38,165841.10999999993,172541.15999999992,-6700.049999999988
8829,2022-03-23 14:45:00,-544.37,165296.73999999993,172541.15999999992,-7244.419999999984
8830,2022-03-23 14:50:00,112.2,165408.93999999994,172541.15999999992,-7132.219999999972
8831,2022-03-23 14:55:00,-1954.98,163453.95999999993,172541.15999999992,-9087.199999999983
8832,2022-03-23 15:00:00,-976.58,162477.37999999995,172541.15999999992,-10063.77999999997
8833,2022-03-23 15:05:00,252.17,162729.54999999996,172541.15999999992,-9811.609999999957
8834,2022-03-23 15:10:00,1253.64,163983.18999999997,172541.15999999992,-8557.969999999943
8835,2022-03-23 15:15:00,-777.05,163206.13999999998,172541.15999999992,-9335.019999999931
8836,2022-03-23 15:20:00,160.94,163367.08,172541.15999999992,-9174.079999999929
8837,2022-03-23 15:25:00,804.12,164171.19999999998,172541.15999999992,-8369.959999999934
8838,2022-03-23 15:30:00,-92.33,164078.87,172541.15999999992,-8462.28999999992
8839,2022-03-23 15:35:00,1121.51,165200.38,172541.15999999992,-7340.7799999999115
8840,2022-03-23 15:40:00,749.95,165950.33000000002,172541.15999999992,-6590.8299999999
8841,2022-03-23 15:45:00,214.08,166164.41,172541.15999999992,-6376.749999999913
8842,2022-03-23 15:50:00,-623.59,165540.82,172541.15999999992,-7000.339999999909
8843,2022-03-23 15:55:00,1530.77,167071.59,172541.15999999992,-5469.56999999992
8844,2022-03-23 16:00:00,-1841.63,165229.96,172541.15999999992,-7311.199999999924
8845,2022-03-23 16:05:00,1448.2,166678.16,172541.15999999992,-5862.999999999913
8846,2022-03-23 16:10:00,1906.98,168585.14,172541.15999999992,-3956.019999999902
8847,2022-03-23 16:15:00,68.55,168653.69,172541.15999999992,-3887.469999999914
8848,2022-03-23 16:20:00,-1606.65,167047.04,172541.15999999992,-5494.119999999908
8849,2022-03-23 16:25:00,-823.02,166224.02000000002,172541.15999999992,-6317.139999999898
8850,2022-03-23 16:30:00,896.92,167120.94000000003,172541.15999999992,-5420.219999999885
8851,2022-03-23 16:35:00,-1191.64,165929.30000000002,172541.15999999992,-6611.859999999899
8852,2022-03-23 16:40:00,124.9,166054.2,172541.15999999992,-6486.9599999999045
8853,2022-03-23 16:45:00,994.89,167049.09000000003,172541.15999999992,-5492.069999999891
8854,2022-03-23 16:50:00,-1674.86,165374.23000000004,172541.15999999992,-7166.929999999877
8855,2022-03-23 16:55:00,869.88,166244.11000000004,172541.15999999992,-6297.049999999872
8856,2022-03-24 08:00:00,-530.5,165713.61000000004,166244.11000000004,-530.5
8857,2022-03-24 08:05:00,844.38,166557.99000000005,166244.11000000004,313.88000000000466
8858,2022-03-24 08:10:00,-26.79,166531.20000000004,166244.11000000004,287.0899999999965
8859,2022-03-24 08:15:00,1242.88,167774.08000000005,166244.11000000004,1529.9700000000012
8860,2022-03-24 08:20:00,1989.42,169763.50000000006,166244.11000000004,3519.390000000014
8861,2022-03-24 08:25:00,1755.33,171518.83000000005,166244.11000000004,5274.720000000001
8862,2022-03-24 08:30:00,-849.8,170669.03000000006,166244.11000000004,4424.920000000013
8863,2022-03-24 08:35:00,663.35,171332.38000000006,166244.11000000004,5088.270000000019
8864,2022-03-24 08:40:00,-609.59,170722.79000000007,166244.11000000004,4478.680000000022
8865,2022-03-24 08:45:00,-1562.64,169160.15000000005,166244.11000000004,2916.040000000008
8866,2022-03-24 08:50:00,1319.4,170479.55000000005,166244.11000000004,4235.440000000002
8867,2022-03-24 08:55:00,1038.73,171518.28000000006,166244.11000000004,5274.170000000013
8868,2022-03-24 09:00:00,-1860.42,169657.86000000004,166244.11000000004,3413.75
8869,2022-03-24 09:05:00,-536.23,169121.63000000003,166244.11000000004,2877.5199999999895
8870,2022-03-24 09:10:00,522.39,169644.02000000005,166244.11000000004,3399.9100000000035
8871,2022-03-24 09:15:00,-731.28,168912.74000000005,166244.11000000004,2668.6300000000047
8872,2022-03-24 09:20:00,1128.11,170040.85000000003,166244.11000000004,3796.7399999999907
8873,2022-03-24 09:25:00,-1017.81,169023.04000000004,166244.11000000004,2778.929999999993
8874,2022-03-24 09:30:00,68.54,169091.58000000005,166244.11000000004,2847.470000000001
8875,2022-03-24 09:35:00,-571.15,168520.43000000005,166244.11000000004,2276.320000000007
8876,2022-03-24 09:40:00,-1189.1,167331.33000000005,166244.11000000004,1087.2200000000012
8877,2022-03-24 09:45:00,-356.62,166974.71000000005,166244.11000000004,730.6000000000058
8878,2022-03-24 09:50:00,333.39,167308.10000000006,166244.11000000004,1063.9900000000198
8879,2022-03-24 09:55:00,-1094.96,166213.14000000007,166244.11000000004,-30.96999999997206
8880,2022-03-24 10:00:00,-1164.88,165048.26000000007,166244.11000000004,-1195.8499999999767
8881,2022-03-24 10:05:00,915.18,165963.44000000006,166244.11000000004,-280.6699999999837
8882,2022-03-24 10:10:00,699.23,166662.67000000007,166244.11000000004,418.5600000000268
8883,2022-03-24 10:15:00,-546.43,166116.24000000008,166244.11000000004,-127.86999999996624
8884,2022-03-24 10:20:00,-1358.75,164757.49000000008,166244.11000000004,-1486.6199999999662
8885,2022-03-24 10:25:00,156.8,164914.29000000007,166244.11000000004,-1329.8199999999779
8886,2022-03-24 10:30:00,-1355.91,163558.38000000006,166244.11000000004,-2685.7299999999814
8887,2022-03-24 10:35:00,131.17,163689.55000000008,166244.11000000004,-2554.5599999999686
8888,2022-03-24 10:40:00,1350.12,165039.67000000007,166244.11000000004,-1204.4399999999732
8889,2022-03-24 10:45:00,1900.51,166940.18000000008,166244.11000000004,696.0700000000361
8890,2022-03-24 10:50:00,307.35,167247.5300000001,166244.11000000004,1003.4200000000419
8891,2022-03-24 10:55:00,1759.96,169007.49000000008,166244.11000000004,2763.3800000000338
8892,2022-03-24 11:00:00,-525.35,168482.14000000007,166244.11000000004,2238.030000000028
8893,2022-03-24 11:05:00,1467.49,169949.63000000006,166244.11000000004,3705.5200000000186
8894,2022-03-24 11:10:00,212.58,170162.21000000005,166244.11000000004,3918.100000000006
8895,2022-03-24 11:15:00,-1011.36,169150.85000000006,166244.11000000004,2906.74000000002
8896,2022-03-24 11:20:00,-257.92,168892.93000000005,166244.11000000004,2648.820000000007
8897,2022-03-24 11:25:00,-1304.28,167588.65000000005,166244.11000000004,1344.5400000000081
8898,2022-03-24 11:30:00,324.79,167913.44000000006,166244.11000000004,1669.3300000000163
8899,2022-03-24 11:35:00,-138.76,167774.68000000005,166244.11000000004,1530.570000000007
8900,2022-03-24 11:40:00,-1897.01,165877.67000000004,166244.11000000004,-366.4400000000023
8901,2022-03-24 11:45:00,1777.73,167655.40000000005,166244.11000000004,1411.2900000000081
8902,2022-03-24 11:50:00,-1025.71,166629.69000000006,166244.11000000004,385.5800000000163
8903,2022-03-24 11:55:00,-1751.44,164878.25000000006,166244.11000000004,-1365.859999999986
8904,2022-03-24 12:00:00,1395.36,166273.61000000004,166244.11000000004,29.5
8905,2022-03-24 12:05:00,1482.27,167755.88000000003,166244.11000000004,1511.7699999999895
8906,2022-03-24 12:10:00,-520.18,167235.70000000004,166244.11000000004,991.5899999999965
8907,2022-03-24 12:15:00,-503.96,166731.74000000005,166244.11000000004,487.63000000000466
8908,2022-03-24 12:20:00,84.96,166816.70000000004,166244.11000000004,572.5899999999965
8909,2022-03-24 12:25:00,354.26,167170.96000000005,166244.11000000004,926.8500000000058
8910,2022-03-24 12:30:00,-665.95,166505.01000000004,166244.11000000004,260.8999999999942
8911,2022-03-24 12:35:00,-1051.18,165453.83000000005,166244.11000000004,-790.2799999999988
8912,2022-03-24 12:40:00,889.98,166343.81000000006,166244.11000000004,99.70000000001164
8913,2022-03-24 12:45:00,44.79,166388.60000000006,166244.11000000004,144.4900000000198
8914,2022-03-24 12:50:00,1960.44,168349.04000000007,166244.11000000004,2104.930000000022
8915,2022-03-24 12:55:00,90.9,168439.94000000006,166244.11000000004,2195.8300000000163
8916,2022-03-24 13:00:00,1316.79,169756.73000000007,166244.11000000004,3512.6200000000244
8917,2022-03-24 13:05:00,-1492.18,168264.55000000008,166244.11000000004,2020.4400000000314
8918,2022-03-24 13:10:00,1371.91,169636.46000000008,166244.11000000004,3392.350000000035
8919,2022-03-24 13:15:00,-230.1,169406.36000000007,166244.11000000004,3162.250000000029
8920,2022-03-24 13:20:00,684.41,170090.77000000008,166244.11000000004,3846.6600000000326
8921,2022-03-24 13:25:00,-1674.11,168416.6600000001,166244.11000000004,2172.5500000000466
8922,2022-03-24 13:30:00,1032.46,169449.12000000008,166244.11000000004,3205.0100000000384
8923,2022-03-24 13:35:00,1240.86,170689.98000000007,166244.11000000004,4445.870000000024
8924,2022-03-24 13:40:00,-478.95,170211.03000000006,166244.11000000004,3966.920000000013
8925,2022-03-24 13:45:00,1895.03,172106.06000000006,166244.11000000004,5861.950000000012
8926,2022-03-24 13:50:00,-1015.89,171090.17000000004,166244.11000000004,4846.059999999998
8927,2022-03-24 13:55:00,1318.58,172408.75000000003,166244.11000000004,6164.639999999985
8928,2022-03-24 14:00:00,-978.36,171430.39000000004,166244.11000000004,5186.279999999999
8929,2022-03-24 14:05:00,600.43,172030.82000000004,166244.11000000004,5786.709999999992
8930,2022-03-24 14:10:00,-991.05,171039.77000000005,166244.11000000004,4795.6600000000035
8931,2022-03-24 14:15:00,-372.39,170667.38000000003,166244.11000000004,4423.2699999999895
8932,2022-03-24 14:20:00,1907.54,172574.92000000004,166244.11000000004,6330.809999999998
8933,2022-03-24 14:25:00,-923.44,171651.48000000004,166244.11000000004,5407.369999999995
8934,2022-03-24 14:30:00,-1887.03,169764.45000000004,166244.11000000004,3520.3399999999965
8935,2022-03-24 14:35:00,-1205.15,168559.30000000005,166244.11000000004,2315.1900000000023
8936,2022-03-24 14:40:00,-1991.63,166567.67000000004,166244.11000000004,323.5599999999977
8937,2022-03-24 14:45:00,1909.96,168477.63000000003,166244.11000000004,2233.5199999999895
8938,2022-03-24 14:50:00,-224.53,168253.10000000003,166244.11000000004,2008.9899999999907
8939,2022-03-24 14:55:00,-595.1,167658.00000000003,166244.11000000004,1413.8899999999849
8940,2022-03-24 15:00:00,1218.92,168876.92000000004,166244.11000000004,2632.8099999999977
8941,2022-03-24 15:05:00,-1549.49,167327.43000000005,166244.11000000004,1083.320000000007
8942,2022-03-24 15:10:00,-249.97,167077.46000000005,166244.11000000004,833.3500000000058
8943,2022-03-24 15:15:00,-408.86,166668.60000000006,166244.11000000004,424.4900000000198
8944,2022-03-24 15:20:00,53.88,166722.48000000007,166244.11000000004,478.37000000002445
8945,2022-03-24 15:25:00,1383.73,168106.21000000008,166244.11000000004,1862.100000000035
8946,2022-03-24 15:30:00,-418.37,167687.84000000008,166244.11000000004,1443.7300000000396
8947,2022-03-24 15:35:00,270.21,167958.05000000008,166244.11000000004,1713.9400000000314
8948,2022-03-24 15:40:00,-1835.22,166122.83000000007,166244.11000000004,-121.27999999996973
8949,2022-03-24 15:45:00,1653.78,167776.61000000007,166244.11000000004,1532.500000000029
8950,2022-03-24 15:50:00,-515.05,167261.56000000008,166244.11000000004,1017.4500000000407
8951,2022-03-24 15:55:00,-742.2,166519.36000000007,166244.11000000004,275.2500000000291
8952,2022-03-24 16:00:00,-1831.31,164688.05000000008,166244.11000000004,-1556.0599999999686
8953,2022-03-24 16:05:00,415.66,165103.71000000008,166244.11000000004,-1140.399999999965
8954,2022-03-24 16:10:00,-1895.19,163208.52000000008,166244.11000000004,-3035.5899999999674
8955,2022-03-24 16:15:00,-441.79,162766.73000000007,166244.11000000004,-3477.3799999999756
8956,2022-03-24 16:20:00,-796.9,161969.83000000007,166244.11000000004,-4274.27999999997
8957,2022-03-24 16:25:00,1167.51,163137.34000000008,166244.11000000004,-3106.7699999999604
8958,2022-03-24 16:30:00,-1062.85,162074.49000000008,166244.11000000004,-4169.619999999966
8959,2022-03-24 16:35:00,1329.45,163403.9400000001,166244.11000000004,-2840.1699999999546
8960,2022-03-24 16:40:00,1976.95,165380.8900000001,166244.11000000004,-863.219999999943
8961,2022-03-24 16:45:00,992.1,166372.9900000001,166244.11000000004,128.88000000006286
8962,2022-03-24 16:50:00,-1658.79,164714.2000000001,166244.11000000004,-1529.9099999999453
8963,2022-03-24 16:55:00,-961.84,163752.3600000001,166244.11000000004,-2491.749999999942
8964,2022-03-25 08:00:00,623.6,164375.9600000001,163752.3600000001,623.6000000000058
8965,2022-03-25 08:05:00,-1211.37,163164.5900000001,163752.3600000001,-587.7699999999895
8966,2022-03-25 08:10:00,664.63,163829.22000000012,163752.3600000001,76.86000000001513
8967,2022-03-25 08:15:00,-1462.15,162367.07000000012,163752.3600000001,-1385.289999999979
8968,2022-03-25 08:20:00,1756.14,164123.21000000014,163752.3600000001,370.8500000000349
8969,2022-03-25 08:25:00,-401.86,163721.35000000015,163752.3600000001,-31.009999999951106
8970,2022-03-25 08:30:00,-1582.28,162139.07000000015,163752.3600000001,-1613.28999999995
8971,2022-03-25 08:35:00,98.86,162237.93000000014,163752.3600000001,-1514.429999999964
8972,2022-03-25 08:40:00,-1105.1,161132.83000000013,163752.3600000001,-2619.5299999999697
8973,2022-03-25 08:45:00,-1291.38,159841.45000000013,163752.3600000001,-3910.9099999999744
8974,2022-03-25 08:50:00,977.09,160818.54000000012,163752.3600000001,-2933.819999999978
8975,2022-03-25 08:55:00,1720.68,162539.22000000012,163752.3600000001,-1213.1399999999849
8976,2022-03-25 09:00:00,1195.35,163734.57000000012,163752.3600000001,-17.789999999979045
8977,2022-03-25 09:05:00,-1975.93,161758.64000000013,163752.3600000001,-1993.719999999972
8978,2022-03-25 09:10:00,453.11,162211.75000000012,163752.3600000001,-1540.609999999986
8979,2022-03-25 09:15:00,-82.74,162129.01000000013,163752.3600000001,-1623.3499999999767
8980,2022-03-25 09:20:00,1826.27,163955.28000000012,163752.3600000001,202.9200000000128
8981,2022-03-25 09:25:00,231.14,164186.42000000013,163752.3600000001,434.0600000000268
8982,2022-03-25 09:30:00,-674.2,163512.22000000012,163752.3600000001,-240.13999999998487
8983,2022-03-25 09:35:00,1719.01,165231.23000000013,163752.3600000001,1478.8700000000244
8984,2022-03-25 09:40:00,-333.62,164897.61000000013,163752.3600000001,1145.250000000029
8985,2022-03-25 09:45:00,-1224.46,163673.15000000014,163752.3600000001,-79.20999999996275
8986,2022-03-25 09:50:00,-1951.81,161721.34000000014,163752.3600000001,-2031.0199999999604
8987,2022-03-25 09:55:00,1827.01,163548.35000000015,163752.3600000001,-204.0099999999511
8988,2022-03-25 10:00:00,-1110.7,162437.65000000014,163752.3600000001,-1314.7099999999627
8989,2022-03-25 10:05:00,-1901.01,160536.64000000013,163752.3600000001,-3215.719999999972
8990,2022-03-25 10:10:00,806.47,161343.11000000013,163752.3600000001,-2409.249999999971
8991,2022-03-25 10:15:00,-1289.86,160053.25000000015,163752.3600000001,-3699.109999999957
8992,2022-03-25 10:20:00,-44.11,160009.14000000016,163752.3600000001,-3743.219999999943
8993,2022-03-25 10:25:00,-52.77,159956.37000000017,163752.3600000001,-3795.9899999999325
8994,2022-03-25 10:30:00,1015.05,160971.42000000016,163752.3600000001,-2780.939999999944
8995,2022-03-25 10:35:00,1460.84,162432.26000000015,163752.3600000001,-1320.0999999999476
8996,2022-03-25 10:40:00,-679.96,161752.30000000016,163752.3600000001,-2000.0599999999395
8997,2022-03-25 10:45:00,-407.78,161344.52000000016,163752.3600000001,-2407.8399999999383
8998,2022-03-25 10:50:00,-426.79,160917.73000000016,163752.3600000001,-2834.6299999999464
8999,2022-03-25 10:55:00,933.57,161851.30000000016,163752.3600000001,-1901.0599999999395
9000,2022-03-25 11:00:00,-241.93,161609.37000000017,163752.3600000001,-2142.9899999999325
9001,2022-03-25 11:05:00,-329.47,161279.90000000017,163752.3600000001,-2472.4599999999336
9002,2022-03-25 11:10:00,75.57,161355.47000000018,163752.3600000001,-2396.8899999999267
9003,2022-03-25 11:15:00,1028.98,162384.4500000002,163752.3600000001,-1367.9099999999162
9004,2022-03-25 11:20:00,-1924.33,160460.1200000002,163752.3600000001,-3292.2399999999034
9005,2022-03-25 11:25:00,-1619.69,158840.4300000002,163752.3600000001,-4911.929999999906
9006,2022-03-25 11:30:00,-407.43,158433.0000000002,163752.3600000001,-5319.359999999899
9007,2022-03-25 11:35:00,-430.97,158002.0300000002,163752.3600000001,-5750.3299999999
9008,2022-03-25 11:40:00,-1408.03,156594.0000000002,163752.3600000001,-7158.359999999899
9009,2022-03-25 11:45:00,-1840.71,154753.2900000002,163752.3600000001,-8999.06999999989
9010,2022-03-25 11:50:00,-361.97,154391.3200000002,163752.3600000001,-9361.039999999892
9011,2022-03-25 11:55:00,517.72,154909.0400000002,163752.3600000001,-8843.31999999989
9012,2022-03-25 12:00:00,-1028.03,153881.0100000002,163752.3600000001,-9871.34999999989
9013,2022-03-25 12:05:00,1925.38,155806.39000000022,163752.3600000001,-7945.969999999885
9014,2022-03-25 12:10:00,1574.23,157380.62000000023,163752.3600000001,-6371.739999999874
9015,2022-03-25 12:15:00,318.34,157698.96000000022,163752.3600000001,-6053.399999999878
9016,2022-03-25 12:20:00,111.26,157810.22000000023,163752.3600000001,-5942.139999999868
9017,2022-03-25 12:25:00,1189.01,158999.23000000024,163752.3600000001,-4753.129999999859
9018,2022-03-25 12:30:00,-376.78,158622.45000000024,163752.3600000001,-5129.909999999858
9019,2022-03-25 12:35:00,1657.87,160280.32000000024,163752.3600000001,-3472.0399999998626
9020,2022-03-25 12:40:00,905.78,161186.10000000024,163752.3600000001,-2566.259999999864
9021,2022-03-25 12:45:00,1690.01,162876.11000000025,163752.3600000001,-876.2499999998545
9022,2022-03-25 12:50:00,1358.77,164234.88000000024,163752.3600000001,482.52000000013504
9023,2022-03-25 12:55:00,349.43,164584.31000000023,163752.3600000001,831.9500000001281
9024,2022-03-25 13:00:00,-1160.53,163423.78000000023,163752.3600000001,-328.5799999998708
9025,2022-03-25 13:05:00,827.15,164250.93000000023,163752.3600000001,498.5700000001234
9026,2022-03-25 13:10:00,-1563.5,162687.43000000023,163752.3600000001,-1064.9299999998766
9027,2022-03-25 13:15:00,-1348.3,161339.13000000024,163752.3600000001,-2413.229999999865
9028,2022-03-25 13:20:00,-251.55,161087.58000000025,163752.3600000001,-2664.7799999998533
9029,2022-03-25 13:25:00,-1333.26,159754.32000000024,163752.3600000001,-3998.0399999998626
9030,2022-03-25 13:30:00,1363.69,161118.01000000024,163752.3600000001,-2634.3499999998603
9031,2022-03-25 13:35:00,-100.87,161017.14000000025,163752.3600000001,-2735.2199999998556
9032,2022-03-25 13:40:00,-549.08,160468.06000000026,163752.3600000001,-3284.299999999843
9033,2022-03-25 13:45:00,-346.58,160121.48000000027,163752.3600000001,-3630.87999999983
9034,2022-03-25 13:50:00,336.98,160458.46000000028,163752.3600000001,-3293.8999999998196
9035,2022-03-25 13:55:00,1630.55,162089.01000000027,163752.3600000001,-1663.3499999998312
9036,2022-03-25 14:00:00,304.06,162393.07000000027,163752.3600000001,-1359.2899999998335
9037,2022-03-25 14:05:00,-1935.73,160457.34000000026,163752.3600000001,-3295.019999999844
9038,2022-03-25 14:10:00,-1993.83,158463.51000000027,163752.3600000001,-5288.849999999831
9039,2022-03-25 14:15:00,1084.0,159547.51000000027,163752.3600000001,-4204.849999999831
9040,2022-03-25 14:20:00,-496.8,159050.71000000028,163752.3600000001,-4701.64999999982
9041,2022-03-25 14:25:00,229.1,159279.8100000003,163752.3600000001,-4472.549999999814
9042,2022-03-25 14:30:00,528.65,159808.46000000028,163752.3600000001,-3943.8999999998196
9043,2022-03-25 14:35:00,777.13,160585.5900000003,163752.3600000001,-3166.769999999815
9044,2022-03-25 14:40:00,1256.7,161842.2900000003,163752.3600000001,-1910.0699999998033
9045,2022-03-25 14:45:00,471.83,162314.1200000003,163752.3600000001,-1438.239999999816
9046,2022-03-25 14:50:00,1708.58,164022.70000000027,163752.3600000001,270.34000000017113
9047,2022-03-25 14:55:00,1918.28,165940.98000000027,163752.3600000001,2188.62000000017
9048,2022-03-25 15:00:00,656.25,166597.23000000027,163752.3600000001,2844.87000000017
9049,2022-03-25 15:05:00,-1995.9,164601.33000000028,163752.3600000001,848.9700000001758
9050,2022-03-25 15:10:00,1762.13,166363.46000000028,163752.3600000001,2611.1000000001804
9051,2022-03-25 15:15:00,1871.03,168234.49000000028,163752.3600000001,4482.130000000179
9052,2022-03-25 15:20:00,-343.43,167891.0600000003,163752.3600000001,4138.700000000186
9053,2022-03-25 15:25:00,36.61,167927.67000000027,163752.3600000001,4175.310000000172
9054,2022-03-25 15:30:00,-963.55,166964.1200000003,163752.3600000001,3211.760000000184
9055,2022-03-25 15:35:00,-1992.22,164971.90000000029,163752.3600000001,1219.5400000001828
9056,2022-03-25 15:40:00,-14.19,164957.71000000028,163752.3600000001,1205.3500000001804
9057,2022-03-25 15:45:00,-1056.48,163901.23000000027,163752.3600000001,148.87000000016997
9058,2022-03-25 15:50:00,-389.6,163511.63000000027,163752.3600000001,-240.72999999983585
9059,2022-03-25 15:55:00,1247.08,164758.71000000025,163752.3600000001,1006.3500000001513
9060,2022-03-25 16:00:00,-389.07,164369.64000000025,163752.3600000001,617.2800000001444
9061,2022-03-25 16:05:00,-875.05,163494.59000000026,163752.3600000001,-257.769999999844
9062,2022-03-25 16:10:00,-1285.95,162208.64000000025,163752.3600000001,-1543.7199999998556
9063,2022-03-25 16:15:00,-656.2,161552.44000000024,163752.3600000001,-2199.9199999998673
9064,2022-03-25 16:20:00,-1060.96,160491.48000000024,163752.3600000001,-3260.879999999859
9065,2022-03-25 16:25:00,3.9,160495.38000000024,163752.3600000001,-3256.979999999865
9066,2022-03-25 16:30:00,685.02,161180.40000000023,163752.3600000001,-2571.9599999998754
9067,2022-03-25 16:35:00,1006.0,162186.40000000023,163752.3600000001,-1565.9599999998754
9068,2022-03-25 16:40:00,-1662.79,160523.61000000022,163752.3600000001,-3228.7499999998836
9069,2022-03-25 16:45:00,226.04,160749.65000000023,163752.3600000001,-3002.7099999998754
9070,2022-03-25 16:50:00,-738.83,160010.82000000024,163752.3600000001,-3741.5399999998626
9071,2022-03-25 16:55:00,1225.35,161236.17000000025,163752.3600000001,-2516.189999999857
9072,2022-03-26 08:00:00,-291.49,160944.68000000025,161236.17000000025,-291.4899999999907
9073,2022-03-26 08:05:00,806.75,161751.43000000025,161236.17000000025,515.2600000000093
9074,2022-03-26 08:10:00,1374.84,163126.27000000025,161236.17000000025,1890.1000000000058
9075,2022-03-26 08:15:00,-1376.34,161749.93000000025,161236.17000000025,513.7600000000093
9076,2022-03-26 08:20:00,-251.66,161498.27000000025,161236.17000000025,262.1000000000058
9077,2022-03-26 08:25:00,1936.63,163434.90000000026,161236.17000000025,2198.7300000000105
9078,2022-03-26 08:30:00,-1860.64,161574.26000000024,161236.17000000025,338.0899999999965
9079,2022-03-26 08:35:00,125.45,161699.71000000025,161236.17000000025,463.54000000000815
9080,2022-03-26 08:40:00,-1645.3,160054.41000000027,161236.17000000025,-1181.7599999999802
9081,2022-03-26 08:45:00,244.27,160298.68000000025,161236.17000000025,-937.4899999999907
9082,2022-03-26 08:50:00,232.33,160531.01000000024,161236.17000000025,-705.1600000000035
9083,2022-03-26 08:55:00,-614.13,159916.88000000024,161236.17000000025,-1319.2900000000081
9084,2022-03-26 09:00:00,-1603.67,158313.21000000022,161236.17000000025,-2922.960000000021
9085,2022-03-26 09:05:00,-1703.14,156610.0700000002,161236.17000000025,-4626.100000000035
9086,2022-03-26 09:10:00,-912.56,155697.5100000002,161236.17000000025,-5538.660000000033
9087,2022-03-26 09:15:00,1459.83,157157.3400000002,161236.17000000025,-4078.8300000000454
9088,2022-03-26 09:20:00,584.33,157741.6700000002,161236.17000000025,-3494.500000000058
9089,2022-03-26 09:25:00,-152.82,157588.85000000018,161236.17000000025,-3647.320000000065
9090,2022-03-26 09:30:00,-1446.28,156142.57000000018,161236.17000000025,-5093.600000000064
9091,2022-03-26 09:35:00,1859.04,158001.6100000002,161236.17000000025,-3234.560000000056
9092,2022-03-26 09:40:00,-499.86,157501.7500000002,161236.17000000025,-3734.420000000042
9093,2022-03-26 09:45:00,163.55,157665.3000000002,161236.17000000025,-3570.8700000000536
9094,2022-03-26 09:50:00,1314.43,158979.73000000019,161236.17000000025,-2256.4400000000605
9095,2022-03-26 09:55:00,1631.75,160611.48000000019,161236.17000000025,-624.6900000000605
9096,2022-03-26 10:00:00,-1980.29,158631.19000000018,161236.17000000025,-2604.9800000000687
9097,2022-03-26 10:05:00,-1730.5,156900.69000000018,161236.17000000025,-4335.480000000069
9098,2022-03-26 10:10:00,936.59,157837.28000000017,161236.17000000025,-3398.890000000072
9099,2022-03-26 10:15:00,-524.38,157312.90000000017,161236.17000000025,-3923.270000000077
9100,2022-03-26 10:20:00,1110.37,158423.27000000016,161236.17000000025,-2812.9000000000815
9101,2022-03-26 10:25:00,786.01,159209.28000000017,161236.17000000025,-2026.8900000000722
9102,2022-03-26 10:30:00,1997.16,161206.44000000018,161236.17000000025,-29.730000000068685
9103,2022-03-26 10:35:00,-652.7,160553.74000000017,161236.17000000025,-682.4300000000803
9104,2022-03-26 10:40:00,160.09,160713.83000000016,161236.17000000025,-522.3400000000838
9105,2022-03-26 10:45:00,1477.29,162191.12000000017,161236.17000000025,954.9499999999243
9106,2022-03-26 10:50:00,987.89,163179.01000000018,161236.17000000025,1942.8399999999383
9107,2022-03-26 10:55:00,-1894.18,161284.8300000002,161236.17000000025,48.659999999945285
9108,2022-03-26 11:00:00,-1166.85,160117.98000000019,161236.17000000025,-1118.1900000000605
9109,2022-03-26 11:05:00,1137.59,161255.57000000018,161236.17000000025,19.39999999993597
9110,2022-03-26 11:10:00,-1188.14,160067.43000000017,161236.17000000025,-1168.740000000078
9111,2022-03-26 11:15:00,535.42,160602.85000000018,161236.17000000025,-633.3200000000652
9112,2022-03-26 11:20:00,-263.93,160338.9200000002,161236.17000000025,-897.2500000000582
9113,2022-03-26 11:25:00,-1734.21,158604.7100000002,161236.17000000025,-2631.46000000005
9114,2022-03-26 11:30:00,-1203.12,157401.5900000002,161236.17000000025,-3834.5800000000454
9115,2022-03-26 11:35:00,-854.47,156547.1200000002,161236.17000000025,-4689.050000000047
9116,2022-03-26 11:40:00,-908.86,155638.2600000002,161236.17000000025,-5597.910000000033
9117,2022-03-26 11:45:00,-1478.81,154159.45000000022,161236.17000000025,-7076.72000000003
9118,2022-03-26 11:50:00,425.64,154585.09000000023,161236.17000000025,-6651.080000000016
9119,2022-03-26 11:55:00,-1423.57,153161.52000000022,161236.17000000025,-8074.650000000023
9120,2022-03-26 12:00:00,1259.47,154420.99000000022,161236.17000000025,-6815.180000000022
9121,2022-03-26 12:05:00,-1725.78,152695.21000000022,161236.17000000025,-8540.960000000021
9122,2022-03-26 12:10:00,1887.03,154582.24000000022,161236.17000000025,-6653.930000000022
9123,2022-03-26 12:15:00,-452.26,154129.9800000002,161236.17000000025,-7106.190000000031
9124,2022-03-26 12:20:00,-738.67,153391.3100000002,161236.17000000025,-7844.860000000044
9125,2022-03-26 12:25:00,-1052.87,152338.4400000002,161236.17000000025,-8897.73000000004
9126,2022-03-26 12:30:00,-439.79,151898.6500000002,161236.17000000025,-9337.520000000048
9127,2022-03-26 12:35:00,1745.62,153644.2700000002,161236.17000000025,-7591.900000000052
9128,2022-03-26 12:40:00,-1680.13,151964.1400000002,161236.17000000025,-9272.030000000057
9129,2022-03-26 12:45:00,1233.49,153197.63000000018,161236.17000000025,-8038.540000000066
9130,2022-03-26 12:50:00,-417.93,152779.7000000002,161236.17000000025,-8456.47000000006
9131,2022-03-26 12:55:00,-1810.69,150969.01000000018,161236.17000000025,-10267.160000000062
9132,2022-03-26 13:00:00,1615.98,152584.9900000002,161236.17000000025,-8651.180000000051
9133,2022-03-26 13:05:00,-515.49,152069.5000000002,161236.17000000025,-9166.670000000042
9134,2022-03-26 13:10:00,1961.04,154030.5400000002,161236.17000000025,-7205.630000000034
9135,2022-03-26 13:15:00,-1431.89,152598.6500000002,161236.17000000025,-8637.520000000048
9136,2022-03-26 13:20:00,1864.5,154463.1500000002,161236.17000000025,-6773.020000000048
9137,2022-03-26 13:25:00,587.17,155050.3200000002,161236.17000000025,-6185.850000000035
9138,2022-03-26 13:30:00,1166.07,156216.39000000022,161236.17000000025,-5019.780000000028
9139,2022-03-26 13:35:00,560.05,156776.4400000002,161236.17000000025,-4459.73000000004
9140,2022-03-26 13:40:00,802.25,157578.6900000002,161236.17000000025,-3657.4800000000396
9141,2022-03-26 13:45:00,1388.85,158967.5400000002,161236.17000000025,-2268.6300000000338
9142,2022-03-26 13:50:00,-993.77,157973.77000000022,161236.17000000025,-3262.4000000000233
9143,2022-03-26 13:55:00,1028.05,159001.8200000002,161236.17000000025,-2234.350000000035
9144,2022-03-26 14:00:00,-864.49,158137.33000000022,161236.17000000025,-3098.8400000000256
9145,2022-03-26 14:05:00,-1074.5,157062.83000000022,161236.17000000025,-4173.340000000026
9146,2022-03-26 14:10:00,547.75,157610.58000000022,161236.17000000025,-3625.5900000000256
9147,2022-03-26 14:15:00,-1177.44,156433.14000000022,161236.17000000025,-4803.030000000028
9148,2022-03-26 14:20:00,-105.25,156327.89000000022,161236.17000000025,-4908.280000000028
9149,2022-03-26 14:25:00,1691.57,158019.46000000022,161236.17000000025,-3216.710000000021
9150,2022-03-26 14:30:00,-748.67,157270.7900000002,161236.17000000025,-3965.3800000000338
9151,2022-03-26 14:35:00,1377.8,158648.5900000002,161236.17000000025,-2587.5800000000454
9152,2022-03-26 14:40:00,-420.3,158228.2900000002,161236.17000000025,-3007.8800000000338
9153,2022-03-26 14:45:00,418.53,158646.8200000002,161236.17000000025,-2589.350000000035
9154,2022-03-26 14:50:00,307.23,158954.05000000022,161236.17000000025,-2282.1200000000244
9155,2022-03-26 14:55:00,43.66,158997.71000000022,161236.17000000025,-2238.460000000021
9156,2022-03-26 15:00:00,-270.18,158727.53000000023,161236.17000000025,-2508.640000000014
9157,2022-03-26 15:05:00,1437.11,160164.64000000022,161236.17000000025,-1071.530000000028
9158,2022-03-26 15:10:00,13.9,160178.5400000002,161236.17000000025,-1057.6300000000338
9159,2022-03-26 15:15:00,-1103.59,159074.95000000022,161236.17000000025,-2161.2200000000303
9160,2022-03-26 15:20:00,-1967.68,157107.27000000022,161236.17000000025,-4128.900000000023
9161,2022-03-26 15:25:00,1808.83,158916.1000000002,161236.17000000025,-2320.070000000036
9162,2022-03-26 15:30:00,434.37,159350.4700000002,161236.17000000025,-1885.7000000000407
9163,2022-03-26 15:35:00,-96.27,159254.20000000022,161236.17000000025,-1981.9700000000303
9164,2022-03-26 15:40:00,87.59,159341.7900000002,161236.17000000025,-1894.3800000000338
9165,2022-03-26 15:45:00,-1102.93,158238.86000000022,161236.17000000025,-2997.310000000027
9166,2022-03-26 15:50:00,232.35,158471.21000000022,161236.17000000025,-2764.960000000021
9167,2022-03-26 15:55:00,393.71,158864.92000000022,161236.17000000025,-2371.250000000029
9168,2022-03-26 16:00:00,-590.79,158274.1300000002,161236.17000000025,-2962.0400000000373
9169,2022-03-26 16:05:00,1680.69,159954.8200000002,161236.17000000025,-1281.350000000035
9170,2022-03-26 16:10:00,459.32,160414.14000000022,161236.17000000025,-822.0300000000279
9171,2022-03-26 16:15:00,1078.94,161493.08000000022,161236.17000000025,256.9099999999744
9172,2022-03-26 16:20:00,348.23,161841.31000000023,161236.17000000025,605.1399999999849
9173,2022-03-26 16:25:00,-1072.65,160768.66000000024,161236.17000000025,-467.5100000000093
9174,2022-03-26 16:30:00,-307.87,160460.79000000024,161236.17000000025,-775.3800000000047
9175,2022-03-26 16:35:00,942.26,161403.05000000025,161236.17000000025,166.88000000000466
9176,2022-03-26 16:40:00,1661.82,163064.87000000026,161236.17000000025,1828.7000000000116
9177,2022-03-26 16:45:00,-1397.96,161666.91000000027,161236.17000000025,430.7400000000198
9178,2022-03-26 16:50:00,-661.29,161005.62000000026,161236.17000000025,-230.54999999998836
9179,2022-03-26 16:55:00,-929.04,160076.58000000025,161236.17000000025,-1159.5899999999965
9180,2022-03-27 08:00:00,1533.88,161610.46000000025,160076.58000000025,1533.8800000000047
9181,2022-03-27 08:05:00,272.93,161883.39000000025,160076.58000000025,1806.8099999999977
9182,2022-03-27 08:10:00,1828.2,163711.59000000026,160076.58000000025,3635.0100000000093
9183,2022-03-27 08:15:00,-627.49,163084.10000000027,160076.58000000025,3007.5200000000186
9184,2022-03-27 08:20:00,996.15,164080.25000000026,160076.58000000025,4003.670000000013
9185,2022-03-27 08:25:00,-989.69,163090.56000000026,160076.58000000025,3013.9800000000105
9186,2022-03-27 08:30:00,-506.75,162583.81000000026,160076.58000000025,2507.2300000000105
9187,2022-03-27 08:35:00,1382.88,163966.69000000026,160076.58000000025,3890.110000000015
9188,2022-03-27 08:40:00,-1053.91,162912.78000000026,160076.58000000025,2836.2000000000116
9189,2022-03-27 08:45:00,-1496.86,161415.92000000027,160076.58000000025,1339.3400000000256
9190,2022-03-27 08:50:00,1376.97,162792.89000000028,160076.58000000025,2716.310000000027
9191,2022-03-27 08:55:00,-815.11,161977.7800000003,160076.58000000025,1901.2000000000407
9192,2022-03-27 09:00:00,1028.63,163006.4100000003,160076.58000000025,2929.8300000000454
9193,2022-03-27 09:05:00,-965.1,162041.3100000003,160076.58000000025,1964.7300000000396
9194,2022-03-27 09:10:00,1354.39,163395.7000000003,160076.58000000025,3319.1200000000536
9195,2022-03-27 09:15:00,-247.05,163148.6500000003,160076.58000000025,3072.070000000065
9196,2022-03-27 09:20:00,1818.35,164967.00000000032,160076.58000000025,4890.420000000071
9197,2022-03-27 09:25:00,-104.24,164862.76000000033,160076.58000000025,4786.18000000008
9198,2022-03-27 09:30:00,1789.49,166652.25000000032,160076.58000000025,6575.670000000071
9199,2022-03-27 09:35:00,1077.78,167730.03000000032,160076.58000000025,7653.45000000007
9200,2022-03-27 09:40:00,789.2,168519.23000000033,160076.58000000025,8442.650000000081
9201,2022-03-27 09:45:00,-1592.14,166927.09000000032,160076.58000000025,6850.5100000000675
9202,2022-03-27 09:50:00,-760.02,166167.07000000033,160076.58000000025,6090.490000000078
9203,2022-03-27 09:55:00,-653.53,165513.54000000033,160076.58000000025,5436.960000000079
9204,2022-03-27 10:00:00,1001.82,166515.36000000034,160076.58000000025,6438.780000000086
9205,2022-03-27 10:05:00,-1394.66,165120.70000000033,160076.58000000025,5044.120000000083
9206,2022-03-27 10:10:00,74.03,165194.73000000033,160076.58000000025,5118.1500000000815
9207,2022-03-27 10:15:00,-952.39,164242.34000000032,160076.58000000025,4165.7600000000675
9208,2022-03-27 10:20:00,1434.44,165676.78000000032,160076.58000000025,5600.20000000007
9209,2022-03-27 10:25:00,1942.5,167619.28000000032,160076.58000000025,7542.70000000007
9210,2022-03-27 10:30:00,-1945.54,165673.7400000003,160076.58000000025,5597.160000000062
9211,2022-03-27 10:35:00,970.42,166644.16000000032,160076.58000000025,6567.5800000000745
9212,2022-03-27 10:40:00,-482.23,166161.9300000003,160076.58000000025,6085.350000000064
9213,2022-03-27 10:45:00,1221.71,167383.6400000003,160076.58000000025,7307.060000000056
9214,2022-03-27 10:50:00,-841.27,166542.37000000032,160076.58000000025,6465.790000000066
9215,2022-03-27 10:55:00,-44.49,166497.88000000032,160076.58000000025,6421.300000000076
9216,2022-03-27 11:00:00,-1997.28,164500.60000000033,160076.58000000025,4424.020000000077
9217,2022-03-27 11:05:00,-1961.57,162539.03000000032,160076.58000000025,2462.45000000007
9218,2022-03-27 11:10:00,162.06,162701.09000000032,160076.58000000025,2624.5100000000675
9219,2022-03-27 11:15:00,1216.9,163917.9900000003,160076.58000000025,3841.4100000000617
9220,2022-03-27 11:20:00,-303.84,163614.1500000003,160076.58000000025,3537.570000000065
9221,2022-03-27 11:25:00,-1185.59,162428.56000000032,160076.58000000025,2351.9800000000687
9222,2022-03-27 11:30:00,1391.72,163820.28000000032,160076.58000000025,3743.70000000007
9223,2022-03-27 11:35:00,1875.12,165695.4000000003,160076.58000000025,5618.820000000065
9224,2022-03-27 11:40:00,1617.46,167312.8600000003,160076.58000000025,7236.280000000057
9225,2022-03-27 11:45:00,1171.66,168484.5200000003,160076.58000000025,8407.94000000006
9226,2022-03-27 11:50:00,1739.0,170223.5200000003,160076.58000000025,10146.94000000006
9227,2022-03-27 11:55:00,1357.05,171580.5700000003,160076.58000000025,11503.990000000049
9228,2022-03-27 12:00:00,-1127.0,170453.5700000003,160076.58000000025,10376.990000000049
9229,2022-03-27 12:05:00,-1910.12,168543.4500000003,160076.58000000025,8466.870000000054
9230,2022-03-27 12:10:00,1760.6,170304.0500000003,160076.58000000025,10227.47000000006
9231,2022-03-27 12:15:00,1344.78,171648.8300000003,160076.58000000025,11572.250000000058
9232,2022-03-27 12:20:00,233.68,171882.5100000003,160076.58000000025,11805.930000000051
9233,2022-03-27 12:25:00,214.92,172097.4300000003,160076.58000000025,12020.850000000064
9234,2022-03-27 12:30:00,836.16,172933.59000000032,160076.58000000025,12857.010000000068
9235,2022-03-27 12:35:00,-1365.61,171567.98000000033,160076.58000000025,11491.400000000081
9236,2022-03-27 12:40:00,1487.0,173054.98000000033,160076.58000000025,12978.400000000081
9237,2022-03-27 12:45:00,862.29,173917.27000000034,160076.58000000025,13840.69000000009
9238,2022-03-27 12:50:00,1408.56,175325.83000000034,160076.58000000025,15249.250000000087
9239,2022-03-27 12:55:00,-1136.12,174189.71000000034,160076.58000000025,14113.130000000092
9240,2022-03-27 13:00:00,-880.07,173309.64000000033,160076.58000000025,13233.060000000085
9241,2022-03-27 13:05:00,894.64,174204.28000000035,160076.58000000025,14127.700000000099
9242,2022-03-27 13:10:00,1479.92,175684.20000000036,160076.58000000025,15607.620000000112
9243,2022-03-27 13:15:00,-119.46,175564.74000000037,160076.58000000025,15488.16000000012
9244,2022-03-27 13:20:00,571.26,176136.00000000038,160076.58000000025,16059.42000000013
9245,2022-03-27 13:25:00,640.99,176776.99000000037,160076.58000000025,16700.41000000012
9246,2022-03-27 13:30:00,-1263.29,175513.70000000036,160076.58000000025,15437.120000000112
9247,2022-03-27 13:35:00,-961.33,174552.37000000037,160076.58000000025,14475.790000000125
9248,2022-03-27 13:40:00,681.65,175234.02000000037,160076.58000000025,15157.440000000119
9249,2022-03-27 13:45:00,-878.55,174355.47000000038,160076.58000000025,14278.89000000013
9250,2022-03-27 13:50:00,1367.2,175722.6700000004,160076.58000000025,15646.090000000142
9251,2022-03-27 13:55:00,-1824.3,173898.3700000004,160076.58000000025,13821.790000000154
9252,2022-03-27 14:00:00,880.63,174779.0000000004,160076.58000000025,14702.420000000158
9253,2022-03-27 14:05:00,-1779.63,172999.3700000004,160076.58000000025,12922.790000000154
9254,2022-03-27 14:10:00,422.09,173421.4600000004,160076.58000000025,13344.88000000015
9255,2022-03-27 14:15:00,1751.39,175172.8500000004,160076.58000000025,15096.270000000164
9256,2022-03-27 14:20:00,-225.75,174947.1000000004,160076.58000000025,14870.520000000164
9257,2022-03-27 14:25:00,-1445.95,173501.1500000004,160076.58000000025,13424.570000000153
9258,2022-03-27 14:30:00,1489.58,174990.7300000004,160076.58000000025,14914.15000000014
9259,2022-03-27 14:35:00,1209.34,176200.07000000039,160076.58000000025,16123.490000000136
9260,2022-03-27 14:40:00,1592.85,177792.9200000004,160076.58000000025,17716.340000000142
9261,2022-03-27 14:45:00,365.5,178158.4200000004,160076.58000000025,18081.840000000142
9262,2022-03-27 14:50:00,-1820.06,176338.3600000004,160076.58000000025,16261.780000000144
9263,2022-03-27 14:55:00,-1712.73,174625.63000000038,160076.58000000025,14549.050000000134
9264,2022-03-27 15:00:00,-431.47,174194.16000000038,160076.58000000025,14117.580000000133
9265,2022-03-27 15:05:00,1265.26,175459.4200000004,160076.58000000025,15382.840000000142
9266,2022-03-27 15:10:00,-1516.22,173943.2000000004,160076.58000000025,13866.62000000014
9267,2022-03-27 15:15:00,-275.27,173667.9300000004,160076.58000000025,13591.350000000151
9268,2022-03-27 15:20:00,293.4,173961.3300000004,160076.58000000025,13884.750000000146
9269,2022-03-27 15:25:00,-1713.66,172247.6700000004,160076.58000000025,12171.090000000142
9270,2022-03-27 15:30:00,1429.76,173677.4300000004,160076.58000000025,13600.850000000151
9271,2022-03-27 15:35:00,1236.33,174913.7600000004,160076.58000000025,14837.180000000139
9272,2022-03-27 15:40:00,745.26,175659.0200000004,160076.58000000025,15582.440000000148
9273,2022-03-27 15:45:00,-294.32,175364.7000000004,160076.58000000025,15288.12000000014
9274,2022-03-27 15:50:00,1677.28,177041.9800000004,160076.58000000025,16965.40000000014
9275,2022-03-27 15:55:00,-16.85,177025.13000000038,160076.58000000025,16948.550000000134
9276,2022-03-27 16:00:00,-1564.59,175460.5400000004,160076.58000000025,15383.960000000137
9277,2022-03-27 16:05:00,668.36,176128.90000000037,160076.58000000025,16052.320000000123
9278,2022-03-27 16:10:00,-1821.58,174307.32000000039,160076.58000000025,14230.740000000136
9279,2022-03-27 16:15:00,995.1,175302.4200000004,160076.58000000025,15225.840000000142
9280,2022-03-27 16:20:00,-1571.32,173731.10000000038,160076.58000000025,13654.520000000135
9281,2022-03-27 16:25:00,1850.39,175581.4900000004,160076.58000000025,15504.910000000149
9282,2022-03-27 16:30:00,-1693.92,173887.57000000039,160076.58000000025,13810.990000000136
9283,2022-03-27 16:35:00,1644.93,175532.50000000038,160076.58000000025,15455.92000000013
9284,2022-03-27 16:40:00,-1395.29,174137.21000000037,160076.58000000025,14060.630000000121
9285,2022-03-27 16:45:00,472.39,174609.60000000038,160076.58000000025,14533.020000000135
9286,2022-03-27 16:50:00,1069.9,175679.50000000038,160076.58000000025,15602.92000000013
9287,2022-03-27 16:55:00,1817.76,177497.2600000004,160076.58000000025,17420.68000000014
9288,2022-03-28 08:00:00,412.9,177910.16000000038,177497.2600000004,412.8999999999942
9289,2022-03-28 08:05:00,1373.17,179283.3300000004,177497.2600000004,1786.070000000007
9290,2022-03-28 08:10:00,-1640.89,177642.44000000038,177497.2600000004,145.17999999999302
9291,2022-03-28 08:15:00,-1157.02,176485.4200000004,177497.2600000004,-1011.8399999999965
9292,2022-03-28 08:20:00,-730.18,175755.2400000004,177497.2600000004,-1742.0199999999895
9293,2022-03-28 08:25:00,876.99,176632.2300000004,177497.2600000004,-865.0299999999988
9294,2022-03-28 08:30:00,-1865.94,174766.2900000004,177497.2600000004,-2730.970000000001
9295,2022-03-28 08:35:00,814.45,175580.7400000004,177497.2600000004,-1916.5199999999895
9296,2022-03-28 08:40:00,-1897.23,173683.5100000004,177497.2600000004,-3813.75
9297,2022-03-28 08:45:00,-669.35,173014.16000000038,177497.2600000004,-4483.100000000006
9298,2022-03-28 08:50:00,1192.74,174206.90000000037,177497.2600000004,-3290.360000000015
9299,2022-03-28 08:55:00,1301.69,175508.59000000037,177497.2600000004,-1988.6700000000128
9300,2022-03-28 09:00:00,-269.59,175239.00000000038,177497.2600000004,-2258.2600000000093
9301,2022-03-28 09:05:00,-392.11,174846.8900000004,177497.2600000004,-2650.3699999999953
9302,2022-03-28 09:10:00,-180.57,174666.32000000039,177497.2600000004,-2830.9400000000023
9303,2022-03-28 09:15:00,71.44,174737.7600000004,177497.2600000004,-2759.5
9304,2022-03-28 09:20:00,-1496.65,173241.1100000004,177497.2600000004,-4256.149999999994
9305,2022-03-28 09:25:00,1243.84,174484.9500000004,177497.2600000004,-3012.3099999999977
9306,2022-03-28 09:30:00,770.29,175255.2400000004,177497.2600000004,-2242.0199999999895
9307,2022-03-28 09:35:00,231.64,175486.8800000004,177497.2600000004,-2010.3799999999756
9308,2022-03-28 09:40:00,1325.07,176811.95000000042,177497.2600000004,-685.3099999999686
9309,2022-03-28 09:45:00,-1256.77,175555.18000000043,177497.2600000004,-1942.079999999958
9310,2022-03-28 09:50:00,-898.03,174657.15000000043,177497.2600000004,-2840.109999999957
9311,2022-03-28 09:55:00,601.56,175258.71000000043,177497.2600000004,-2238.5499999999593
9312,2022-03-28 10:00:00,1621.27,176879.98000000042,177497.2600000004,-617.2799999999697
9313,2022-03-28 10:05:00,1405.8,178285.7800000004,177497.2600000004,788.5200000000186
9314,2022-03-28 10:10:00,1004.7,179290.48000000042,177497.2600000004,1793.2200000000303
9315,2022-03-28 10:15:00,1380.54,180671.02000000043,177497.2600000004,3173.7600000000384
9316,2022-03-28 10:20:00,-1170.51,179500.51000000042,177497.2600000004,2003.250000000029
9317,2022-03-28 10:25:00,-803.0,178697.51000000042,177497.2600000004,1200.250000000029
9318,2022-03-28 10:30:00,477.79,179175.30000000042,177497.2600000004,1678.0400000000373
9319,2022-03-28 10:35:00,-226.29,178949.01000000042,177497.2600000004,1451.750000000029
9320,2022-03-28 10:40:00,-75.32,178873.6900000004,177497.2600000004,1376.4300000000221
9321,2022-03-28 10:45:00,-1537.91,177335.7800000004,177497.2600000004,-161.47999999998137
9322,2022-03-28 10:50:00,559.56,177895.3400000004,177497.2600000004,398.0800000000163
9323,2022-03-28 10:55:00,1768.41,179663.7500000004,177497.2600000004,2166.49000000002
9324,2022-03-28 11:00:00,-843.93,178819.8200000004,177497.2600000004,1322.5600000000268
9325,2022-03-28 11:05:00,-335.41,178484.4100000004,177497.2600000004,987.1500000000233
9326,2022-03-28 11:10:00,1524.04,180008.45000000042,177497.2600000004,2511.1900000000314
9327,2022-03-28 11:15:00,-478.26,179530.1900000004,177497.2600000004,2032.9300000000221
9328,2022-03-28 11:20:00,787.75,180317.9400000004,177497.2600000004,2820.680000000022
9329,2022-03-28 11:25:00,1743.79,182061.73000000042,177497.2600000004,4564.47000000003
9330,2022-03-28 11:30:00,1156.64,183218.37000000043,177497.2600000004,5721.110000000044
9331,2022-03-28 11:35:00,-1858.51,181359.86000000042,177497.2600000004,3862.600000000035
9332,2022-03-28 11:40:00,132.69,181492.55000000042,177497.2600000004,3995.2900000000373
9333,2022-03-28 11:45:00,462.6,181955.15000000043,177497.2600000004,4457.890000000043
9334,2022-03-28 11:50:00,1694.37,183649.52000000043,177497.2600000004,6152.260000000038
9335,2022-03-28 11:55:00,-863.9,182785.62000000043,177497.2600000004,5288.360000000044
9336,2022-03-28 12:00:00,-265.36,182520.26000000045,177497.2600000004,5023.000000000058
9337,2022-03-28 12:05:00,855.94,183376.20000000045,177497.2600000004,5878.9400000000605
9338,2022-03-28 12:10:00,-1051.92,182324.28000000044,177497.2600000004,4827.020000000048
9339,2022-03-28 12:15:00,-335.82,181988.46000000043,177497.2600000004,4491.200000000041
9340,2022-03-28 12:20:00,1450.23,183438.69000000044,177497.2600000004,5941.430000000051
9341,2022-03-28 12:25:00,1776.42,185215.11000000045,177497.2600000004,7717.850000000064
9342,2022-03-28 12:30:00,854.43,186069.54000000044,177497.2600000004,8572.280000000057
9343,2022-03-28 12:35:00,-1762.93,184306.61000000045,177497.2600000004,6809.350000000064
9344,2022-03-28 12:40:00,-964.61,183342.00000000047,177497.2600000004,5844.740000000078
9345,2022-03-28 12:45:00,653.56,183995.56000000046,177497.2600000004,6498.300000000076
9346,2022-03-28 12:50:00,-822.29,183173.27000000046,177497.2600000004,5676.0100000000675
9347,2022-03-28 12:55:00,315.2,183488.47000000047,177497.2600000004,5991.210000000079
9348,2022-03-28 13:00:00,-1574.88,181913.59000000046,177497.2600000004,4416.3300000000745
9349,2022-03-28 13:05:00,-1422.15,180491.44000000047,177497.2600000004,2994.1800000000803
9350,2022-03-28 13:10:00,1324.63,181816.07000000047,177497.2600000004,4318.810000000085
9351,2022-03-28 13:15:00,931.92,182747.9900000005,177497.2600000004,5250.730000000098
9352,2022-03-28 13:20:00,1510.17,184258.1600000005,177497.2600000004,6760.900000000111
9353,2022-03-28 13:25:00,-1711.9,182546.2600000005,177497.2600000004,5049.000000000116
9354,2022-03-28 13:30:00,-1355.8,181190.46000000052,177497.2600000004,3693.200000000128
9355,2022-03-28 13:35:00,-1722.89,179467.5700000005,177497.2600000004,1970.310000000114
9356,2022-03-28 13:40:00,-256.83,179210.74000000051,177497.2600000004,1713.480000000127
9357,2022-03-28 13:45:00,54.94,179265.68000000052,177497.2600000004,1768.4200000001292
9358,2022-03-28 13:50:00,330.87,179596.5500000005,177497.2600000004,2099.2900000001246
9359,2022-03-28 13:55:00,-559.19,179037.3600000005,177497.2600000004,1540.1000000001222
9360,2022-03-28 14:00:00,590.58,179627.9400000005,177497.2600000004,2130.6800000001094
9361,2022-03-28 14:05:00,-180.32,179447.6200000005,177497.2600000004,1950.3600000001024
9362,2022-03-28 14:10:00,237.46,179685.08000000048,177497.2600000004,2187.8200000000943
9363,2022-03-28 14:15:00,182.6,179867.6800000005,177497.2600000004,2370.4200000001
9364,2022-03-28 14:20:00,-282.11,179585.5700000005,177497.2600000004,2088.310000000114
9365,2022-03-28 14:25:00,343.03,179928.6000000005,177497.2600000004,2431.340000000113
9366,2022-03-28 14:30:00,1106.41,181035.0100000005,177497.2600000004,3537.7500000001164
9367,2022-03-28 14:35:00,-196.91,180838.1000000005,177497.2600000004,3340.840000000113
9368,2022-03-28 14:40:00,-977.14,179860.9600000005,177497.2600000004,2363.700000000099
9369,2022-03-28 14:45:00,1877.99,181738.95000000048,177497.2600000004,4241.69000000009
9370,2022-03-28 14:50:00,-996.97,180741.98000000048,177497.2600000004,3244.7200000000885
9371,2022-03-28 14:55:00,1165.57,181907.55000000048,177497.2600000004,4410.2900000000955
9372,2022-03-28 15:00:00,1994.59,183902.14000000048,177497.2600000004,6404.880000000092
9373,2022-03-28 15:05:00,-1286.85,182615.29000000047,177497.2600000004,5118.030000000086
9374,2022-03-28 15:10:00,-1083.16,181532.13000000047,177497.2600000004,4034.8700000000827
9375,2022-03-28 15:15:00,-1.76,181530.37000000046,177497.2600000004,4033.1100000000733
9376,2022-03-28 15:20:00,-265.24,181265.13000000047,177497.2600000004,3767.8700000000827
9377,2022-03-28 15:25:00,-1933.5,179331.63000000047,177497.2600000004,1834.3700000000827
9378,2022-03-28 15:30:00,789.31,180120.94000000047,177497.2600000004,2623.6800000000803
9379,2022-03-28 15:35:00,-461.05,179659.89000000048,177497.2600000004,2162.630000000092
9380,2022-03-28 15:40:00,-1973.04,177686.85000000047,177497.2600000004,189.59000000008382
9381,2022-03-28 15:45:00,-1625.48,176061.37000000046,177497.2600000004,-1435.8899999999267
9382,2022-03-28 15:50:00,335.06,176396.43000000046,177497.2600000004,-1100.829999999929
9383,2022-03-28 15:55:00,1729.54,178125.97000000047,177497.2600000004,628.7100000000792
9384,2022-03-28 16:00:00,-936.5,177189.47000000047,177497.2600000004,-307.78999999992084
9385,2022-03-28 16:05:00,905.93,178095.40000000046,177497.2600000004,598.1400000000722
9386,2022-03-28 16:10:00,1541.05,179636.45000000045,177497.2600000004,2139.1900000000605
9387,2022-03-28 16:15:00,1785.72,181422.17000000045,177497.2600000004,3924.9100000000617
9388,2022-03-28 16:20:00,515.41,181937.58000000045,177497.2600000004,4440.320000000065
9389,2022-03-28 16:25:00,1278.62,183216.20000000045,177497.2600000004,5718.9400000000605
9390,2022-03-28 16:30:00,-1867.54,181348.66000000044,177497.2600000004,3851.4000000000524
9391,2022-03-28 16:35:00,-383.82,180964.84000000043,177497.2600000004,3467.5800000000454
9392,2022-03-28 16:40:00,178.83,181143.67000000042,177497.2600000004,3646.4100000000326
9393,2022-03-28 16:45:00,-1633.56,179510.11000000042,177497.2600000004,2012.850000000035
9394,2022-03-28 16:50:00,977.01,180487.12000000043,177497.2600000004,2989.8600000000442
9395,2022-03-28 16:55:00,3.88,180491.00000000044,177497.2600000004,2993.740000000049
9396,2022-03-29 08:00:00,1977.31,182468.31000000043,180491.00000000044,1977.3099999999977
9397,2022-03-29 08:05:00,1932.69,184401.00000000044,180491.00000000044,3910.0
9398,2022-03-29 08:10:00,-1607.73,182793.27000000043,180491.00000000044,2302.2699999999895
9399,2022-03-29 08:15:00,1607.12,184400.39000000042,180491.00000000044,3909.389999999985
9400,2022-03-29 08:20:00,-508.59,183891.80000000042,180491.00000000044,3400.7999999999884
9401,2022-03-29 08:25:00,1277.05,185168.8500000004,180491.00000000044,4677.849999999977
9402,2022-03-29 08:30:00,-1253.78,183915.0700000004,180491.00000000044,3424.069999999978
9403,2022-03-29 08:35:00,660.13,184575.20000000042,180491.00000000044,4084.1999999999825
9404,2022-03-29 08:40:00,-849.5,183725.70000000042,180491.00000000044,3234.6999999999825
9405,2022-03-29 08:45:00,271.38,183997.08000000042,180491.00000000044,3506.079999999987
9406,2022-03-29 08:50:00,-322.22,183674.86000000042,180491.00000000044,3183.859999999986
9407,2022-03-29 08:55:00,329.54,184004.40000000043,180491.00000000044,3513.399999999994
9408,2022-03-29 09:00:00,-676.19,183328.21000000043,180491.00000000044,2837.209999999992
9409,2022-03-29 09:05:00,-1518.9,181809.31000000043,180491.00000000044,1318.3099999999977
9410,2022-03-29 09:10:00,1160.17,182969.48000000045,180491.00000000044,2478.4800000000105
9411,2022-03-29 09:15:00,-195.05,182774.43000000046,180491.00000000044,2283.430000000022
9412,2022-03-29 09:20:00,1335.48,184109.91000000047,180491.00000000044,3618.9100000000326
9413,2022-03-29 09:25:00,27.89,184137.80000000048,180491.00000000044,3646.8000000000466
9414,2022-03-29 09:30:00,-1759.78,182378.02000000048,180491.00000000044,1887.0200000000477
9415,2022-03-29 09:35:00,-1154.95,181223.07000000047,180491.00000000044,732.0700000000361
9416,2022-03-29 09:40:00,1471.52,182694.59000000046,180491.00000000044,2203.5900000000256
9417,2022-03-29 09:45:00,-796.21,181898.38000000047,180491.00000000044,1407.3800000000338
9418,2022-03-29 09:50:00,-333.45,181564.93000000046,180491.00000000044,1073.9300000000221
9419,2022-03-29 09:55:00,-683.17,180881.76000000045,180491.00000000044,390.7600000000093
9420,2022-03-29 10:00:00,731.14,181612.90000000046,180491.00000000044,1121.9000000000233
9421,2022-03-29 10:05:00,-656.81,180956.09000000046,180491.00000000044,465.0900000000256
9422,2022-03-29 10:10:00,175.31,181131.40000000046,180491.00000000044,640.4000000000233
9423,2022-03-29 10:15:00,-653.15,180478.25000000047,180491.00000000044,-12.749999999970896
9424,2022-03-29 10:20:00,-1532.73,178945.52000000046,180491.00000000044,-1545.4799999999814
9425,2022-03-29 10:25:00,104.74,179050.26000000045,180491.00000000044,-1440.7399999999907
9426,2022-03-29 10:30:00,345.45,179395.71000000046,180491.00000000044,-1095.289999999979
9427,2022-03-29 10:35:00,1022.49,180418.20000000045,180491.00000000044,-72.79999999998836
9428,2022-03-29 10:40:00,811.31,181229.51000000045,180491.00000000044,738.5100000000093
9429,2022-03-29 10:45:00,-895.84,180333.67000000045,180491.00000000044,-157.3299999999872
9430,2022-03-29 10:50:00,-1490.4,178843.27000000046,180491.00000000044,-1647.7299999999814
9431,2022-03-29 10:55:00,521.16,179364.43000000046,180491.00000000044,-1126.5699999999779
9432,2022-03-29 11:00:00,-1849.58,177514.85000000047,180491.00000000044,-2976.149999999965
9433,2022-03-29 11:05:00,994.12,178508.97000000047,180491.00000000044,-1982.0299999999697
9434,2022-03-29 11:10:00,-1409.36,177099.61000000048,180491.00000000044,-3391.3899999999558
9435,2022-03-29 11:15:00,-605.98,176493.63000000047,180491.00000000044,-3997.3699999999662
9436,2022-03-29 11:20:00,1767.12,178260.75000000047,180491.00000000044,-2230.249999999971
9437,2022-03-29 11:25:00,-1682.66,176578.09000000046,180491.00000000044,-3912.9099999999744
9438,2022-03-29 11:30:00,-1172.18,175405.91000000047,180491.00000000044,-5085.089999999967
9439,2022-03-29 11:35:00,1089.28,176495.19000000047,180491.00000000044,-3995.8099999999686
9440,2022-03-29 11:40:00,1155.88,177651.07000000047,180491.00000000044,-2839.929999999964
9441,2022-03-29 11:45:00,636.74,178287.81000000046,180491.00000000044,-2203.189999999973
9442,2022-03-29 11:50:00,404.77,178692.58000000045,180491.00000000044,-1798.4199999999837
9443,2022-03-29 11:55:00,-1342.64,177349.94000000044,180491.00000000044,-3141.0599999999977
9444,2022-03-29 12:00:00,-1782.33,175567.61000000045,180491.00000000044,-4923.389999999985
9445,2022-03-29 12:05:00,57.59,175625.20000000045,180491.00000000044,-4865.799999999988
9446,2022-03-29 12:10:00,-273.57,175351.63000000044,180491.00000000044,-5139.369999999995
9447,2022-03-29 12:15:00,-298.6,175053.03000000044,180491.00000000044,-5437.970000000001
9448,2022-03-29 12:20:00,-1929.27,173123.76000000045,180491.00000000044,-7367.239999999991
9449,2022-03-29 12:25:00,1620.66,174744.42000000045,180491.00000000044,-5746.579999999987
9450,2022-03-29 12:30:00,433.17,175177.59000000046,180491.00000000044,-5313.409999999974
9451,2022-03-29 12:35:00,-1855.09,173322.50000000047,180491.00000000044,-7168.499999999971
9452,2022-03-29 12:40:00,1663.63,174986.13000000047,180491.00000000044,-5504.869999999966
9453,2022-03-29 12:45:00,-756.77,174229.36000000048,180491.00000000044,-6261.639999999956
9454,2022-03-29 12:50:00,-1013.98,173215.38000000047,180491.00000000044,-7275.619999999966
9455,2022-03-29 12:55:00,483.68,173699.06000000046,180491.00000000044,-6791.939999999973
9456,2022-03-29 13:00:00,1927.15,175626.21000000046,180491.00000000044,-4864.789999999979
9457,2022-03-29 13:05:00,-35.73,175590.48000000045,180491.00000000044,-4900.5199999999895
9458,2022-03-29 13:10:00,1597.14,177187.62000000046,180491.00000000044,-3303.3799999999756
9459,2022-03-29 13:15:00,1641.25,178828.87000000046,180491.00000000044,-1662.1299999999756
9460,2022-03-29 13:20:00,1658.31,180487.18000000046,180491.00000000044,-3.819999999977881
9461,2022-03-29 13:25:00,-1324.92,179162.26000000045,180491.00000000044,-1328.7399999999907
9462,2022-03-29 13:30:00,-1283.21,177879.05000000045,180491.00000000044,-2611.9499999999825
9463,2022-03-29 13:35:00,1765.75,179644.80000000045,180491.00000000044,-846.1999999999825
9464,2022-03-29 13:40:00,1499.31,181144.11000000045,180491.00000000044,653.1100000000151
9465,2022-03-29 13:45:00,-712.92,180431.19000000044,180491.00000000044,-59.80999999999767
9466,2022-03-29 13:50:00,957.41,181388.60000000044,180491.00000000044,897.6000000000058
9467,2022-03-29 13:55:00,326.78,181715.38000000044,180491.00000000044,1224.3800000000047
9468,2022-03-29 14:00:00,924.04,182639.42000000045,180491.00000000044,2148.420000000013
9469,2022-03-29 14:05:00,-1763.22,180876.20000000045,180491.00000000044,385.20000000001164
9470,2022-03-29 14:10:00,1830.98,182707.18000000046,180491.00000000044,2216.180000000022
9471,2022-03-29 14:15:00,-236.29,182470.89000000045,180491.00000000044,1979.890000000014
9472,2022-03-29 14:20:00,722.49,183193.38000000044,180491.00000000044,2702.3800000000047
9473,2022-03-29 14:25:00,1814.8,185008.18000000043,180491.00000000044,4517.179999999993
9474,2022-03-29 14:30:00,1165.38,186173.56000000043,180491.00000000044,5682.559999999998
9475,2022-03-29 14:35:00,937.97,187111.53000000044,180491.00000000044,6620.529999999999
9476,2022-03-29 14:40:00,1864.05,188975.58000000042,180491.00000000044,8484.579999999987
9477,2022-03-29 14:45:00,-477.3,188498.28000000044,180491.00000000044,8007.279999999999
9478,2022-03-29 14:50:00,-1156.81,187341.47000000044,180491.00000000044,6850.470000000001
9479,2022-03-29 14:55:00,800.08,188141.55000000042,180491.00000000044,7650.549999999988
9480,2022-03-29 15:00:00,-177.56,187963.99000000043,180491.00000000044,7472.989999999991
9481,2022-03-29 15:05:00,991.03,188955.02000000043,180491.00000000044,8464.01999999999
9482,2022-03-29 15:10:00,-1669.24,187285.78000000044,180491.00000000044,6794.779999999999
9483,2022-03-29 15:15:00,769.04,188054.82000000044,180491.00000000044,7563.820000000007
9484,2022-03-29 15:20:00,-1028.88,187025.94000000044,180491.00000000044,6534.940000000002
9485,2022-03-29 15:25:00,-1786.91,185239.03000000044,180491.00000000044,4748.029999999999
9486,2022-03-29 15:30:00,-1893.24,183345.79000000044,180491.00000000044,2854.790000000008
9487,2022-03-29 15:35:00,-753.7,182592.09000000043,180491.00000000044,2101.0899999999965
9488,2022-03-29 15:40:00,-1765.56,180826.53000000044,180491.00000000044,335.52999999999884
9489,2022-03-29 15:45:00,-1545.33,179281.20000000045,180491.00000000044,-1209.7999999999884
9490,2022-03-29 15:50:00,1686.58,180967.78000000044,180491.00000000044,476.77999999999884
9491,2022-03-29 15:55:00,1129.64,182097.42000000045,180491.00000000044,1606.4200000000128
9492,2022-03-29 16:00:00,-587.21,181510.21000000046,180491.00000000044,1019.210000000021
9493,2022-03-29 16:05:00,572.57,182082.78000000046,180491.00000000044,1591.780000000028
9494,2022-03-29 16:10:00,161.05,182243.83000000045,180491.00000000044,1752.8300000000163
9495,2022-03-29 16:15:00,813.49,183057.32000000044,180491.00000000044,2566.320000000007
9496,2022-03-29 16:20:00,945.71,184003.03000000044,180491.00000000044,3512.029999999999
9497,2022-03-29 16:25:00,1555.88,185558.91000000044,180491.00000000044,5067.9100000000035
9498,2022-03-29 16:30:00,1493.1,187052.01000000045,180491.00000000044,6561.010000000009
9499,2022-03-29 16:35:00,-312.91,186739.10000000044,180491.00000000044,6248.100000000006
9500,2022-03-29 16:40:00,1922.52,188661.62000000043,180491.00000000044,8170.619999999995
9501,2022-03-29 16:45:00,1944.86,190606.48000000042,180491.00000000044,10115.479999999981
9502,2022-03-29 16:50:00,-956.66,189649.8200000004,180491.00000000044,9158.819999999978
9503,2022-03-29 16:55:00,108.08,189757.9000000004,180491.00000000044,9266.899999999965
9504,2022-03-30 08:00:00,1770.22,191528.1200000004,189757.9000000004,1770.2200000000012
9505,2022-03-30 08:05:00,-1395.76,190132.3600000004,189757.9000000004,374.45999999999185
9506,2022-03-30 08:10:00,1034.71,191167.07000000039,189757.9000000004,1409.1699999999837
9507,2022-03-30 08:15:00,-1415.64,189751.43000000037,189757.9000000004,-6.470000000030268
9508,2022-03-30 08:20:00,-237.63,189513.80000000037,189757.9000000004,-244.10000000003492
9509,2022-03-30 08:25:00,513.15,190026.95000000036,189757.9000000004,269.04999999995925
9510,2022-03-30 08:30:00,1000.27,191027.22000000035,189757.9000000004,1269.3199999999488
9511,2022-03-30 08:35:00,857.6,191884.82000000036,189757.9000000004,2126.9199999999546
9512,2022-03-30 08:40:00,-418.66,191466.16000000035,189757.9000000004,1708.259999999951
9513,2022-03-30 08:45:00,1738.38,193204.54000000036,189757.9000000004,3446.6399999999558
9514,2022-03-30 08:50:00,421.42,193625.96000000037,189757.9000000004,3868.0599999999686
9515,2022-03-30 08:55:00,1771.22,195397.18000000037,189757.9000000004,5639.27999999997
9516,2022-03-30 09:00:00,-1209.88,194187.30000000037,189757.9000000004,4429.399999999965
9517,2022-03-30 09:05:00,-337.33,193849.97000000038,189757.9000000004,4092.069999999978
9518,2022-03-30 09:10:00,-63.35,193786.62000000037,189757.9000000004,4028.719999999972
9519,2022-03-30 09:15:00,-1167.12,192619.50000000038,189757.9000000004,2861.5999999999767
9520,2022-03-30 09:20:00,1311.2,193930.7000000004,189757.9000000004,4172.799999999988
9521,2022-03-30 09:25:00,1176.97,195107.6700000004,189757.9000000004,5349.7699999999895
9522,2022-03-30 09:30:00,-1088.57,194019.10000000038,189757.9000000004,4261.1999999999825
9523,2022-03-30 09:35:00,342.2,194361.3000000004,189757.9000000004,4603.399999999994
9524,2022-03-30 09:40:00,429.79,194791.0900000004,189757.9000000004,5033.190000000002
9525,2022-03-30 09:45:00,1623.53,196414.6200000004,189757.9000000004,6656.720000000001
9526,2022-03-30 09:50:00,619.12,197033.7400000004,189757.9000000004,7275.8399999999965
9527,2022-03-30 09:55:00,-1995.36,195038.3800000004,189757.9000000004,5280.4800000000105
9528,2022-03-30 10:00:00,743.41,195781.79000000042,189757.9000000004,6023.890000000014
9529,2022-03-30 10:05:00,50.66,195832.45000000042,189757.9000000004,6074.5500000000175
9530,2022-03-30 10:10:00,1251.02,197083.4700000004,189757.9000000004,7325.570000000007
9531,2022-03-30 10:15:00,540.07,197623.54000000042,189757.9000000004,7865.640000000014
9532,2022-03-30 10:20:00,-1027.17,196596.3700000004,189757.9000000004,6838.470000000001
9533,2022-03-30 10:25:00,591.83,197188.2000000004,189757.9000000004,7430.299999999988
9534,2022-03-30 10:30:00,689.91,197878.1100000004,189757.9000000004,8120.209999999992
9535,2022-03-30 10:35:00,-966.85,196911.2600000004,189757.9000000004,7153.359999999986
9536,2022-03-30 10:40:00,-1740.13,195171.13000000038,189757.9000000004,5413.229999999981
9537,2022-03-30 10:45:00,-347.81,194823.32000000039,189757.9000000004,5065.419999999984
9538,2022-03-30 10:50:00,-520.38,194302.94000000038,189757.9000000004,4545.039999999979
9539,2022-03-30 10:55:00,984.14,195287.0800000004,189757.9000000004,5529.179999999993
9540,2022-03-30 11:00:00,-175.54,195111.5400000004,189757.9000000004,5353.639999999985
9541,2022-03-30 11:05:00,1367.11,196478.65000000037,189757.9000000004,6720.749999999971
9542,2022-03-30 11:10:00,866.94,197345.59000000037,189757.9000000004,7587.689999999973
9543,2022-03-30 11:15:00,965.33,198310.92000000036,189757.9000000004,8553.01999999996
9544,2022-03-30 11:20:00,401.35,198712.27000000037,189757.9000000004,8954.369999999966
9545,2022-03-30 11:25:00,-1784.72,196927.55000000037,189757.9000000004,7169.649999999965
9546,2022-03-30 11:30:00,-1218.18,195709.37000000037,189757.9000000004,5951.469999999972
9547,2022-03-30 11:35:00,-345.58,195363.7900000004,189757.9000000004,5605.889999999985
9548,2022-03-30 11:40:00,-344.89,195018.90000000037,189757.9000000004,5260.999999999971
9549,2022-03-30 11:45:00,526.84,195545.74000000037,189757.9000000004,5787.839999999967
9550,2022-03-30 11:50:00,-754.68,194791.06000000038,189757.9000000004,5033.159999999974
9551,2022-03-30 11:55:00,1633.02,196424.08000000037,189757.9000000004,6666.179999999964
9552,2022-03-30 12:00:00,709.69,197133.77000000037,189757.9000000004,7375.869999999966
9553,2022-03-30 12:05:00,-1199.11,195934.66000000038,189757.9000000004,6176.75999999998
9554,2022-03-30 12:10:00,1702.95,197637.6100000004,189757.9000000004,7879.709999999992
9555,2022-03-30 12:15:00,1569.55,199207.16000000038,189757.9000000004,9449.25999999998
9556,2022-03-30 12:20:00,1134.33,200341.49000000037,189757.9000000004,10583.589999999967
9557,2022-03-30 12:25:00,566.55,200908.04000000036,189757.9000000004,11150.139999999956
9558,2022-03-30 12:30:00,-311.24,200596.80000000037,189757.9000000004,10838.899999999965
9559,2022-03-30 12:35:00,-1047.83,199548.97000000038,189757.9000000004,9791.069999999978
9560,2022-03-30 12:40:00,-353.15,199195.82000000039,189757.9000000004,9437.919999999984
9561,2022-03-30 12:45:00,1524.25,200720.07000000039,189757.9000000004,10962.169999999984
9562,2022-03-30 12:50:00,-493.34,200226.7300000004,189757.9000000004,10468.829999999987
9563,2022-03-30 12:55:00,280.34,200507.07000000039,189757.9000000004,10749.169999999984
9564,2022-03-30 13:00:00,-297.35,200209.72000000038,189757.9000000004,10451.819999999978
9565,2022-03-30 13:05:00,1478.73,201688.4500000004,189757.9000000004,11930.549999999988
9566,2022-03-30 13:10:00,260.18,201948.63000000038,189757.9000000004,12190.729999999981
9567,2022-03-30 13:15:00,-154.12,201794.5100000004,189757.9000000004,12036.609999999986
9568,2022-03-30 13:20:00,-343.86,201450.6500000004,189757.9000000004,11692.75
9569,2022-03-30 13:25:00,155.23,201605.8800000004,189757.9000000004,11847.98000000001
9570,2022-03-30 13:30:00,-609.73,200996.1500000004,189757.9000000004,11238.25
9571,2022-03-30 13:35:00,-1875.66,199120.4900000004,189757.9000000004,9362.589999999997
9572,2022-03-30 13:40:00,1237.97,200358.4600000004,189757.9000000004,10600.559999999998
9573,2022-03-30 13:45:00,-392.15,199966.3100000004,189757.9000000004,10208.410000000003
9574,2022-03-30 13:50:00,1195.16,201161.4700000004,189757.9000000004,11403.570000000007
9575,2022-03-30 13:55:00,-1684.24,199477.23000000042,189757.9000000004,9719.330000000016
9576,2022-03-30 14:00:00,1442.99,200920.2200000004,189757.9000000004,11162.320000000007
9577,2022-03-30 14:05:00,234.15,201154.3700000004,189757.9000000004,11396.470000000001
9578,2022-03-30 14:10:00,1387.26,202541.6300000004,189757.9000000004,12783.73000000001
9579,2022-03-30 14:15:00,520.1,203061.73000000042,189757.9000000004,13303.830000000016
9580,2022-03-30 14:20:00,1291.07,204352.80000000042,189757.9000000004,14594.900000000023
9581,2022-03-30 14:25:00,1876.02,206228.8200000004,189757.9000000004,16470.920000000013
9582,2022-03-30 14:30:00,1947.95,208176.77000000043,189757.9000000004,18418.870000000024
9583,2022-03-30 14:35:00,-742.67,207434.1000000004,189757.9000000004,17676.20000000001
9584,2022-03-30 14:40:00,590.88,208024.98000000042,189757.9000000004,18267.080000000016
9585,2022-03-30 14:45:00,797.77,208822.7500000004,189757.9000000004,19064.850000000006
9586,2022-03-30 14:50:00,65.98,208888.73000000042,189757.9000000004,19130.830000000016
9587,2022-03-30 14:55:00,-1256.77,207631.96000000043,189757.9000000004,17874.060000000027
9588,2022-03-30 15:00:00,1678.57,209310.53000000044,189757.9000000004,19552.630000000034
9589,2022-03-30 15:05:00,-1778.44,207532.09000000043,189757.9000000004,17774.19000000003
9590,2022-03-30 15:10:00,317.33,207849.42000000042,189757.9000000004,18091.52000000002
9591,2022-03-30 15:15:00,1263.1,209112.52000000043,189757.9000000004,19354.620000000024
9592,2022-03-30 15:20:00,549.67,209662.19000000044,189757.9000000004,19904.290000000037
9593,2022-03-30 15:25:00,-695.52,208966.67000000045,189757.9000000004,19208.770000000048
9594,2022-03-30 15:30:00,-855.6,208111.07000000044,189757.9000000004,18353.170000000042
9595,2022-03-30 15:35:00,536.8,208647.87000000043,189757.9000000004,18889.97000000003
9596,2022-03-30 15:40:00,733.09,209380.96000000043,189757.9000000004,19623.060000000027
9597,2022-03-30 15:45:00,-1461.33,207919.63000000044,189757.9000000004,18161.73000000004
9598,2022-03-30 15:50:00,769.44,208689.07000000044,189757.9000000004,18931.170000000042
9599,2022-03-30 15:55:00,414.75,209103.82000000044,189757.9000000004,19345.920000000042
9600,2022-03-30 16:00:00,-439.67,208664.15000000043,189757.9000000004,18906.25000000003
9601,2022-03-30 16:05:00,1305.13,209969.28000000044,189757.9000000004,20211.380000000034
9602,2022-03-30 16:10:00,-37.09,209932.19000000044,189757.9000000004,20174.290000000037
9603,2022-03-30 16:15:00,1551.88,211484.07000000044,189757.9000000004,21726.170000000042
9604,2022-03-30 16:20:00,458.59,211942.66000000044,189757.9000000004,22184.76000000004
9605,2022-03-30 16:25:00,-50.44,211892.22000000044,189757.9000000004,22134.320000000036
9606,2022-03-30 16:30:00,-584.5,211307.72000000044,189757.9000000004,21549.820000000036
9607,2022-03-30 16:35:00,-428.26,210879.46000000043,189757.9000000004,21121.560000000027
9608,2022-03-30 16:40:00,916.22,211795.68000000043,189757.9000000004,22037.780000000028
9609,2022-03-30 16:45:00,-37.16,211758.52000000043,189757.9000000004,22000.620000000024
9610,2022-03-30 16:50:00,480.98,212239.50000000044,189757.9000000004,22481.600000000035
9611,2022-03-30 16:55:00,1694.93,213934.43000000043,189757.9000000004,24176.530000000028
9612,2022-03-31 08:00:00,-1572.35,212362.08000000042,213934.43000000043,-1572.3500000000058
9613,2022-03-31 08:05:00,1500.86,213862.9400000004,213934.43000000043,-71.49000000001979
9614,2022-03-31 08:10:00,-519.25,213343.6900000004,213934.43000000043,-590.7400000000198
9615,2022-03-31 08:15:00,1349.05,214692.7400000004,213934.43000000043,758.3099999999686
9616,2022-03-31 08:20:00,1844.38,216537.1200000004,213934.43000000043,2602.689999999973
9617,2022-03-31 08:25:00,1490.21,218027.3300000004,213934.43000000043,4092.899999999965
9618,2022-03-31 08:30:00,-605.62,217421.7100000004,213934.43000000043,3487.2799999999697
9619,2022-03-31 08:35:00,1817.17,219238.8800000004,213934.43000000043,5304.4499999999825
9620,2022-03-31 08:40:00,260.21,219499.0900000004,213934.43000000043,5564.659999999974
9621,2022-03-31 08:45:00,-44.94,219454.1500000004,213934.43000000043,5519.719999999972
9622,2022-03-31 08:50:00,1628.1,221082.2500000004,213934.43000000043,7147.819999999978
9623,2022-03-31 08:55:00,1008.2,222090.45000000042,213934.43000000043,8156.0199999999895
9624,2022-03-31 09:00:00,-342.46,221747.99000000043,213934.43000000043,7813.559999999998
9625,2022-03-31 09:05:00,1091.85,222839.84000000043,213934.43000000043,8905.410000000003
9626,2022-03-31 09:10:00,1171.41,224011.25000000044,213934.43000000043,10076.820000000007
9627,2022-03-31 09:15:00,956.13,224967.38000000044,213934.43000000043,11032.950000000012
9628,2022-03-31 09:20:00,-839.56,224127.82000000044,213934.43000000043,10193.390000000014
9629,2022-03-31 09:25:00,902.57,225030.39000000045,213934.43000000043,11095.960000000021
9630,2022-03-31 09:30:00,1601.89,226632.28000000046,213934.43000000043,12697.850000000035
9631,2022-03-31 09:35:00,168.39,226800.67000000048,213934.43000000043,12866.240000000049
9632,2022-03-31 09:40:00,-619.63,226181.04000000047,213934.43000000043,12246.610000000044
9633,2022-03-31 09:45:00,1243.9,227424.94000000047,213934.43000000043,13490.510000000038
9634,2022-03-31 09:50:00,1832.35,229257.29000000047,213934.43000000043,15322.860000000044
9635,2022-03-31 09:55:00,-657.22,228600.07000000047,213934.43000000043,14665.640000000043
9636,2022-03-31 10:00:00,-1478.33,227121.7400000005,213934.43000000043,13187.310000000056
9637,2022-03-31 10:05:00,-1960.63,225161.11000000048,213934.43000000043,11226.680000000051
9638,2022-03-31 10:10:00,-1399.93,223761.1800000005,213934.43000000043,9826.750000000058
9639,2022-03-31 10:15:00,1460.56,225221.7400000005,213934.43000000043,11287.310000000056
9640,2022-03-31 10:20:00,-1424.28,223797.4600000005,213934.43000000043,9863.030000000057
9641,2022-03-31 10:25:00,-1011.23,222786.23000000048,213934.43000000043,8851.800000000047
9642,2022-03-31 10:30:00,-80.13,222706.10000000047,213934.43000000043,8771.670000000042
9643,2022-03-31 10:35:00,1223.56,223929.66000000047,213934.43000000043,9995.23000000004
9644,2022-03-31 10:40:00,1165.63,225095.29000000047,213934.43000000043,11160.860000000044
9645,2022-03-31 10:45:00,-1372.34,223722.95000000048,213934.43000000043,9788.520000000048
9646,2022-03-31 10:50:00,-1146.45,222576.50000000047,213934.43000000043,8642.070000000036
9647,2022-03-31 10:55:00,1343.68,223920.18000000046,213934.43000000043,9985.75000000003
9648,2022-03-31 11:00:00,-1685.83,222234.35000000047,213934.43000000043,8299.920000000042
9649,2022-03-31 11:05:00,-266.33,221968.02000000048,213934.43000000043,8033.590000000055
9650,2022-03-31 11:10:00,483.96,222451.98000000048,213934.43000000043,8517.550000000047
9651,2022-03-31 11:15:00,-1840.0,220611.98000000048,213934.43000000043,6677.550000000047
9652,2022-03-31 11:20:00,-347.77,220264.2100000005,213934.43000000043,6329.780000000057
9653,2022-03-31 11:25:00,-1895.49,218368.7200000005,213934.43000000043,4434.290000000066
9654,2022-03-31 11:30:00,-787.79,217580.9300000005,213934.43000000043,3646.500000000058
9655,2022-03-31 11:35:00,-1329.43,216251.5000000005,213934.43000000043,2317.070000000065
9656,2022-03-31 11:40:00,-1496.43,214755.0700000005,213934.43000000043,820.6400000000722
9657,2022-03-31 11:45:00,1650.48,216405.5500000005,213934.43000000043,2471.1200000000827
9658,2022-03-31 11:50:00,1562.7,217968.25000000052,213934.43000000043,4033.8200000000943
9659,2022-03-31 11:55:00,1689.04,219657.29000000053,213934.43000000043,5722.860000000102
9660,2022-03-31 12:00:00,1377.33,221034.62000000052,213934.43000000043,7100.19000000009
9661,2022-03-31 12:05:00,247.56,221282.18000000052,213934.43000000043,7347.750000000087
9662,2022-03-31 12:10:00,-1596.94,219685.24000000051,213934.43000000043,5750.810000000085
9663,2022-03-31 12:15:00,939.45,220624.69000000053,213934.43000000043,6690.260000000097
9664,2022-03-31 12:20:00,-313.82,220310.87000000052,213934.43000000043,6376.44000000009
9665,2022-03-31 12:25:00,1752.16,222063.03000000052,213934.43000000043,8128.600000000093
9666,2022-03-31 12:30:00,-1567.61,220495.42000000054,213934.43000000043,6560.990000000107
9667,2022-03-31 12:35:00,1959.75,222455.17000000054,213934.43000000043,8520.740000000107
9668,2022-03-31 12:40:00,-697.81,221757.36000000054,213934.43000000043,7822.930000000109
9669,2022-03-31 12:45:00,321.51,222078.87000000055,213934.43000000043,8144.440000000119
9670,2022-03-31 12:50:00,391.45,222470.32000000056,213934.43000000043,8535.89000000013
9671,2022-03-31 12:55:00,53.08,222523.40000000055,213934.43000000043,8588.970000000118
9672,2022-03-31 13:00:00,-350.22,222173.18000000055,213934.43000000043,8238.750000000116
9673,2022-03-31 13:05:00,1782.19,223955.37000000055,213934.43000000043,10020.940000000119
9674,2022-03-31 13:10:00,1843.66,225799.03000000055,213934.43000000043,11864.600000000122
9675,2022-03-31 13:15:00,1294.31,227093.34000000055,213934.43000000043,13158.91000000012
9676,2022-03-31 13:20:00,-1944.35,225148.99000000054,213934.43000000043,11214.560000000114
9677,2022-03-31 13:25:00,169.69,225318.68000000055,213934.43000000043,11384.250000000116
9678,2022-03-31 13:30:00,403.31,225721.99000000054,213934.43000000043,11787.560000000114
9679,2022-03-31 13:35:00,-1446.45,224275.54000000053,213934.43000000043,10341.110000000102
9680,2022-03-31 13:40:00,960.7,225236.24000000054,213934.43000000043,11301.810000000114
9681,2022-03-31 13:45:00,1022.6,226258.84000000055,213934.43000000043,12324.41000000012
9682,2022-03-31 13:50:00,845.74,227104.58000000054,213934.43000000043,13170.15000000011
9683,2022-03-31 13:55:00,-1358.37,225746.21000000054,213934.43000000043,11811.780000000115
9684,2022-03-31 14:00:00,-1660.87,224085.34000000055,213934.43000000043,10150.91000000012
9685,2022-03-31 14:05:00,1415.21,225500.55000000054,213934.43000000043,11566.120000000112
9686,2022-03-31 14:10:00,784.55,226285.10000000053,213934.43000000043,12350.6700000001
9687,2022-03-31 14:15:00,-1451.77,224833.33000000054,213934.43000000043,10898.90000000011
9688,2022-03-31 14:20:00,31.64,224864.97000000055,213934.43000000043,10930.540000000125
9689,2022-03-31 14:25:00,-1520.01,223344.96000000054,213934.43000000043,9410.530000000115
9690,2022-03-31 14:30:00,1458.39,224803.35000000056,213934.43000000043,10868.92000000013
9691,2022-03-31 14:35:00,-854.44,223948.91000000056,213934.43000000043,10014.480000000127
9692,2022-03-31 14:40:00,200.87,224149.78000000055,213934.43000000043,10215.350000000122
9693,2022-03-31 14:45:00,-483.19,223666.59000000055,213934.43000000043,9732.16000000012
9694,2022-03-31 14:50:00,-1894.21,221772.38000000056,213934.43000000043,7837.950000000128
9695,2022-03-31 14:55:00,-251.35,221521.03000000055,213934.43000000043,7586.600000000122
9696,2022-03-31 15:00:00,-641.31,220879.72000000055,213934.43000000043,6945.290000000125
9697,2022-03-31 15:05:00,-973.3,219906.42000000057,213934.43000000043,5971.990000000136
9698,2022-03-31 15:10:00,1177.51,221083.93000000058,213934.43000000043,7149.5000000001455
9699,2022-03-31 15:15:00,-1756.04,219327.89000000057,213934.43000000043,5393.460000000137
9700,2022-03-31 15:20:00,1709.63,221037.52000000057,213934.43000000043,7103.090000000142
9701,2022-03-31 15:25:00,-1076.03,219961.49000000057,213934.43000000043,6027.060000000143
9702,2022-03-31 15:30:00,680.66,220642.15000000058,213934.43000000043,6707.720000000147
9703,2022-03-31 15:35:00,-1170.98,219471.17000000057,213934.43000000043,5536.740000000136
9704,2022-03-31 15:40:00,-908.8,218562.37000000058,213934.43000000043,4627.940000000148
9705,2022-03-31 15:45:00,158.42,218720.7900000006,213934.43000000043,4786.360000000161
9706,2022-03-31 15:50:00,1264.18,219984.97000000058,213934.43000000043,6050.540000000154
9707,2022-03-31 15:55:00,681.45,220666.4200000006,213934.43000000043,6731.990000000165
9708,2022-03-31 16:00:00,-1291.79,219374.6300000006,213934.43000000043,5440.200000000157
9709,2022-03-31 16:05:00,814.51,220189.1400000006,213934.43000000043,6254.7100000001665
9710,2022-03-31 16:10:00,236.79,220425.9300000006,213934.43000000043,6491.500000000175
9711,2022-03-31 16:15:00,-1145.99,219279.9400000006,213934.43000000043,5345.510000000184
9712,2022-03-31 16:20:00,-1830.62,217449.32000000062,213934.43000000043,3514.8900000001886
9713,2022-03-31 16:25:00,-1076.89,216372.4300000006,213934.43000000043,2438.0000000001746
9714,2022-03-31 16:30:00,-742.83,215629.60000000062,213934.43000000043,1695.1700000001874
9715,2022-03-31 16:35:00,1473.81,217103.41000000061,213934.43000000043,3168.980000000185
9716,2022-03-31 16:40:00,-253.06,216850.35000000062,213934.43000000043,2915.9200000001874
9717,2022-03-31 16:45:00,32.84,216883.1900000006,213934.43000000043,2948.760000000184
9718,2022-03-31 16:50:00,-1789.15,215094.04000000062,213934.43000000043,1159.6100000001898
9719,2022-03-31 16:55:00,-571.21,214522.83000000063,213934.43000000043,588.4000000001979
9720,2022-04-01 08:00:00,-819.48,213703.35000000062,214522.83000000063,-819.4800000000105
9721,2022-04-01 08:05:00,1635.46,215338.8100000006,214522.83000000063,815.9799999999814
9722,2022-04-01 08:10:00,-1499.79,213839.0200000006,214522.83000000063,-683.8100000000268
9723,2022-04-01 08:15:00,-732.63,213106.3900000006,214522.83000000063,-1416.4400000000314
9724,2022-04-01 08:20:00,334.02,213440.4100000006,214522.83000000063,-1082.420000000042
9725,2022-04-01 08:25:00,102.74,213543.15000000058,214522.83000000063,-979.6800000000512
9726,2022-04-01 08:30:00,469.92,214013.0700000006,214522.83000000063,-509.7600000000384
9727,2022-04-01 08:35:00,-1765.5,212247.5700000006,214522.83000000063,-2275.2600000000384
9728,2022-04-01 08:40:00,-151.33,212096.2400000006,214522.83000000063,-2426.5900000000256
9729,2022-04-01 08:45:00,805.36,212901.6000000006,214522.83000000063,-1621.2300000000396
9730,2022-04-01 08:50:00,-50.51,212851.09000000058,214522.83000000063,-1671.740000000049
9731,2022-04-01 08:55:00,-849.63,212001.46000000057,214522.83000000063,-2521.3700000000536
9732,2022-04-01 09:00:00,-1763.67,210237.79000000056,214522.83000000063,-4285.040000000066
9733,2022-04-01 09:05:00,-116.45,210121.34000000055,214522.83000000063,-4401.490000000078
9734,2022-04-01 09:10:00,1071.65,211192.99000000054,214522.83000000063,-3329.840000000084
9735,2022-04-01 09:15:00,-303.53,210889.46000000054,214522.83000000063,-3633.3700000000827
9736,2022-04-01 09:20:00,1482.87,212372.33000000054,214522.83000000063,-2150.5000000000873
9737,2022-04-01 09:25:00,1566.56,213938.89000000054,214522.83000000063,-583.9400000000896
9738,2022-04-01 09:30:00,-642.31,213296.58000000054,214522.83000000063,-1226.2500000000873
9739,2022-04-01 09:35:00,-1626.71,211669.87000000055,214522.83000000063,-2852.960000000079
9740,2022-04-01 09:40:00,999.25,212669.12000000055,214522.83000000063,-1853.7100000000792
9741,2022-04-01 09:45:00,-362.94,212306.18000000055,214522.83000000063,-2216.6500000000815
9742,2022-04-01 09:50:00,-272.15,212034.03000000055,214522.83000000063,-2488.8000000000757
9743,2022-04-01 09:55:00,1022.21,213056.24000000054,214522.83000000063,-1466.5900000000838
9744,2022-04-01 10:00:00,1319.43,214375.67000000054,214522.83000000063,-147.1600000000908
9745,2022-04-01 10:05:00,-1173.84,213201.83000000054,214522.83000000063,-1321.0000000000873
9746,2022-04-01 10:10:00,304.08,213505.91000000053,214522.83000000063,-1016.9200000001001
9747,2022-04-01 10:15:00,-1553.94,211951.97000000053,214522.83000000063,-2570.8600000001024
9748,2022-04-01 10:20:00,-1839.19,210112.78000000052,214522.83000000063,-4410.050000000105
9749,2022-04-01 10:25:00,1923.34,212036.12000000052,214522.83000000063,-2486.7100000001083
9750,2022-04-01 10:30:00,-911.6,211124.5200000005,214522.83000000063,-3398.310000000114
9751,2022-04-01 10:35:00,1634.44,212758.96000000052,214522.83000000063,-1763.8700000001118
9752,2022-04-01 10:40:00,326.98,213085.94000000053,214522.83000000063,-1436.8900000001013
9753,2022-04-01 10:45:00,687.9,213773.84000000052,214522.83000000063,-748.9900000001071
9754,2022-04-01 10:50:00,1137.53,214911.37000000052,214522.83000000063,388.53999999989173
9755,2022-04-01 10:55:00,-1800.08,213111.29000000053,214522.83000000063,-1411.5400000000955
9756,2022-04-01 11:00:00,694.16,213805.45000000054,214522.83000000063,-717.380000000092
9757,2022-04-01 11:05:00,-1920.24,211885.21000000054,214522.83000000063,-2637.6200000000827
9758,2022-04-01 11:10:00,-92.26,211792.95000000054,214522.83000000063,-2729.880000000092
9759,2022-04-01 11:15:00,1136.89,212929.84000000055,214522.83000000063,-1592.990000000078
9760,2022-04-01 11:20:00,-1162.89,211766.95000000054,214522.83000000063,-2755.880000000092
9761,2022-04-01 11:25:00,-1368.2,210398.75000000052,214522.83000000063,-4124.080000000104
9762,2022-04-01 11:30:00,-1205.08,209193.67000000054,214522.83000000063,-5329.160000000091
9763,2022-04-01 11:35:00,979.88,210173.55000000054,214522.83000000063,-4349.280000000086
9764,2022-04-01 11:40:00,-299.75,209873.80000000054,214522.83000000063,-4649.030000000086
9765,2022-04-01 11:45:00,-476.73,209397.07000000053,214522.83000000063,-5125.760000000097
9766,2022-04-01 11:50:00,-53.55,209343.52000000054,214522.83000000063,-5179.310000000085
9767,2022-04-01 11:55:00,-317.28,209026.24000000054,214522.83000000063,-5496.590000000084
9768,2022-04-01 12:00:00,1079.96,210106.20000000054,214522.83000000063,-4416.630000000092
9769,2022-04-01 12:05:00,77.65,210183.85000000053,214522.83000000063,-4338.980000000098
9770,2022-04-01 12:10:00,-1888.04,208295.81000000052,214522.83000000063,-6227.020000000106
9771,2022-04-01 12:15:00,1168.53,209464.34000000052,214522.83000000063,-5058.490000000107
9772,2022-04-01 12:20:00,1061.19,210525.53000000052,214522.83000000063,-3997.300000000105
9773,2022-04-01 12:25:00,1840.97,212366.50000000052,214522.83000000063,-2156.3300000001036
9774,2022-04-01 12:30:00,946.61,213313.1100000005,214522.83000000063,-1209.7200000001176
9775,2022-04-01 12:35:00,-1706.23,211606.8800000005,214522.83000000063,-2915.950000000128
9776,2022-04-01 12:40:00,1114.43,212721.3100000005,214522.83000000063,-1801.520000000135
9777,2022-04-01 12:45:00,1593.93,214315.2400000005,214522.83000000063,-207.59000000014203
9778,2022-04-01 12:50:00,-367.86,213947.3800000005,214522.83000000063,-575.4500000001281
9779,2022-04-01 12:55:00,1254.41,215201.7900000005,214522.83000000063,678.9599999998754
9780,2022-04-01 13:00:00,-1335.42,213866.3700000005,214522.83000000063,-656.4600000001374
9781,2022-04-01 13:05:00,1668.18,215534.55000000048,214522.83000000063,1011.7199999998556
9782,2022-04-01 13:10:00,75.79,215610.3400000005,214522.83000000063,1087.5099999998638
9783,2022-04-01 13:15:00,-1948.2,213662.14000000048,214522.83000000063,-860.6900000001478
9784,2022-04-01 13:20:00,-202.47,213459.67000000048,214522.83000000063,-1063.160000000149
9785,2022-04-01 13:25:00,1986.35,215446.02000000048,214522.83000000063,923.1899999998568
9786,2022-04-01 13:30:00,-1296.64,214149.38000000047,214522.83000000063,-373.45000000015716
9787,2022-04-01 13:35:00,-753.26,213396.12000000046,214522.83000000063,-1126.7100000001665
9788,2022-04-01 13:40:00,-978.58,212417.54000000047,214522.83000000063,-2105.2900000001537
9789,2022-04-01 13:45:00,-349.41,212068.13000000047,214522.83000000063,-2454.700000000157
9790,2022-04-01 13:50:00,-1374.35,210693.78000000046,214522.83000000063,-3829.050000000163
9791,2022-04-01 13:55:00,250.28,210944.06000000046,214522.83000000063,-3578.770000000164
9792,2022-04-01 14:00:00,-1008.09,209935.97000000047,214522.83000000063,-4586.860000000161
9793,2022-04-01 14:05:00,379.12,210315.09000000046,214522.83000000063,-4207.740000000165
9794,2022-04-01 14:10:00,-1607.07,208708.02000000046,214522.83000000063,-5814.810000000172
9795,2022-04-01 14:15:00,-1308.81,207399.21000000046,214522.83000000063,-7123.62000000017
9796,2022-04-01 14:20:00,-31.71,207367.50000000047,214522.83000000063,-7155.330000000162
9797,2022-04-01 14:25:00,-92.97,207274.53000000046,214522.83000000063,-7248.300000000163
9798,2022-04-01 14:30:00,316.23,207590.76000000047,214522.83000000063,-6932.0700000001525
9799,2022-04-01 14:35:00,-1833.42,205757.34000000046,214522.83000000063,-8765.490000000165
9800,2022-04-01 14:40:00,1387.03,207144.37000000046,214522.83000000063,-7378.4600000001665
9801,2022-04-01 14:45:00,-1787.86,205356.51000000047,214522.83000000063,-9166.320000000153
9802,2022-04-01 14:50:00,-228.23,205128.28000000046,214522.83000000063,-9394.550000000163
9803,2022-04-01 14:55:00,1427.45,206555.73000000048,214522.83000000063,-7967.100000000151
9804,2022-04-01 15:00:00,280.44,206836.17000000048,214522.83000000063,-7686.660000000149
9805,2022-04-01 15:05:00,-1380.38,205455.79000000047,214522.83000000063,-9067.040000000154
9806,2022-04-01 15:10:00,-433.24,205022.55000000048,214522.83000000063,-9500.280000000144
9807,2022-04-01 15:15:00,-519.71,204502.8400000005,214522.83000000063,-10019.990000000136
9808,2022-04-01 15:20:00,-104.58,204398.2600000005,214522.83000000063,-10124.570000000123
9809,2022-04-01 15:25:00,-1393.05,203005.21000000052,214522.83000000063,-11517.620000000112
9810,2022-04-01 15:30:00,430.02,203435.2300000005,214522.83000000063,-11087.600000000122
9811,2022-04-01 15:35:00,-1047.16,202388.0700000005,214522.83000000063,-12134.760000000126
9812,2022-04-01 15:40:00,-194.03,202194.0400000005,214522.83000000063,-12328.790000000125
9813,2022-04-01 15:45:00,-1564.75,200629.2900000005,214522.83000000063,-13893.540000000125
9814,2022-04-01 15:50:00,1001.26,201630.5500000005,214522.83000000063,-12892.280000000115
9815,2022-04-01 15:55:00,1110.71,202741.2600000005,214522.83000000063,-11781.570000000123
9816,2022-04-01 16:00:00,60.7,202801.96000000052,214522.83000000063,-11720.870000000112
9817,2022-04-01 16:05:00,1499.48,204301.44000000053,214522.83000000063,-10221.390000000101
9818,2022-04-01 16:10:00,-700.12,203601.32000000053,214522.83000000063,-10921.510000000097
9819,2022-04-01 16:15:00,-897.51,202703.81000000052,214522.83000000063,-11819.020000000106
9820,2022-04-01 16:20:00,446.89,203150.70000000054,214522.83000000063,-11372.130000000092
9821,2022-04-01 16:25:00,-619.72,202530.98000000053,214522.83000000063,-11991.850000000093
9822,2022-04-01 16:30:00,-1363.91,201167.07000000053,214522.83000000063,-13355.760000000097
9823,2022-04-01 16:35:00,-759.5,200407.57000000053,214522.83000000063,-14115.260000000097
9824,2022-04-01 16:40:00,-1290.09,199117.48000000053,214522.83000000063,-15405.350000000093
9825,2022-04-01 16:45:00,-282.51,198834.97000000053,214522.83000000063,-15687.860000000102
9826,2022-04-01 16:50:00,-698.39,198136.5800000005,214522.83000000063,-16386.250000000116
9827,2022-04-01 16:55:00,229.29,198365.87000000052,214522.83000000063,-16156.960000000108
9828,2022-04-02 08:00:00,1323.1,199688.97000000053,198365.87000000052,1323.1000000000058
9829,2022-04-02 08:05:00,-1413.87,198275.10000000053,198365.87000000052,-90.76999999998952
9830,2022-04-02 08:10:00,1654.22,199929.32000000053,198365.87000000052,1563.4500000000116
9831,2022-04-02 08:15:00,-775.85,199153.47000000053,198365.87000000052,787.6000000000058
9832,2022-04-02 08:20:00,-856.39,198297.0800000005,198365.87000000052,-68.79000000000815
9833,2022-04-02 08:25:00,734.98,199032.06000000052,198365.87000000052,666.1900000000023
9834,2022-04-02 08:30:00,1641.04,200673.10000000053,198365.87000000052,2307.2300000000105
9835,2022-04-02 08:35:00,-1644.18,199028.92000000054,198365.87000000052,663.0500000000175
9836,2022-04-02 08:40:00,-1819.08,197209.84000000055,198365.87000000052,-1156.0299999999697
9837,2022-04-02 08:45:00,983.41,198193.25000000055,198365.87000000052,-172.61999999996624
9838,2022-04-02 08:50:00,1192.09,199385.34000000055,198365.87000000052,1019.4700000000303
9839,2022-04-02 08:55:00,-796.51,198588.83000000054,198365.87000000052,222.96000000002095
9840,2022-04-02 09:00:00,988.4,199577.23000000053,198365.87000000052,1211.3600000000151
9841,2022-04-02 09:05:00,1920.83,201498.06000000052,198365.87000000052,3132.1900000000023
9842,2022-04-02 09:10:00,-1584.99,199913.07000000053,198365.87000000052,1547.2000000000116
9843,2022-04-02 09:15:00,1624.17,201537.24000000054,198365.87000000052,3171.3700000000244
9844,2022-04-02 09:20:00,1303.62,202840.86000000054,198365.87000000052,4474.99000000002
9845,2022-04-02 09:25:00,1854.02,204694.88000000053,198365.87000000052,6329.010000000009
9846,2022-04-02 09:30:00,-662.42,204032.46000000052,198365.87000000052,5666.5899999999965
9847,2022-04-02 09:35:00,1274.04,205306.50000000052,198365.87000000052,6940.630000000005
9848,2022-04-02 09:40:00,252.61,205559.1100000005,198365.87000000052,7193.239999999991
9849,2022-04-02 09:45:00,1956.99,207516.1000000005,198365.87000000052,9150.229999999981
9850,2022-04-02 09:50:00,-1262.08,206254.0200000005,198365.87000000052,7888.149999999994
9851,2022-04-02 09:55:00,1702.15,207956.1700000005,198365.87000000052,9590.299999999988
9852,2022-04-02 10:00:00,850.7,208806.87000000052,198365.87000000052,10441.0
9853,2022-04-02 10:05:00,-845.04,207961.8300000005,198365.87000000052,9595.959999999992
9854,2022-04-02 10:10:00,428.86,208390.6900000005,198365.87000000052,10024.819999999978
9855,2022-04-02 10:15:00,603.41,208994.1000000005,198365.87000000052,10628.229999999981
9856,2022-04-02 10:20:00,215.75,209209.8500000005,198365.87000000052,10843.979999999981
9857,2022-04-02 10:25:00,-1430.78,207779.0700000005,198365.87000000052,9413.199999999983
9858,2022-04-02 10:30:00,-1025.21,206753.8600000005,198365.87000000052,8387.98999999999
9859,2022-04-02 10:35:00,-530.81,206223.0500000005,198365.87000000052,7857.179999999993
9860,2022-04-02 10:40:00,617.46,206840.5100000005,198365.87000000052,8474.639999999985
9861,2022-04-02 10:45:00,152.84,206993.3500000005,198365.87000000052,8627.479999999981
9862,2022-04-02 10:50:00,-1103.66,205889.6900000005,198365.87000000052,7523.819999999978
9863,2022-04-02 10:55:00,1805.29,207694.9800000005,198365.87000000052,9329.109999999986
9864,2022-04-02 11:00:00,1508.05,209203.0300000005,198365.87000000052,10837.159999999974
9865,2022-04-02 11:05:00,1115.07,210318.1000000005,198365.87000000052,11952.229999999981
9866,2022-04-02 11:10:00,-766.0,209552.1000000005,198365.87000000052,11186.229999999981
9867,2022-04-02 11:15:00,800.11,210352.2100000005,198365.87000000052,11986.339999999967
9868,2022-04-02 11:20:00,238.03,210590.2400000005,198365.87000000052,12224.369999999966
9869,2022-04-02 11:25:00,-445.95,210144.29000000047,198365.87000000052,11778.419999999955
9870,2022-04-02 11:30:00,355.46,210499.75000000047,198365.87000000052,12133.879999999946
9871,2022-04-02 11:35:00,-388.07,210111.68000000046,198365.87000000052,11745.80999999994
9872,2022-04-02 11:40:00,-973.01,209138.67000000045,198365.87000000052,10772.79999999993
9873,2022-04-02 11:45:00,1717.43,210856.10000000044,198365.87000000052,12490.229999999923
9874,2022-04-02 11:50:00,1303.6,212159.70000000045,198365.87000000052,13793.829999999929
9875,2022-04-02 11:55:00,1255.88,213415.58000000045,198365.87000000052,15049.709999999934
9876,2022-04-02 12:00:00,1138.78,214554.36000000045,198365.87000000052,16188.489999999932
9877,2022-04-02 12:05:00,1213.86,215768.22000000044,198365.87000000052,17402.34999999992
9878,2022-04-02 12:10:00,-584.57,215183.65000000043,198365.87000000052,16817.77999999991
9879,2022-04-02 12:15:00,463.02,215646.67000000042,198365.87000000052,17280.7999999999
9880,2022-04-02 12:20:00,-589.32,215057.3500000004,198365.87000000052,16691.479999999894
9881,2022-04-02 12:25:00,-644.98,214412.3700000004,198365.87000000052,16046.499999999884
9882,2022-04-02 12:30:00,488.18,214900.5500000004,198365.87000000052,16534.679999999877
9883,2022-04-02 12:35:00,966.59,215867.1400000004,198365.87000000052,17501.269999999873
9884,2022-04-02 12:40:00,-1101.91,214765.2300000004,198365.87000000052,16399.35999999987
9885,2022-04-02 12:45:00,-428.57,214336.66000000038,198365.87000000052,15970.789999999863
9886,2022-04-02 12:50:00,-1595.88,212740.78000000038,198365.87000000052,14374.909999999858
9887,2022-04-02 12:55:00,502.07,213242.85000000038,198365.87000000052,14876.979999999865
9888,2022-04-02 13:00:00,-1300.23,211942.62000000037,198365.87000000052,13576.749999999854
9889,2022-04-02 13:05:00,-531.41,211411.21000000037,198365.87000000052,13045.339999999851
9890,2022-04-02 13:10:00,-807.11,210604.10000000038,198365.87000000052,12238.229999999865
9891,2022-04-02 13:15:00,-402.71,210201.3900000004,198365.87000000052,11835.519999999873
9892,2022-04-02 13:20:00,836.66,211038.0500000004,198365.87000000052,12672.179999999877
9893,2022-04-02 13:25:00,-864.26,210173.7900000004,198365.87000000052,11807.919999999867
9894,2022-04-02 13:30:00,536.51,210710.3000000004,198365.87000000052,12344.429999999877
9895,2022-04-02 13:35:00,1251.41,211961.7100000004,198365.87000000052,13595.83999999988
9896,2022-04-02 13:40:00,465.85,212427.5600000004,198365.87000000052,14061.689999999886
9897,2022-04-02 13:45:00,1646.45,214074.01000000042,198365.87000000052,15708.139999999898
9898,2022-04-02 13:50:00,1826.8,215900.8100000004,198365.87000000052,17534.939999999886
9899,2022-04-02 13:55:00,891.31,216792.1200000004,198365.87000000052,18426.249999999884
9900,2022-04-02 14:00:00,1051.73,217843.8500000004,198365.87000000052,19477.979999999894
9901,2022-04-02 14:05:00,-1615.21,216228.64000000042,198365.87000000052,17862.769999999902
9902,2022-04-02 14:10:00,-1221.53,215007.11000000042,198365.87000000052,16641.239999999903
9903,2022-04-02 14:15:00,688.64,215695.75000000044,198365.87000000052,17329.879999999917
9904,2022-04-02 14:20:00,-1660.51,214035.24000000043,198365.87000000052,15669.369999999908
9905,2022-04-02 14:25:00,356.79,214392.03000000044,198365.87000000052,16026.159999999916
9906,2022-04-02 14:30:00,1528.37,215920.40000000043,198365.87000000052,17554.52999999991
9907,2022-04-02 14:35:00,689.6,216610.00000000044,198365.87000000052,18244.129999999917
9908,2022-04-02 14:40:00,1333.4,217943.40000000043,198365.87000000052,19577.52999999991
9909,2022-04-02 14:45:00,-1468.24,216475.16000000044,198365.87000000052,18109.28999999992
9910,2022-04-02 14:50:00,1136.49,217611.65000000043,198365.87000000052,19245.77999999991
9911,2022-04-02 14:55:00,38.32,217649.97000000044,198365.87000000052,19284.09999999992
9912,2022-04-02 15:00:00,153.98,217803.95000000045,198365.87000000052,19438.07999999993
9913,2022-04-02 15:05:00,-1494.6,216309.35000000044,198365.87000000052,17943.479999999923
9914,2022-04-02 15:10:00,1806.28,218115.63000000044,198365.87000000052,19749.759999999922
9915,2022-04-02 15:15:00,-961.62,217154.01000000045,198365.87000000052,18788.139999999927
9916,2022-04-02 15:20:00,-1031.79,216122.22000000044,198365.87000000052,17756.34999999992
9917,2022-04-02 15:25:00,-112.82,216009.40000000043,198365.87000000052,17643.52999999991
9918,2022-04-02 15:30:00,547.66,216557.06000000043,198365.87000000052,18191.189999999915
9919,2022-04-02 15:35:00,-1851.63,214705.43000000043,198365.87000000052,16339.55999999991
9920,2022-04-02 15:40:00,1073.05,215778.48000000042,198365.87000000052,17412.6099999999
9921,2022-04-02 15:45:00,-1877.39,213901.0900000004,198365.87000000052,15535.219999999885
9922,2022-04-02 15:50:00,1603.99,215505.0800000004,198365.87000000052,17139.209999999875
9923,2022-04-02 15:55:00,-125.95,215379.13000000038,198365.87000000052,17013.259999999864
9924,2022-04-02 16:00:00,555.73,215934.8600000004,198365.87000000052,17568.989999999874
9925,2022-04-02 16:05:00,1724.41,217659.2700000004,198365.87000000052,19293.399999999878
9926,2022-04-02 16:10:00,-125.81,217533.4600000004,198365.87000000052,19167.58999999988
9927,2022-04-02 16:15:00,467.08,218000.5400000004,198365.87000000052,19634.669999999867
9928,2022-04-02 16:20:00,61.12,218061.66000000038,198365.87000000052,19695.789999999863
9929,2022-04-02 16:25:00,1461.11,219522.77000000037,198365.87000000052,21156.89999999985
9930,2022-04-02 16:30:00,67.38,219590.15000000037,198365.87000000052,21224.279999999853
9931,2022-04-02 16:35:00,1172.63,220762.78000000038,198365.87000000052,22396.909999999858
9932,2022-04-02 16:40:00,-799.01,219963.77000000037,198365.87000000052,21597.89999999985
9933,2022-04-02 16:45:00,1237.21,221200.98000000036,198365.87000000052,22835.10999999984
9934,2022-04-02 16:50:00,-439.72,220761.26000000036,198365.87000000052,22395.38999999984
9935,2022-04-02 16:55:00,-1382.91,219378.35000000036,198365.87000000052,21012.479999999836
9936,2022-04-03 08:00:00,707.73,220086.08000000037,219378.35000000036,707.7300000000105
9937,2022-04-03 08:05:00,-1595.57,218490.51000000036,219378.35000000036,-887.8399999999965
9938,2022-04-03 08:10:00,1445.22,219935.73000000036,219378.35000000036,557.3800000000047
9939,2022-04-03 08:15:00,1294.93,221230.66000000035,219378.35000000036,1852.3099999999977
9940,2022-04-03 08:20:00,-1598.36,219632.30000000037,219378.35000000036,253.95000000001164
9941,2022-04-03 08:25:00,1768.93,221401.23000000036,219378.35000000036,2022.8800000000047
9942,2022-04-03 08:30:00,871.49,222272.72000000035,219378.35000000036,2894.3699999999953
9943,2022-04-03 08:35:00,-1257.7,221015.02000000034,219378.35000000036,1636.6699999999837
9944,2022-04-03 08:40:00,-1189.54,219825.48000000033,219378.35000000036,447.12999999997555
9945,2022-04-03 08:45:00,-1220.97,218604.51000000033,219378.35000000036,-773.8400000000256
9946,2022-04-03 08:50:00,-1294.18,217310.33000000034,219378.35000000036,-2068.0200000000186
9947,2022-04-03 08:55:00,-694.53,216615.80000000034,219378.35000000036,-2762.5500000000175
9948,2022-04-03 09:00:00,-873.55,215742.25000000035,219378.35000000036,-3636.100000000006
9949,2022-04-03 09:05:00,-1096.2,214646.05000000034,219378.35000000036,-4732.3000000000175
9950,2022-04-03 09:10:00,1328.99,215975.04000000033,219378.35000000036,-3403.310000000027
9951,2022-04-03 09:15:00,1190.94,217165.98000000033,219378.35000000036,-2212.3700000000244
9952,2022-04-03 09:20:00,-793.24,216372.74000000034,219378.35000000036,-3005.610000000015
9953,2022-04-03 09:25:00,876.08,217248.82000000033,219378.35000000036,-2129.530000000028
9954,2022-04-03 09:30:00,-1494.18,215754.64000000033,219378.35000000036,-3623.710000000021
9955,2022-04-03 09:35:00,-1512.73,214241.91000000032,219378.35000000036,-5136.440000000031
9956,2022-04-03 09:40:00,-478.63,213763.28000000032,219378.35000000036,-5615.070000000036
9957,2022-04-03 09:45:00,-984.67,212778.6100000003,219378.35000000036,-6599.740000000049
9958,2022-04-03 09:50:00,1498.9,214277.5100000003,219378.35000000036,-5100.840000000055
9959,2022-04-03 09:55:00,618.04,214895.5500000003,219378.35000000036,-4482.800000000047
9960,2022-04-03 10:00:00,66.38,214961.9300000003,219378.35000000036,-4416.420000000042
9961,2022-04-03 10:05:00,1454.4,216416.3300000003,219378.35000000036,-2962.0200000000477
9962,2022-04-03 10:10:00,371.32,216787.6500000003,219378.35000000036,-2590.7000000000407
9963,2022-04-03 10:15:00,-162.58,216625.07000000033,219378.35000000036,-2753.280000000028
9964,2022-04-03 10:20:00,284.02,216909.09000000032,219378.35000000036,-2469.2600000000384
9965,2022-04-03 10:25:00,-1831.58,215077.51000000033,219378.35000000036,-4300.840000000026
9966,2022-04-03 10:30:00,991.42,216068.93000000034,219378.35000000036,-3309.420000000013
9967,2022-04-03 10:35:00,-1764.51,214304.42000000033,219378.35000000036,-5073.930000000022
9968,2022-04-03 10:40:00,619.47,214923.89000000033,219378.35000000036,-4454.460000000021
9969,2022-04-03 10:45:00,918.18,215842.07000000033,219378.35000000036,-3536.280000000028
9970,2022-04-03 10:50:00,513.86,216355.9300000003,219378.35000000036,-3022.420000000042
9971,2022-04-03 10:55:00,1755.36,218111.2900000003,219378.35000000036,-1267.0600000000559
9972,2022-04-03 11:00:00,911.04,219022.3300000003,219378.35000000036,-356.02000000004773
9973,2022-04-03 11:05:00,237.27,219259.6000000003,219378.35000000036,-118.75000000005821
9974,2022-04-03 11:10:00,1006.68,220266.2800000003,219378.35000000036,887.9299999999348
9975,2022-04-03 11:15:00,-1459.6,218806.68000000028,219378.35000000036,-571.670000000071
9976,2022-04-03 11:20:00,437.09,219243.77000000028,219378.35000000036,-134.5800000000745
9977,2022-04-03 11:25:00,-323.92,218919.85000000027,219378.35000000036,-458.5000000000873
9978,2022-04-03 11:30:00,1083.43,220003.28000000026,219378.35000000036,624.9299999999057
9979,2022-04-03 11:35:00,1270.33,221273.61000000025,219378.35000000036,1895.259999999893
9980,2022-04-03 11:40:00,780.06,222053.67000000025,219378.35000000036,2675.3199999998906
9981,2022-04-03 11:45:00,-967.21,221086.46000000025,219378.35000000036,1708.1099999998987
9982,2022-04-03 11:50:00,1915.23,223001.69000000026,219378.35000000036,3623.339999999909
9983,2022-04-03 11:55:00,-959.33,222042.36000000028,219378.35000000036,2664.009999999922
9984,2022-04-03 12:00:00,-822.66,221219.70000000027,219378.35000000036,1841.3499999999185
9985,2022-04-03 12:05:00,-681.55,220538.15000000029,219378.35000000036,1159.7999999999302
9986,2022-04-03 12:10:00,-37.57,220500.58000000028,219378.35000000036,1122.2299999999232
9987,2022-04-03 12:15:00,-543.84,219956.74000000028,219378.35000000036,578.3899999999267
9988,2022-04-03 12:20:00,1160.31,221117.05000000028,219378.35000000036,1738.6999999999243
9989,2022-04-03 12:25:00,-1656.86,219460.1900000003,219378.35000000036,81.8399999999383
9990,2022-04-03 12:30:00,-1701.99,217758.2000000003,219378.35000000036,-1620.1500000000524
9991,2022-04-03 12:35:00,61.07,217819.2700000003,219378.35000000036,-1559.0800000000454
9992,2022-04-03 12:40:00,1061.37,218880.6400000003,219378.35000000036,-497.71000000005006
9993,2022-04-03 12:45:00,-1640.78,217239.8600000003,219378.35000000036,-2138.490000000049
9994,2022-04-03 12:50:00,1832.83,219072.6900000003,219378.35000000036,-305.6600000000617
9995,2022-04-03 12:55:00,951.05,220023.74000000028,219378.35000000036,645.3899999999267
9996,2022-04-03 13:00:00,684.56,220708.30000000028,219378.35000000036,1329.9499999999243
9997,2022-04-03 13:05:00,1890.2,222598.5000000003,219378.35000000036,3220.149999999936
9998,2022-04-03 13:10:00,-1737.14,220861.36000000028,219378.35000000036,1483.009999999922
9999,2022-04-03 13:15:00,-1498.65,219362.71000000028,219378.35000000036,-15.640000000072177
10000,2022-04-03 13:20:00,1668.67,221031.3800000003,219378.35000000036,1653.0299999999406
10001,2022-04-03 13:25:00,-825.28,220206.1000000003,219378.35000000036,827.7499999999418
10002,2022-04-03 13:30:00,1466.06,221672.1600000003,219378.35000000036,2293.8099999999395
10003,2022-04-03 13:35:00,-1855.13,219817.0300000003,219378.35000000036,438.6799999999348
10004,2022-04-03 13:40:00,-136.39,219680.64000000028,219378.35000000036,302.28999999992084
10005,2022-04-03 13:45:00,343.87,220024.51000000027,219378.35000000036,646.1599999999162
10006,2022-04-03 13:50:00,709.62,220734.13000000027,219378.35000000036,1355.7799999999115
10007,2022-04-03 13:55:00,-169.09,220565.04000000027,219378.35000000036,1186.689999999915
10008,2022-04-03 14:00:00,-623.36,219941.68000000028,219378.35000000036,563.329999999929
10009,2022-04-03 14:05:00,-976.02,218965.6600000003,219378.35000000036,-412.69000000006054
10010,2022-04-03 14:10:00,1662.62,220628.2800000003,219378.35000000036,1249.9299999999348
10011,2022-04-03 14:15:00,1695.4,222323.68000000028,219378.35000000036,2945.329999999929
10012,2022-04-03 14:20:00,1131.39,223455.0700000003,219378.35000000036,4076.719999999943
10013,2022-04-03 14:25:00,-187.63,223267.4400000003,219378.35000000036,3889.0899999999383
10014,2022-04-03 14:30:00,-717.18,222550.2600000003,219378.35000000036,3171.9099999999453
10015,2022-04-03 14:35:00,28.2,222578.4600000003,219378.35000000036,3200.109999999957
10016,2022-04-03 14:40:00,1199.88,223778.34000000032,219378.35000000036,4399.989999999962
10017,2022-04-03 14:45:00,518.16,224296.50000000032,219378.35000000036,4918.149999999965
10018,2022-04-03 14:50:00,184.64,224481.14000000033,219378.35000000036,5102.789999999979
10019,2022-04-03 14:55:00,-596.33,223884.81000000035,219378.35000000036,4506.459999999992
10020,2022-04-03 15:00:00,1308.09,225192.90000000034,219378.35000000036,5814.549999999988
10021,2022-04-03 15:05:00,1846.62,227039.52000000034,219378.35000000036,7661.169999999984
10022,2022-04-03 15:10:00,1039.85,228079.37000000034,219378.35000000036,8701.01999999999
10023,2022-04-03 15:15:00,-273.98,227805.39000000033,219378.35000000036,8427.039999999979
10024,2022-04-03 15:20:00,41.01,227846.40000000034,219378.35000000036,8468.049999999988
10025,2022-04-03 15:25:00,-125.99,227720.41000000035,219378.35000000036,8342.059999999998
10026,2022-04-03 15:30:00,873.9,228594.31000000035,219378.35000000036,9215.959999999992
10027,2022-04-03 15:35:00,-159.89,228434.42000000033,219378.35000000036,9056.069999999978
10028,2022-04-03 15:40:00,-849.87,227584.55000000034,219378.35000000036,8206.199999999983
10029,2022-04-03 15:45:00,1377.22,228961.77000000034,219378.35000000036,9583.419999999984
10030,2022-04-03 15:50:00,710.94,229672.71000000034,219378.35000000036,10294.359999999986
10031,2022-04-03 15:55:00,1824.23,231496.94000000035,219378.35000000036,12118.589999999997
10032,2022-04-03 16:00:00,-1769.89,229727.05000000034,219378.35000000036,10348.699999999983
10033,2022-04-03 16:05:00,-1333.48,228393.57000000033,219378.35000000036,9015.219999999972
10034,2022-04-03 16:10:00,535.59,228929.16000000032,219378.35000000036,9550.809999999969
10035,2022-04-03 16:15:00,859.7,229788.86000000034,219378.35000000036,10410.50999999998
10036,2022-04-03 16:20:00,-776.05,229012.81000000035,219378.35000000036,9634.459999999992
10037,2022-04-03 16:25:00,1544.91,230557.72000000035,219378.35000000036,11179.369999999995
10038,2022-04-03 16:30:00,-1752.22,228805.50000000035,219378.35000000036,9427.149999999994
10039,2022-04-03 16:35:00,-1578.21,227227.29000000036,219378.35000000036,7848.940000000002
10040,2022-04-03 16:40:00,702.42,227929.71000000037,219378.35000000036,8551.360000000015
10041,2022-04-03 16:45:00,-177.16,227752.55000000037,219378.35000000036,8374.200000000012
10042,2022-04-03 16:50:00,-1273.86,226478.69000000038,219378.35000000036,7100.340000000026
10043,2022-04-03 16:55:00,924.47,227403.16000000038,219378.35000000036,8024.810000000027
10044,2022-04-04 08:00:00,-358.85,227044.31000000038,227403.16000000038,-358.8500000000058
10045,2022-04-04 08:05:00,520.12,227564.43000000037,227403.16000000038,161.26999999998952
10046,2022-04-04 08:10:00,-1573.48,225990.95000000036,227403.16000000038,-1412.210000000021
10047,2022-04-04 08:15:00,-1474.22,224516.73000000036,227403.16000000038,-2886.430000000022
10048,2022-04-04 08:20:00,-1272.49,223244.24000000037,227403.16000000038,-4158.920000000013
10049,2022-04-04 08:25:00,-1825.06,221419.18000000037,227403.16000000038,-5983.9800000000105
10050,2022-04-04 08:30:00,-867.63,220551.55000000037,227403.16000000038,-6851.610000000015
10051,2022-04-04 08:35:00,-1659.91,218891.64000000036,227403.16000000038,-8511.520000000019
10052,2022-04-04 08:40:00,46.66,218938.30000000037,227403.16000000038,-8464.860000000015
10053,2022-04-04 08:45:00,-487.62,218450.68000000037,227403.16000000038,-8952.48000000001
10054,2022-04-04 08:50:00,-797.79,217652.89000000036,227403.16000000038,-9750.270000000019
10055,2022-04-04 08:55:00,-113.88,217539.01000000036,227403.16000000038,-9864.150000000023
10056,2022-04-04 09:00:00,1544.86,219083.87000000034,227403.16000000038,-8319.290000000037
10057,2022-04-04 09:05:00,-14.3,219069.57000000036,227403.16000000038,-8333.590000000026
10058,2022-04-04 09:10:00,1154.25,220223.82000000036,227403.16000000038,-7179.340000000026
10059,2022-04-04 09:15:00,400.02,220623.84000000035,227403.16000000038,-6779.320000000036
10060,2022-04-04 09:20:00,425.21,221049.05000000034,227403.16000000038,-6354.110000000044
10061,2022-04-04 09:25:00,1500.13,222549.18000000034,227403.16000000038,-4853.98000000004
10062,2022-04-04 09:30:00,-1117.73,221431.45000000033,227403.16000000038,-5971.71000000005
10063,2022-04-04 09:35:00,881.63,222313.08000000034,227403.16000000038,-5090.080000000045
10064,2022-04-04 09:40:00,1823.13,224136.21000000034,227403.16000000038,-3266.9500000000407
10065,2022-04-04 09:45:00,1604.01,225740.22000000035,227403.16000000038,-1662.9400000000314
10066,2022-04-04 09:50:00,1908.58,227648.80000000034,227403.16000000038,245.63999999995576
10067,2022-04-04 09:55:00,-1824.67,225824.13000000032,227403.16000000038,-1579.030000000057
10068,2022-04-04 10:00:00,339.99,226164.12000000032,227403.16000000038,-1239.0400000000664
10069,2022-04-04 10:05:00,1420.16,227584.28000000032,227403.16000000038,181.11999999993714
10070,2022-04-04 10:10:00,96.04,227680.32000000033,227403.16000000038,277.1599999999453
10071,2022-04-04 10:15:00,-1272.73,226407.59000000032,227403.16000000038,-995.5700000000652
10072,2022-04-04 10:20:00,-1293.55,225114.04000000033,227403.16000000038,-2289.1200000000536
10073,2022-04-04 10:25:00,891.17,226005.21000000034,227403.16000000038,-1397.9500000000407
10074,2022-04-04 10:30:00,-548.4,225456.81000000035,227403.16000000038,-1946.350000000035
10075,2022-04-04 10:35:00,-152.01,225304.80000000034,227403.16000000038,-2098.3600000000442
10076,2022-04-04 10:40:00,-1213.92,224090.88000000032,227403.16000000038,-3312.280000000057
10077,2022-04-04 10:45:00,-797.64,223293.2400000003,227403.16000000038,-4109.920000000071
10078,2022-04-04 10:50:00,-856.16,222437.0800000003,227403.16000000038,-4966.0800000000745
10079,2022-04-04 10:55:00,733.96,223171.0400000003,227403.16000000038,-4232.120000000083
10080,2022-04-04 11:00:00,1925.0,225096.0400000003,227403.16000000038,-2307.1200000000827
10081,2022-04-04 11:05:00,937.42,226033.4600000003,227403.16000000038,-1369.7000000000698
10082,2022-04-04 11:10:00,1943.85,227977.31000000032,227403.16000000038,574.149999999936
10083,2022-04-04 11:15:00,-1535.92,226441.3900000003,227403.16000000038,-961.7700000000768
10084,2022-04-04 11:20:00,403.16,226844.5500000003,227403.16000000038,-558.6100000000733
10085,2022-04-04 11:25:00,-1897.16,224947.3900000003,227403.16000000038,-2455.770000000077
10086,2022-04-04 11:30:00,-1902.51,223044.8800000003,227403.16000000038,-4358.280000000086
10087,2022-04-04 11:35:00,1948.72,224993.6000000003,227403.16000000038,-2409.560000000085
10088,2022-04-04 11:40:00,654.07,225647.6700000003,227403.16000000038,-1755.490000000078
10089,2022-04-04 11:45:00,29.31,225676.9800000003,227403.16000000038,-1726.1800000000803
10090,2022-04-04 11:50:00,-1235.95,224441.0300000003,227403.16000000038,-2962.130000000092
10091,2022-04-04 11:55:00,-871.71,223569.3200000003,227403.16000000038,-3833.840000000084
10092,2022-04-04 12:00:00,-825.38,222743.9400000003,227403.16000000038,-4659.2200000000885
10093,2022-04-04 12:05:00,-1072.99,221670.9500000003,227403.16000000038,-5732.210000000079
10094,2022-04-04 12:10:00,-1400.57,220270.3800000003,227403.16000000038,-7132.780000000086
10095,2022-04-04 12:15:00,1243.04,221513.4200000003,227403.16000000038,-5889.740000000078
10096,2022-04-04 12:20:00,1662.55,223175.9700000003,227403.16000000038,-4227.19000000009
10097,2022-04-04 12:25:00,1440.9,224616.8700000003,227403.16000000038,-2786.2900000000955
10098,2022-04-04 12:30:00,1987.52,226604.39000000028,227403.16000000038,-798.7700000001059
10099,2022-04-04 12:35:00,33.95,226638.3400000003,227403.16000000038,-764.8200000000943
10100,2022-04-04 12:40:00,-26.34,226612.0000000003,227403.16000000038,-791.1600000000908
10101,2022-04-04 12:45:00,1464.34,228076.3400000003,227403.16000000038,673.1799999999057
10102,2022-04-04 12:50:00,916.94,228993.2800000003,227403.16000000038,1590.119999999908
10103,2022-04-04 12:55:00,-1994.69,226998.5900000003,227403.16000000038,-404.5700000000943
10104,2022-04-04 13:00:00,-627.08,226371.5100000003,227403.16000000038,-1031.6500000000815
10105,2022-04-04 13:05:00,-411.39,225960.1200000003,227403.16000000038,-1443.0400000000955
10106,2022-04-04 13:10:00,-932.11,225028.0100000003,227403.16000000038,-2375.1500000000815
10107,2022-04-04 13:15:00,952.92,225980.9300000003,227403.16000000038,-1422.2300000000687
10108,2022-04-04 13:20:00,146.39,226127.32000000033,227403.16000000038,-1275.8400000000547
10109,2022-04-04 13:25:00,1514.05,227641.37000000032,227403.16000000038,238.20999999993364
10110,2022-04-04 13:30:00,298.56,227939.9300000003,227403.16000000038,536.7699999999313
10111,2022-04-04 13:35:00,400.98,228340.91000000032,227403.16000000038,937.7499999999418
10112,2022-04-04 13:40:00,1785.32,230126.23000000033,227403.16000000038,2723.069999999949
10113,2022-04-04 13:45:00,609.94,230736.17000000033,227403.16000000038,3333.009999999951
10114,2022-04-04 13:50:00,1979.43,232715.60000000033,227403.16000000038,5312.439999999944
10115,2022-04-04 13:55:00,-1632.14,231083.4600000003,227403.16000000038,3680.29999999993
10116,2022-04-04 14:00:00,1608.07,232691.53000000032,227403.16000000038,5288.369999999937
10117,2022-04-04 14:05:00,-1484.09,231207.44000000032,227403.16000000038,3804.2799999999406
10118,2022-04-04 14:10:00,-52.52,231154.92000000033,227403.16000000038,3751.759999999951
10119,2022-04-04 14:15:00,1374.05,232528.97000000032,227403.16000000038,5125.8099999999395
10120,2022-04-04 14:20:00,1095.4,233624.37000000032,227403.16000000038,6221.209999999934
10121,2022-04-04 14:25:00,1368.84,234993.2100000003,227403.16000000038,7590.04999999993
10122,2022-04-04 14:30:00,-1041.98,233951.2300000003,227403.16000000038,6548.06999999992
10123,2022-04-04 14:35:00,547.14,234498.37000000032,227403.16000000038,7095.209999999934
10124,2022-04-04 14:40:00,-705.77,233792.60000000033,227403.16000000038,6389.439999999944
10125,2022-04-04 14:45:00,-664.53,233128.07000000033,227403.16000000038,5724.909999999945
10126,2022-04-04 14:50:00,1306.04,234434.11000000034,227403.16000000038,7030.949999999953
10127,2022-04-04 14:55:00,748.88,235182.99000000034,227403.16000000038,7779.829999999958
10128,2022-04-04 15:00:00,764.61,235947.60000000033,227403.16000000038,8544.439999999944
10129,2022-04-04 15:05:00,1827.92,237775.52000000034,227403.16000000038,10372.359999999957
10130,2022-04-04 15:10:00,-1615.15,236160.37000000034,227403.16000000038,8757.209999999963
10131,2022-04-04 15:15:00,-1680.78,234479.59000000035,227403.16000000038,7076.429999999964
10132,2022-04-04 15:20:00,1358.08,235837.67000000033,227403.16000000038,8434.509999999951
10133,2022-04-04 15:25:00,1772.22,237609.89000000033,227403.16000000038,10206.729999999952
10134,2022-04-04 15:30:00,-1945.04,235664.85000000033,227403.16000000038,8261.689999999944
10135,2022-04-04 15:35:00,661.72,236326.57000000033,227403.16000000038,8923.409999999945
10136,2022-04-04 15:40:00,559.25,236885.82000000033,227403.16000000038,9482.659999999945
10137,2022-04-04 15:45:00,196.17,237081.99000000034,227403.16000000038,9678.829999999958
10138,2022-04-04 15:50:00,-1852.83,235229.16000000035,227403.16000000038,7825.999999999971
10139,2022-04-04 15:55:00,1816.99,237046.15000000034,227403.16000000038,9642.989999999962
10140,2022-04-04 16:00:00,920.23,237966.38000000035,227403.16000000038,10563.219999999972
10141,2022-04-04 16:05:00,2.61,237968.99000000034,227403.16000000038,10565.829999999958
10142,2022-04-04 16:10:00,1509.18,239478.17000000033,227403.16000000038,12075.009999999951
10143,2022-04-04 16:15:00,-1349.05,238129.12000000034,227403.16000000038,10725.959999999963
10144,2022-04-04 16:20:00,-1561.11,236568.01000000036,227403.16000000038,9164.849999999977
10145,2022-04-04 16:25:00,1436.12,238004.13000000035,227403.16000000038,10600.969999999972
10146,2022-04-04 16:30:00,-467.84,237536.29000000036,227403.16000000038,10133.129999999976
10147,2022-04-04 16:35:00,-1917.22,235619.07000000036,227403.16000000038,8215.909999999974
10148,2022-04-04 16:40:00,-1242.52,234376.55000000037,227403.16000000038,6973.389999999985
10149,2022-04-04 16:45:00,1366.32,235742.87000000037,227403.16000000038,8339.709999999992
10150,2022-04-04 16:50:00,-733.0,235009.87000000037,227403.16000000038,7606.709999999992
10151,2022-04-04 16:55:00,-511.45,234498.42000000036,227403.16000000038,7095.25999999998
10152,2022-04-05 08:00:00,673.13,235171.55000000037,234498.42000000036,673.1300000000047
10153,2022-04-05 08:05:00,-1320.86,233850.69000000038,234498.42000000036,-647.7299999999814
10154,2022-04-05 08:10:00,1845.22,235695.91000000038,234498.42000000036,1197.4900000000198
10155,2022-04-05 08:15:00,1335.09,237031.00000000038,234498.42000000036,2532.5800000000163
10156,2022-04-05 08:20:00,458.11,237489.11000000036,234498.42000000036,2990.6900000000023
10157,2022-04-05 08:25:00,-583.96,236905.15000000037,234498.42000000036,2406.7300000000105
10158,2022-04-05 08:30:00,-787.74,236117.41000000038,234498.42000000036,1618.9900000000198
10159,2022-04-05 08:35:00,-100.73,236016.68000000037,234498.42000000036,1518.2600000000093
10160,2022-04-05 08:40:00,402.44,236419.12000000037,234498.42000000036,1920.7000000000116
10161,2022-04-05 08:45:00,-347.99,236071.13000000038,234498.42000000036,1572.710000000021
10162,2022-04-05 08:50:00,1186.93,237258.06000000038,234498.42000000036,2759.640000000014
10163,2022-04-05 08:55:00,-829.19,236428.87000000037,234498.42000000036,1930.4500000000116
10164,2022-04-05 09:00:00,-597.34,235831.53000000038,234498.42000000036,1333.1100000000151
10165,2022-04-05 09:05:00,-615.22,235216.31000000038,234498.42000000036,717.890000000014
10166,2022-04-05 09:10:00,-1261.41,233954.90000000037,234498.42000000036,-543.5199999999895
10167,2022-04-05 09:15:00,820.44,234775.34000000037,234498.42000000036,276.9200000000128
10168,2022-04-05 09:20:00,574.04,235349.38000000038,234498.42000000036,850.960000000021
10169,2022-04-05 09:25:00,-281.8,235067.5800000004,234498.42000000036,569.1600000000326
10170,2022-04-05 09:30:00,401.58,235469.16000000038,234498.42000000036,970.7400000000198
10171,2022-04-05 09:35:00,-991.48,234477.68000000037,234498.42000000036,-20.739999999990687
10172,2022-04-05 09:40:00,-1251.38,233226.30000000037,234498.42000000036,-1272.1199999999953
10173,2022-04-05 09:45:00,-791.83,232434.47000000038,234498.42000000036,-2063.9499999999825
10174,2022-04-05 09:50:00,1668.26,234102.7300000004,234498.42000000036,-395.6899999999732
10175,2022-04-05 09:55:00,-402.03,233700.7000000004,234498.42000000036,-797.7199999999721
10176,2022-04-05 10:00:00,-1678.79,232021.91000000038,234498.42000000036,-2476.50999999998
10177,2022-04-05 10:05:00,1382.24,233404.15000000037,234498.42000000036,-1094.2699999999895
10178,2022-04-05 10:10:00,-544.73,232859.42000000036,234498.42000000036,-1639.0
10179,2022-04-05 10:15:00,870.81,233730.23000000036,234498.42000000036,-768.1900000000023
10180,2022-04-05 10:20:00,-1750.61,231979.62000000037,234498.42000000036,-2518.7999999999884
10181,2022-04-05 10:25:00,-648.4,231331.22000000038,234498.42000000036,-3167.1999999999825
10182,2022-04-05 10:30:00,609.23,231940.4500000004,234498.42000000036,-2557.969999999972
10183,2022-04-05 10:35:00,-264.7,231675.75000000038,234498.42000000036,-2822.6699999999837
10184,2022-04-05 10:40:00,873.18,232548.93000000037,234498.42000000036,-1949.4899999999907
10185,2022-04-05 10:45:00,-1807.6,230741.33000000037,234498.42000000036,-3757.0899999999965
10186,2022-04-05 10:50:00,1646.15,232387.48000000036,234498.42000000036,-2110.9400000000023
10187,2022-04-05 10:55:00,1981.39,234368.87000000037,234498.42000000036,-129.54999999998836
10188,2022-04-05 11:00:00,-545.68,233823.19000000038,234498.42000000036,-675.2299999999814
10189,2022-04-05 11:05:00,1571.37,235394.56000000038,234498.42000000036,896.140000000014
10190,2022-04-05 11:10:00,1290.45,236685.0100000004,234498.42000000036,2186.5900000000256
10191,2022-04-05 11:15:00,-495.34,236189.6700000004,234498.42000000036,1691.250000000029
10192,2022-04-05 11:20:00,-22.98,236166.69000000038,234498.42000000036,1668.2700000000186
10193,2022-04-05 11:25:00,-1045.07,235121.62000000037,234498.42000000036,623.2000000000116
10194,2022-04-05 11:30:00,53.24,235174.86000000036,234498.42000000036,676.4400000000023
10195,2022-04-05 11:35:00,-1611.93,233562.93000000037,234498.42000000036,-935.4899999999907
10196,2022-04-05 11:40:00,-265.82,233297.11000000036,234498.42000000036,-1201.3099999999977
10197,2022-04-05 11:45:00,221.81,233518.92000000036,234498.42000000036,-979.5
10198,2022-04-05 11:50:00,-226.72,233292.20000000036,234498.42000000036,-1206.2200000000012
10199,2022-04-05 11:55:00,1547.95,234840.15000000037,234498.42000000036,341.7300000000105
10200,2022-04-05 12:00:00,701.95,235542.10000000038,234498.42000000036,1043.6800000000221
10201,2022-04-05 12:05:00,-299.53,235242.57000000039,234498.42000000036,744.1500000000233
10202,2022-04-05 12:10:00,736.91,235979.4800000004,234498.42000000036,1481.0600000000268
10203,2022-04-05 12:15:00,1907.96,237887.44000000038,234498.42000000036,3389.0200000000186
10204,2022-04-05 12:20:00,-1674.31,236213.13000000038,234498.42000000036,1714.710000000021
10205,2022-04-05 12:25:00,354.25,236567.38000000038,234498.42000000036,2068.960000000021
10206,2022-04-05 12:30:00,-1284.75,235282.63000000038,234498.42000000036,784.210000000021
10207,2022-04-05 12:35:00,807.17,236089.8000000004,234498.42000000036,1591.3800000000338
10208,2022-04-05 12:40:00,961.83,237051.63000000038,234498.42000000036,2553.210000000021
10209,2022-04-05 12:45:00,238.69,237290.32000000039,234498.42000000036,2791.9000000000233
10210,2022-04-05 12:50:00,1521.83,238812.15000000037,234498.42000000036,4313.7300000000105
10211,2022-04-05 12:55:00,189.17,239001.32000000039,234498.42000000036,4502.900000000023
10212,2022-04-05 13:00:00,907.2,239908.5200000004,234498.42000000036,5410.100000000035
10213,2022-04-05 13:05:00,-41.14,239867.38000000038,234498.42000000036,5368.960000000021
10214,2022-04-05 13:10:00,1097.99,240965.37000000037,234498.42000000036,6466.950000000012
10215,2022-04-05 13:15:00,-1194.76,239770.61000000036,234498.42000000036,5272.190000000002
10216,2022-04-05 13:20:00,-130.07,239640.54000000036,234498.42000000036,5142.119999999995
10217,2022-04-05 13:25:00,25.52,239666.06000000035,234498.42000000036,5167.639999999985
10218,2022-04-05 13:30:00,1526.86,241192.92000000033,234498.42000000036,6694.499999999971
10219,2022-04-05 13:35:00,-822.62,240370.30000000034,234498.42000000036,5871.879999999976
10220,2022-04-05 13:40:00,1664.54,242034.84000000035,234498.42000000036,7536.419999999984
10221,2022-04-05 13:45:00,-1062.13,240972.71000000034,234498.42000000036,6474.289999999979
10222,2022-04-05 13:50:00,1808.18,242780.89000000033,234498.42000000036,8282.469999999972
10223,2022-04-05 13:55:00,399.07,243179.96000000034,234498.42000000036,8681.539999999979
10224,2022-04-05 14:00:00,-1390.6,241789.36000000034,234498.42000000036,7290.939999999973
10225,2022-04-05 14:05:00,-1802.92,239986.44000000032,234498.42000000036,5488.01999999996
10226,2022-04-05 14:10:00,610.61,240597.0500000003,234498.42000000036,6098.629999999946
10227,2022-04-05 14:15:00,780.68,241377.7300000003,234498.42000000036,6879.3099999999395
10228,2022-04-05 14:20:00,358.26,241735.9900000003,234498.42000000036,7237.569999999949
10229,2022-04-05 14:25:00,-724.61,241011.38000000032,234498.42000000036,6512.959999999963
10230,2022-04-05 14:30:00,1543.04,242554.42000000033,234498.42000000036,8055.999999999971
10231,2022-04-05 14:35:00,719.45,243273.87000000034,234498.42000000036,8775.449999999983
10232,2022-04-05 14:40:00,830.47,244104.34000000035,234498.42000000036,9605.919999999984
10233,2022-04-05 14:45:00,1191.53,245295.87000000034,234498.42000000036,10797.449999999983
10234,2022-04-05 14:50:00,1965.92,247261.79000000036,234498.42000000036,12763.369999999995
10235,2022-04-05 14:55:00,449.89,247711.68000000037,234498.42000000036,13213.26000000001
10236,2022-04-05 15:00:00,1344.15,249055.83000000037,234498.42000000036,14557.410000000003
10237,2022-04-05 15:05:00,-1844.19,247211.64000000036,234498.42000000036,12713.220000000001
10238,2022-04-05 15:10:00,-1469.07,245742.57000000036,234498.42000000036,11244.149999999994
10239,2022-04-05 15:15:00,1845.77,247588.34000000035,234498.42000000036,13089.919999999984
10240,2022-04-05 15:20:00,68.27,247656.61000000034,234498.42000000036,13158.189999999973
10241,2022-04-05 15:25:00,1524.99,249181.60000000033,234498.42000000036,14683.179999999964
10242,2022-04-05 15:30:00,1127.3,250308.9000000003,234498.42000000036,15810.479999999952
10243,2022-04-05 15:35:00,1623.08,251931.9800000003,234498.42000000036,17433.55999999994
10244,2022-04-05 15:40:00,722.18,252654.1600000003,234498.42000000036,18155.739999999932
10245,2022-04-05 15:45:00,1566.24,254220.40000000029,234498.42000000036,19721.979999999923
10246,2022-04-05 15:50:00,-854.57,253365.83000000028,234498.42000000036,18867.409999999916
10247,2022-04-05 15:55:00,608.28,253974.11000000028,234498.42000000036,19475.689999999915
10248,2022-04-05 16:00:00,-459.24,253514.8700000003,234498.42000000036,19016.449999999924
10249,2022-04-05 16:05:00,-6.05,253508.8200000003,234498.42000000036,19010.399999999936
10250,2022-04-05 16:10:00,1285.97,254794.7900000003,234498.42000000036,20296.369999999937
10251,2022-04-05 16:15:00,-1283.17,253511.6200000003,234498.42000000036,19013.199999999924
10252,2022-04-05 16:20:00,979.92,254491.5400000003,234498.42000000036,19993.119999999937
10253,2022-04-05 16:25:00,-777.39,253714.15000000029,234498.42000000036,19215.729999999923
10254,2022-04-05 16:30:00,826.71,254540.86000000028,234498.42000000036,20042.439999999915
10255,2022-04-05 16:35:00,-665.34,253875.52000000028,234498.42000000036,19377.09999999992
10256,2022-04-05 16:40:00,1924.23,255799.7500000003,234498.42000000036,21301.32999999993
10257,2022-04-05 16:45:00,-1941.46,253858.2900000003,234498.42000000036,19359.869999999937
10258,2022-04-05 16:50:00,-497.28,253361.0100000003,234498.42000000036,18862.58999999994
10259,2022-04-05 16:55:00,1637.34,254998.3500000003,234498.42000000036,20499.929999999935
10260,2022-04-06 08:00:00,1191.57,256189.9200000003,254998.3500000003,1191.570000000007
10261,2022-04-06 08:05:00,-862.14,255327.7800000003,254998.3500000003,329.429999999993
10262,2022-04-06 08:10:00,-97.01,255230.77000000028,254998.3500000003,232.4199999999837
10263,2022-04-06 08:15:00,1825.97,257056.74000000028,254998.3500000003,2058.389999999985
10264,2022-04-06 08:20:00,1318.96,258375.70000000027,254998.3500000003,3377.3499999999767
10265,2022-04-06 08:25:00,833.87,259209.57000000027,254998.3500000003,4211.219999999972
10266,2022-04-06 08:30:00,1636.69,260846.26000000027,254998.3500000003,5847.909999999974
10267,2022-04-06 08:35:00,1985.13,262831.39000000025,254998.3500000003,7833.03999999995
10268,2022-04-06 08:40:00,-1355.31,261476.08000000025,254998.3500000003,6477.729999999952
10269,2022-04-06 08:45:00,-1717.4,259758.68000000025,254998.3500000003,4760.329999999958
10270,2022-04-06 08:50:00,1125.18,260883.86000000025,254998.3500000003,5885.509999999951
10271,2022-04-06 08:55:00,-1865.02,259018.84000000026,254998.3500000003,4020.4899999999616
10272,2022-04-06 09:00:00,-1947.53,257071.31000000026,254998.3500000003,2072.9599999999627
10273,2022-04-06 09:05:00,509.54,257580.85000000027,254998.3500000003,2582.499999999971
10274,2022-04-06 09:10:00,-1816.37,255764.48000000027,254998.3500000003,766.1299999999756
10275,2022-04-06 09:15:00,928.06,256692.54000000027,254998.3500000003,1694.1899999999732
10276,2022-04-06 09:20:00,642.3,257334.84000000026,254998.3500000003,2336.4899999999616
10277,2022-04-06 09:25:00,1805.58,259140.42000000025,254998.3500000003,4142.069999999949
10278,2022-04-06 09:30:00,730.63,259871.05000000025,254998.3500000003,4872.699999999953
10279,2022-04-06 09:35:00,-888.51,258982.54000000024,254998.3500000003,3984.189999999944
10280,2022-04-06 09:40:00,-99.88,258882.66000000024,254998.3500000003,3884.3099999999395
10281,2022-04-06 09:45:00,177.01,259059.67000000025,254998.3500000003,4061.319999999949
10282,2022-04-06 09:50:00,636.4,259696.07000000024,254998.3500000003,4697.719999999943
10283,2022-04-06 09:55:00,718.03,260414.10000000024,254998.3500000003,5415.749999999942
10284,2022-04-06 10:00:00,1035.84,261449.94000000024,254998.3500000003,6451.589999999938
10285,2022-04-06 10:05:00,1033.57,262483.51000000024,254998.3500000003,7485.159999999945
10286,2022-04-06 10:10:00,-1900.56,260582.95000000024,254998.3500000003,5584.599999999948
10287,2022-04-06 10:15:00,-361.32,260221.63000000024,254998.3500000003,5223.279999999941
10288,2022-04-06 10:20:00,149.99,260371.62000000023,254998.3500000003,5373.269999999931
10289,2022-04-06 10:25:00,1620.92,261992.54000000024,254998.3500000003,6994.189999999944
10290,2022-04-06 10:30:00,-352.16,261640.38000000024,254998.3500000003,6642.029999999941
10291,2022-04-06 10:35:00,-1772.43,259867.95000000024,254998.3500000003,4869.599999999948
10292,2022-04-06 10:40:00,-37.52,259830.43000000025,254998.3500000003,4832.079999999958
10293,2022-04-06 10:45:00,-463.9,259366.53000000026,254998.3500000003,4368.179999999964
10294,2022-04-06 10:50:00,985.64,260352.17000000027,254998.3500000003,5353.819999999978
10295,2022-04-06 10:55:00,288.44,260640.61000000028,254998.3500000003,5642.25999999998
10296,2022-04-06 11:00:00,-406.11,260234.5000000003,254998.3500000003,5236.149999999994
10297,2022-04-06 11:05:00,921.11,261155.61000000028,254998.3500000003,6157.25999999998
10298,2022-04-06 11:10:00,62.38,261217.99000000028,254998.3500000003,6219.639999999985
10299,2022-04-06 11:15:00,522.02,261740.01000000027,254998.3500000003,6741.659999999974
10300,2022-04-06 11:20:00,1509.11,263249.1200000003,254998.3500000003,8250.76999999999
10301,2022-04-06 11:25:00,357.48,263606.60000000027,254998.3500000003,8608.24999999997
10302,2022-04-06 11:30:00,-1590.84,262015.76000000027,254998.3500000003,7017.409999999974
10303,2022-04-06 11:35:00,-784.89,261230.87000000026,254998.3500000003,6232.51999999996
10304,2022-04-06 11:40:00,1670.51,262901.38000000024,254998.3500000003,7903.029999999941
10305,2022-04-06 11:45:00,-155.47,262745.91000000027,254998.3500000003,7747.559999999969
10306,2022-04-06 11:50:00,1175.2,263921.1100000003,254998.3500000003,8922.75999999998
10307,2022-04-06 11:55:00,1839.73,265760.84000000026,254998.3500000003,10762.489999999962
10308,2022-04-06 12:00:00,341.7,266102.54000000027,254998.3500000003,11104.189999999973
10309,2022-04-06 12:05:00,1347.05,267449.59000000026,254998.3500000003,12451.239999999962
10310,2022-04-06 12:10:00,1198.81,268648.40000000026,254998.3500000003,13650.04999999996
10311,2022-04-06 12:15:00,1655.37,270303.77000000025,254998.3500000003,15305.419999999955
10312,2022-04-06 12:20:00,-1509.98,268793.79000000027,254998.3500000003,13795.439999999973
10313,2022-04-06 12:25:00,-1065.75,267728.04000000027,254998.3500000003,12729.689999999973
10314,2022-04-06 12:30:00,992.18,268720.22000000026,254998.3500000003,13721.869999999966
10315,2022-04-06 12:35:00,-633.63,268086.59000000026,254998.3500000003,13088.239999999962
10316,2022-04-06 12:40:00,10.23,268096.82000000024,254998.3500000003,13098.469999999943
10317,2022-04-06 12:45:00,1945.09,270041.91000000027,254998.3500000003,15043.559999999969
10318,2022-04-06 12:50:00,-1703.71,268338.20000000024,254998.3500000003,13339.849999999948
10319,2022-04-06 12:55:00,1403.72,269741.9200000002,254998.3500000003,14743.56999999992
10320,2022-04-06 13:00:00,1857.78,271599.70000000024,254998.3500000003,16601.349999999948
10321,2022-04-06 13:05:00,-1954.58,269645.1200000002,254998.3500000003,14646.769999999931
10322,2022-04-06 13:10:00,223.3,269868.4200000002,254998.3500000003,14870.06999999992
10323,2022-04-06 13:15:00,1138.66,271007.0800000002,254998.3500000003,16008.729999999894
10324,2022-04-06 13:20:00,450.1,271457.18000000017,254998.3500000003,16458.82999999987
10325,2022-04-06 13:25:00,567.02,272024.2000000002,254998.3500000003,17025.84999999989
10326,2022-04-06 13:30:00,-1552.64,270471.5600000002,254998.3500000003,15473.209999999875
10327,2022-04-06 13:35:00,-1852.57,268618.99000000017,254998.3500000003,13620.639999999868
10328,2022-04-06 13:40:00,-1871.76,266747.23000000016,254998.3500000003,11748.87999999986
10329,2022-04-06 13:45:00,177.53,266924.7600000002,254998.3500000003,11926.409999999887
10330,2022-04-06 13:50:00,1259.25,268184.0100000002,254998.3500000003,13185.659999999887
10331,2022-04-06 13:55:00,424.44,268608.4500000002,254998.3500000003,13610.09999999989
10332,2022-04-06 14:00:00,-1277.39,267331.0600000002,254998.3500000003,12332.709999999875
10333,2022-04-06 14:05:00,-440.23,266890.8300000002,254998.3500000003,11892.479999999894
10334,2022-04-06 14:10:00,730.14,267620.9700000002,254998.3500000003,12622.619999999908
10335,2022-04-06 14:15:00,-1319.13,266301.8400000002,254998.3500000003,11303.489999999903
10336,2022-04-06 14:20:00,1524.58,267826.4200000002,254998.3500000003,12828.06999999992
10337,2022-04-06 14:25:00,856.48,268682.9000000002,254998.3500000003,13684.549999999901
10338,2022-04-06 14:30:00,-982.51,267700.3900000002,254998.3500000003,12702.039999999892
10339,2022-04-06 14:35:00,-1288.76,266411.6300000002,254998.3500000003,11413.279999999882
10340,2022-04-06 14:40:00,-1500.36,264911.2700000002,254998.3500000003,9912.919999999896
10341,2022-04-06 14:45:00,-662.46,264248.8100000002,254998.3500000003,9250.459999999875
10342,2022-04-06 14:50:00,-178.35,264070.4600000002,254998.3500000003,9072.109999999899
10343,2022-04-06 14:55:00,-590.44,263480.0200000002,254998.3500000003,8481.669999999896
10344,2022-04-06 15:00:00,209.44,263689.4600000002,254998.3500000003,8691.109999999899
10345,2022-04-06 15:05:00,-1566.04,262123.4200000002,254998.3500000003,7125.069999999891
10346,2022-04-06 15:10:00,1380.76,263504.18000000017,254998.3500000003,8505.82999999987
10347,2022-04-06 15:15:00,-814.12,262690.0600000002,254998.3500000003,7691.709999999875
10348,2022-04-06 15:20:00,315.35,263005.41000000015,254998.3500000003,8007.059999999852
10349,2022-04-06 15:25:00,218.83,263224.24000000017,254998.3500000003,8225.889999999868
10350,2022-04-06 15:30:00,1914.03,265138.2700000002,254998.3500000003,10139.919999999896
10351,2022-04-06 15:35:00,1591.85,266730.12000000017,254998.3500000003,11731.769999999873
10352,2022-04-06 15:40:00,1023.07,267753.1900000002,254998.3500000003,12754.83999999988
10353,2022-04-06 15:45:00,-786.96,266966.23000000016,254998.3500000003,11967.87999999986
10354,2022-04-06 15:50:00,-294.15,266672.08000000013,254998.3500000003,11673.729999999836
10355,2022-04-06 15:55:00,196.22,266868.3000000001,254998.3500000003,11869.949999999808
10356,2022-04-06 16:00:00,1252.57,268120.8700000001,254998.3500000003,13122.519999999815
10357,2022-04-06 16:05:00,1631.05,269751.9200000001,254998.3500000003,14753.569999999803
10358,2022-04-06 16:10:00,1987.44,271739.3600000001,254998.3500000003,16741.009999999806
10359,2022-04-06 16:15:00,-1707.76,270031.6000000001,254998.3500000003,15033.249999999796
10360,2022-04-06 16:20:00,353.72,270385.32000000007,254998.3500000003,15386.969999999768
10361,2022-04-06 16:25:00,-1195.51,269189.81000000006,254998.3500000003,14191.459999999759
10362,2022-04-06 16:30:00,-303.86,268885.95000000007,254998.3500000003,13887.599999999773
10363,2022-04-06 16:35:00,-1156.42,267729.5300000001,254998.3500000003,12731.17999999979
10364,2022-04-06 16:40:00,596.53,268326.0600000001,254998.3500000003,13327.709999999817
10365,2022-04-06 16:45:00,-276.12,268049.9400000001,254998.3500000003,13051.589999999822
10366,2022-04-06 16:50:00,1605.56,269655.5000000001,254998.3500000003,14657.14999999982
10367,2022-04-06 16:55:00,703.81,270359.3100000001,254998.3500000003,15360.959999999817
10368,2022-04-07 08:00:00,-1078.97,269280.34000000014,270359.3100000001,-1078.969999999972
10369,2022-04-07 08:05:00,651.38,269931.72000000015,270359.3100000001,-427.5899999999674
10370,2022-04-07 08:10:00,997.57,270929.29000000015,270359.3100000001,569.9800000000396
10371,2022-04-07 08:15:00,-397.97,270531.3200000002,270359.3100000001,172.01000000006752
10372,2022-04-07 08:20:00,1001.49,271532.8100000002,270359.3100000001,1173.5000000000582
10373,2022-04-07 08:25:00,-1426.47,270106.3400000002,270359.3100000001,-252.96999999991385
10374,2022-04-07 08:30:00,-1682.95,268423.3900000002,270359.3100000001,-1935.9199999999255
10375,2022-04-07 08:35:00,-1393.51,267029.8800000002,270359.3100000001,-3329.429999999935
10376,2022-04-07 08:40:00,-851.47,266178.4100000002,270359.3100000001,-4180.899999999907
10377,2022-04-07 08:45:00,1079.37,267257.7800000002,270359.3100000001,-3101.5299999999115
10378,2022-04-07 08:50:00,-1772.18,265485.6000000002,270359.3100000001,-4873.7099999999045
10379,2022-04-07 08:55:00,-1378.44,264107.1600000002,270359.3100000001,-6252.149999999907
10380,2022-04-07 09:00:00,-991.91,263115.25000000023,270359.3100000001,-7244.059999999881
10381,2022-04-07 09:05:00,770.11,263885.3600000002,270359.3100000001,-6473.949999999895
10382,2022-04-07 09:10:00,-1614.49,262270.8700000002,270359.3100000001,-8088.439999999886
10383,2022-04-07 09:15:00,971.76,263242.63000000024,270359.3100000001,-7116.679999999877
10384,2022-04-07 09:20:00,-837.95,262404.6800000002,270359.3100000001,-7954.629999999888
10385,2022-04-07 09:25:00,-527.64,261877.0400000002,270359.3100000001,-8482.269999999902
10386,2022-04-07 09:30:00,-1048.82,260828.2200000002,270359.3100000001,-9531.08999999991
10387,2022-04-07 09:35:00,-1961.11,258867.11000000022,270359.3100000001,-11492.199999999895
10388,2022-04-07 09:40:00,-1933.91,256933.20000000022,270359.3100000001,-13426.109999999899
10389,2022-04-07 09:45:00,-881.83,256051.37000000023,270359.3100000001,-14307.939999999886
10390,2022-04-07 09:50:00,1699.46,257750.83000000022,270359.3100000001,-12608.479999999894
10391,2022-04-07 09:55:00,384.61,258135.4400000002,270359.3100000001,-12223.869999999908
10392,2022-04-07 10:00:00,833.61,258969.0500000002,270359.3100000001,-11390.259999999922
10393,2022-04-07 10:05:00,65.57,259034.6200000002,270359.3100000001,-11324.689999999915
10394,2022-04-07 10:10:00,-953.39,258081.23000000019,270359.3100000001,-12278.079999999929
10395,2022-04-07 10:15:00,427.0,258508.23000000019,270359.3100000001,-11851.079999999929
10396,2022-04-07 10:20:00,-389.9,258118.3300000002,270359.3100000001,-12240.979999999923
10397,2022-04-07 10:25:00,118.35,258236.6800000002,270359.3100000001,-12122.629999999917
10398,2022-04-07 10:30:00,206.7,258443.3800000002,270359.3100000001,-11915.929999999906
10399,2022-04-07 10:35:00,-1818.04,256625.3400000002,270359.3100000001,-13733.969999999914
10400,2022-04-07 10:40:00,-967.1,255658.2400000002,270359.3100000001,-14701.06999999992
10401,2022-04-07 10:45:00,-1260.17,254398.07000000018,270359.3100000001,-15961.239999999932
10402,2022-04-07 10:50:00,1372.96,255771.03000000017,270359.3100000001,-14588.27999999994
10403,2022-04-07 10:55:00,1256.55,257027.58000000016,270359.3100000001,-13331.729999999952
10404,2022-04-07 11:00:00,-992.11,256035.47000000018,270359.3100000001,-14323.839999999938
10405,2022-04-07 11:05:00,1238.7,257274.1700000002,270359.3100000001,-13085.139999999927
10406,2022-04-07 11:10:00,993.45,258267.6200000002,270359.3100000001,-12091.689999999915
10407,2022-04-07 11:15:00,101.1,258368.7200000002,270359.3100000001,-11990.58999999991
10408,2022-04-07 11:20:00,-1144.77,257223.95000000022,270359.3100000001,-13135.359999999899
10409,2022-04-07 11:25:00,611.57,257835.52000000022,270359.3100000001,-12523.789999999892
10410,2022-04-07 11:30:00,-79.61,257755.91000000024,270359.3100000001,-12603.399999999878
10411,2022-04-07 11:35:00,-884.05,256871.86000000025,270359.3100000001,-13487.449999999866
10412,2022-04-07 11:40:00,-1807.64,255064.22000000023,270359.3100000001,-15295.08999999988
10413,2022-04-07 11:45:00,1869.45,256933.67000000025,270359.3100000001,-13425.639999999868
10414,2022-04-07 11:50:00,1643.3,258576.97000000023,270359.3100000001,-11782.33999999988
10415,2022-04-07 11:55:00,-259.07,258317.90000000023,270359.3100000001,-12041.409999999887
10416,2022-04-07 12:00:00,-1384.1,256933.80000000022,270359.3100000001,-13425.509999999893
10417,2022-04-07 12:05:00,1159.14,258092.94000000024,270359.3100000001,-12266.369999999879
10418,2022-04-07 12:10:00,1531.64,259624.58000000025,270359.3100000001,-10734.729999999865
10419,2022-04-07 12:15:00,-1025.65,258598.93000000025,270359.3100000001,-11760.37999999986
10420,2022-04-07 12:20:00,1825.87,260424.80000000025,270359.3100000001,-9934.509999999864
10421,2022-04-07 12:25:00,1922.16,262346.96000000025,270359.3100000001,-8012.34999999986
10422,2022-04-07 12:30:00,-1680.54,260666.42000000025,270359.3100000001,-9692.889999999868
10423,2022-04-07 12:35:00,-281.98,260384.44000000024,270359.3100000001,-9974.869999999879
10424,2022-04-07 12:40:00,-537.81,259846.63000000024,270359.3100000001,-10512.679999999877
10425,2022-04-07 12:45:00,385.08,260231.71000000022,270359.3100000001,-10127.59999999989
10426,2022-04-07 12:50:00,55.28,260286.99000000022,270359.3100000001,-10072.31999999989
10427,2022-04-07 12:55:00,-181.86,260105.13000000024,270359.3100000001,-10254.179999999877
10428,2022-04-07 13:00:00,568.23,260673.36000000025,270359.3100000001,-9685.949999999866
10429,2022-04-07 13:05:00,670.68,261344.04000000024,270359.3100000001,-9015.269999999873
10430,2022-04-07 13:10:00,1715.79,263059.83000000025,270359.3100000001,-7299.479999999865
10431,2022-04-07 13:15:00,1902.49,264962.32000000024,270359.3100000001,-5396.989999999874
10432,2022-04-07 13:20:00,-1298.44,263663.88000000024,270359.3100000001,-6695.429999999877
10433,2022-04-07 13:25:00,-582.52,263081.3600000002,270359.3100000001,-7277.949999999895
10434,2022-04-07 13:30:00,-1979.47,261101.89000000022,270359.3100000001,-9257.419999999896
10435,2022-04-07 13:35:00,202.24,261304.1300000002,270359.3100000001,-9055.179999999906
10436,2022-04-07 13:40:00,1476.45,262780.5800000002,270359.3100000001,-7578.729999999923
10437,2022-04-07 13:45:00,1547.88,264328.4600000002,270359.3100000001,-6030.8499999999185
10438,2022-04-07 13:50:00,-1818.37,262510.0900000002,270359.3100000001,-7849.219999999914
10439,2022-04-07 13:55:00,1318.77,263828.8600000002,270359.3100000001,-6530.449999999895
10440,2022-04-07 14:00:00,-1569.09,262259.7700000002,270359.3100000001,-8099.539999999921
10441,2022-04-07 14:05:00,-1339.15,260920.6200000002,270359.3100000001,-9438.689999999915
10442,2022-04-07 14:10:00,-515.74,260404.8800000002,270359.3100000001,-9954.429999999906
10443,2022-04-07 14:15:00,-183.25,260221.6300000002,270359.3100000001,-10137.679999999906
10444,2022-04-07 14:20:00,-260.3,259961.33000000022,270359.3100000001,-10397.979999999894
10445,2022-04-07 14:25:00,-895.53,259065.80000000022,270359.3100000001,-11293.509999999893
10446,2022-04-07 14:30:00,166.58,259232.3800000002,270359.3100000001,-11126.929999999906
10447,2022-04-07 14:35:00,-1390.96,257841.42000000022,270359.3100000001,-12517.889999999898
10448,2022-04-07 14:40:00,-619.66,257221.7600000002,270359.3100000001,-13137.549999999901
10449,2022-04-07 14:45:00,1842.35,259064.11000000022,270359.3100000001,-11295.199999999895
10450,2022-04-07 14:50:00,295.97,259360.08000000022,270359.3100000001,-10999.229999999894
10451,2022-04-07 14:55:00,1795.99,261156.0700000002,270359.3100000001,-9203.239999999903
10452,2022-04-07 15:00:00,-1302.01,259854.0600000002,270359.3100000001,-10505.249999999913
10453,2022-04-07 15:05:00,470.85,260324.9100000002,270359.3100000001,-10034.399999999907
10454,2022-04-07 15:10:00,-1726.8,258598.11000000022,270359.3100000001,-11761.199999999895
10455,2022-04-07 15:15:00,708.25,259306.36000000022,270359.3100000001,-11052.949999999895
10456,2022-04-07 15:20:00,682.86,259989.2200000002,270359.3100000001,-10370.08999999991
10457,2022-04-07 15:25:00,-1012.66,258976.5600000002,270359.3100000001,-11382.749999999913
10458,2022-04-07 15:30:00,-394.95,258581.6100000002,270359.3100000001,-11777.699999999924
10459,2022-04-07 15:35:00,-564.93,258016.6800000002,270359.3100000001,-12342.629999999917
10460,2022-04-07 15:40:00,225.05,258241.73000000019,270359.3100000001,-12117.579999999929
10461,2022-04-07 15:45:00,441.66,258683.3900000002,270359.3100000001,-11675.919999999925
10462,2022-04-07 15:50:00,-1472.39,257211.00000000017,270359.3100000001,-13148.30999999994
10463,2022-04-07 15:55:00,1568.71,258779.71000000017,270359.3100000001,-11579.599999999948
10464,2022-04-07 16:00:00,-1540.06,257239.65000000017,270359.3100000001,-13119.659999999945
10465,2022-04-07 16:05:00,-1607.41,255632.24000000017,270359.3100000001,-14727.069999999949
10466,2022-04-07 16:10:00,630.45,256262.69000000018,270359.3100000001,-14096.619999999937
10467,2022-04-07 16:15:00,485.7,256748.3900000002,270359.3100000001,-13610.919999999925
10468,2022-04-07 16:20:00,1932.02,258680.41000000018,270359.3100000001,-11678.899999999936
10469,2022-04-07 16:25:00,-1140.73,257539.68000000017,270359.3100000001,-12819.629999999946
10470,2022-04-07 16:30:00,1343.89,258883.57000000018,270359.3100000001,-11475.739999999932
10471,2022-04-07 16:35:00,1740.17,260623.7400000002,270359.3100000001,-9735.56999999992
10472,2022-04-07 16:40:00,-1956.03,258667.7100000002,270359.3100000001,-11691.599999999919
10473,2022-04-07 16:45:00,-1425.57,257242.1400000002,270359.3100000001,-13117.169999999925
10474,2022-04-07 16:50:00,-239.54,257002.60000000018,270359.3100000001,-13356.709999999934
10475,2022-04-07 16:55:00,-1169.88,255832.72000000018,270359.3100000001,-14526.589999999938
10476,2022-04-08 08:00:00,-942.16,254890.56000000017,255832.72000000018,-942.1600000000035
10477,2022-04-08 08:05:00,-74.89,254815.67000000016,255832.72000000018,-1017.0500000000175
10478,2022-04-08 08:10:00,1337.06,256152.73000000016,255832.72000000018,320.0099999999802
10479,2022-04-08 08:15:00,-1010.27,255142.46000000017,255832.72000000018,-690.2600000000093
10480,2022-04-08 08:20:00,-735.1,254407.36000000016,255832.72000000018,-1425.3600000000151
10481,2022-04-08 08:25:00,-1594.9,252812.46000000017,255832.72000000018,-3020.2600000000093
10482,2022-04-08 08:30:00,247.97,253060.43000000017,255832.72000000018,-2772.290000000008
10483,2022-04-08 08:35:00,1549.33,254609.76000000015,255832.72000000018,-1222.960000000021
10484,2022-04-08 08:40:00,194.04,254803.80000000016,255832.72000000018,-1028.9200000000128
10485,2022-04-08 08:45:00,52.27,254856.07000000015,255832.72000000018,-976.6500000000233
10486,2022-04-08 08:50:00,1659.64,256515.71000000017,255832.72000000018,682.9899999999907
10487,2022-04-08 08:55:00,-1380.35,255135.36000000016,255832.72000000018,-697.3600000000151
10488,2022-04-08 09:00:00,-1531.75,253603.61000000016,255832.72000000018,-2229.110000000015
10489,2022-04-08 09:05:00,-394.64,253208.97000000015,255832.72000000018,-2623.750000000029
10490,2022-04-08 09:10:00,992.22,254201.19000000015,255832.72000000018,-1631.530000000028
10491,2022-04-08 09:15:00,-1390.06,252811.13000000015,255832.72000000018,-3021.5900000000256
10492,2022-04-08 09:20:00,532.9,253344.03000000014,255832.72000000018,-2488.6900000000314
10493,2022-04-08 09:25:00,-1035.27,252308.76000000015,255832.72000000018,-3523.960000000021
10494,2022-04-08 09:30:00,-1676.54,250632.22000000015,255832.72000000018,-5200.500000000029
10495,2022-04-08 09:35:00,-192.61,250439.61000000016,255832.72000000018,-5393.110000000015
10496,2022-04-08 09:40:00,-1824.44,248615.17000000016,255832.72000000018,-7217.5500000000175
10497,2022-04-08 09:45:00,-1798.15,246817.02000000016,255832.72000000018,-9015.700000000012
10498,2022-04-08 09:50:00,-1152.1,245664.92000000016,255832.72000000018,-10167.800000000017
10499,2022-04-08 09:55:00,1878.51,247543.43000000017,255832.72000000018,-8289.290000000008
10500,2022-04-08 10:00:00,-1083.87,246459.56000000017,255832.72000000018,-9373.160000000003
10501,2022-04-08 10:05:00,28.65,246488.21000000017,255832.72000000018,-9344.51000000001
10502,2022-04-08 10:10:00,-807.07,245681.14000000016,255832.72000000018,-10151.580000000016
10503,2022-04-08 10:15:00,183.88,245865.02000000016,255832.72000000018,-9967.700000000012
10504,2022-04-08 10:20:00,1760.36,247625.38000000015,255832.72000000018,-8207.340000000026
10505,2022-04-08 10:25:00,-1412.07,246213.31000000014,255832.72000000018,-9619.410000000033
10506,2022-04-08 10:30:00,-1679.45,244533.86000000013,255832.72000000018,-11298.860000000044
10507,2022-04-08 10:35:00,82.11,244615.97000000012,255832.72000000018,-11216.750000000058
10508,2022-04-08 10:40:00,-1580.97,243035.00000000012,255832.72000000018,-12797.72000000006
10509,2022-04-08 10:45:00,-1756.25,241278.75000000012,255832.72000000018,-14553.97000000006
10510,2022-04-08 10:50:00,844.08,242122.8300000001,255832.72000000018,-13709.890000000072
10511,2022-04-08 10:55:00,-592.44,241530.3900000001,255832.72000000018,-14302.330000000075
10512,2022-04-08 11:00:00,1521.55,243051.9400000001,255832.72000000018,-12780.780000000086
10513,2022-04-08 11:05:00,1093.62,244145.56000000008,255832.72000000018,-11687.16000000009
10514,2022-04-08 11:10:00,-1658.09,242487.4700000001,255832.72000000018,-13345.250000000087
10515,2022-04-08 11:15:00,1667.36,244154.83000000007,255832.72000000018,-11677.890000000101
10516,2022-04-08 11:20:00,1515.86,245670.69000000006,255832.72000000018,-10162.030000000115
10517,2022-04-08 11:25:00,-1207.57,244463.12000000005,255832.72000000018,-11369.600000000122
10518,2022-04-08 11:30:00,872.41,245335.53000000006,255832.72000000018,-10497.190000000119
10519,2022-04-08 11:35:00,1908.52,247244.05000000005,255832.72000000018,-8588.67000000013
10520,2022-04-08 11:40:00,1334.58,248578.63000000003,255832.72000000018,-7254.090000000142
10521,2022-04-08 11:45:00,1046.6,249625.23000000004,255832.72000000018,-6207.490000000136
10522,2022-04-08 11:50:00,1554.72,251179.95000000004,255832.72000000018,-4652.770000000135
10523,2022-04-08 11:55:00,-431.23,250748.72000000003,255832.72000000018,-5084.0000000001455
10524,2022-04-08 12:00:00,671.29,251420.01000000004,255832.72000000018,-4412.710000000137
10525,2022-04-08 12:05:00,-1602.06,249817.95000000004,255832.72000000018,-6014.770000000135
10526,2022-04-08 12:10:00,268.19,250086.14000000004,255832.72000000018,-5746.580000000133
10527,2022-04-08 12:15:00,980.19,251066.33000000005,255832.72000000018,-4766.39000000013
10528,2022-04-08 12:20:00,-1312.31,249754.02000000005,255832.72000000018,-6078.700000000128
10529,2022-04-08 12:25:00,-375.63,249378.39000000004,255832.72000000018,-6454.330000000133
10530,2022-04-08 12:30:00,918.68,250297.07000000004,255832.72000000018,-5535.65000000014
10531,2022-04-08 12:35:00,715.93,251013.00000000003,255832.72000000018,-4819.720000000147
10532,2022-04-08 12:40:00,611.73,251624.73000000004,255832.72000000018,-4207.990000000136
10533,2022-04-08 12:45:00,-1118.26,250506.47000000003,255832.72000000018,-5326.2500000001455
10534,2022-04-08 12:50:00,1687.21,252193.68000000002,255832.72000000018,-3639.0400000001537
10535,2022-04-08 12:55:00,-968.05,251225.63000000003,255832.72000000018,-4607.090000000142
10536,2022-04-08 13:00:00,-1314.21,249911.42000000004,255832.72000000018,-5921.300000000134
10537,2022-04-08 13:05:00,1811.79,251723.21000000005,255832.72000000018,-4109.510000000126
10538,2022-04-08 13:10:00,1892.59,253615.80000000005,255832.72000000018,-2216.920000000129
10539,2022-04-08 13:15:00,-1908.0,251707.80000000005,255832.72000000018,-4124.920000000129
10540,2022-04-08 13:20:00,694.22,252402.02000000005,255832.72000000018,-3430.700000000128
10541,2022-04-08 13:25:00,-730.88,251671.14000000004,255832.72000000018,-4161.580000000133
10542,2022-04-08 13:30:00,-1826.98,249844.16000000003,255832.72000000018,-5988.560000000143
10543,2022-04-08 13:35:00,1888.41,251732.57000000004,255832.72000000018,-4100.15000000014
10544,2022-04-08 13:40:00,-1708.59,250023.98000000004,255832.72000000018,-5808.740000000136
10545,2022-04-08 13:45:00,669.08,250693.06000000003,255832.72000000018,-5139.660000000149
10546,2022-04-08 13:50:00,1728.02,252421.08000000002,255832.72000000018,-3411.6400000001595
10547,2022-04-08 13:55:00,652.82,253073.90000000002,255832.72000000018,-2758.8200000001525
10548,2022-04-08 14:00:00,-1070.68,252003.22000000003,255832.72000000018,-3829.5000000001455
10549,2022-04-08 14:05:00,645.14,252648.36000000004,255832.72000000018,-3184.3600000001315
10550,2022-04-08 14:10:00,-1346.23,251302.13000000003,255832.72000000018,-4530.590000000142
10551,2022-04-08 14:15:00,-1301.69,250000.44000000003,255832.72000000018,-5832.280000000144
10552,2022-04-08 14:20:00,856.97,250857.41000000003,255832.72000000018,-4975.310000000143
10553,2022-04-08 14:25:00,-291.98,250565.43000000002,255832.72000000018,-5267.290000000154
10554,2022-04-08 14:30:00,-1330.55,249234.88000000003,255832.72000000018,-6597.840000000142
10555,2022-04-08 14:35:00,1709.14,250944.02000000005,255832.72000000018,-4888.700000000128
10556,2022-04-08 14:40:00,-872.5,250071.52000000005,255832.72000000018,-5761.200000000128
10557,2022-04-08 14:45:00,-1543.24,248528.28000000006,255832.72000000018,-7304.440000000119
10558,2022-04-08 14:50:00,1434.83,249963.11000000004,255832.72000000018,-5869.610000000132
10559,2022-04-08 14:55:00,760.22,250723.33000000005,255832.72000000018,-5109.39000000013
10560,2022-04-08 15:00:00,-372.81,250350.52000000005,255832.72000000018,-5482.200000000128
10561,2022-04-08 15:05:00,-1766.29,248584.23000000004,255832.72000000018,-7248.490000000136
10562,2022-04-08 15:10:00,-815.65,247768.58000000005,255832.72000000018,-8064.14000000013
10563,2022-04-08 15:15:00,1764.06,249532.64000000004,255832.72000000018,-6300.080000000133
10564,2022-04-08 15:20:00,-1362.37,248170.27000000005,255832.72000000018,-7662.450000000128
10565,2022-04-08 15:25:00,1293.91,249464.18000000005,255832.72000000018,-6368.540000000125
10566,2022-04-08 15:30:00,-1272.86,248191.32000000007,255832.72000000018,-7641.400000000111
10567,2022-04-08 15:35:00,1247.52,249438.84000000005,255832.72000000018,-6393.880000000121
10568,2022-04-08 15:40:00,1851.78,251290.62000000005,255832.72000000018,-4542.100000000122
10569,2022-04-08 15:45:00,1393.47,252684.09000000005,255832.72000000018,-3148.630000000121
10570,2022-04-08 15:50:00,-1541.45,251142.64000000004,255832.72000000018,-4690.080000000133
10571,2022-04-08 15:55:00,-1660.21,249482.43000000005,255832.72000000018,-6350.290000000125
10572,2022-04-08 16:00:00,-893.69,248588.74000000005,255832.72000000018,-7243.980000000127
10573,2022-04-08 16:05:00,-1163.4,247425.34000000005,255832.72000000018,-8407.380000000121
10574,2022-04-08 16:10:00,1954.95,249380.29000000007,255832.72000000018,-6452.430000000109
10575,2022-04-08 16:15:00,-346.32,249033.97000000006,255832.72000000018,-6798.750000000116
10576,2022-04-08 16:20:00,520.37,249554.34000000005,255832.72000000018,-6278.380000000121
10577,2022-04-08 16:25:00,-1223.88,248330.46000000005,255832.72000000018,-7502.260000000126
10578,2022-04-08 16:30:00,-996.36,247334.10000000006,255832.72000000018,-8498.620000000112
10579,2022-04-08 16:35:00,1319.68,248653.78000000006,255832.72000000018,-7178.940000000119
10580,2022-04-08 16:40:00,1427.04,250080.82000000007,255832.72000000018,-5751.900000000111
10581,2022-04-08 16:45:00,-1233.1,248847.72000000006,255832.72000000018,-6985.000000000116
10582,2022-04-08 16:50:00,1839.84,250687.56000000006,255832.72000000018,-5145.16000000012
10583,2022-04-08 16:55:00,-1357.72,249329.84000000005,255832.72000000018,-6502.880000000121
10584,2022-04-09 08:00:00,-1359.62,247970.22000000006,249329.84000000005,-1359.6199999999953
10585,2022-04-09 08:05:00,1045.9,249016.12000000005,249329.84000000005,-313.72000000000116
10586,2022-04-09 08:10:00,915.74,249931.86000000004,249329.84000000005,602.0199999999895
10587,2022-04-09 08:15:00,1567.39,251499.25000000006,249329.84000000005,2169.4100000000035
10588,2022-04-09 08:20:00,1402.65,252901.90000000005,249329.84000000005,3572.0599999999977
10589,2022-04-09 08:25:00,1116.08,254017.98000000004,249329.84000000005,4688.139999999985
10590,2022-04-09 08:30:00,394.1,254412.08000000005,249329.84000000005,5082.239999999991
10591,2022-04-09 08:35:00,504.73,254916.81000000006,249329.84000000005,5586.970000000001
10592,2022-04-09 08:40:00,-325.34,254591.47000000006,249329.84000000005,5261.630000000005
10593,2022-04-09 08:45:00,-673.59,253917.88000000006,249329.84000000005,4588.040000000008
10594,2022-04-09 08:50:00,1800.12,255718.00000000006,249329.84000000005,6388.1600000000035
10595,2022-04-09 08:55:00,912.97,256630.97000000006,249329.84000000005,7301.130000000005
10596,2022-04-09 09:00:00,-1881.42,254749.55000000005,249329.84000000005,5419.709999999992
10597,2022-04-09 09:05:00,1892.3,256641.85000000003,249329.84000000005,7312.00999999998
10598,2022-04-09 09:10:00,1154.92,257796.77000000005,249329.84000000005,8466.929999999993
10599,2022-04-09 09:15:00,230.65,258027.42000000004,249329.84000000005,8697.579999999987
10600,2022-04-09 09:20:00,412.72,258440.14000000004,249329.84000000005,9110.299999999988
10601,2022-04-09 09:25:00,955.0,259395.14000000004,249329.84000000005,10065.299999999988
10602,2022-04-09 09:30:00,-1473.82,257921.32000000004,249329.84000000005,8591.479999999981
10603,2022-04-09 09:35:00,-1162.71,256758.61000000004,249329.84000000005,7428.7699999999895
10604,2022-04-09 09:40:00,-807.7,255950.91000000003,249329.84000000005,6621.069999999978
10605,2022-04-09 09:45:00,513.59,256464.50000000003,249329.84000000005,7134.659999999974
10606,2022-04-09 09:50:00,1814.2,258278.70000000004,249329.84000000005,8948.859999999986
10607,2022-04-09 09:55:00,1885.47,260164.17000000004,249329.84000000005,10834.329999999987
10608,2022-04-09 10:00:00,799.91,260964.08000000005,249329.84000000005,11634.23999999999
10609,2022-04-09 10:05:00,-780.62,260183.46000000005,249329.84000000005,10853.619999999995
10610,2022-04-09 10:10:00,1469.25,261652.71000000005,249329.84000000005,12322.869999999995
10611,2022-04-09 10:15:00,73.84,261726.55000000005,249329.84000000005,12396.709999999992
10612,2022-04-09 10:20:00,-967.82,260758.73000000004,249329.84000000005,11428.889999999985
10613,2022-04-09 10:25:00,1734.28,262493.01000000007,249329.84000000005,13163.170000000013
10614,2022-04-09 10:30:00,1587.72,264080.73000000004,249329.84000000005,14750.889999999985
10615,2022-04-09 10:35:00,-1950.02,262130.71000000005,249329.84000000005,12800.869999999995
10616,2022-04-09 10:40:00,351.78,262482.49000000005,249329.84000000005,13152.649999999994
10617,2022-04-09 10:45:00,-79.3,262403.19000000006,249329.84000000005,13073.350000000006
10618,2022-04-09 10:50:00,531.62,262934.81000000006,249329.84000000005,13604.970000000001
10619,2022-04-09 10:55:00,1729.77,264664.5800000001,249329.84000000005,15334.74000000002
10620,2022-04-09 11:00:00,1729.58,266394.1600000001,249329.84000000005,17064.320000000036
10621,2022-04-09 11:05:00,1339.14,267733.3000000001,249329.84000000005,18403.46000000005
10622,2022-04-09 11:10:00,-1899.64,265833.6600000001,249329.84000000005,16503.820000000036
10623,2022-04-09 11:15:00,-749.34,265084.32000000007,249329.84000000005,15754.48000000001
10624,2022-04-09 11:20:00,-345.43,264738.8900000001,249329.84000000005,15409.050000000017
10625,2022-04-09 11:25:00,-433.63,264305.26000000007,249329.84000000005,14975.420000000013
10626,2022-04-09 11:30:00,-1664.38,262640.88000000006,249329.84000000005,13311.040000000008
10627,2022-04-09 11:35:00,-1673.65,260967.23000000007,249329.84000000005,11637.390000000014
10628,2022-04-09 11:40:00,-1963.7,259003.53000000006,249329.84000000005,9673.690000000002
10629,2022-04-09 11:45:00,-906.95,258096.58000000005,249329.84000000005,8766.73999999999
10630,2022-04-09 11:50:00,1726.21,259822.79000000004,249329.84000000005,10492.949999999983
10631,2022-04-09 11:55:00,-1875.56,257947.23000000004,249329.84000000005,8617.389999999985
10632,2022-04-09 12:00:00,-532.0,257415.23000000004,249329.84000000005,8085.389999999985
10633,2022-04-09 12:05:00,-1468.05,255947.18000000005,249329.84000000005,6617.3399999999965
10634,2022-04-09 12:10:00,-1592.98,254354.20000000004,249329.84000000005,5024.359999999986
10635,2022-04-09 12:15:00,445.25,254799.45000000004,249329.84000000005,5469.609999999986
10636,2022-04-09 12:20:00,-1734.86,253064.59000000005,249329.84000000005,3734.75
10637,2022-04-09 12:25:00,-726.35,252338.24000000005,249329.84000000005,3008.399999999994
10638,2022-04-09 12:30:00,-819.13,251519.11000000004,249329.84000000005,2189.2699999999895
10639,2022-04-09 12:35:00,270.08,251789.19000000003,249329.84000000005,2459.3499999999767
10640,2022-04-09 12:40:00,-178.08,251611.11000000004,249329.84000000005,2281.2699999999895
10641,2022-04-09 12:45:00,605.44,252216.55000000005,249329.84000000005,2886.709999999992
10642,2022-04-09 12:50:00,253.18,252469.73000000004,249329.84000000005,3139.889999999985
10643,2022-04-09 12:55:00,334.18,252803.91000000003,249329.84000000005,3474.069999999978
10644,2022-04-09 13:00:00,931.95,253735.86000000004,249329.84000000005,4406.0199999999895
10645,2022-04-09 13:05:00,1599.21,255335.07000000004,249329.84000000005,6005.229999999981
10646,2022-04-09 13:10:00,227.45,255562.52000000005,249329.84000000005,6232.679999999993
10647,2022-04-09 13:15:00,-1271.71,254290.81000000006,249329.84000000005,4960.970000000001
10648,2022-04-09 13:20:00,1439.54,255730.35000000006,249329.84000000005,6400.510000000009
10649,2022-04-09 13:25:00,1844.99,257575.34000000005,249329.84000000005,8245.5
10650,2022-04-09 13:30:00,1569.11,259144.45000000004,249329.84000000005,9814.609999999986
10651,2022-04-09 13:35:00,1710.59,260855.04000000004,249329.84000000005,11525.199999999983
10652,2022-04-09 13:40:00,956.27,261811.31000000003,249329.84000000005,12481.469999999972
10653,2022-04-09 13:45:00,-428.2,261383.11000000002,249329.84000000005,12053.26999999996
10654,2022-04-09 13:50:00,881.36,262264.47000000003,249329.84000000005,12934.629999999976
10655,2022-04-09 13:55:00,1085.98,263350.45,249329.84000000005,14020.609999999957
10656,2022-04-09 14:00:00,-1244.64,262105.81,249329.84000000005,12775.969999999943
10657,2022-04-09 14:05:00,1069.43,263175.24,249329.84000000005,13845.399999999936
10658,2022-04-09 14:10:00,1974.73,265149.97,249329.84000000005,15820.129999999917
10659,2022-04-09 14:15:00,667.28,265817.25,249329.84000000005,16487.409999999945
10660,2022-04-09 14:20:00,-15.2,265802.05,249329.84000000005,16472.209999999934
10661,2022-04-09 14:25:00,-83.29,265718.76,249329.84000000005,16388.919999999955
10662,2022-04-09 14:30:00,-875.7,264843.06,249329.84000000005,15513.219999999943
10663,2022-04-09 14:35:00,293.98,265137.04,249329.84000000005,15807.199999999924
10664,2022-04-09 14:40:00,1837.82,266974.86,249329.84000000005,17645.01999999993
10665,2022-04-09 14:45:00,94.18,267069.04,249329.84000000005,17739.199999999924
10666,2022-04-09 14:50:00,-1210.51,265858.52999999997,249329.84000000005,16528.689999999915
10667,2022-04-09 14:55:00,-1500.71,264357.81999999995,249329.84000000005,15027.979999999894
10668,2022-04-09 15:00:00,1275.45,265633.26999999996,249329.84000000005,16303.429999999906
10669,2022-04-09 15:05:00,-212.38,265420.88999999996,249329.84000000005,16091.049999999901
10670,2022-04-09 15:10:00,1985.39,267406.27999999997,249329.84000000005,18076.439999999915
10671,2022-04-09 15:15:00,-641.94,266764.33999999997,249329.84000000005,17434.499999999913
10672,2022-04-09 15:20:00,1732.48,268496.81999999995,249329.84000000005,19166.979999999894
10673,2022-04-09 15:25:00,-1590.35,266906.47,249329.84000000005,17576.629999999917
10674,2022-04-09 15:30:00,-1850.24,265056.23,249329.84000000005,15726.389999999927
10675,2022-04-09 15:35:00,686.04,265742.26999999996,249329.84000000005,16412.429999999906
10676,2022-04-09 15:40:00,-1198.97,264543.3,249329.84000000005,15213.459999999934
10677,2022-04-09 15:45:00,269.75,264813.05,249329.84000000005,15483.209999999934
10678,2022-04-09 15:50:00,-1702.49,263110.56,249329.84000000005,13780.719999999943
10679,2022-04-09 15:55:00,-1296.76,261813.8,249329.84000000005,12483.959999999934
10680,2022-04-09 16:00:00,-1043.75,260770.05,249329.84000000005,11440.209999999934
10681,2022-04-09 16:05:00,538.8,261308.84999999998,249329.84000000005,11979.009999999922
10682,2022-04-09 16:10:00,1364.43,262673.27999999997,249329.84000000005,13343.439999999915
10683,2022-04-09 16:15:00,1544.65,264217.93,249329.84000000005,14888.089999999938
10684,2022-04-09 16:20:00,-1664.6,262553.33,249329.84000000005,13223.489999999962
10685,2022-04-09 16:25:00,-782.56,261770.77000000002,249329.84000000005,12440.929999999964
10686,2022-04-09 16:30:00,-486.01,261284.76,249329.84000000005,11954.919999999955
10687,2022-04-09 16:35:00,647.68,261932.44,249329.84000000005,12602.599999999948
10688,2022-04-09 16:40:00,1029.9,262962.34,249329.84000000005,13632.49999999997
10689,2022-04-09 16:45:00,385.79,263348.13,249329.84000000005,14018.28999999995
10690,2022-04-09 16:50:00,-1460.46,261887.67,249329.84000000005,12557.829999999958
10691,2022-04-09 16:55:00,1055.01,262942.68,249329.84000000005,13612.839999999938
10692,2022-04-10 08:00:00,-1110.23,261832.44999999998,262942.68,-1110.2300000000105
10693,2022-04-10 08:05:00,1483.24,263315.69,262942.68,373.0100000000093
10694,2022-04-10 08:10:00,-178.15,263137.54,262942.68,194.85999999998603
10695,2022-04-10 08:15:00,1543.28,264680.82,262942.68,1738.140000000014
10696,2022-04-10 08:20:00,178.67,264859.49,262942.68,1916.8099999999977
10697,2022-04-10 08:25:00,202.23,265061.72,262942.68,2119.039999999979
10698,2022-04-10 08:30:00,880.88,265942.6,262942.68,2999.9199999999837
10699,2022-04-10 08:35:00,-284.42,265658.18,262942.68,2715.5
10700,2022-04-10 08:40:00,-31.78,265626.39999999997,262942.68,2683.719999999972
10701,2022-04-10 08:45:00,1163.65,266790.05,262942.68,3847.3699999999953
10702,2022-04-10 08:50:00,1568.37,268358.42,262942.68,5415.739999999991
10703,2022-04-10 08:55:00,3.83,268362.25,262942.68,5419.570000000007
10704,2022-04-10 09:00:00,-1242.28,267119.97,262942.68,4177.289999999979
10705,2022-04-10 09:05:00,4.2,267124.17,262942.68,4181.489999999991
10706,2022-04-10 09:10:00,-509.46,266614.70999999996,262942.68,3672.0299999999697
10707,2022-04-10 09:15:00,1071.29,267685.99999999994,262942.68,4743.319999999949
10708,2022-04-10 09:20:00,454.09,268140.08999999997,262942.68,5197.409999999974
10709,2022-04-10 09:25:00,-950.08,267190.00999999995,262942.68,4247.329999999958
10710,2022-04-10 09:30:00,260.8,267450.80999999994,262942.68,4508.129999999946
10711,2022-04-10 09:35:00,610.41,268061.2199999999,262942.68,5118.539999999921
10712,2022-04-10 09:40:00,445.33,268506.54999999993,262942.68,5563.869999999937
10713,2022-04-10 09:45:00,-410.49,268096.05999999994,262942.68,5153.379999999946
10714,2022-04-10 09:50:00,-1694.91,266401.14999999997,262942.68,3458.469999999972
10715,2022-04-10 09:55:00,-439.14,265962.00999999995,262942.68,3019.329999999958
10716,2022-04-10 10:00:00,-1995.83,263966.17999999993,262942.68,1023.4999999999418
10717,2022-04-10 10:05:00,-1557.01,262409.1699999999,262942.68,-533.5100000000675
10718,2022-04-10 10:10:00,-471.44,261937.72999999992,262942.68,-1004.9500000000698
10719,2022-04-10 10:15:00,-932.8,261004.92999999993,262942.68,-1937.7500000000582
10720,2022-04-10 10:20:00,-178.88,260826.04999999993,262942.68,-2116.630000000063
10721,2022-04-10 10:25:00,-466.74,260359.30999999994,262942.68,-2583.3700000000536
10722,2022-04-10 10:30:00,1441.32,261800.62999999995,262942.68,-1142.0500000000466
10723,2022-04-10 10:35:00,942.9,262743.52999999997,262942.68,-199.15000000002328
10724,2022-04-10 10:40:00,-1412.05,261331.47999999998,262942.68,-1611.2000000000116
10725,2022-04-10 10:45:00,297.16,261628.63999999998,262942.68,-1314.0400000000081
10726,2022-04-10 10:50:00,828.29,262456.93,262942.68,-485.75
10727,2022-04-10 10:55:00,1702.62,264159.55,262942.68,1216.8699999999953
10728,2022-04-10 11:00:00,-1651.29,262508.26,262942.68,-434.4199999999837
10729,2022-04-10 11:05:00,1681.31,264189.57,262942.68,1246.890000000014
10730,2022-04-10 11:10:00,1050.44,265240.01,262942.68,2297.3300000000163
10731,2022-04-10 11:15:00,1903.5,267143.51,262942.68,4200.830000000016
10732,2022-04-10 11:20:00,1459.7,268603.21,262942.68,5660.530000000028
10733,2022-04-10 11:25:00,-161.47,268441.74000000005,262942.68,5499.060000000056
10734,2022-04-10 11:30:00,758.06,269199.80000000005,262942.68,6257.120000000054
10735,2022-04-10 11:35:00,-224.14,268975.66000000003,262942.68,6032.98000000004
10736,2022-04-10 11:40:00,1052.14,270027.80000000005,262942.68,7085.120000000054
10737,2022-04-10 11:45:00,1589.89,271617.69000000006,262942.68,8675.010000000068
10738,2022-04-10 11:50:00,-1915.28,269702.41000000003,262942.68,6759.73000000004
10739,2022-04-10 11:55:00,-839.61,268862.80000000005,262942.68,5920.120000000054
10740,2022-04-10 12:00:00,-960.97,267901.8300000001,262942.68,4959.1500000000815
10741,2022-04-10 12:05:00,-1133.94,266767.8900000001,262942.68,3825.210000000079
10742,2022-04-10 12:10:00,-1901.12,264866.7700000001,262942.68,1924.0900000000838
10743,2022-04-10 12:15:00,-45.43,264821.3400000001,262942.68,1878.6600000000908
10744,2022-04-10 12:20:00,-1493.5,263327.8400000001,262942.68,385.1600000000908
10745,2022-04-10 12:25:00,852.86,264180.70000000007,262942.68,1238.0200000000768
10746,2022-04-10 12:30:00,1770.54,265951.24000000005,262942.68,3008.560000000056
10747,2022-04-10 12:35:00,-154.32,265796.92000000004,262942.68,2854.240000000049
10748,2022-04-10 12:40:00,1987.84,267784.76000000007,262942.68,4842.0800000000745
10749,2022-04-10 12:45:00,1236.83,269021.5900000001,262942.68,6078.910000000091
10750,2022-04-10 12:50:00,-375.55,268646.0400000001,262942.68,5703.360000000102
10751,2022-04-10 12:55:00,984.73,269630.7700000001,262942.68,6688.090000000084
10752,2022-04-10 13:00:00,-158.32,269472.45000000007,262942.68,6529.770000000077
10753,2022-04-10 13:05:00,1075.64,270548.0900000001,262942.68,7605.410000000091
10754,2022-04-10 13:10:00,1415.99,271964.0800000001,262942.68,9021.400000000081
10755,2022-04-10 13:15:00,682.07,272646.1500000001,262942.68,9703.470000000088
10756,2022-04-10 13:20:00,-889.49,271756.6600000001,262942.68,8813.980000000098
10757,2022-04-10 13:25:00,339.86,272096.5200000001,262942.68,9153.840000000084
10758,2022-04-10 13:30:00,1037.52,273134.0400000001,262942.68,10191.360000000102
10759,2022-04-10 13:35:00,-503.6,272630.4400000001,262942.68,9687.760000000126
10760,2022-04-10 13:40:00,-334.02,272296.4200000001,262942.68,9353.740000000107
10761,2022-04-10 13:45:00,-962.34,271334.0800000001,262942.68,8391.400000000081
10762,2022-04-10 13:50:00,330.82,271664.9000000001,262942.68,8722.220000000088
10763,2022-04-10 13:55:00,-1078.65,270586.25000000006,262942.68,7643.570000000065
10764,2022-04-10 14:00:00,1044.55,271630.80000000005,262942.68,8688.120000000054
10765,2022-04-10 14:05:00,581.9,272212.70000000007,262942.68,9270.020000000077
10766,2022-04-10 14:10:00,1704.51,273917.2100000001,262942.68,10974.530000000086
10767,2022-04-10 14:15:00,-1914.21,272003.00000000006,262942.68,9060.320000000065
10768,2022-04-10 14:20:00,1883.11,273886.11000000004,262942.68,10943.430000000051
10769,2022-04-10 14:25:00,42.48,273928.59,262942.68,10985.910000000033
10770,2022-04-10 14:30:00,-110.09,273818.5,262942.68,10875.820000000007
10771,2022-04-10 14:35:00,-668.63,273149.87,262942.68,10207.190000000002
10772,2022-04-10 14:40:00,-663.24,272486.63,262942.68,9543.950000000012
10773,2022-04-10 14:45:00,-1665.22,270821.41000000003,262942.68,7878.73000000004
10774,2022-04-10 14:50:00,-16.71,270804.7,262942.68,7862.020000000019
10775,2022-04-10 14:55:00,1932.84,272737.54000000004,262942.68,9794.860000000044
10776,2022-04-10 15:00:00,-418.23,272319.31000000006,262942.68,9376.630000000063
10777,2022-04-10 15:05:00,51.81,272371.12000000005,262942.68,9428.44000000006
10778,2022-04-10 15:10:00,-1326.91,271044.2100000001,262942.68,8101.530000000086
10779,2022-04-10 15:15:00,-969.45,270074.76000000007,262942.68,7132.0800000000745
10780,2022-04-10 15:20:00,-25.8,270048.9600000001,262942.68,7106.280000000086
10781,2022-04-10 15:25:00,-341.01,269707.95000000007,262942.68,6765.270000000077
10782,2022-04-10 15:30:00,758.55,270466.50000000006,262942.68,7523.820000000065
10783,2022-04-10 15:35:00,-501.58,269964.92000000004,262942.68,7022.240000000049
10784,2022-04-10 15:40:00,465.53,270430.45000000007,262942.68,7487.770000000077
10785,2022-04-10 15:45:00,-450.46,269979.99000000005,262942.68,7037.310000000056
10786,2022-04-10 15:50:00,-806.56,269173.43000000005,262942.68,6230.750000000058
10787,2022-04-10 15:55:00,-829.38,268344.05000000005,262942.68,5401.370000000054
10788,2022-04-10 16:00:00,-689.98,267654.07000000007,262942.68,4711.390000000072
10789,2022-04-10 16:05:00,-5.25,267648.82000000007,262942.68,4706.140000000072
10790,2022-04-10 16:10:00,-1688.25,265960.57000000007,262942.68,3017.890000000072
10791,2022-04-10 16:15:00,675.89,266636.4600000001,262942.68,3693.780000000086
10792,2022-04-10 16:20:00,-1016.43,265620.0300000001,262942.68,2677.350000000093
10793,2022-04-10 16:25:00,1466.42,267086.45000000007,262942.68,4143.770000000077
10794,2022-04-10 16:30:00,-501.02,266585.43000000005,262942.68,3642.750000000058
10795,2022-04-10 16:35:00,-409.21,266176.22000000003,262942.68,3233.5400000000373
10796,2022-04-10 16:40:00,-1955.5,264220.72000000003,262942.68,1278.0400000000373
10797,2022-04-10 16:45:00,-1529.19,262691.53,262942.68,-251.14999999996508
10798,2022-04-10 16:50:00,-754.65,261936.88000000003,262942.68,-1005.7999999999593
10799,2022-04-10 16:55:00,-760.27,261176.61000000004,262942.68,-1766.0699999999488
10800,2022-04-11 08:00:00,1851.26,263027.87000000005,261176.61000000004,1851.2600000000093
10801,2022-04-11 08:05:00,-1739.26,261288.61000000004,261176.61000000004,112.0
10802,2022-04-11 08:10:00,-1945.18,259343.43000000005,261176.61000000004,-1833.179999999993
10803,2022-04-11 08:15:00,565.16,259908.59000000005,261176.61000000004,-1268.0199999999895
10804,2022-04-11 08:20:00,229.16,260137.75000000006,261176.61000000004,-1038.859999999986
10805,2022-04-11 08:25:00,-461.85,259675.90000000005,261176.61000000004,-1500.7099999999919
10806,2022-04-11 08:30:00,-1031.39,258644.51000000004,261176.61000000004,-2532.100000000006
10807,2022-04-11 08:35:00,667.68,259312.19000000003,261176.61000000004,-1864.4200000000128
10808,2022-04-11 08:40:00,1619.95,260932.14000000004,261176.61000000004,-244.47000000000116
10809,2022-04-11 08:45:00,1587.87,262520.01000000007,261176.61000000004,1343.4000000000233
10810,2022-04-11 08:50:00,-1085.64,261434.37000000005,261176.61000000004,257.7600000000093
10811,2022-04-11 08:55:00,313.86,261748.23000000004,261176.61000000004,571.6199999999953
10812,2022-04-11 09:00:00,-285.66,261462.57000000004,261176.61000000004,285.95999999999185
10813,2022-04-11 09:05:00,-1622.01,259840.56000000003,261176.61000000004,-1336.0500000000175
10814,2022-04-11 09:10:00,-1194.22,258646.34000000003,261176.61000000004,-2530.2700000000186
10815,2022-04-11 09:15:00,-1186.47,257459.87000000002,261176.61000000004,-3716.74000000002
10816,2022-04-11 09:20:00,-436.11,257023.76000000004,261176.61000000004,-4152.850000000006
10817,2022-04-11 09:25:00,1408.9,258432.66000000003,261176.61000000004,-2743.9500000000116
10818,2022-04-11 09:30:00,1449.1,259881.76000000004,261176.61000000004,-1294.8500000000058
10819,2022-04-11 09:35:00,1253.84,261135.60000000003,261176.61000000004,-41.01000000000931
10820,2022-04-11 09:40:00,440.9,261576.50000000003,261176.61000000004,399.88999999998487
10821,2022-04-11 09:45:00,948.24,262524.74000000005,261176.61000000004,1348.1300000000047
10822,2022-04-11 09:50:00,-819.28,261705.46000000005,261176.61000000004,528.8500000000058
10823,2022-04-11 09:55:00,405.38,262110.84000000005,261176.61000000004,934.2300000000105
10824,2022-04-11 10:00:00,-1614.16,260496.68000000005,261176.61000000004,-679.929999999993
10825,2022-04-11 10:05:00,-48.02,260448.66000000006,261176.61000000004,-727.9499999999825
10826,2022-04-11 10:10:00,416.18,260864.84000000005,261176.61000000004,-311.7699999999895
10827,2022-04-11 10:15:00,1330.99,262195.8300000001,261176.61000000004,1019.2200000000303
10828,2022-04-11 10:20:00,-961.21,261234.62000000008,261176.61000000004,58.01000000003842
10829,2022-04-11 10:25:00,-482.59,260752.0300000001,261176.61000000004,-424.5799999999581
10830,2022-04-11 10:30:00,-1940.64,258811.39000000007,261176.61000000004,-2365.219999999972
10831,2022-04-11 10:35:00,183.12,258994.51000000007,261176.61000000004,-2182.0999999999767
10832,2022-04-11 10:40:00,271.62,259266.13000000006,261176.61000000004,-1910.4799999999814
10833,2022-04-11 10:45:00,-40.48,259225.65000000005,261176.61000000004,-1950.9599999999919
10834,2022-04-11 10:50:00,395.04,259620.69000000006,261176.61000000004,-1555.9199999999837
10835,2022-04-11 10:55:00,-1993.5,257627.19000000006,261176.61000000004,-3549.4199999999837
10836,2022-04-11 11:00:00,-385.68,257241.51000000007,261176.61000000004,-3935.0999999999767
10837,2022-04-11 11:05:00,151.58,257393.09000000005,261176.61000000004,-3783.5199999999895
10838,2022-04-11 11:10:00,1176.42,258569.51000000007,261176.61000000004,-2607.0999999999767
10839,2022-04-11 11:15:00,1092.11,259661.62000000005,261176.61000000004,-1514.9899999999907
10840,2022-04-11 11:20:00,1650.53,261312.15000000005,261176.61000000004,135.54000000000815
10841,2022-04-11 11:25:00,-752.41,260559.74000000005,261176.61000000004,-616.8699999999953
10842,2022-04-11 11:30:00,-1126.38,259433.36000000004,261176.61000000004,-1743.25
10843,2022-04-11 11:35:00,1626.8,261060.16000000003,261176.61000000004,-116.45000000001164
10844,2022-04-11 11:40:00,-41.41,261018.75000000003,261176.61000000004,-157.86000000001513
10845,2022-04-11 11:45:00,-1369.31,259649.44000000003,261176.61000000004,-1527.1700000000128
10846,2022-04-11 11:50:00,1779.34,261428.78000000003,261176.61000000004,252.1699999999837
10847,2022-04-11 11:55:00,-654.66,260774.12000000002,261176.61000000004,-402.4900000000198
10848,2022-04-11 12:00:00,-867.4,259906.72000000003,261176.61000000004,-1269.890000000014
10849,2022-04-11 12:05:00,1953.89,261860.61000000004,261176.61000000004,684.0
10850,2022-04-11 12:10:00,2.01,261862.62000000005,261176.61000000004,686.0100000000093
10851,2022-04-11 12:15:00,1226.47,263089.09,261176.61000000004,1912.4799999999814
10852,2022-04-11 12:20:00,165.36,263254.45,261176.61000000004,2077.8399999999674
10853,2022-04-11 12:25:00,933.58,264188.03,261176.61000000004,3011.4199999999837
10854,2022-04-11 12:30:00,-858.01,263330.02,261176.61000000004,2153.4099999999744
10855,2022-04-11 12:35:00,1325.4,264655.42000000004,261176.61000000004,3478.8099999999977
10856,2022-04-11 12:40:00,-604.92,264050.50000000006,261176.61000000004,2873.890000000014
10857,2022-04-11 12:45:00,1896.74,265947.24000000005,261176.61000000004,4770.630000000005
10858,2022-04-11 12:50:00,-1202.5,264744.74000000005,261176.61000000004,3568.1300000000047
10859,2022-04-11 12:55:00,-94.1,264650.6400000001,261176.61000000004,3474.030000000028
10860,2022-04-11 13:00:00,752.29,265402.93000000005,261176.61000000004,4226.320000000007
10861,2022-04-11 13:05:00,-507.54,264895.3900000001,261176.61000000004,3718.780000000028
10862,2022-04-11 13:10:00,-931.21,263964.18000000005,261176.61000000004,2787.570000000007
10863,2022-04-11 13:15:00,297.75,264261.93000000005,261176.61000000004,3085.320000000007
10864,2022-04-11 13:20:00,1211.13,265473.06000000006,261176.61000000004,4296.450000000012
10865,2022-04-11 13:25:00,1275.32,266748.38000000006,261176.61000000004,5571.770000000019
10866,2022-04-11 13:30:00,-180.06,266568.32000000007,261176.61000000004,5391.710000000021
10867,2022-04-11 13:35:00,-1536.43,265031.8900000001,261176.61000000004,3855.280000000028
10868,2022-04-11 13:40:00,909.62,265941.51000000007,261176.61000000004,4764.900000000023
10869,2022-04-11 13:45:00,1081.55,267023.06000000006,261176.61000000004,5846.450000000012
10870,2022-04-11 13:50:00,-1982.81,265040.25000000006,261176.61000000004,3863.640000000014
10871,2022-04-11 13:55:00,1823.61,266863.86000000004,261176.61000000004,5687.25
10872,2022-04-11 14:00:00,-879.99,265983.87000000005,261176.61000000004,4807.260000000009
10873,2022-04-11 14:05:00,929.74,266913.61000000004,261176.61000000004,5737.0
10874,2022-04-11 14:10:00,-1859.23,265054.38000000006,261176.61000000004,3877.7700000000186
10875,2022-04-11 14:15:00,51.16,265105.54000000004,261176.61000000004,3928.929999999993
10876,2022-04-11 14:20:00,1151.49,266257.03,261176.61000000004,5080.419999999984
10877,2022-04-11 14:25:00,1574.87,267831.9,261176.61000000004,6655.289999999979
10878,2022-04-11 14:30:00,650.18,268482.08,261176.61000000004,7305.469999999972
10879,2022-04-11 14:35:00,-1985.02,266497.06,261176.61000000004,5320.449999999953
10880,2022-04-11 14:40:00,-1036.39,265460.67,261176.61000000004,4284.0599999999395
10881,2022-04-11 14:45:00,656.88,266117.55,261176.61000000004,4940.939999999944
10882,2022-04-11 14:50:00,1853.52,267971.07,261176.61000000004,6794.459999999963
10883,2022-04-11 14:55:00,-734.52,267236.55,261176.61000000004,6059.939999999944
10884,2022-04-11 15:00:00,1150.29,268386.83999999997,261176.61000000004,7210.229999999923
10885,2022-04-11 15:05:00,-18.71,268368.12999999995,261176.61000000004,7191.519999999902
10886,2022-04-11 15:10:00,814.71,269182.83999999997,261176.61000000004,8006.229999999923
10887,2022-04-11 15:15:00,570.29,269753.12999999995,261176.61000000004,8576.519999999902
10888,2022-04-11 15:20:00,142.31,269895.43999999994,261176.61000000004,8718.8299999999
10889,2022-04-11 15:25:00,-1809.41,268086.02999999997,261176.61000000004,6909.4199999999255
10890,2022-04-11 15:30:00,-230.31,267855.72,261176.61000000004,6679.109999999928
10891,2022-04-11 15:35:00,607.59,268463.31,261176.61000000004,7286.699999999953
10892,2022-04-11 15:40:00,1864.27,270327.58,261176.61000000004,9150.969999999972
10893,2022-04-11 15:45:00,1102.53,271430.11000000004,261176.61000000004,10253.5
10894,2022-04-11 15:50:00,1590.09,273020.20000000007,261176.61000000004,11843.590000000026
10895,2022-04-11 15:55:00,-1376.57,271643.63000000006,261176.61000000004,10467.020000000019
10896,2022-04-11 16:00:00,-838.68,270804.95000000007,261176.61000000004,9628.340000000026
10897,2022-04-11 16:05:00,-1299.63,269505.32000000007,261176.61000000004,8328.710000000021
10898,2022-04-11 16:10:00,-843.07,268662.25000000006,261176.61000000004,7485.640000000014
10899,2022-04-11 16:15:00,866.08,269528.3300000001,261176.61000000004,8351.72000000003
10900,2022-04-11 16:20:00,-1581.52,267946.81000000006,261176.61000000004,6770.200000000012
10901,2022-04-11 16:25:00,1913.49,269860.30000000005,261176.61000000004,8683.690000000002
10902,2022-04-11 16:30:00,-1713.7,268146.60000000003,261176.61000000004,6969.989999999991
10903,2022-04-11 16:35:00,-1011.62,267134.98000000004,261176.61000000004,5958.369999999995
10904,2022-04-11 16:40:00,-649.66,266485.32000000007,261176.61000000004,5308.710000000021
10905,2022-04-11 16:45:00,-1415.72,265069.6000000001,261176.61000000004,3892.990000000049
10906,2022-04-11 16:50:00,-1709.61,263359.9900000001,261176.61000000004,2183.380000000063
10907,2022-04-11 16:55:00,-258.94,263101.0500000001,261176.61000000004,1924.4400000000605
10908,2022-04-12 08:00:00,546.32,263647.3700000001,263101.0500000001,546.320000000007
10909,2022-04-12 08:05:00,-547.92,263099.4500000001,263101.0500000001,-1.599999999976717
10910,2022-04-12 08:10:00,-760.8,262338.65000000014,263101.0500000001,-762.3999999999651
10911,2022-04-12 08:15:00,-1885.66,260452.99000000014,263101.0500000001,-2648.0599999999686
10912,2022-04-12 08:20:00,-221.48,260231.51000000013,263101.0500000001,-2869.539999999979
10913,2022-04-12 08:25:00,-599.24,259632.27000000014,263101.0500000001,-3468.7799999999697
10914,2022-04-12 08:30:00,-662.6,258969.67000000013,263101.0500000001,-4131.379999999976
10915,2022-04-12 08:35:00,1242.22,260211.89000000013,263101.0500000001,-2889.1599999999744
10916,2022-04-12 08:40:00,1382.69,261594.58000000013,263101.0500000001,-1506.469999999972
10917,2022-04-12 08:45:00,-1732.06,259862.52000000014,263101.0500000001,-3238.5299999999697
10918,2022-04-12 08:50:00,-830.82,259031.70000000013,263101.0500000001,-4069.3499999999767
10919,2022-04-12 08:55:00,-1206.9,257824.80000000013,263101.0500000001,-5276.249999999971
10920,2022-04-12 09:00:00,-168.6,257656.20000000013,263101.0500000001,-5444.849999999977
10921,2022-04-12 09:05:00,14.43,257670.63000000012,263101.0500000001,-5430.419999999984
10922,2022-04-12 09:10:00,-1633.11,256037.52000000014,263101.0500000001,-7063.52999999997
10923,2022-04-12 09:15:00,-1366.44,254671.08000000013,263101.0500000001,-8429.969999999972
10924,2022-04-12 09:20:00,-615.67,254055.41000000012,263101.0500000001,-9045.639999999985
10925,2022-04-12 09:25:00,1164.24,255219.6500000001,263101.0500000001,-7881.399999999994
10926,2022-04-12 09:30:00,-993.76,254225.8900000001,263101.0500000001,-8875.160000000003
10927,2022-04-12 09:35:00,1634.69,255860.5800000001,263101.0500000001,-7240.470000000001
10928,2022-04-12 09:40:00,-1944.3,253916.28000000012,263101.0500000001,-9184.76999999999
10929,2022-04-12 09:45:00,-1647.05,252269.23000000013,263101.0500000001,-10831.819999999978
10930,2022-04-12 09:50:00,-265.08,252004.15000000014,263101.0500000001,-11096.899999999965
10931,2022-04-12 09:55:00,86.21,252090.36000000013,263101.0500000001,-11010.689999999973
10932,2022-04-12 10:00:00,584.2,252674.56000000014,263101.0500000001,-10426.489999999962
10933,2022-04-12 10:05:00,-669.93,252004.63000000015,263101.0500000001,-11096.419999999955
10934,2022-04-12 10:10:00,1902.37,253907.00000000015,263101.0500000001,-9194.04999999996
10935,2022-04-12 10:15:00,1395.17,255302.17000000016,263101.0500000001,-7798.879999999946
10936,2022-04-12 10:20:00,-541.52,254760.65000000017,263101.0500000001,-8340.399999999936
10937,2022-04-12 10:25:00,-917.93,253842.72000000018,263101.0500000001,-9258.329999999929
10938,2022-04-12 10:30:00,529.02,254371.74000000017,263101.0500000001,-8729.30999999994
10939,2022-04-12 10:35:00,793.84,255165.58000000016,263101.0500000001,-7935.469999999943
10940,2022-04-12 10:40:00,830.22,255995.80000000016,263101.0500000001,-7105.249999999942
10941,2022-04-12 10:45:00,-1420.29,254575.51000000015,263101.0500000001,-8525.53999999995
10942,2022-04-12 10:50:00,-1273.68,253301.83000000016,263101.0500000001,-9799.219999999943
10943,2022-04-12 10:55:00,540.77,253842.60000000015,263101.0500000001,-9258.449999999953
10944,2022-04-12 11:00:00,-1546.45,252296.15000000014,263101.0500000001,-10804.899999999965
10945,2022-04-12 11:05:00,134.53,252430.68000000014,263101.0500000001,-10670.369999999966
10946,2022-04-12 11:10:00,880.03,253310.71000000014,263101.0500000001,-9790.339999999967
10947,2022-04-12 11:15:00,-668.13,252642.58000000013,263101.0500000001,-10458.469999999972
10948,2022-04-12 11:20:00,813.02,253455.60000000012,263101.0500000001,-9645.449999999983
10949,2022-04-12 11:25:00,127.34,253582.94000000012,263101.0500000001,-9518.109999999986
10950,2022-04-12 11:30:00,-506.46,253076.48000000013,263101.0500000001,-10024.569999999978
10951,2022-04-12 11:35:00,794.39,253870.87000000014,263101.0500000001,-9230.179999999964
10952,2022-04-12 11:40:00,-1161.58,252709.29000000015,263101.0500000001,-10391.759999999951
10953,2022-04-12 11:45:00,118.37,252827.66000000015,263101.0500000001,-10273.389999999956
10954,2022-04-12 11:50:00,-183.28,252644.38000000015,263101.0500000001,-10456.669999999955
10955,2022-04-12 11:55:00,497.49,253141.87000000014,263101.0500000001,-9959.179999999964
10956,2022-04-12 12:00:00,-1845.75,251296.12000000014,263101.0500000001,-11804.929999999964
10957,2022-04-12 12:05:00,-150.28,251145.84000000014,263101.0500000001,-11955.209999999963
10958,2022-04-12 12:10:00,277.97,251423.81000000014,263101.0500000001,-11677.239999999962
10959,2022-04-12 12:15:00,-1242.8,250181.01000000015,263101.0500000001,-12920.03999999995
10960,2022-04-12 12:20:00,-805.36,249375.65000000017,263101.0500000001,-13725.399999999936
10961,2022-04-12 12:25:00,1175.61,250551.26000000015,263101.0500000001,-12549.78999999995
10962,2022-04-12 12:30:00,-1883.41,248667.85000000015,263101.0500000001,-14433.199999999953
10963,2022-04-12 12:35:00,1256.36,249924.21000000014,263101.0500000001,-13176.839999999967
10964,2022-04-12 12:40:00,-630.09,249294.12000000014,263101.0500000001,-13806.929999999964
10965,2022-04-12 12:45:00,987.97,250282.09000000014,263101.0500000001,-12818.959999999963
10966,2022-04-12 12:50:00,987.82,251269.91000000015,263101.0500000001,-11831.139999999956
10967,2022-04-12 12:55:00,-801.52,250468.39000000016,263101.0500000001,-12632.659999999945
10968,2022-04-12 13:00:00,316.35,250784.74000000017,263101.0500000001,-12316.30999999994
10969,2022-04-12 13:05:00,-401.7,250383.04000000015,263101.0500000001,-12718.009999999951
10970,2022-04-12 13:10:00,248.0,250631.04000000015,263101.0500000001,-12470.009999999951
10971,2022-04-12 13:15:00,295.92,250926.96000000017,263101.0500000001,-12174.089999999938
10972,2022-04-12 13:20:00,-717.75,250209.21000000017,263101.0500000001,-12891.839999999938
10973,2022-04-12 13:25:00,-668.23,249540.98000000016,263101.0500000001,-13560.069999999949
10974,2022-04-12 13:30:00,-1914.17,247626.81000000014,263101.0500000001,-15474.239999999962
10975,2022-04-12 13:35:00,437.15,248063.96000000014,263101.0500000001,-15037.089999999967
10976,2022-04-12 13:40:00,-725.29,247338.67000000013,263101.0500000001,-15762.379999999976
10977,2022-04-12 13:45:00,-878.73,246459.94000000012,263101.0500000001,-16641.109999999986
10978,2022-04-12 13:50:00,1318.99,247778.9300000001,263101.0500000001,-15322.119999999995
10979,2022-04-12 13:55:00,-1877.77,245901.16000000012,263101.0500000001,-17199.889999999985
10980,2022-04-12 14:00:00,1917.31,247818.47000000012,263101.0500000001,-15282.579999999987
10981,2022-04-12 14:05:00,-965.38,246853.0900000001,263101.0500000001,-16247.959999999992
10982,2022-04-12 14:10:00,1343.15,248196.2400000001,263101.0500000001,-14904.809999999998
10983,2022-04-12 14:15:00,-380.11,247816.13000000012,263101.0500000001,-15284.919999999984
10984,2022-04-12 14:20:00,561.64,248377.77000000014,263101.0500000001,-14723.27999999997
10985,2022-04-12 14:25:00,1464.16,249841.93000000014,263101.0500000001,-13259.119999999966
10986,2022-04-12 14:30:00,-1668.18,248173.75000000015,263101.0500000001,-14927.29999999996
10987,2022-04-12 14:35:00,-1808.95,246364.80000000013,263101.0500000001,-16736.24999999997
10988,2022-04-12 14:40:00,725.06,247089.86000000013,263101.0500000001,-16011.189999999973
10989,2022-04-12 14:45:00,-260.69,246829.17000000013,263101.0500000001,-16271.879999999976
10990,2022-04-12 14:50:00,303.97,247133.14000000013,263101.0500000001,-15967.909999999974
10991,2022-04-12 14:55:00,-1972.15,245160.99000000014,263101.0500000001,-17940.05999999997
10992,2022-04-12 15:00:00,513.6,245674.59000000014,263101.0500000001,-17426.459999999963
10993,2022-04-12 15:05:00,-921.37,244753.22000000015,263101.0500000001,-18347.829999999958
10994,2022-04-12 15:10:00,-451.3,244301.92000000016,263101.0500000001,-18799.129999999946
10995,2022-04-12 15:15:00,1549.38,245851.30000000016,263101.0500000001,-17249.74999999994
10996,2022-04-12 15:20:00,-1791.68,244059.62000000017,263101.0500000001,-19041.429999999935
10997,2022-04-12 15:25:00,1137.69,245197.31000000017,263101.0500000001,-17903.739999999932
10998,2022-04-12 15:30:00,-28.12,245169.19000000018,263101.0500000001,-17931.859999999928
10999,2022-04-12 15:35:00,-1261.13,243908.06000000017,263101.0500000001,-19192.989999999932
11000,2022-04-12 15:40:00,119.41,244027.47000000018,263101.0500000001,-19073.57999999993
11001,2022-04-12 15:45:00,51.79,244079.26000000018,263101.0500000001,-19021.78999999992
11002,2022-04-12 15:50:00,1024.78,245104.04000000018,263101.0500000001,-17997.009999999922
11003,2022-04-12 15:55:00,490.41,245594.4500000002,263101.0500000001,-17506.59999999992
11004,2022-04-12 16:00:00,1416.65,247011.10000000018,263101.0500000001,-16089.949999999924
11005,2022-04-12 16:05:00,-543.72,246467.38000000018,263101.0500000001,-16633.669999999925
11006,2022-04-12 16:10:00,830.68,247298.06000000017,263101.0500000001,-15802.989999999932
11007,2022-04-12 16:15:00,-813.96,246484.10000000018,263101.0500000001,-16616.949999999924
11008,2022-04-12 16:20:00,248.5,246732.60000000018,263101.0500000001,-16368.449999999924
11009,2022-04-12 16:25:00,-1140.46,245592.1400000002,263101.0500000001,-17508.909999999916
11010,2022-04-12 16:30:00,759.83,246351.97000000018,263101.0500000001,-16749.07999999993
11011,2022-04-12 16:35:00,1044.59,247396.56000000017,263101.0500000001,-15704.489999999932
11012,2022-04-12 16:40:00,1114.7,248511.26000000018,263101.0500000001,-14589.78999999992
11013,2022-04-12 16:45:00,-1099.49,247411.7700000002,263101.0500000001,-15689.279999999912
11014,2022-04-12 16:50:00,-681.67,246730.10000000018,263101.0500000001,-16370.949999999924
11015,2022-04-12 16:55:00,167.73,246897.8300000002,263101.0500000001,-16203.219999999914
11016,2022-04-13 08:00:00,631.54,247529.3700000002,246897.8300000002,631.5400000000081
11017,2022-04-13 08:05:00,-1067.02,246462.3500000002,246897.8300000002,-435.4799999999814
11018,2022-04-13 08:10:00,1784.56,248246.9100000002,246897.8300000002,1349.0800000000163
11019,2022-04-13 08:15:00,-781.16,247465.7500000002,246897.8300000002,567.9200000000128
11020,2022-04-13 08:20:00,-569.25,246896.5000000002,246897.8300000002,-1.3299999999871943
11021,2022-04-13 08:25:00,593.93,247490.4300000002,246897.8300000002,592.6000000000058
11022,2022-04-13 08:30:00,-964.15,246526.2800000002,246897.8300000002,-371.54999999998836
11023,2022-04-13 08:35:00,-1111.38,245414.9000000002,246897.8300000002,-1482.929999999993
11024,2022-04-13 08:40:00,948.01,246362.9100000002,246897.8300000002,-534.9199999999837
11025,2022-04-13 08:45:00,327.39,246690.30000000022,246897.8300000002,-207.52999999996973
11026,2022-04-13 08:50:00,1573.56,248263.86000000022,246897.8300000002,1366.030000000028
11027,2022-04-13 08:55:00,-548.78,247715.08000000022,246897.8300000002,817.2500000000291
11028,2022-04-13 09:00:00,-1588.05,246127.03000000023,246897.8300000002,-770.7999999999593
11029,2022-04-13 09:05:00,-175.63,245951.40000000023,246897.8300000002,-946.4299999999639
11030,2022-04-13 09:10:00,30.3,245981.70000000022,246897.8300000002,-916.1299999999756
11031,2022-04-13 09:15:00,-125.12,245856.58000000022,246897.8300000002,-1041.249999999971
11032,2022-04-13 09:20:00,-611.94,245244.64000000022,246897.8300000002,-1653.1899999999732
11033,2022-04-13 09:25:00,1440.27,246684.9100000002,246897.8300000002,-212.9199999999837
11034,2022-04-13 09:30:00,1504.48,248189.39000000022,246897.8300000002,1291.5600000000268
11035,2022-04-13 09:35:00,-1770.48,246418.9100000002,246897.8300000002,-478.9199999999837
11036,2022-04-13 09:40:00,-720.06,245698.8500000002,246897.8300000002,-1198.9799999999814
11037,2022-04-13 09:45:00,1782.16,247481.0100000002,246897.8300000002,583.1800000000221
11038,2022-04-13 09:50:00,1447.82,248928.83000000022,246897.8300000002,2031.000000000029
11039,2022-04-13 09:55:00,-1304.2,247624.6300000002,246897.8300000002,726.8000000000175
11040,2022-04-13 10:00:00,-301.29,247323.3400000002,246897.8300000002,425.5100000000093
11041,2022-04-13 10:05:00,-1151.64,246171.7000000002,246897.8300000002,-726.1300000000047
11042,2022-04-13 10:10:00,1008.5,247180.2000000002,246897.8300000002,282.36999999999534
11043,2022-04-13 10:15:00,-1003.23,246176.97000000018,246897.8300000002,-720.8600000000151
11044,2022-04-13 10:20:00,-465.91,245711.06000000017,246897.8300000002,-1186.7700000000186
11045,2022-04-13 10:25:00,1761.9,247472.96000000017,246897.8300000002,575.1299999999756
11046,2022-04-13 10:30:00,461.34,247934.30000000016,246897.8300000002,1036.469999999972
11047,2022-04-13 10:35:00,971.95,248906.25000000017,246897.8300000002,2008.4199999999837
11048,2022-04-13 10:40:00,-352.05,248554.2000000002,246897.8300000002,1656.3699999999953
11049,2022-04-13 10:45:00,922.76,249476.9600000002,246897.8300000002,2579.1300000000047
11050,2022-04-13 10:50:00,-656.75,248820.2100000002,246897.8300000002,1922.3800000000047
11051,2022-04-13 10:55:00,-1209.34,247610.8700000002,246897.8300000002,713.0400000000081
11052,2022-04-13 11:00:00,-793.9,246816.9700000002,246897.8300000002,-80.85999999998603
11053,2022-04-13 11:05:00,-1719.46,245097.5100000002,246897.8300000002,-1800.3199999999779
11054,2022-04-13 11:10:00,1893.6,246991.11000000022,246897.8300000002,93.28000000002794
11055,2022-04-13 11:15:00,306.61,247297.7200000002,246897.8300000002,399.89000000001397
11056,2022-04-13 11:20:00,24.22,247321.9400000002,246897.8300000002,424.11000000001513
11057,2022-04-13 11:25:00,-224.46,247097.4800000002,246897.8300000002,199.65000000002328
11058,2022-04-13 11:30:00,927.69,248025.17000000022,246897.8300000002,1127.3400000000256
11059,2022-04-13 11:35:00,-108.97,247916.20000000022,246897.8300000002,1018.3700000000244
11060,2022-04-13 11:40:00,-1382.98,246533.2200000002,246897.8300000002,-364.60999999998603
11061,2022-04-13 11:45:00,-398.45,246134.7700000002,246897.8300000002,-763.0599999999977
11062,2022-04-13 11:50:00,-1098.76,245036.01000000018,246897.8300000002,-1861.820000000007
11063,2022-04-13 11:55:00,1918.12,246954.13000000018,246897.8300000002,56.29999999998836
11064,2022-04-13 12:00:00,1054.44,248008.57000000018,246897.8300000002,1110.7399999999907
11065,2022-04-13 12:05:00,-446.17,247562.40000000017,246897.8300000002,664.5699999999779
11066,2022-04-13 12:10:00,-1370.1,246192.30000000016,246897.8300000002,-705.5300000000279
11067,2022-04-13 12:15:00,706.24,246898.54000000015,246897.8300000002,0.7099999999627471
11068,2022-04-13 12:20:00,1225.65,248124.19000000015,246897.8300000002,1226.359999999957
11069,2022-04-13 12:25:00,791.01,248915.20000000016,246897.8300000002,2017.3699999999662
11070,2022-04-13 12:30:00,736.99,249652.19000000015,246897.8300000002,2754.359999999957
11071,2022-04-13 12:35:00,764.04,250416.23000000016,246897.8300000002,3518.399999999965
11072,2022-04-13 12:40:00,-222.44,250193.79000000015,246897.8300000002,3295.9599999999627
11073,2022-04-13 12:45:00,-1651.87,248541.92000000016,246897.8300000002,1644.0899999999674
11074,2022-04-13 12:50:00,1574.96,250116.88000000015,246897.8300000002,3219.0499999999593
11075,2022-04-13 12:55:00,-814.6,249302.28000000014,246897.8300000002,2404.4499999999534
11076,2022-04-13 13:00:00,-490.56,248811.72000000015,246897.8300000002,1913.8899999999558
11077,2022-04-13 13:05:00,-1841.83,246969.89000000016,246897.8300000002,72.05999999996857
11078,2022-04-13 13:10:00,-1365.04,245604.85000000015,246897.8300000002,-1292.9800000000396
11079,2022-04-13 13:15:00,-507.86,245096.99000000017,246897.8300000002,-1800.8400000000256
11080,2022-04-13 13:20:00,-1502.78,243594.21000000017,246897.8300000002,-3303.6200000000244
11081,2022-04-13 13:25:00,-1062.79,242531.42000000016,246897.8300000002,-4366.410000000033
11082,2022-04-13 13:30:00,1743.03,244274.45000000016,246897.8300000002,-2623.3800000000338
11083,2022-04-13 13:35:00,-264.01,244010.44000000015,246897.8300000002,-2887.390000000043
11084,2022-04-13 13:40:00,-1037.26,242973.18000000014,246897.8300000002,-3924.6500000000524
11085,2022-04-13 13:45:00,-97.4,242875.78000000014,246897.8300000002,-4022.0500000000466
11086,2022-04-13 13:50:00,1101.27,243977.05000000013,246897.8300000002,-2920.780000000057
11087,2022-04-13 13:55:00,76.09,244053.14000000013,246897.8300000002,-2844.6900000000605
11088,2022-04-13 14:00:00,-1098.77,242954.37000000014,246897.8300000002,-3943.46000000005
11089,2022-04-13 14:05:00,174.05,243128.42000000013,246897.8300000002,-3769.4100000000617
11090,2022-04-13 14:10:00,364.32,243492.74000000014,246897.8300000002,-3405.0900000000547
11091,2022-04-13 14:15:00,505.77,243998.51000000013,246897.8300000002,-2899.320000000065
11092,2022-04-13 14:20:00,-504.55,243493.96000000014,246897.8300000002,-3403.8700000000536
11093,2022-04-13 14:25:00,415.28,243909.24000000014,246897.8300000002,-2988.5900000000547
11094,2022-04-13 14:30:00,-678.58,243230.66000000015,246897.8300000002,-3667.170000000042
11095,2022-04-13 14:35:00,555.34,243786.00000000015,246897.8300000002,-3111.8300000000454
11096,2022-04-13 14:40:00,-890.37,242895.63000000015,246897.8300000002,-4002.2000000000407
11097,2022-04-13 14:45:00,-692.12,242203.51000000015,246897.8300000002,-4694.320000000036
11098,2022-04-13 14:50:00,1762.51,243966.02000000016,246897.8300000002,-2931.810000000027
11099,2022-04-13 14:55:00,162.73,244128.75000000017,246897.8300000002,-2769.0800000000163
11100,2022-04-13 15:00:00,788.46,244917.21000000017,246897.8300000002,-1980.6200000000244
11101,2022-04-13 15:05:00,1540.64,246457.85000000018,246897.8300000002,-439.9800000000105
11102,2022-04-13 15:10:00,-1768.61,244689.2400000002,246897.8300000002,-2208.5899999999965
11103,2022-04-13 15:15:00,-1933.16,242756.0800000002,246897.8300000002,-4141.75
11104,2022-04-13 15:20:00,1125.03,243881.1100000002,246897.8300000002,-3016.720000000001
11105,2022-04-13 15:25:00,1549.05,245430.16000000018,246897.8300000002,-1467.6700000000128
11106,2022-04-13 15:30:00,341.16,245771.32000000018,246897.8300000002,-1126.5100000000093
11107,2022-04-13 15:35:00,1638.73,247410.0500000002,246897.8300000002,512.2200000000012
11108,2022-04-13 15:40:00,-1989.62,245420.4300000002,246897.8300000002,-1477.3999999999942
11109,2022-04-13 15:45:00,1713.56,247133.9900000002,246897.8300000002,236.1600000000035
11110,2022-04-13 15:50:00,130.16,247264.1500000002,246897.8300000002,366.320000000007
11111,2022-04-13 15:55:00,1585.29,248849.4400000002,246897.8300000002,1951.6100000000151
11112,2022-04-13 16:00:00,1020.89,249870.33000000022,246897.8300000002,2972.500000000029
11113,2022-04-13 16:05:00,1746.85,251617.18000000023,246897.8300000002,4719.350000000035
11114,2022-04-13 16:10:00,-1503.7,250113.4800000002,246897.8300000002,3215.6500000000233
11115,2022-04-13 16:15:00,893.85,251007.33000000022,246897.8300000002,4109.500000000029
11116,2022-04-13 16:20:00,57.88,251065.21000000022,246897.8300000002,4167.380000000034
11117,2022-04-13 16:25:00,-915.8,250149.41000000024,246897.8300000002,3251.5800000000454
11118,2022-04-13 16:30:00,1988.64,252138.05000000025,246897.8300000002,5240.220000000059
11119,2022-04-13 16:35:00,-182.28,251955.77000000025,246897.8300000002,5057.9400000000605
11120,2022-04-13 16:40:00,1746.08,253701.85000000024,246897.8300000002,6804.020000000048
11121,2022-04-13 16:45:00,1310.74,255012.59000000023,246897.8300000002,8114.760000000038
11122,2022-04-13 16:50:00,-1943.12,253069.47000000023,246897.8300000002,6171.640000000043
11123,2022-04-13 16:55:00,-1667.92,251401.55000000022,246897.8300000002,4503.72000000003
11124,2022-04-14 08:00:00,-487.92,250913.6300000002,251401.55000000022,-487.9200000000128
11125,2022-04-14 08:05:00,878.89,251792.52000000022,251401.55000000022,390.97000000000116
11126,2022-04-14 08:10:00,1728.86,253521.3800000002,251401.55000000022,2119.829999999987
11127,2022-04-14 08:15:00,-1539.59,251981.7900000002,251401.55000000022,580.2399999999907
11128,2022-04-14 08:20:00,1927.39,253909.18000000023,251401.55000000022,2507.6300000000047
11129,2022-04-14 08:25:00,1113.87,255023.05000000022,251401.55000000022,3621.5
11130,2022-04-14 08:30:00,-1020.68,254002.37000000023,251401.55000000022,2600.820000000007
11131,2022-04-14 08:35:00,-669.94,253332.43000000023,251401.55000000022,1930.8800000000047
11132,2022-04-14 08:40:00,1659.96,254992.39000000022,251401.55000000022,3590.8399999999965
11133,2022-04-14 08:45:00,-1970.27,253022.12000000023,251401.55000000022,1620.570000000007
11134,2022-04-14 08:50:00,-1998.12,251024.00000000023,251401.55000000022,-377.54999999998836
11135,2022-04-14 08:55:00,1303.92,252327.92000000025,251401.55000000022,926.3700000000244
11136,2022-04-14 09:00:00,1773.26,254101.18000000025,251401.55000000022,2699.6300000000338
11137,2022-04-14 09:05:00,480.16,254581.34000000026,251401.55000000022,3179.7900000000373
11138,2022-04-14 09:10:00,1130.29,255711.63000000027,251401.55000000022,4310.080000000045
11139,2022-04-14 09:15:00,-1079.66,254631.97000000026,251401.55000000022,3230.420000000042
11140,2022-04-14 09:20:00,-778.59,253853.38000000027,251401.55000000022,2451.8300000000454
11141,2022-04-14 09:25:00,-334.52,253518.86000000028,251401.55000000022,2117.310000000056
11142,2022-04-14 09:30:00,1431.11,254949.97000000026,251401.55000000022,3548.420000000042
11143,2022-04-14 09:35:00,699.45,255649.42000000027,251401.55000000022,4247.870000000054
11144,2022-04-14 09:40:00,459.7,256109.1200000003,251401.55000000022,4707.570000000065
11145,2022-04-14 09:45:00,1429.84,257538.96000000028,251401.55000000022,6137.410000000062
11146,2022-04-14 09:50:00,1636.64,259175.6000000003,251401.55000000022,7774.050000000076
11147,2022-04-14 09:55:00,1298.0,260473.6000000003,251401.55000000022,9072.050000000076
11148,2022-04-14 10:00:00,-558.76,259914.8400000003,251401.55000000022,8513.290000000066
11149,2022-04-14 10:05:00,1217.39,261132.2300000003,251401.55000000022,9730.68000000008
11150,2022-04-14 10:10:00,-1842.98,259289.2500000003,251401.55000000022,7887.70000000007
11151,2022-04-14 10:15:00,176.84,259466.0900000003,251401.55000000022,8064.540000000066
11152,2022-04-14 10:20:00,-1179.04,258287.05000000028,251401.55000000022,6885.500000000058
11153,2022-04-14 10:25:00,-1880.8,256406.2500000003,251401.55000000022,5004.70000000007
11154,2022-04-14 10:30:00,-365.63,256040.6200000003,251401.55000000022,4639.070000000065
11155,2022-04-14 10:35:00,1241.05,257281.67000000027,251401.55000000022,5880.120000000054
11156,2022-04-14 10:40:00,1528.29,258809.96000000028,251401.55000000022,7408.410000000062
11157,2022-04-14 10:45:00,778.55,259588.51000000027,251401.55000000022,8186.96000000005
11158,2022-04-14 10:50:00,1849.09,261437.60000000027,251401.55000000022,10036.050000000047
11159,2022-04-14 10:55:00,1816.14,263253.7400000003,251401.55000000022,11852.19000000006
11160,2022-04-14 11:00:00,-1259.99,261993.7500000003,251401.55000000022,10592.20000000007
11161,2022-04-14 11:05:00,732.95,262726.7000000003,251401.55000000022,11325.150000000081
11162,2022-04-14 11:10:00,-890.02,261836.6800000003,251401.55000000022,10435.130000000092
11163,2022-04-14 11:15:00,1781.83,263618.5100000003,251401.55000000022,12216.96000000008
11164,2022-04-14 11:20:00,566.81,264185.3200000003,251401.55000000022,12783.770000000077
11165,2022-04-14 11:25:00,-1862.83,262322.4900000003,251401.55000000022,10920.94000000006
11166,2022-04-14 11:30:00,1362.9,263685.3900000003,251401.55000000022,12283.840000000084
11167,2022-04-14 11:35:00,-71.29,263614.1000000003,251401.55000000022,12212.550000000105
11168,2022-04-14 11:40:00,992.97,264607.0700000003,251401.55000000022,13205.520000000077
11169,2022-04-14 11:45:00,-1455.85,263151.2200000003,251401.55000000022,11749.6700000001
11170,2022-04-14 11:50:00,945.86,264097.0800000003,251401.55000000022,12695.530000000086
11171,2022-04-14 11:55:00,1844.84,265941.92000000033,251401.55000000022,14540.370000000112
11172,2022-04-14 12:00:00,846.19,266788.11000000034,251401.55000000022,15386.560000000114
11173,2022-04-14 12:05:00,-756.64,266031.4700000003,251401.55000000022,14629.9200000001
11174,2022-04-14 12:10:00,854.37,266885.8400000003,251401.55000000022,15484.290000000095
11175,2022-04-14 12:15:00,1053.37,267939.2100000003,251401.55000000022,16537.66000000009
11176,2022-04-14 12:20:00,599.79,268539.0000000003,251401.55000000022,17137.45000000007
11177,2022-04-14 12:25:00,-401.44,268137.5600000003,251401.55000000022,16736.010000000068
11178,2022-04-14 12:30:00,-1086.86,267050.7000000003,251401.55000000022,15649.150000000081
11179,2022-04-14 12:35:00,-899.45,266151.2500000003,251401.55000000022,14749.70000000007
11180,2022-04-14 12:40:00,185.76,266337.0100000003,251401.55000000022,14935.46000000008
11181,2022-04-14 12:45:00,-1914.88,264422.1300000003,251401.55000000022,13020.580000000075
11182,2022-04-14 12:50:00,-871.32,263550.8100000003,251401.55000000022,12149.260000000068
11183,2022-04-14 12:55:00,522.02,264072.8300000003,251401.55000000022,12671.280000000086
11184,2022-04-14 13:00:00,-1056.0,263016.8300000003,251401.55000000022,11615.280000000086
11185,2022-04-14 13:05:00,-559.11,262457.7200000003,251401.55000000022,11056.1700000001
11186,2022-04-14 13:10:00,-866.71,261591.01000000033,251401.55000000022,10189.460000000108
11187,2022-04-14 13:15:00,1075.9,262666.9100000003,251401.55000000022,11265.360000000102
11188,2022-04-14 13:20:00,-1505.5,261161.41000000032,251401.55000000022,9759.860000000102
11189,2022-04-14 13:25:00,1404.87,262566.2800000003,251401.55000000022,11164.730000000098
11190,2022-04-14 13:30:00,-1126.21,261440.07000000033,251401.55000000022,10038.520000000106
11191,2022-04-14 13:35:00,-1649.22,259790.85000000033,251401.55000000022,8389.300000000105
11192,2022-04-14 13:40:00,-198.01,259592.84000000032,251401.55000000022,8191.2900000000955
11193,2022-04-14 13:45:00,1468.81,261061.6500000003,251401.55000000022,9660.100000000093
11194,2022-04-14 13:50:00,412.34,261473.9900000003,251401.55000000022,10072.44000000009
11195,2022-04-14 13:55:00,1804.26,263278.2500000003,251401.55000000022,11876.70000000007
11196,2022-04-14 14:00:00,1890.99,265169.2400000003,251401.55000000022,13767.69000000006
11197,2022-04-14 14:05:00,1743.24,266912.4800000003,251401.55000000022,15510.930000000051
11198,2022-04-14 14:10:00,816.93,267729.41000000027,251401.55000000022,16327.860000000044
11199,2022-04-14 14:15:00,-202.25,267527.16000000027,251401.55000000022,16125.610000000044
11200,2022-04-14 14:20:00,521.73,268048.89000000025,251401.55000000022,16647.340000000026
11201,2022-04-14 14:25:00,-835.71,267213.1800000002,251401.55000000022,15811.630000000005
11202,2022-04-14 14:30:00,341.18,267554.3600000002,251401.55000000022,16152.809999999998
11203,2022-04-14 14:35:00,1774.79,269329.1500000002,251401.55000000022,17927.599999999977
11204,2022-04-14 14:40:00,1463.39,270792.5400000002,251401.55000000022,19390.98999999999
11205,2022-04-14 14:45:00,1869.28,272661.82000000024,251401.55000000022,21260.27000000002
11206,2022-04-14 14:50:00,1610.89,274272.71000000025,251401.55000000022,22871.160000000033
11207,2022-04-14 14:55:00,109.27,274381.9800000003,251401.55000000022,22980.43000000005
11208,2022-04-14 15:00:00,710.89,275092.8700000003,251401.55000000022,23691.320000000065
11209,2022-04-14 15:05:00,614.0,275706.8700000003,251401.55000000022,24305.320000000065
11210,2022-04-14 15:10:00,-1182.15,274524.72000000026,251401.55000000022,23123.170000000042
11211,2022-04-14 15:15:00,-1004.17,273520.5500000003,251401.55000000022,22119.00000000006
11212,2022-04-14 15:20:00,-879.15,272641.40000000026,251401.55000000022,21239.850000000035
11213,2022-04-14 15:25:00,-63.51,272577.89000000025,251401.55000000022,21176.340000000026
11214,2022-04-14 15:30:00,-728.96,271848.9300000002,251401.55000000022,20447.380000000005
11215,2022-04-14 15:35:00,-1541.0,270307.9300000002,251401.55000000022,18906.380000000005
11216,2022-04-14 15:40:00,1587.85,271895.7800000002,251401.55000000022,20494.22999999998
11217,2022-04-14 15:45:00,686.26,272582.0400000002,251401.55000000022,21180.48999999999
11218,2022-04-14 15:50:00,-652.13,271929.9100000002,251401.55000000022,20528.359999999986
11219,2022-04-14 15:55:00,482.72,272412.6300000002,251401.55000000022,21011.079999999958
11220,2022-04-14 16:00:00,-464.19,271948.4400000002,251401.55000000022,20546.889999999956
11221,2022-04-14 16:05:00,977.73,272926.17000000016,251401.55000000022,21524.619999999937
11222,2022-04-14 16:10:00,1707.76,274633.93000000017,251401.55000000022,23232.379999999946
11223,2022-04-14 16:15:00,-1574.71,273059.22000000015,251401.55000000022,21657.669999999925
11224,2022-04-14 16:20:00,-1364.2,271695.02000000014,251401.55000000022,20293.469999999914
11225,2022-04-14 16:25:00,1216.99,272912.0100000001,251401.55000000022,21510.459999999905
11226,2022-04-14 16:30:00,-232.88,272679.1300000001,251401.55000000022,21277.5799999999
11227,2022-04-14 16:35:00,-150.09,272529.0400000001,251401.55000000022,21127.489999999874
11228,2022-04-14 16:40:00,1100.12,273629.1600000001,251401.55000000022,22227.60999999987
11229,2022-04-14 16:45:00,-1355.84,272273.32000000007,251401.55000000022,20871.769999999844
11230,2022-04-14 16:50:00,1361.13,273634.45000000007,251401.55000000022,22232.89999999985
11231,2022-04-14 16:55:00,-777.07,272857.38000000006,251401.55000000022,21455.82999999984
11232,2022-04-15 08:00:00,-1581.79,271275.5900000001,272857.38000000006,-1581.789999999979
11233,2022-04-15 08:05:00,1160.94,272436.5300000001,272857.38000000006,-420.8499999999767
11234,2022-04-15 08:10:00,-785.71,271650.82000000007,272857.38000000006,-1206.5599999999977
11235,2022-04-15 08:15:00,-682.21,270968.61000000004,272857.38000000006,-1888.7700000000186
11236,2022-04-15 08:20:00,739.96,271708.57000000007,272857.38000000006,-1148.8099999999977
11237,2022-04-15 08:25:00,323.97,272032.54000000004,272857.38000000006,-824.8400000000256
11238,2022-04-15 08:30:00,-1996.81,270035.73000000004,272857.38000000006,-2821.6500000000233
11239,2022-04-15 08:35:00,-1812.57,268223.16000000003,272857.38000000006,-4634.22000000003
11240,2022-04-15 08:40:00,468.06,268691.22000000003,272857.38000000006,-4166.160000000033
11241,2022-04-15 08:45:00,385.76,269076.98000000004,272857.38000000006,-3780.4000000000233
11242,2022-04-15 08:50:00,1309.02,270386.00000000006,272857.38000000006,-2471.3800000000047
11243,2022-04-15 08:55:00,-1046.98,269339.0200000001,272857.38000000006,-3518.359999999986
11244,2022-04-15 09:00:00,1345.39,270684.4100000001,272857.38000000006,-2172.969999999972
11245,2022-04-15 09:05:00,-897.52,269786.8900000001,272857.38000000006,-3070.4899999999907
11246,2022-04-15 09:10:00,1558.52,271345.4100000001,272857.38000000006,-1511.969999999972
11247,2022-04-15 09:15:00,-1972.07,269373.3400000001,272857.38000000006,-3484.039999999979
11248,2022-04-15 09:20:00,-1945.5,267427.8400000001,272857.38000000006,-5429.539999999979
11249,2022-04-15 09:25:00,1014.32,268442.1600000001,272857.38000000006,-4415.219999999972
11250,2022-04-15 09:30:00,1121.87,269564.0300000001,272857.38000000006,-3293.3499999999767
11251,2022-04-15 09:35:00,1304.14,270868.1700000001,272857.38000000006,-1989.2099999999627
11252,2022-04-15 09:40:00,1647.2,272515.3700000001,272857.38000000006,-342.0099999999511
11253,2022-04-15 09:45:00,928.62,273443.9900000001,272857.38000000006,586.6100000000442
11254,2022-04-15 09:50:00,-717.52,272726.4700000001,272857.38000000006,-130.9099999999744
11255,2022-04-15 09:55:00,-277.92,272448.5500000001,272857.38000000006,-408.8299999999581
11256,2022-04-15 10:00:00,1967.51,274416.0600000001,272857.38000000006,1558.6800000000512
11257,2022-04-15 10:05:00,-717.67,273698.39000000013,272857.38000000006,841.0100000000675
11258,2022-04-15 10:10:00,-1168.85,272529.54000000015,272857.38000000006,-327.8399999999092
11259,2022-04-15 10:15:00,-728.29,271801.2500000002,272857.38000000006,-1056.1299999998882
11260,2022-04-15 10:20:00,-972.16,270829.0900000002,272857.38000000006,-2028.2899999998626
11261,2022-04-15 10:25:00,-103.9,270725.1900000002,272857.38000000006,-2132.189999999886
11262,2022-04-15 10:30:00,-466.76,270258.43000000017,272857.38000000006,-2598.949999999895
11263,2022-04-15 10:35:00,-285.34,269973.09000000014,272857.38000000006,-2884.289999999921
11264,2022-04-15 10:40:00,-761.07,269212.02000000014,272857.38000000006,-3645.359999999928
11265,2022-04-15 10:45:00,118.36,269330.3800000001,272857.38000000006,-3526.999999999942
11266,2022-04-15 10:50:00,-1355.97,267974.41000000015,272857.38000000006,-4882.969999999914
11267,2022-04-15 10:55:00,-957.22,267017.1900000002,272857.38000000006,-5840.189999999886
11268,2022-04-15 11:00:00,-1908.96,265108.23000000016,272857.38000000006,-7749.149999999907
11269,2022-04-15 11:05:00,-1142.06,263966.17000000016,272857.38000000006,-8891.209999999905
11270,2022-04-15 11:10:00,1067.86,265034.03000000014,272857.38000000006,-7823.3499999999185
11271,2022-04-15 11:15:00,-1043.44,263990.59000000014,272857.38000000006,-8866.78999999992
11272,2022-04-15 11:20:00,-1438.19,262552.40000000014,272857.38000000006,-10304.979999999923
11273,2022-04-15 11:25:00,1655.86,264208.2600000001,272857.38000000006,-8649.119999999937
11274,2022-04-15 11:30:00,-1109.95,263098.3100000001,272857.38000000006,-9759.069999999949
11275,2022-04-15 11:35:00,-1918.44,261179.8700000001,272857.38000000006,-11677.509999999951
11276,2022-04-15 11:40:00,227.53,261407.4000000001,272857.38000000006,-11449.979999999952
11277,2022-04-15 11:45:00,366.72,261774.1200000001,272857.38000000006,-11083.259999999951
11278,2022-04-15 11:50:00,-101.85,261672.2700000001,272857.38000000006,-11185.109999999957
11279,2022-04-15 11:55:00,1086.21,262758.4800000001,272857.38000000006,-10098.899999999965
11280,2022-04-15 12:00:00,-816.48,261942.0000000001,272857.38000000006,-10915.379999999976
11281,2022-04-15 12:05:00,-1748.41,260193.59000000008,272857.38000000006,-12663.789999999979
11282,2022-04-15 12:10:00,-875.32,259318.27000000008,272857.38000000006,-13539.109999999986
11283,2022-04-15 12:15:00,-21.9,259296.37000000008,272857.38000000006,-13561.00999999998
11284,2022-04-15 12:20:00,1623.84,260920.21000000008,272857.38000000006,-11937.169999999984
11285,2022-04-15 12:25:00,864.0,261784.21000000008,272857.38000000006,-11073.169999999984
11286,2022-04-15 12:30:00,-159.1,261625.11000000007,272857.38000000006,-11232.26999999999
11287,2022-04-15 12:35:00,-1237.44,260387.67000000007,272857.38000000006,-12469.709999999992
11288,2022-04-15 12:40:00,1925.54,262313.2100000001,272857.38000000006,-10544.169999999984
11289,2022-04-15 12:45:00,-470.71,261842.5000000001,272857.38000000006,-11014.879999999976
11290,2022-04-15 12:50:00,-1696.34,260146.1600000001,272857.38000000006,-12711.219999999972
11291,2022-04-15 12:55:00,-28.61,260117.5500000001,272857.38000000006,-12739.829999999958
11292,2022-04-15 13:00:00,-36.44,260081.1100000001,272857.38000000006,-12776.26999999996
11293,2022-04-15 13:05:00,-892.76,259188.3500000001,272857.38000000006,-13669.02999999997
11294,2022-04-15 13:10:00,1200.4,260388.7500000001,272857.38000000006,-12468.629999999976
11295,2022-04-15 13:15:00,-923.68,259465.0700000001,272857.38000000006,-13392.309999999969
11296,2022-04-15 13:20:00,989.51,260454.5800000001,272857.38000000006,-12402.79999999996
11297,2022-04-15 13:25:00,227.69,260682.2700000001,272857.38000000006,-12175.109999999957
11298,2022-04-15 13:30:00,-1975.96,258706.3100000001,272857.38000000006,-14151.069999999949
11299,2022-04-15 13:35:00,-23.42,258682.8900000001,272857.38000000006,-14174.489999999962
11300,2022-04-15 13:40:00,414.0,259096.8900000001,272857.38000000006,-13760.489999999962
11301,2022-04-15 13:45:00,-1297.36,257799.53000000012,272857.38000000006,-15057.849999999948
11302,2022-04-15 13:50:00,-1032.26,256767.2700000001,272857.38000000006,-16090.109999999957
11303,2022-04-15 13:55:00,636.3,257403.5700000001,272857.38000000006,-15453.809999999969
11304,2022-04-15 14:00:00,502.89,257906.4600000001,272857.38000000006,-14950.919999999955
11305,2022-04-15 14:05:00,114.11,258020.5700000001,272857.38000000006,-14836.809999999969
11306,2022-04-15 14:10:00,74.39,258094.9600000001,272857.38000000006,-14762.419999999955
11307,2022-04-15 14:15:00,639.38,258734.3400000001,272857.38000000006,-14123.03999999995
11308,2022-04-15 14:20:00,433.8,259168.1400000001,272857.38000000006,-13689.239999999962
11309,2022-04-15 14:25:00,509.95,259678.0900000001,272857.38000000006,-13179.28999999995
11310,2022-04-15 14:30:00,-1524.22,258153.8700000001,272857.38000000006,-14703.509999999951
11311,2022-04-15 14:35:00,-1966.77,256187.10000000012,272857.38000000006,-16670.27999999994
11312,2022-04-15 14:40:00,-240.51,255946.5900000001,272857.38000000006,-16910.78999999995
11313,2022-04-15 14:45:00,-1308.76,254637.8300000001,272857.38000000006,-18219.54999999996
11314,2022-04-15 14:50:00,-949.01,253688.8200000001,272857.38000000006,-19168.55999999997
11315,2022-04-15 14:55:00,934.05,254622.87000000008,272857.38000000006,-18234.50999999998
11316,2022-04-15 15:00:00,-743.45,253879.42000000007,272857.38000000006,-18977.959999999992
11317,2022-04-15 15:05:00,-488.89,253390.53000000006,272857.38000000006,-19466.850000000006
11318,2022-04-15 15:10:00,-1865.45,251525.08000000005,272857.38000000006,-21332.300000000017
11319,2022-04-15 15:15:00,-800.98,250724.10000000003,272857.38000000006,-22133.280000000028
11320,2022-04-15 15:20:00,870.18,251594.28000000003,272857.38000000006,-21263.100000000035
11321,2022-04-15 15:25:00,-1473.67,250120.61000000002,272857.38000000006,-22736.770000000048
11322,2022-04-15 15:30:00,-310.07,249810.54,272857.38000000006,-23046.840000000055
11323,2022-04-15 15:35:00,-265.04,249545.5,272857.38000000006,-23311.880000000063
11324,2022-04-15 15:40:00,1653.31,251198.81,272857.38000000006,-21658.570000000065
11325,2022-04-15 15:45:00,-308.83,250889.98,272857.38000000006,-21967.400000000052
11326,2022-04-15 15:50:00,1073.63,251963.61000000002,272857.38000000006,-20893.770000000048
11327,2022-04-15 15:55:00,979.86,252943.47,272857.38000000006,-19913.91000000006
11328,2022-04-15 16:00:00,-1514.07,251429.4,272857.38000000006,-21427.98000000007
11329,2022-04-15 16:05:00,-1832.49,249596.91,272857.38000000006,-23260.47000000006
11330,2022-04-15 16:10:00,-439.42,249157.49,272857.38000000006,-23699.890000000072
11331,2022-04-15 16:15:00,-1134.72,248022.77,272857.38000000006,-24834.610000000073
11332,2022-04-15 16:20:00,1702.71,249725.47999999998,272857.38000000006,-23131.90000000008
11333,2022-04-15 16:25:00,1834.0,251559.47999999998,272857.38000000006,-21297.90000000008
11334,2022-04-15 16:30:00,-1153.41,250406.06999999998,272857.38000000006,-22451.310000000085
11335,2022-04-15 16:35:00,1920.49,252326.55999999997,272857.38000000006,-20530.820000000094
11336,2022-04-15 16:40:00,676.73,253003.28999999998,272857.38000000006,-19854.090000000084
11337,2022-04-15 16:45:00,-1816.26,251187.02999999997,272857.38000000006,-21670.350000000093
11338,2022-04-15 16:50:00,637.91,251824.93999999997,272857.38000000006,-21032.44000000009
11339,2022-04-15 16:55:00,1322.38,253147.31999999998,272857.38000000006,-19710.060000000085
11340,2022-04-16 08:00:00,-17.24,253130.08,253147.31999999998,-17.239999999990687
11341,2022-04-16 08:05:00,-835.51,252294.56999999998,253147.31999999998,-852.75
11342,2022-04-16 08:10:00,1939.58,254234.14999999997,253147.31999999998,1086.8299999999872
11343,2022-04-16 08:15:00,147.48,254381.62999999998,253147.31999999998,1234.3099999999977
11344,2022-04-16 08:20:00,1077.51,255459.13999999998,253147.31999999998,2311.820000000007
11345,2022-04-16 08:25:00,1621.46,257080.59999999998,253147.31999999998,3933.279999999999
11346,2022-04-16 08:30:00,121.85,257202.44999999998,253147.31999999998,4055.1300000000047
11347,2022-04-16 08:35:00,-1506.84,255695.61,253147.31999999998,2548.290000000008
11348,2022-04-16 08:40:00,-918.06,254777.55,253147.31999999998,1630.2300000000105
11349,2022-04-16 08:45:00,588.79,255366.34,253147.31999999998,2219.0200000000186
11350,2022-04-16 08:50:00,1737.83,257104.16999999998,253147.31999999998,3956.850000000006
11351,2022-04-16 08:55:00,-544.51,256559.65999999997,253147.31999999998,3412.3399999999965
11352,2022-04-16 09:00:00,293.96,256853.61999999997,253147.31999999998,3706.2999999999884
11353,2022-04-16 09:05:00,-1244.3,255609.31999999998,253147.31999999998,2462.0
11354,2022-04-16 09:10:00,1833.14,257442.46,253147.31999999998,4295.140000000014
11355,2022-04-16 09:15:00,-311.9,257130.56,253147.31999999998,3983.24000000002
11356,2022-04-16 09:20:00,-1261.37,255869.19,253147.31999999998,2721.8700000000244
11357,2022-04-16 09:25:00,66.2,255935.39,253147.31999999998,2788.070000000036
11358,2022-04-16 09:30:00,-1156.44,254778.95,253147.31999999998,1631.6300000000338
11359,2022-04-16 09:35:00,1286.66,256065.61000000002,253147.31999999998,2918.2900000000373
11360,2022-04-16 09:40:00,373.69,256439.30000000002,253147.31999999998,3291.9800000000396
11361,2022-04-16 09:45:00,1271.15,257710.45,253147.31999999998,4563.130000000034
11362,2022-04-16 09:50:00,-1767.59,255942.86000000002,253147.31999999998,2795.5400000000373
11363,2022-04-16 09:55:00,1783.34,257726.2,253147.31999999998,4578.880000000034
11364,2022-04-16 10:00:00,434.63,258160.83000000002,253147.31999999998,5013.510000000038
11365,2022-04-16 10:05:00,-1364.6,256796.23,253147.31999999998,3648.9100000000326
11366,2022-04-16 10:10:00,-1620.69,255175.54,253147.31999999998,2028.2200000000303
11367,2022-04-16 10:15:00,501.8,255677.34,253147.31999999998,2530.0200000000186
11368,2022-04-16 10:20:00,630.01,256307.35,253147.31999999998,3160.030000000028
11369,2022-04-16 10:25:00,8.59,256315.94,253147.31999999998,3168.6200000000244
11370,2022-04-16 10:30:00,-222.42,256093.52,253147.31999999998,2946.2000000000116
11371,2022-04-16 10:35:00,1112.21,257205.72999999998,253147.31999999998,4058.4100000000035
11372,2022-04-16 10:40:00,-177.26,257028.46999999997,253147.31999999998,3881.149999999994
11373,2022-04-16 10:45:00,817.8,257846.26999999996,253147.31999999998,4698.9499999999825
11374,2022-04-16 10:50:00,1921.63,259767.89999999997,253147.31999999998,6620.579999999987
11375,2022-04-16 10:55:00,-1186.51,258581.38999999996,253147.31999999998,5434.069999999978
11376,2022-04-16 11:00:00,-1051.78,257529.60999999996,253147.31999999998,4382.289999999979
11377,2022-04-16 11:05:00,-1013.14,256516.46999999994,253147.31999999998,3369.149999999965
11378,2022-04-16 11:10:00,392.38,256908.84999999995,253147.31999999998,3761.5299999999697
11379,2022-04-16 11:15:00,908.09,257816.93999999994,253147.31999999998,4669.619999999966
11380,2022-04-16 11:20:00,818.45,258635.38999999996,253147.31999999998,5488.069999999978
11381,2022-04-16 11:25:00,-1839.67,256795.71999999994,253147.31999999998,3648.399999999965
11382,2022-04-16 11:30:00,157.72,256953.43999999994,253147.31999999998,3806.1199999999662
11383,2022-04-16 11:35:00,-711.31,256242.12999999995,253147.31999999998,3094.8099999999686
11384,2022-04-16 11:40:00,-1705.61,254536.51999999996,253147.31999999998,1389.1999999999825
11385,2022-04-16 11:45:00,-1612.49,252924.02999999997,253147.31999999998,-223.29000000000815
11386,2022-04-16 11:50:00,-430.14,252493.88999999996,253147.31999999998,-653.4300000000221
11387,2022-04-16 11:55:00,592.98,253086.86999999997,253147.31999999998,-60.45000000001164
11388,2022-04-16 12:00:00,1852.41,254939.27999999997,253147.31999999998,1791.9599999999919
11389,2022-04-16 12:05:00,-1407.4,253531.87999999998,253147.31999999998,384.5599999999977
11390,2022-04-16 12:10:00,564.77,254096.64999999997,253147.31999999998,949.3299999999872
11391,2022-04-16 12:15:00,269.76,254366.40999999997,253147.31999999998,1219.0899999999965
11392,2022-04-16 12:20:00,-42.97,254323.43999999997,253147.31999999998,1176.1199999999953
11393,2022-04-16 12:25:00,1240.1,255563.53999999998,253147.31999999998,2416.220000000001
11394,2022-04-16 12:30:00,-48.7,255514.83999999997,253147.31999999998,2367.5199999999895
11395,2022-04-16 12:35:00,1486.35,257001.18999999997,253147.31999999998,3853.8699999999953
11396,2022-04-16 12:40:00,-59.46,256941.72999999998,253147.31999999998,3794.4100000000035
11397,2022-04-16 12:45:00,-879.49,256062.24,253147.31999999998,2914.920000000013
11398,2022-04-16 12:50:00,-1698.49,254363.75,253147.31999999998,1216.4300000000221
11399,2022-04-16 12:55:00,-1652.95,252710.8,253147.31999999998,-436.5199999999895
11400,2022-04-16 13:00:00,703.19,253413.99,253147.31999999998,266.6700000000128
11401,2022-04-16 13:05:00,-674.16,252739.83,253147.31999999998,-407.4899999999907
11402,2022-04-16 13:10:00,-988.01,251751.81999999998,253147.31999999998,-1395.5
11403,2022-04-16 13:15:00,-1517.28,250234.53999999998,253147.31999999998,-2912.779999999999
11404,2022-04-16 13:20:00,-63.45,250171.08999999997,253147.31999999998,-2976.2300000000105
11405,2022-04-16 13:25:00,1033.31,251204.39999999997,253147.31999999998,-1942.9200000000128
11406,2022-04-16 13:30:00,1006.36,252210.75999999995,253147.31999999998,-936.5600000000268
11407,2022-04-16 13:35:00,-1956.41,250254.34999999995,253147.31999999998,-2892.9700000000303
11408,2022-04-16 13:40:00,-720.6,249533.74999999994,253147.31999999998,-3613.570000000036
11409,2022-04-16 13:45:00,-478.04,249055.70999999993,253147.31999999998,-4091.6100000000442
11410,2022-04-16 13:50:00,-1318.53,247737.17999999993,253147.31999999998,-5410.140000000043
11411,2022-04-16 13:55:00,795.6,248532.77999999994,253147.31999999998,-4614.540000000037
11412,2022-04-16 14:00:00,798.61,249331.38999999993,253147.31999999998,-3815.930000000051
11413,2022-04-16 14:05:00,636.31,249967.69999999992,253147.31999999998,-3179.6200000000536
11414,2022-04-16 14:10:00,463.12,250430.81999999992,253147.31999999998,-2716.500000000058
11415,2022-04-16 14:15:00,1237.04,251667.85999999993,253147.31999999998,-1479.46000000005
11416,2022-04-16 14:20:00,1017.5,252685.35999999993,253147.31999999998,-461.96000000005006
11417,2022-04-16 14:25:00,435.46,253120.81999999992,253147.31999999998,-26.500000000058208
11418,2022-04-16 14:30:00,943.97,254064.78999999992,253147.31999999998,917.469999999943
11419,2022-04-16 14:35:00,-976.22,253088.56999999992,253147.31999999998,-58.75000000005821
11420,2022-04-16 14:40:00,-321.93,252766.63999999993,253147.31999999998,-380.6800000000512
11421,2022-04-16 14:45:00,-988.84,251777.79999999993,253147.31999999998,-1369.5200000000477
11422,2022-04-16 14:50:00,-396.73,251381.06999999992,253147.31999999998,-1766.2500000000582
11423,2022-04-16 14:55:00,-1868.03,249513.03999999992,253147.31999999998,-3634.280000000057
11424,2022-04-16 15:00:00,-590.65,248922.38999999993,253147.31999999998,-4224.930000000051
11425,2022-04-16 15:05:00,1058.98,249981.36999999994,253147.31999999998,-3165.9500000000407
11426,2022-04-16 15:10:00,-1612.75,248368.61999999994,253147.31999999998,-4778.700000000041
11427,2022-04-16 15:15:00,1636.93,250005.54999999993,253147.31999999998,-3141.7700000000477
11428,2022-04-16 15:20:00,871.29,250876.83999999994,253147.31999999998,-2270.4800000000396
11429,2022-04-16 15:25:00,-756.91,250119.92999999993,253147.31999999998,-3027.390000000043
11430,2022-04-16 15:30:00,-413.62,249706.30999999994,253147.31999999998,-3441.0100000000384
11431,2022-04-16 15:35:00,1415.73,251122.03999999995,253147.31999999998,-2025.280000000028
11432,2022-04-16 15:40:00,1742.53,252864.56999999995,253147.31999999998,-282.7500000000291
11433,2022-04-16 15:45:00,1886.12,254750.68999999994,253147.31999999998,1603.3699999999662
11434,2022-04-16 15:50:00,-823.09,253927.59999999995,253147.31999999998,780.2799999999697
11435,2022-04-16 15:55:00,-804.77,253122.82999999996,253147.31999999998,-24.49000000001979
11436,2022-04-16 16:00:00,-1034.73,252088.09999999995,253147.31999999998,-1059.2200000000303
11437,2022-04-16 16:05:00,1013.26,253101.35999999996,253147.31999999998,-45.960000000020955
11438,2022-04-16 16:10:00,-254.1,252847.25999999995,253147.31999999998,-300.0600000000268
11439,2022-04-16 16:15:00,-1473.63,251373.62999999995,253147.31999999998,-1773.6900000000314
11440,2022-04-16 16:20:00,-583.46,250790.16999999995,253147.31999999998,-2357.1500000000233
11441,2022-04-16 16:25:00,-1923.4,248866.76999999996,253147.31999999998,-4280.5500000000175
11442,2022-04-16 16:30:00,1470.68,250337.44999999995,253147.31999999998,-2809.8700000000244
11443,2022-04-16 16:35:00,778.08,251115.52999999994,253147.31999999998,-2031.7900000000373
11444,2022-04-16 16:40:00,-1058.64,250056.88999999993,253147.31999999998,-3090.430000000051
11445,2022-04-16 16:45:00,-1833.22,248223.66999999993,253147.31999999998,-4923.650000000052
11446,2022-04-16 16:50:00,-824.82,247398.84999999992,253147.31999999998,-5748.470000000059
11447,2022-04-16 16:55:00,-1207.42,246191.4299999999,253147.31999999998,-6955.890000000072
11448,2022-04-17 08:00:00,-1710.11,244481.31999999992,246191.4299999999,-1710.109999999986
11449,2022-04-17 08:05:00,158.29,244639.60999999993,246191.4299999999,-1551.8199999999779
11450,2022-04-17 08:10:00,409.72,245049.32999999993,246191.4299999999,-1142.0999999999767
11451,2022-04-17 08:15:00,-7.77,245041.55999999994,246191.4299999999,-1149.8699999999662
11452,2022-04-17 08:20:00,-7.62,245033.93999999994,246191.4299999999,-1157.4899999999616
11453,2022-04-17 08:25:00,750.76,245784.69999999995,246191.4299999999,-406.72999999995227
11454,2022-04-17 08:30:00,1387.47,247172.16999999995,246191.4299999999,980.7400000000489
11455,2022-04-17 08:35:00,-1325.44,245846.72999999995,246191.4299999999,-344.69999999995343
11456,2022-04-17 08:40:00,-787.93,245058.79999999996,246191.4299999999,-1132.6299999999464
11457,2022-04-17 08:45:00,1901.05,246959.84999999995,246191.4299999999,768.4200000000419
11458,2022-04-17 08:50:00,-134.15,246825.69999999995,246191.4299999999,634.2700000000477
11459,2022-04-17 08:55:00,-858.81,245966.88999999996,246191.4299999999,-224.53999999994994
11460,2022-04-17 09:00:00,1357.9,247324.78999999995,246191.4299999999,1133.3600000000442
11461,2022-04-17 09:05:00,1921.31,249246.09999999995,246191.4299999999,3054.670000000042
11462,2022-04-17 09:10:00,620.06,249866.15999999995,246191.4299999999,3674.7300000000396
11463,2022-04-17 09:15:00,-617.53,249248.62999999995,246191.4299999999,3057.2000000000407
11464,2022-04-17 09:20:00,251.52,249500.14999999994,246191.4299999999,3308.7200000000303
11465,2022-04-17 09:25:00,464.96,249965.10999999993,246191.4299999999,3773.680000000022
11466,2022-04-17 09:30:00,-1675.28,248289.82999999993,246191.4299999999,2098.4000000000233
11467,2022-04-17 09:35:00,529.78,248819.60999999993,246191.4299999999,2628.180000000022
11468,2022-04-17 09:40:00,1584.11,250403.7199999999,246191.4299999999,4212.290000000008
11469,2022-04-17 09:45:00,-1894.49,248509.22999999992,246191.4299999999,2317.8000000000175
11470,2022-04-17 09:50:00,1466.6,249975.82999999993,246191.4299999999,3784.4000000000233
11471,2022-04-17 09:55:00,925.28,250901.10999999993,246191.4299999999,4709.680000000022
11472,2022-04-17 10:00:00,340.79,251241.89999999994,246191.4299999999,5050.47000000003
11473,2022-04-17 10:05:00,-1986.21,249255.68999999994,246191.4299999999,3064.2600000000384
11474,2022-04-17 10:10:00,644.52,249900.20999999993,246191.4299999999,3708.780000000028
11475,2022-04-17 10:15:00,-1009.87,248890.33999999994,246191.4299999999,2698.9100000000326
11476,2022-04-17 10:20:00,-1975.19,246915.14999999994,246191.4299999999,723.7200000000303
11477,2022-04-17 10:25:00,30.45,246945.59999999995,246191.4299999999,754.1700000000419
11478,2022-04-17 10:30:00,1025.75,247971.34999999995,246191.4299999999,1779.920000000042
11479,2022-04-17 10:35:00,505.51,248476.85999999996,246191.4299999999,2285.430000000051
11480,2022-04-17 10:40:00,1324.3,249801.15999999995,246191.4299999999,3609.7300000000396
11481,2022-04-17 10:45:00,-1689.54,248111.61999999994,246191.4299999999,1920.1900000000314
11482,2022-04-17 10:50:00,962.68,249074.29999999993,246191.4299999999,2882.8700000000244
11483,2022-04-17 10:55:00,-1435.43,247638.86999999994,246191.4299999999,1447.4400000000314
11484,2022-04-17 11:00:00,1344.02,248982.88999999993,246191.4299999999,2791.460000000021
11485,2022-04-17 11:05:00,1417.61,250400.4999999999,246191.4299999999,4209.070000000007
11486,2022-04-17 11:10:00,-752.49,249648.00999999992,246191.4299999999,3456.5800000000163
11487,2022-04-17 11:15:00,154.29,249802.29999999993,246191.4299999999,3610.8700000000244
11488,2022-04-17 11:20:00,23.95,249826.24999999994,246191.4299999999,3634.820000000036
11489,2022-04-17 11:25:00,1465.39,251291.63999999996,246191.4299999999,5100.21000000005
11490,2022-04-17 11:30:00,1079.61,252371.24999999994,246191.4299999999,6179.820000000036
11491,2022-04-17 11:35:00,1687.86,254059.10999999993,246191.4299999999,7867.680000000022
11492,2022-04-17 11:40:00,98.9,254158.00999999992,246191.4299999999,7966.580000000016
11493,2022-04-17 11:45:00,-1371.48,252786.5299999999,246191.4299999999,6595.100000000006
11494,2022-04-17 11:50:00,1934.11,254720.6399999999,246191.4299999999,8529.209999999992
11495,2022-04-17 11:55:00,1280.69,256001.3299999999,246191.4299999999,9809.899999999994
11496,2022-04-17 12:00:00,-1340.27,254661.0599999999,246191.4299999999,8469.630000000005
11497,2022-04-17 12:05:00,-1287.96,253373.09999999992,246191.4299999999,7181.670000000013
11498,2022-04-17 12:10:00,-1461.71,251911.38999999993,246191.4299999999,5719.960000000021
11499,2022-04-17 12:15:00,-1130.52,250780.86999999994,246191.4299999999,4589.440000000031
11500,2022-04-17 12:20:00,-1497.47,249283.39999999994,246191.4299999999,3091.9700000000303
11501,2022-04-17 12:25:00,-376.52,248906.87999999995,246191.4299999999,2715.4500000000407
11502,2022-04-17 12:30:00,971.11,249877.98999999993,246191.4299999999,3686.560000000027
11503,2022-04-17 12:35:00,-1498.12,248379.86999999994,246191.4299999999,2188.4400000000314
11504,2022-04-17 12:40:00,232.33,248612.19999999992,246191.4299999999,2420.7700000000186
11505,2022-04-17 12:45:00,-503.93,248108.26999999993,246191.4299999999,1916.8400000000256
11506,2022-04-17 12:50:00,-684.98,247423.28999999992,246191.4299999999,1231.8600000000151
11507,2022-04-17 12:55:00,-1341.67,246081.6199999999,246191.4299999999,-109.80999999999767
11508,2022-04-17 13:00:00,1554.06,247635.6799999999,246191.4299999999,1444.25
11509,2022-04-17 13:05:00,985.67,248621.34999999992,246191.4299999999,2429.920000000013
11510,2022-04-17 13:10:00,-171.29,248450.0599999999,246191.4299999999,2258.6300000000047
11511,2022-04-17 13:15:00,714.95,249165.00999999992,246191.4299999999,2973.5800000000163
11512,2022-04-17 13:20:00,1116.94,250281.94999999992,246191.4299999999,4090.5200000000186
11513,2022-04-17 13:25:00,-386.55,249895.39999999994,246191.4299999999,3703.9700000000303
11514,2022-04-17 13:30:00,-465.96,249429.43999999994,246191.4299999999,3238.0100000000384
11515,2022-04-17 13:35:00,-1065.6,248363.83999999994,246191.4299999999,2172.4100000000326
11516,2022-04-17 13:40:00,-879.85,247483.98999999993,246191.4299999999,1292.5600000000268
11517,2022-04-17 13:45:00,-1485.05,245998.93999999994,246191.4299999999,-192.48999999996158
11518,2022-04-17 13:50:00,-1849.31,244149.62999999995,246191.4299999999,-2041.7999999999593
11519,2022-04-17 13:55:00,-590.41,243559.21999999994,246191.4299999999,-2632.2099999999627
11520,2022-04-17 14:00:00,-1966.4,241592.81999999995,246191.4299999999,-4598.609999999957
11521,2022-04-17 14:05:00,-1662.28,239930.53999999995,246191.4299999999,-6260.889999999956
11522,2022-04-17 14:10:00,1129.05,241059.58999999994,246191.4299999999,-5131.839999999967
11523,2022-04-17 14:15:00,1757.84,242817.42999999993,246191.4299999999,-3373.999999999971
11524,2022-04-17 14:20:00,756.24,243573.66999999993,246191.4299999999,-2617.75999999998
11525,2022-04-17 14:25:00,1425.46,244999.12999999992,246191.4299999999,-1192.2999999999884
11526,2022-04-17 14:30:00,-718.8,244280.32999999993,246191.4299999999,-1911.0999999999767
11527,2022-04-17 14:35:00,-323.24,243957.08999999994,246191.4299999999,-2234.3399999999674
11528,2022-04-17 14:40:00,192.09,244149.17999999993,246191.4299999999,-2042.249999999971
11529,2022-04-17 14:45:00,-1389.11,242760.06999999995,246191.4299999999,-3431.359999999957
11530,2022-04-17 14:50:00,1251.75,244011.81999999995,246191.4299999999,-2179.609999999957
11531,2022-04-17 14:55:00,179.37,244191.18999999994,246191.4299999999,-2000.2399999999616
11532,2022-04-17 15:00:00,1648.56,245839.74999999994,246191.4299999999,-351.6799999999639
11533,2022-04-17 15:05:00,1410.68,247250.42999999993,246191.4299999999,1059.000000000029
11534,2022-04-17 15:10:00,-764.08,246486.34999999995,246191.4299999999,294.9200000000419
11535,2022-04-17 15:15:00,-695.67,245790.67999999993,246191.4299999999,-400.7499999999709
11536,2022-04-17 15:20:00,142.56,245933.23999999993,246191.4299999999,-258.1899999999732
11537,2022-04-17 15:25:00,1254.87,247188.10999999993,246191.4299999999,996.6800000000221
11538,2022-04-17 15:30:00,-1536.85,245651.25999999992,246191.4299999999,-540.1699999999837
11539,2022-04-17 15:35:00,-252.03,245399.22999999992,246191.4299999999,-792.1999999999825
11540,2022-04-17 15:40:00,336.73,245735.95999999993,246191.4299999999,-455.46999999997206
11541,2022-04-17 15:45:00,-1001.54,244734.41999999993,246191.4299999999,-1457.0099999999802
11542,2022-04-17 15:50:00,-1143.62,243590.79999999993,246191.4299999999,-2600.6299999999756
11543,2022-04-17 15:55:00,954.48,244545.27999999994,246191.4299999999,-1646.149999999965
11544,2022-04-17 16:00:00,-1877.23,242668.04999999993,246191.4299999999,-3523.3799999999756
11545,2022-04-17 16:05:00,128.16,242796.20999999993,246191.4299999999,-3395.219999999972
11546,2022-04-17 16:10:00,-1345.48,241450.72999999992,246191.4299999999,-4740.6999999999825
11547,2022-04-17 16:15:00,-1378.9,240071.82999999993,246191.4299999999,-6119.599999999977
11548,2022-04-17 16:20:00,-1788.42,238283.40999999992,246191.4299999999,-7908.0199999999895
11549,2022-04-17 16:25:00,1350.49,239633.8999999999,246191.4299999999,-6557.529999999999
11550,2022-04-17 16:30:00,201.96,239835.8599999999,246191.4299999999,-6355.570000000007
11551,2022-04-17 16:35:00,1589.85,241425.7099999999,246191.4299999999,-4765.720000000001
11552,2022-04-17 16:40:00,1055.49,242481.1999999999,246191.4299999999,-3710.2300000000105
11553,2022-04-17 16:45:00,-1694.77,240786.4299999999,246191.4299999999,-5405.0
11554,2022-04-17 16:50:00,-207.53,240578.8999999999,246191.4299999999,-5612.529999999999
11555,2022-04-17 16:55:00,-300.17,240278.7299999999,246191.4299999999,-5912.700000000012
11556,2022-04-18 08:00:00,1351.28,241630.0099999999,240278.7299999999,1351.2799999999988
11557,2022-04-18 08:05:00,-30.47,241599.5399999999,240278.7299999999,1320.8099999999977
11558,2022-04-18 08:10:00,-1943.77,239655.7699999999,240278.7299999999,-622.9599999999919
11559,2022-04-18 08:15:00,1802.43,241458.1999999999,240278.7299999999,1179.4700000000012
11560,2022-04-18 08:20:00,956.71,242414.9099999999,240278.7299999999,2136.179999999993
11561,2022-04-18 08:25:00,-885.72,241529.1899999999,240278.7299999999,1250.4599999999919
11562,2022-04-18 08:30:00,-857.6,240671.58999999988,240278.7299999999,392.85999999998603
11563,2022-04-18 08:35:00,336.69,241008.27999999988,240278.7299999999,729.5499999999884
11564,2022-04-18 08:40:00,1328.16,242336.4399999999,240278.7299999999,2057.709999999992
11565,2022-04-18 08:45:00,1003.24,243339.67999999988,240278.7299999999,3060.9499999999825
11566,2022-04-18 08:50:00,1419.06,244758.73999999987,240278.7299999999,4480.00999999998
11567,2022-04-18 08:55:00,-5.32,244753.41999999987,240278.7299999999,4474.689999999973
11568,2022-04-18 09:00:00,1947.3,246700.71999999986,240278.7299999999,6421.989999999962
11569,2022-04-18 09:05:00,-257.9,246442.81999999986,240278.7299999999,6164.089999999967
11570,2022-04-18 09:10:00,-856.74,245586.07999999987,240278.7299999999,5307.349999999977
11571,2022-04-18 09:15:00,-727.14,244858.93999999986,240278.7299999999,4580.209999999963
11572,2022-04-18 09:20:00,-332.02,244526.91999999987,240278.7299999999,4248.189999999973
11573,2022-04-18 09:25:00,-217.05,244309.86999999988,240278.7299999999,4031.139999999985
11574,2022-04-18 09:30:00,943.36,245253.22999999986,240278.7299999999,4974.499999999971
11575,2022-04-18 09:35:00,142.06,245395.28999999986,240278.7299999999,5116.559999999969
11576,2022-04-18 09:40:00,615.65,246010.93999999986,240278.7299999999,5732.209999999963
11577,2022-04-18 09:45:00,41.85,246052.78999999986,240278.7299999999,5774.059999999969
11578,2022-04-18 09:50:00,-1348.69,244704.09999999986,240278.7299999999,4425.369999999966
11579,2022-04-18 09:55:00,713.85,245417.94999999987,240278.7299999999,5139.219999999972
11580,2022-04-18 10:00:00,-180.8,245237.14999999988,240278.7299999999,4958.419999999984
11581,2022-04-18 10:05:00,-1819.47,243417.67999999988,240278.7299999999,3138.9499999999825
11582,2022-04-18 10:10:00,855.26,244272.9399999999,240278.7299999999,3994.209999999992
11583,2022-04-18 10:15:00,1083.91,245356.8499999999,240278.7299999999,5078.119999999995
11584,2022-04-18 10:20:00,-360.89,244995.95999999988,240278.7299999999,4717.229999999981
11585,2022-04-18 10:25:00,-90.36,244905.5999999999,240278.7299999999,4626.869999999995
11586,2022-04-18 10:30:00,-1846.48,243059.11999999988,240278.7299999999,2780.389999999985
11587,2022-04-18 10:35:00,665.49,243724.60999999987,240278.7299999999,3445.8799999999756
11588,2022-04-18 10:40:00,-1147.77,242576.83999999988,240278.7299999999,2298.109999999986
11589,2022-04-18 10:45:00,-972.82,241604.01999999987,240278.7299999999,1325.289999999979
11590,2022-04-18 10:50:00,-1577.37,240026.64999999988,240278.7299999999,-252.0800000000163
11591,2022-04-18 10:55:00,537.3,240563.94999999987,240278.7299999999,285.21999999997206
11592,2022-04-18 11:00:00,-1214.58,239349.36999999988,240278.7299999999,-929.3600000000151
11593,2022-04-18 11:05:00,1385.1,240734.46999999988,240278.7299999999,455.7399999999907
11594,2022-04-18 11:10:00,437.75,241172.21999999988,240278.7299999999,893.4899999999907
11595,2022-04-18 11:15:00,1285.28,242457.49999999988,240278.7299999999,2178.7699999999895
11596,2022-04-18 11:20:00,-1422.84,241034.6599999999,240278.7299999999,755.929999999993
11597,2022-04-18 11:25:00,-500.94,240533.71999999988,240278.7299999999,254.9899999999907
11598,2022-04-18 11:30:00,-1811.75,238721.96999999988,240278.7299999999,-1556.7600000000093
11599,2022-04-18 11:35:00,1341.5,240063.46999999988,240278.7299999999,-215.2600000000093
11600,2022-04-18 11:40:00,-191.8,239871.6699999999,240278.7299999999,-407.0599999999977
11601,2022-04-18 11:45:00,-1268.97,238602.6999999999,240278.7299999999,-1676.0299999999988
11602,2022-04-18 11:50:00,378.79,238981.4899999999,240278.7299999999,-1297.2399999999907
11603,2022-04-18 11:55:00,739.93,239721.4199999999,240278.7299999999,-557.3099999999977
11604,2022-04-18 12:00:00,1929.36,241650.77999999988,240278.7299999999,1372.0499999999884
11605,2022-04-18 12:05:00,-567.13,241083.64999999988,240278.7299999999,804.9199999999837
11606,2022-04-18 12:10:00,-1895.87,239187.77999999988,240278.7299999999,-1090.9500000000116
11607,2022-04-18 12:15:00,-616.33,238571.4499999999,240278.7299999999,-1707.2799999999988
11608,2022-04-18 12:20:00,978.85,239550.2999999999,240278.7299999999,-728.429999999993
11609,2022-04-18 12:25:00,623.67,240173.9699999999,240278.7299999999,-104.75999999998021
11610,2022-04-18 12:30:00,-1990.73,238183.2399999999,240278.7299999999,-2095.4899999999907
11611,2022-04-18 12:35:00,-477.67,237705.5699999999,240278.7299999999,-2573.1600000000035
11612,2022-04-18 12:40:00,-1775.75,235929.8199999999,240278.7299999999,-4348.9100000000035
11613,2022-04-18 12:45:00,-1527.75,234402.0699999999,240278.7299999999,-5876.6600000000035
11614,2022-04-18 12:50:00,-44.41,234357.6599999999,240278.7299999999,-5921.070000000007
11615,2022-04-18 12:55:00,-432.95,233924.70999999988,240278.7299999999,-6354.020000000019
11616,2022-04-18 13:00:00,567.89,234492.5999999999,240278.7299999999,-5786.130000000005
11617,2022-04-18 13:05:00,1524.81,236017.4099999999,240278.7299999999,-4261.320000000007
11618,2022-04-18 13:10:00,-434.82,235582.58999999988,240278.7299999999,-4696.140000000014
11619,2022-04-18 13:15:00,710.02,236292.60999999987,240278.7299999999,-3986.1200000000244
11620,2022-04-18 13:20:00,1122.45,237415.05999999988,240278.7299999999,-2863.670000000013
11621,2022-04-18 13:25:00,647.95,238063.0099999999,240278.7299999999,-2215.720000000001
11622,2022-04-18 13:30:00,-89.03,237973.9799999999,240278.7299999999,-2304.75
11623,2022-04-18 13:35:00,-469.24,237504.7399999999,240278.7299999999,-2773.9899999999907
11624,2022-04-18 13:40:00,1595.23,239099.9699999999,240278.7299999999,-1178.7599999999802
11625,2022-04-18 13:45:00,1659.67,240759.63999999993,240278.7299999999,480.9100000000326
11626,2022-04-18 13:50:00,1223.96,241983.59999999992,240278.7299999999,1704.8700000000244
11627,2022-04-18 13:55:00,-1680.32,240303.2799999999,240278.7299999999,24.550000000017462
11628,2022-04-18 14:00:00,-1098.37,239204.90999999992,240278.7299999999,-1073.8199999999779
11629,2022-04-18 14:05:00,174.11,239379.0199999999,240278.7299999999,-899.7099999999919
11630,2022-04-18 14:10:00,119.76,239498.7799999999,240278.7299999999,-779.9499999999825
11631,2022-04-18 14:15:00,-1154.03,238344.7499999999,240278.7299999999,-1933.9799999999814
11632,2022-04-18 14:20:00,1668.64,240013.38999999993,240278.7299999999,-265.3399999999674
11633,2022-04-18 14:25:00,318.93,240332.31999999992,240278.7299999999,53.59000000002561
11634,2022-04-18 14:30:00,-980.52,239351.79999999993,240278.7299999999,-926.9299999999639
11635,2022-04-18 14:35:00,525.33,239877.12999999992,240278.7299999999,-401.5999999999767
11636,2022-04-18 14:40:00,494.59,240371.7199999999,240278.7299999999,92.99000000001979
11637,2022-04-18 14:45:00,710.68,241082.3999999999,240278.7299999999,803.6700000000128
11638,2022-04-18 14:50:00,847.7,241930.09999999992,240278.7299999999,1651.3700000000244
11639,2022-04-18 14:55:00,84.05,242014.1499999999,240278.7299999999,1735.4200000000128
11640,2022-04-18 15:00:00,-404.57,241609.5799999999,240278.7299999999,1330.8500000000058
11641,2022-04-18 15:05:00,1342.97,242952.5499999999,240278.7299999999,2673.820000000007
11642,2022-04-18 15:10:00,1109.57,244062.1199999999,240278.7299999999,3783.390000000014
11643,2022-04-18 15:15:00,-184.34,243877.7799999999,240278.7299999999,3599.0500000000175
11644,2022-04-18 15:20:00,1535.57,245413.34999999992,240278.7299999999,5134.620000000024
11645,2022-04-18 15:25:00,-1327.96,244085.38999999993,240278.7299999999,3806.6600000000326
11646,2022-04-18 15:30:00,1780.4,245865.78999999992,240278.7299999999,5587.060000000027
11647,2022-04-18 15:35:00,1547.45,247413.23999999993,240278.7299999999,7134.510000000038
11648,2022-04-18 15:40:00,-1239.02,246174.21999999994,240278.7299999999,5895.490000000049
11649,2022-04-18 15:45:00,1160.64,247334.85999999996,240278.7299999999,7056.130000000063
11650,2022-04-18 15:50:00,-1139.32,246195.53999999995,240278.7299999999,5916.810000000056
11651,2022-04-18 15:55:00,695.14,246890.67999999996,240278.7299999999,6611.95000000007
11652,2022-04-18 16:00:00,1337.02,248227.69999999995,240278.7299999999,7948.970000000059
11653,2022-04-18 16:05:00,687.38,248915.07999999996,240278.7299999999,8636.350000000064
11654,2022-04-18 16:10:00,158.36,249073.43999999994,240278.7299999999,8794.71000000005
11655,2022-04-18 16:15:00,-1217.82,247855.61999999994,240278.7299999999,7576.890000000043
11656,2022-04-18 16:20:00,965.95,248821.56999999995,240278.7299999999,8542.840000000055
11657,2022-04-18 16:25:00,1771.14,250592.70999999996,240278.7299999999,10313.980000000069
11658,2022-04-18 16:30:00,-1048.51,249544.19999999995,240278.7299999999,9265.47000000006
11659,2022-04-18 16:35:00,955.27,250499.46999999994,240278.7299999999,10220.740000000049
11660,2022-04-18 16:40:00,-88.25,250411.21999999994,240278.7299999999,10132.490000000049
11661,2022-04-18 16:45:00,-312.53,250098.68999999994,240278.7299999999,9819.96000000005
11662,2022-04-18 16:50:00,674.72,250773.40999999995,240278.7299999999,10494.680000000051
11663,2022-04-18 16:55:00,1179.02,251952.42999999993,240278.7299999999,11673.70000000004
11664,2022-04-19 08:00:00,-1117.7,250834.72999999992,251952.42999999993,-1117.7000000000116
11665,2022-04-19 08:05:00,1428.49,252263.2199999999,251952.42999999993,310.78999999997905
11666,2022-04-19 08:10:00,1043.81,253307.0299999999,251952.42999999993,1354.5999999999767
11667,2022-04-19 08:15:00,-712.36,252594.66999999993,251952.42999999993,642.2399999999907
11668,2022-04-19 08:20:00,928.69,253523.35999999993,251952.42999999993,1570.929999999993
11669,2022-04-19 08:25:00,-363.82,253159.53999999992,251952.42999999993,1207.109999999986
11670,2022-04-19 08:30:00,-1683.66,251475.87999999992,251952.42999999993,-476.55000000001746
11671,2022-04-19 08:35:00,-1625.48,249850.3999999999,251952.42999999993,-2102.030000000028
11672,2022-04-19 08:40:00,-1332.39,248518.0099999999,251952.42999999993,-3434.420000000042
11673,2022-04-19 08:45:00,-315.11,248202.8999999999,251952.42999999993,-3749.530000000028
11674,2022-04-19 08:50:00,1845.31,250048.2099999999,251952.42999999993,-1904.2200000000303
11675,2022-04-19 08:55:00,981.04,251029.2499999999,251952.42999999993,-923.1800000000221
11676,2022-04-19 09:00:00,-739.9,250289.34999999992,251952.42999999993,-1663.0800000000163
11677,2022-04-19 09:05:00,1660.16,251949.50999999992,251952.42999999993,-2.9200000000128057
11678,2022-04-19 09:10:00,-990.45,250959.0599999999,251952.42999999993,-993.3700000000244
11679,2022-04-19 09:15:00,839.78,251798.8399999999,251952.42999999993,-153.5900000000256
11680,2022-04-19 09:20:00,1420.65,253219.4899999999,251952.42999999993,1267.0599999999686
11681,2022-04-19 09:25:00,-648.01,252571.4799999999,251952.42999999993,619.0499999999593
11682,2022-04-19 09:30:00,-157.37,252414.1099999999,251952.42999999993,461.6799999999639
11683,2022-04-19 09:35:00,-678.68,251735.4299999999,251952.42999999993,-217.0000000000291
11684,2022-04-19 09:40:00,900.49,252635.9199999999,251952.42999999993,683.4899999999616
11685,2022-04-19 09:45:00,1945.85,254581.7699999999,251952.42999999993,2629.3399999999674
11686,2022-04-19 09:50:00,1044.34,255626.1099999999,251952.42999999993,3673.679999999964
11687,2022-04-19 09:55:00,-1915.78,253710.3299999999,251952.42999999993,1757.899999999965
11688,2022-04-19 10:00:00,1248.02,254958.3499999999,251952.42999999993,3005.9199999999546
11689,2022-04-19 10:05:00,1199.0,256157.3499999999,251952.42999999993,4204.919999999955
11690,2022-04-19 10:10:00,848.98,257006.3299999999,251952.42999999993,5053.899999999965
11691,2022-04-19 10:15:00,818.2,257824.5299999999,251952.42999999993,5872.099999999977
11692,2022-04-19 10:20:00,471.2,258295.72999999992,251952.42999999993,6343.299999999988
11693,2022-04-19 10:25:00,282.29,258578.01999999993,251952.42999999993,6625.5899999999965
11694,2022-04-19 10:30:00,698.82,259276.83999999994,251952.42999999993,7324.4100000000035
11695,2022-04-19 10:35:00,-573.43,258703.40999999995,251952.42999999993,6750.9800000000105
11696,2022-04-19 10:40:00,1784.12,260487.52999999994,251952.42999999993,8535.100000000006
11697,2022-04-19 10:45:00,405.01,260892.53999999995,251952.42999999993,8940.110000000015
11698,2022-04-19 10:50:00,-549.12,260343.41999999995,251952.42999999993,8390.99000000002
11699,2022-04-19 10:55:00,-429.65,259913.76999999996,251952.42999999993,7961.340000000026
11700,2022-04-19 11:00:00,-1544.59,258369.17999999996,251952.42999999993,6416.750000000029
11701,2022-04-19 11:05:00,1176.26,259545.43999999997,251952.42999999993,7593.010000000038
11702,2022-04-19 11:10:00,-1973.99,257571.44999999998,251952.42999999993,5619.020000000048
11703,2022-04-19 11:15:00,1887.22,259458.66999999998,251952.42999999993,7506.240000000049
11704,2022-04-19 11:20:00,1259.55,260718.21999999997,251952.42999999993,8765.790000000037
11705,2022-04-19 11:25:00,-100.85,260617.36999999997,251952.42999999993,8664.940000000031
11706,2022-04-19 11:30:00,733.38,261350.74999999997,251952.42999999993,9398.320000000036
11707,2022-04-19 11:35:00,-1496.96,259853.78999999998,251952.42999999993,7901.360000000044
11708,2022-04-19 11:40:00,1772.07,261625.86,251952.42999999993,9673.430000000051
11709,2022-04-19 11:45:00,496.97,262122.83,251952.42999999993,10170.400000000052
11710,2022-04-19 11:50:00,343.74,262466.57,251952.42999999993,10514.140000000072
11711,2022-04-19 11:55:00,1939.6,264406.17,251952.42999999993,12453.740000000049
11712,2022-04-19 12:00:00,547.68,264953.85,251952.42999999993,13001.420000000042
11713,2022-04-19 12:05:00,1551.2,266505.05,251952.42999999993,14552.620000000054
11714,2022-04-19 12:10:00,-587.06,265917.99,251952.42999999993,13965.560000000056
11715,2022-04-19 12:15:00,1432.44,267350.43,251952.42999999993,15398.000000000058
11716,2022-04-19 12:20:00,-981.56,266368.87,251952.42999999993,14416.44000000006
11717,2022-04-19 12:25:00,-1669.94,264698.93,251952.42999999993,12746.500000000058
11718,2022-04-19 12:30:00,-528.75,264170.18,251952.42999999993,12217.750000000058
11719,2022-04-19 12:35:00,-1607.57,262562.61,251952.42999999993,10610.180000000051
11720,2022-04-19 12:40:00,-877.78,261684.83,251952.42999999993,9732.400000000052
11721,2022-04-19 12:45:00,1678.95,263363.77999999997,251952.42999999993,11411.350000000035
11722,2022-04-19 12:50:00,-1488.94,261874.83999999997,251952.42999999993,9922.410000000033
11723,2022-04-19 12:55:00,-1856.5,260018.33999999997,251952.42999999993,8065.910000000033
11724,2022-04-19 13:00:00,-1195.85,258822.48999999996,251952.42999999993,6870.060000000027
11725,2022-04-19 13:05:00,-967.52,257854.96999999997,251952.42999999993,5902.540000000037
11726,2022-04-19 13:10:00,851.02,258705.98999999996,251952.42999999993,6753.560000000027
11727,2022-04-19 13:15:00,-1342.16,257363.82999999996,251952.42999999993,5411.400000000023
11728,2022-04-19 13:20:00,308.7,257672.52999999997,251952.42999999993,5720.100000000035
11729,2022-04-19 13:25:00,-1275.46,256397.06999999998,251952.42999999993,4444.640000000043
11730,2022-04-19 13:30:00,-1110.75,255286.31999999998,251952.42999999993,3333.890000000043
11731,2022-04-19 13:35:00,-812.3,254474.02,251952.42999999993,2521.5900000000547
11732,2022-04-19 13:40:00,455.14,254929.16,251952.42999999993,2976.7300000000687
11733,2022-04-19 13:45:00,-1263.65,253665.51,251952.42999999993,1713.0800000000745
11734,2022-04-19 13:50:00,1757.99,255423.5,251952.42999999993,3471.070000000065
11735,2022-04-19 13:55:00,-1586.02,253837.48,251952.42999999993,1885.0500000000757
11736,2022-04-19 14:00:00,-1210.12,252627.36000000002,251952.42999999993,674.9300000000803
11737,2022-04-19 14:05:00,1738.84,254366.2,251952.42999999993,2413.770000000077
11738,2022-04-19 14:10:00,19.15,254385.35,251952.42999999993,2432.920000000071
11739,2022-04-19 14:15:00,-1488.5,252896.85,251952.42999999993,944.420000000071
11740,2022-04-19 14:20:00,-145.09,252751.76,251952.42999999993,799.3300000000745
11741,2022-04-19 14:25:00,-1986.49,250765.27000000002,251952.42999999993,-1187.1599999999162
11742,2022-04-19 14:30:00,682.85,251448.12000000002,251952.42999999993,-504.30999999991036
11743,2022-04-19 14:35:00,-1508.93,249939.19000000003,251952.42999999993,-2013.2399999999034
11744,2022-04-19 14:40:00,-1755.64,248183.55000000002,251952.42999999993,-3768.8799999999173
11745,2022-04-19 14:45:00,-401.37,247782.18000000002,251952.42999999993,-4170.249999999913
11746,2022-04-19 14:50:00,1521.61,249303.79,251952.42999999993,-2648.6399999999267
11747,2022-04-19 14:55:00,-565.47,248738.32,251952.42999999993,-3214.109999999928
11748,2022-04-19 15:00:00,1242.0,249980.32,251952.42999999993,-1972.1099999999278
11749,2022-04-19 15:05:00,-1742.1,248238.22,251952.42999999993,-3714.2099999999336
11750,2022-04-19 15:10:00,463.47,248701.69,251952.42999999993,-3250.7399999999325
11751,2022-04-19 15:15:00,1850.61,250552.3,251952.42999999993,-1400.1299999999464
11752,2022-04-19 15:20:00,1035.2,251587.5,251952.42999999993,-364.9299999999348
11753,2022-04-19 15:25:00,1139.2,252726.7,251952.42999999993,774.2700000000768
11754,2022-04-19 15:30:00,1033.8,253760.5,251952.42999999993,1808.0700000000652
11755,2022-04-19 15:35:00,1667.9,255428.4,251952.42999999993,3475.9700000000594
11756,2022-04-19 15:40:00,-1902.1,253526.3,251952.42999999993,1573.8700000000536
11757,2022-04-19 15:45:00,-237.57,253288.72999999998,251952.42999999993,1336.3000000000466
11758,2022-04-19 15:50:00,-1451.82,251836.90999999997,251952.42999999993,-115.51999999996042
11759,2022-04-19 15:55:00,-1941.3,249895.61,251952.42999999993,-2056.819999999949
11760,2022-04-19 16:00:00,-1517.65,248377.96,251952.42999999993,-3574.469999999943
11761,2022-04-19 16:05:00,-1574.95,246803.00999999998,251952.42999999993,-5149.419999999955
11762,2022-04-19 16:10:00,1950.87,248753.87999999998,251952.42999999993,-3198.5499999999593
11763,2022-04-19 16:15:00,-71.41,248682.46999999997,251952.42999999993,-3269.9599999999627
11764,2022-04-19 16:20:00,-58.42,248624.04999999996,251952.42999999993,-3328.3799999999756
11765,2022-04-19 16:25:00,-1782.86,246841.18999999997,251952.42999999993,-5111.239999999962
11766,2022-04-19 16:30:00,-1223.52,245617.66999999998,251952.42999999993,-6334.759999999951
11767,2022-04-19 16:35:00,1688.65,247306.31999999998,251952.42999999993,-4646.109999999957
11768,2022-04-19 16:40:00,-189.77,247116.55,251952.42999999993,-4835.879999999946
11769,2022-04-19 16:45:00,147.8,247264.34999999998,251952.42999999993,-4688.079999999958
11770,2022-04-19 16:50:00,-1013.03,246251.31999999998,251952.42999999993,-5701.109999999957
11771,2022-04-19 16:55:00,-1155.25,245096.06999999998,251952.42999999993,-6856.359999999957
11772,2022-04-20 08:00:00,-1440.9,243655.16999999998,245096.06999999998,-1440.8999999999942
11773,2022-04-20 08:05:00,-593.14,243062.02999999997,245096.06999999998,-2034.0400000000081
11774,2022-04-20 08:10:00,-1956.82,241105.20999999996,245096.06999999998,-3990.860000000015
11775,2022-04-20 08:15:00,608.84,241714.04999999996,245096.06999999998,-3382.0200000000186
11776,2022-04-20 08:20:00,1260.38,242974.42999999996,245096.06999999998,-2121.640000000014
11777,2022-04-20 08:25:00,-1068.72,241905.70999999996,245096.06999999998,-3190.360000000015
11778,2022-04-20 08:30:00,990.16,242895.86999999997,245096.06999999998,-2200.2000000000116
11779,2022-04-20 08:35:00,395.34,243291.20999999996,245096.06999999998,-1804.8600000000151
11780,2022-04-20 08:40:00,-1194.85,242096.35999999996,245096.06999999998,-2999.710000000021
11781,2022-04-20 08:45:00,-1690.63,240405.72999999995,245096.06999999998,-4690.340000000026
11782,2022-04-20 08:50:00,1614.67,242020.39999999997,245096.06999999998,-3075.670000000013
11783,2022-04-20 08:55:00,-748.6,241271.79999999996,245096.06999999998,-3824.2700000000186
11784,2022-04-20 09:00:00,-1732.98,239538.81999999995,245096.06999999998,-5557.250000000029
11785,2022-04-20 09:05:00,1444.58,240983.39999999994,245096.06999999998,-4112.670000000042
11786,2022-04-20 09:10:00,-1542.57,239440.82999999993,245096.06999999998,-5655.240000000049
11787,2022-04-20 09:15:00,-850.13,238590.69999999992,245096.06999999998,-6505.370000000054
11788,2022-04-20 09:20:00,1934.97,240525.66999999993,245096.06999999998,-4570.400000000052
11789,2022-04-20 09:25:00,541.56,241067.22999999992,245096.06999999998,-4028.8400000000547
11790,2022-04-20 09:30:00,-1176.35,239890.87999999992,245096.06999999998,-5205.1900000000605
11791,2022-04-20 09:35:00,854.1,240744.97999999992,245096.06999999998,-4351.090000000055
11792,2022-04-20 09:40:00,530.58,241275.5599999999,245096.06999999998,-3820.5100000000675
11793,2022-04-20 09:45:00,-125.74,241149.81999999992,245096.06999999998,-3946.250000000058
11794,2022-04-20 09:50:00,1756.46,242906.2799999999,245096.06999999998,-2189.7900000000664
11795,2022-04-20 09:55:00,1644.36,244550.6399999999,245096.06999999998,-545.4300000000803
11796,2022-04-20 10:00:00,407.91,244958.5499999999,245096.06999999998,-137.52000000007683
11797,2022-04-20 10:05:00,1727.01,246685.5599999999,245096.06999999998,1589.4899999999325
11798,2022-04-20 10:10:00,-1078.49,245607.06999999992,245096.06999999998,510.9999999999418
11799,2022-04-20 10:15:00,1179.74,246786.8099999999,245096.06999999998,1690.7399999999325
11800,2022-04-20 10:20:00,-589.78,246197.0299999999,245096.06999999998,1100.9599999999336
11801,2022-04-20 10:25:00,1681.65,247878.6799999999,245096.06999999998,2782.609999999928
11802,2022-04-20 10:30:00,-1968.79,245909.8899999999,245096.06999999998,813.8199999999197
11803,2022-04-20 10:35:00,-659.62,245250.2699999999,245096.06999999998,154.19999999992433
11804,2022-04-20 10:40:00,1134.7,246384.9699999999,245096.06999999998,1288.899999999936
11805,2022-04-20 10:45:00,-1293.83,245091.13999999993,245096.06999999998,-4.930000000051223
11806,2022-04-20 10:50:00,-1442.43,243648.70999999993,245096.06999999998,-1447.3600000000442
11807,2022-04-20 10:55:00,-913.05,242735.65999999995,245096.06999999998,-2360.4100000000326
11808,2022-04-20 11:00:00,1833.09,244568.74999999994,245096.06999999998,-527.3200000000361
11809,2022-04-20 11:05:00,783.33,245352.07999999993,245096.06999999998,256.0099999999511
11810,2022-04-20 11:10:00,987.47,246339.54999999993,245096.06999999998,1243.4799999999523
11811,2022-04-20 11:15:00,1243.04,247582.58999999994,245096.06999999998,2486.5199999999604
11812,2022-04-20 11:20:00,-1927.01,245655.57999999993,245096.06999999998,559.5099999999511
11813,2022-04-20 11:25:00,1875.38,247530.95999999993,245096.06999999998,2434.8899999999558
11814,2022-04-20 11:30:00,868.19,248399.14999999994,245096.06999999998,3303.079999999958
11815,2022-04-20 11:35:00,100.74,248499.88999999993,245096.06999999998,3403.819999999949
11816,2022-04-20 11:40:00,-1527.47,246972.41999999993,245096.06999999998,1876.3499999999476
11817,2022-04-20 11:45:00,1733.46,248705.87999999992,245096.06999999998,3609.8099999999395
11818,2022-04-20 11:50:00,-1897.68,246808.19999999992,245096.06999999998,1712.1299999999464
11819,2022-04-20 11:55:00,1212.87,248021.06999999992,245096.06999999998,2924.999999999942
11820,2022-04-20 12:00:00,1799.2,249820.26999999993,245096.06999999998,4724.199999999953
11821,2022-04-20 12:05:00,-1894.47,247925.79999999993,245096.06999999998,2829.7299999999523
11822,2022-04-20 12:10:00,-1062.37,246863.42999999993,245096.06999999998,1767.359999999957
11823,2022-04-20 12:15:00,1666.73,248530.15999999995,245096.06999999998,3434.0899999999674
11824,2022-04-20 12:20:00,-1389.87,247140.28999999995,245096.06999999998,2044.219999999972
11825,2022-04-20 12:25:00,779.72,247920.00999999995,245096.06999999998,2823.939999999973
11826,2022-04-20 12:30:00,1694.8,249614.80999999994,245096.06999999998,4518.739999999962
11827,2022-04-20 12:35:00,-84.37,249530.43999999994,245096.06999999998,4434.369999999966
11828,2022-04-20 12:40:00,-957.51,248572.92999999993,245096.06999999998,3476.859999999957
11829,2022-04-20 12:45:00,-95.86,248477.06999999995,245096.06999999998,3380.999999999971
11830,2022-04-20 12:50:00,772.17,249249.23999999996,245096.06999999998,4153.169999999984
11831,2022-04-20 12:55:00,898.84,250148.07999999996,245096.06999999998,5052.00999999998
11832,2022-04-20 13:00:00,-1437.95,248710.12999999995,245096.06999999998,3614.0599999999686
11833,2022-04-20 13:05:00,-852.61,247857.51999999996,245096.06999999998,2761.4499999999825
11834,2022-04-20 13:10:00,1789.58,249647.09999999995,245096.06999999998,4551.02999999997
11835,2022-04-20 13:15:00,-1377.55,248269.54999999996,245096.06999999998,3173.4799999999814
11836,2022-04-20 13:20:00,1456.62,249726.16999999995,245096.06999999998,4630.099999999977
11837,2022-04-20 13:25:00,216.51,249942.67999999996,245096.06999999998,4846.609999999986
11838,2022-04-20 13:30:00,1076.7,251019.37999999998,245096.06999999998,5923.309999999998
11839,2022-04-20 13:35:00,-833.1,250186.27999999997,245096.06999999998,5090.209999999992
11840,2022-04-20 13:40:00,1082.19,251268.46999999997,245096.06999999998,6172.399999999994
11841,2022-04-20 13:45:00,-1184.68,250083.78999999998,245096.06999999998,4987.720000000001
11842,2022-04-20 13:50:00,-1001.99,249081.8,245096.06999999998,3985.7300000000105
11843,2022-04-20 13:55:00,-1116.56,247965.24,245096.06999999998,2869.170000000013
11844,2022-04-20 14:00:00,600.17,248565.41,245096.06999999998,3469.3400000000256
11845,2022-04-20 14:05:00,882.35,249447.76,245096.06999999998,4351.690000000031
11846,2022-04-20 14:10:00,-1771.68,247676.08000000002,245096.06999999998,2580.0100000000384
11847,2022-04-20 14:15:00,109.08,247785.16,245096.06999999998,2689.0900000000256
11848,2022-04-20 14:20:00,369.8,248154.96,245096.06999999998,3058.890000000014
11849,2022-04-20 14:25:00,-84.76,248070.19999999998,245096.06999999998,2974.1300000000047
11850,2022-04-20 14:30:00,795.04,248865.24,245096.06999999998,3769.170000000013
11851,2022-04-20 14:35:00,1438.63,250303.87,245096.06999999998,5207.8000000000175
11852,2022-04-20 14:40:00,947.68,251251.55,245096.06999999998,6155.4800000000105
11853,2022-04-20 14:45:00,-217.97,251033.58,245096.06999999998,5937.510000000009
11854,2022-04-20 14:50:00,-142.55,250891.03,245096.06999999998,5794.960000000021
11855,2022-04-20 14:55:00,-24.75,250866.28,245096.06999999998,5770.210000000021
11856,2022-04-20 15:00:00,985.64,251851.92,245096.06999999998,6755.850000000035
11857,2022-04-20 15:05:00,-1727.02,250124.90000000002,245096.06999999998,5028.830000000045
11858,2022-04-20 15:10:00,846.12,250971.02000000002,245096.06999999998,5874.950000000041
11859,2022-04-20 15:15:00,1265.43,252236.45,245096.06999999998,7140.380000000034
11860,2022-04-20 15:20:00,506.86,252743.31,245096.06999999998,7647.24000000002
11861,2022-04-20 15:25:00,931.64,253674.95,245096.06999999998,8578.880000000034
11862,2022-04-20 15:30:00,-1339.97,252334.98,245096.06999999998,7238.910000000033
11863,2022-04-20 15:35:00,-1701.52,250633.46000000002,245096.06999999998,5537.390000000043
11864,2022-04-20 15:40:00,-276.55,250356.91000000003,245096.06999999998,5260.840000000055
11865,2022-04-20 15:45:00,-1981.31,248375.60000000003,245096.06999999998,3279.530000000057
11866,2022-04-20 15:50:00,-1908.14,246467.46000000002,245096.06999999998,1371.390000000043
11867,2022-04-20 15:55:00,539.71,247007.17,245096.06999999998,1911.100000000035
11868,2022-04-20 16:00:00,-1162.48,245844.69,245096.06999999998,748.6200000000244
11869,2022-04-20 16:05:00,-1656.88,244187.81,245096.06999999998,-908.2599999999802
11870,2022-04-20 16:10:00,-1722.27,242465.54,245096.06999999998,-2630.5299999999697
11871,2022-04-20 16:15:00,601.28,243066.82,245096.06999999998,-2029.249999999971
11872,2022-04-20 16:20:00,475.12,243541.94,245096.06999999998,-1554.1299999999756
11873,2022-04-20 16:25:00,-1214.42,242327.52,245096.06999999998,-2768.5499999999884
11874,2022-04-20 16:30:00,930.18,243257.69999999998,245096.06999999998,-1838.3699999999953
11875,2022-04-20 16:35:00,91.44,243349.13999999998,245096.06999999998,-1746.929999999993
11876,2022-04-20 16:40:00,733.83,244082.96999999997,245096.06999999998,-1013.1000000000058
11877,2022-04-20 16:45:00,-1091.91,242991.05999999997,245096.06999999998,-2105.0100000000093
11878,2022-04-20 16:50:00,1182.88,244173.93999999997,245096.06999999998,-922.1300000000047
11879,2022-04-20 16:55:00,-1152.85,243021.08999999997,245096.06999999998,-2074.9800000000105
11880,2022-04-21 08:00:00,984.81,244005.89999999997,243021.08999999997,984.8099999999977
11881,2022-04-21 08:05:00,778.51,244784.40999999997,243021.08999999997,1763.320000000007
11882,2022-04-21 08:10:00,619.87,245404.27999999997,243021.08999999997,2383.1900000000023
11883,2022-04-21 08:15:00,447.61,245851.88999999996,243021.08999999997,2830.7999999999884
11884,2022-04-21 08:20:00,1749.56,247601.44999999995,243021.08999999997,4580.359999999986
11885,2022-04-21 08:25:00,332.81,247934.25999999995,243021.08999999997,4913.169999999984
11886,2022-04-21 08:30:00,1233.75,249168.00999999995,243021.08999999997,6146.919999999984
11887,2022-04-21 08:35:00,-1889.57,247278.43999999994,243021.08999999997,4257.349999999977
11888,2022-04-21 08:40:00,1934.98,249213.41999999995,243021.08999999997,6192.329999999987
11889,2022-04-21 08:45:00,-1764.46,247448.95999999996,243021.08999999997,4427.869999999995
11890,2022-04-21 08:50:00,-1446.99,246001.96999999997,243021.08999999997,2980.8800000000047
11891,2022-04-21 08:55:00,725.61,246727.57999999996,243021.08999999997,3706.4899999999907
11892,2022-04-21 09:00:00,1771.5,248499.07999999996,243021.08999999997,5477.989999999991
11893,2022-04-21 09:05:00,-58.77,248440.30999999997,243021.08999999997,5419.220000000001
11894,2022-04-21 09:10:00,-1551.9,246888.40999999997,243021.08999999997,3867.320000000007
11895,2022-04-21 09:15:00,-1393.13,245495.27999999997,243021.08999999997,2474.1900000000023
11896,2022-04-21 09:20:00,-666.82,244828.45999999996,243021.08999999997,1807.3699999999953
11897,2022-04-21 09:25:00,-1357.09,243471.36999999997,243021.08999999997,450.27999999999884
11898,2022-04-21 09:30:00,-1114.39,242356.97999999995,243021.08999999997,-664.1100000000151
11899,2022-04-21 09:35:00,232.24,242589.21999999994,243021.08999999997,-431.87000000002445
11900,2022-04-21 09:40:00,-719.39,241869.82999999993,243021.08999999997,-1151.2600000000384
11901,2022-04-21 09:45:00,-1137.68,240732.14999999994,243021.08999999997,-2288.9400000000314
11902,2022-04-21 09:50:00,1800.66,242532.80999999994,243021.08999999997,-488.28000000002794
11903,2022-04-21 09:55:00,651.2,243184.00999999995,243021.08999999997,162.9199999999837
11904,2022-04-21 10:00:00,1679.75,244863.75999999995,243021.08999999997,1842.6699999999837
11905,2022-04-21 10:05:00,858.22,245721.97999999995,243021.08999999997,2700.889999999985
11906,2022-04-21 10:10:00,-504.62,245217.35999999996,243021.08999999997,2196.2699999999895
11907,2022-04-21 10:15:00,-17.41,245199.94999999995,243021.08999999997,2178.859999999986
11908,2022-04-21 10:20:00,1064.06,246264.00999999995,243021.08999999997,3242.9199999999837
11909,2022-04-21 10:25:00,325.47,246589.47999999995,243021.08999999997,3568.389999999985
11910,2022-04-21 10:30:00,1215.65,247805.12999999995,243021.08999999997,4784.039999999979
11911,2022-04-21 10:35:00,1827.23,249632.35999999996,243021.08999999997,6611.2699999999895
11912,2022-04-21 10:40:00,-353.4,249278.95999999996,243021.08999999997,6257.869999999995
11913,2022-04-21 10:45:00,485.13,249764.08999999997,243021.08999999997,6743.0
11914,2022-04-21 10:50:00,570.83,250334.91999999995,243021.08999999997,7313.829999999987
11915,2022-04-21 10:55:00,-597.2,249737.71999999994,243021.08999999997,6716.629999999976
11916,2022-04-21 11:00:00,1392.89,251130.60999999996,243021.08999999997,8109.5199999999895
11917,2022-04-21 11:05:00,1700.22,252830.82999999996,243021.08999999997,9809.73999999999
11918,2022-04-21 11:10:00,458.47,253289.29999999996,243021.08999999997,10268.209999999992
11919,2022-04-21 11:15:00,-576.01,252713.28999999995,243021.08999999997,9692.199999999983
11920,2022-04-21 11:20:00,1417.91,254131.19999999995,243021.08999999997,11110.109999999986
11921,2022-04-21 11:25:00,147.33,254278.52999999994,243021.08999999997,11257.439999999973
11922,2022-04-21 11:30:00,-540.43,253738.09999999995,243021.08999999997,10717.00999999998
11923,2022-04-21 11:35:00,-208.46,253529.63999999996,243021.08999999997,10508.549999999988
11924,2022-04-21 11:40:00,735.98,254265.61999999997,243021.08999999997,11244.529999999999
11925,2022-04-21 11:45:00,-587.81,253677.80999999997,243021.08999999997,10656.720000000001
11926,2022-04-21 11:50:00,1733.29,255411.09999999998,243021.08999999997,12390.01000000001
11927,2022-04-21 11:55:00,936.26,256347.36,243021.08999999997,13326.270000000019
11928,2022-04-21 12:00:00,-8.37,256338.99,243021.08999999997,13317.900000000023
11929,2022-04-21 12:05:00,-325.98,256013.00999999998,243021.08999999997,12991.920000000013
11930,2022-04-21 12:10:00,-1927.97,254085.03999999998,243021.08999999997,11063.950000000012
11931,2022-04-21 12:15:00,1767.52,255852.55999999997,243021.08999999997,12831.470000000001
11932,2022-04-21 12:20:00,656.81,256509.36999999997,243021.08999999997,13488.279999999999
11933,2022-04-21 12:25:00,-299.34,256210.02999999997,243021.08999999997,13188.940000000002
11934,2022-04-21 12:30:00,567.32,256777.34999999998,243021.08999999997,13756.26000000001
11935,2022-04-21 12:35:00,1416.21,258193.55999999997,243021.08999999997,15172.470000000001
11936,2022-04-21 12:40:00,-1122.18,257071.37999999998,243021.08999999997,14050.290000000008
11937,2022-04-21 12:45:00,-264.1,256807.27999999997,243021.08999999997,13786.190000000002
11938,2022-04-21 12:50:00,1977.2,258784.47999999998,243021.08999999997,15763.390000000014
11939,2022-04-21 12:55:00,-811.15,257973.33,243021.08999999997,14952.24000000002
11940,2022-04-21 13:00:00,883.03,258856.36,243021.08999999997,15835.270000000019
11941,2022-04-21 13:05:00,746.1,259602.46,243021.08999999997,16581.370000000024
11942,2022-04-21 13:10:00,1449.04,261051.5,243021.08999999997,18030.410000000033
11943,2022-04-21 13:15:00,1764.89,262816.39,243021.08999999997,19795.300000000047
11944,2022-04-21 13:20:00,857.78,263674.17000000004,243021.08999999997,20653.080000000075
11945,2022-04-21 13:25:00,-1569.31,262104.86000000004,243021.08999999997,19083.770000000077
11946,2022-04-21 13:30:00,1162.02,263266.88000000006,243021.08999999997,20245.790000000095
11947,2022-04-21 13:35:00,-722.53,262544.35000000003,243021.08999999997,19523.260000000068
11948,2022-04-21 13:40:00,-1181.36,261362.99000000005,243021.08999999997,18341.90000000008
11949,2022-04-21 13:45:00,-664.61,260698.38000000006,243021.08999999997,17677.290000000095
11950,2022-04-21 13:50:00,1994.34,262692.7200000001,243021.08999999997,19671.63000000012
11951,2022-04-21 13:55:00,1682.95,264375.6700000001,243021.08999999997,21354.580000000133
11952,2022-04-21 14:00:00,-1610.99,262764.6800000001,243021.08999999997,19743.590000000142
11953,2022-04-21 14:05:00,1801.44,264566.1200000001,243021.08999999997,21545.030000000144
11954,2022-04-21 14:10:00,-392.29,264173.83000000013,243021.08999999997,21152.740000000165
11955,2022-04-21 14:15:00,112.22,264286.0500000001,243021.08999999997,21264.960000000137
11956,2022-04-21 14:20:00,-102.59,264183.4600000001,243021.08999999997,21162.37000000011
11957,2022-04-21 14:25:00,-144.06,264039.4000000001,243021.08999999997,21018.310000000114
11958,2022-04-21 14:30:00,1205.0,265244.4000000001,243021.08999999997,22223.310000000114
11959,2022-04-21 14:35:00,-1587.58,263656.82000000007,243021.08999999997,20635.730000000098
11960,2022-04-21 14:40:00,-1354.34,262302.48000000004,243021.08999999997,19281.390000000072
11961,2022-04-21 14:45:00,1926.88,264229.36000000004,243021.08999999997,21208.270000000077
11962,2022-04-21 14:50:00,908.53,265137.8900000001,243021.08999999997,22116.800000000105
11963,2022-04-21 14:55:00,-165.19,264972.70000000007,243021.08999999997,21951.610000000102
11964,2022-04-21 15:00:00,1190.18,266162.88000000006,243021.08999999997,23141.790000000095
11965,2022-04-21 15:05:00,1286.19,267449.07000000007,243021.08999999997,24427.980000000098
11966,2022-04-21 15:10:00,-1737.63,265711.44000000006,243021.08999999997,22690.350000000093
11967,2022-04-21 15:15:00,1104.69,266816.13000000006,243021.08999999997,23795.040000000095
11968,2022-04-21 15:20:00,-1029.57,265786.56000000006,243021.08999999997,22765.47000000009
11969,2022-04-21 15:25:00,-1347.76,264438.80000000005,243021.08999999997,21417.71000000008
11970,2022-04-21 15:30:00,275.67,264714.47000000003,243021.08999999997,21693.380000000063
11971,2022-04-21 15:35:00,1054.28,265768.75000000006,243021.08999999997,22747.66000000009
11972,2022-04-21 15:40:00,-788.07,264980.68000000005,243021.08999999997,21959.590000000084
11973,2022-04-21 15:45:00,150.9,265131.5800000001,243021.08999999997,22110.490000000107
11974,2022-04-21 15:50:00,-626.07,264505.51000000007,243021.08999999997,21484.4200000001
11975,2022-04-21 15:55:00,-443.35,264062.1600000001,243021.08999999997,21041.070000000123
11976,2022-04-21 16:00:00,1713.35,265775.51000000007,243021.08999999997,22754.4200000001
11977,2022-04-21 16:05:00,800.54,266576.05000000005,243021.08999999997,23554.96000000008
11978,2022-04-21 16:10:00,1226.53,267802.5800000001,243021.08999999997,24781.490000000107
11979,2022-04-21 16:15:00,1286.43,269089.01000000007,243021.08999999997,26067.9200000001
11980,2022-04-21 16:20:00,86.79,269175.80000000005,243021.08999999997,26154.71000000008
11981,2022-04-21 16:25:00,1957.9,271133.70000000007,243021.08999999997,28112.610000000102
11982,2022-04-21 16:30:00,-701.78,270431.92000000004,243021.08999999997,27410.830000000075
11983,2022-04-21 16:35:00,-640.05,269791.87000000005,243021.08999999997,26770.780000000086
11984,2022-04-21 16:40:00,-573.41,269218.4600000001,243021.08999999997,26197.37000000011
11985,2022-04-21 16:45:00,-109.95,269108.51000000007,243021.08999999997,26087.4200000001
11986,2022-04-21 16:50:00,-1939.81,267168.70000000007,243021.08999999997,24147.610000000102
11987,2022-04-21 16:55:00,-1277.35,265891.3500000001,243021.08999999997,22870.260000000126
11988,2022-04-22 08:00:00,17.79,265909.1400000001,265891.3500000001,17.789999999979045
11989,2022-04-22 08:05:00,-1780.08,264129.06000000006,265891.3500000001,-1762.2900000000373
11990,2022-04-22 08:10:00,-1136.76,262992.30000000005,265891.3500000001,-2899.0500000000466
11991,2022-04-22 08:15:00,1406.68,264398.98000000004,265891.3500000001,-1492.3700000000536
11992,2022-04-22 08:20:00,931.31,265330.29000000004,265891.3500000001,-561.0600000000559
11993,2022-04-22 08:25:00,-1292.86,264037.43000000005,265891.3500000001,-1853.920000000042
11994,2022-04-22 08:30:00,-840.82,263196.61000000004,265891.3500000001,-2694.740000000049
11995,2022-04-22 08:35:00,-767.29,262429.32000000007,265891.3500000001,-3462.030000000028
11996,2022-04-22 08:40:00,237.26,262666.5800000001,265891.3500000001,-3224.7700000000186
11997,2022-04-22 08:45:00,1188.17,263854.75000000006,265891.3500000001,-2036.600000000035
11998,2022-04-22 08:50:00,1014.5,264869.25000000006,265891.3500000001,-1022.1000000000349
11999,2022-04-22 08:55:00,-927.35,263941.9000000001,265891.3500000001,-1949.4500000000116
12000,2022-04-22 09:00:00,-1125.18,262816.7200000001,265891.3500000001,-3074.6300000000047
12001,2022-04-22 09:05:00,1536.4,264353.1200000001,265891.3500000001,-1538.2299999999814
12002,2022-04-22 09:10:00,624.91,264978.0300000001,265891.3500000001,-913.320000000007
12003,2022-04-22 09:15:00,1810.77,266788.8000000001,265891.3500000001,897.4500000000116
12004,2022-04-22 09:20:00,1003.12,267791.9200000001,265891.3500000001,1900.570000000007
12005,2022-04-22 09:25:00,179.17,267971.0900000001,265891.3500000001,2079.7399999999907
12006,2022-04-22 09:30:00,-1444.15,266526.94000000006,265891.3500000001,635.5899999999674
12007,2022-04-22 09:35:00,48.98,266575.92000000004,265891.3500000001,684.5699999999488
12008,2022-04-22 09:40:00,887.46,267463.38000000006,265891.3500000001,1572.0299999999697
12009,2022-04-22 09:45:00,-84.65,267378.73000000004,265891.3500000001,1487.3799999999464
12010,2022-04-22 09:50:00,906.37,268285.10000000003,265891.3500000001,2393.749999999942
12011,2022-04-22 09:55:00,-1254.35,267030.75000000006,265891.3500000001,1139.399999999965
12012,2022-04-22 10:00:00,1497.34,268528.0900000001,265891.3500000001,2636.7399999999907
12013,2022-04-22 10:05:00,-770.66,267757.4300000001,265891.3500000001,1866.0800000000163
12014,2022-04-22 10:10:00,1755.16,269512.5900000001,265891.3500000001,3621.2399999999907
12015,2022-04-22 10:15:00,1343.29,270855.88000000006,265891.3500000001,4964.52999999997
12016,2022-04-22 10:20:00,40.2,270896.0800000001,265891.3500000001,5004.729999999981
12017,2022-04-22 10:25:00,1359.47,272255.55000000005,265891.3500000001,6364.199999999953
12018,2022-04-22 10:30:00,-57.19,272198.36000000004,265891.3500000001,6307.009999999951
12019,2022-04-22 10:35:00,-1712.98,270485.38000000006,265891.3500000001,4594.02999999997
12020,2022-04-22 10:40:00,366.91,270852.29000000004,265891.3500000001,4960.939999999944
12021,2022-04-22 10:45:00,1659.69,272511.98000000004,265891.3500000001,6620.629999999946
12022,2022-04-22 10:50:00,1063.33,273575.31000000006,265891.3500000001,7683.959999999963
12023,2022-04-22 10:55:00,1086.52,274661.8300000001,265891.3500000001,8770.479999999981
12024,2022-04-22 11:00:00,1069.09,275730.9200000001,265891.3500000001,9839.570000000007
12025,2022-04-22 11:05:00,-1801.86,273929.0600000001,265891.3500000001,8037.710000000021
12026,2022-04-22 11:10:00,-884.4,273044.6600000001,265891.3500000001,7153.309999999998
12027,2022-04-22 11:15:00,-1121.42,271923.2400000001,265891.3500000001,6031.890000000014
12028,2022-04-22 11:20:00,766.8,272690.0400000001,265891.3500000001,6798.690000000002
12029,2022-04-22 11:25:00,-68.7,272621.3400000001,265891.3500000001,6729.989999999991
12030,2022-04-22 11:30:00,-1447.11,271174.2300000001,265891.3500000001,5282.880000000005
12031,2022-04-22 11:35:00,963.06,272137.2900000001,265891.3500000001,6245.940000000002
12032,2022-04-22 11:40:00,-1081.25,271056.0400000001,265891.3500000001,5164.690000000002
12033,2022-04-22 11:45:00,1809.84,272865.8800000001,265891.3500000001,6974.530000000028
12034,2022-04-22 11:50:00,285.84,273151.72000000015,265891.3500000001,7260.370000000054
12035,2022-04-22 11:55:00,652.18,273803.90000000014,265891.3500000001,7912.550000000047
12036,2022-04-22 12:00:00,-1916.64,271887.2600000001,265891.3500000001,5995.910000000033
12037,2022-04-22 12:05:00,-1169.17,270718.09000000014,265891.3500000001,4826.740000000049
12038,2022-04-22 12:10:00,130.14,270848.23000000016,265891.3500000001,4956.880000000063
12039,2022-04-22 12:15:00,930.77,271779.0000000002,265891.3500000001,5887.6500000000815
12040,2022-04-22 12:20:00,1900.39,273679.3900000002,265891.3500000001,7788.0400000000955
12041,2022-04-22 12:25:00,410.6,274089.99000000017,265891.3500000001,8198.640000000072
12042,2022-04-22 12:30:00,64.97,274154.96000000014,265891.3500000001,8263.610000000044
12043,2022-04-22 12:35:00,1054.66,275209.6200000001,265891.3500000001,9318.270000000019
12044,2022-04-22 12:40:00,-1536.67,273672.9500000001,265891.3500000001,7781.600000000035
12045,2022-04-22 12:45:00,-531.52,273141.4300000001,265891.3500000001,7250.080000000016
12046,2022-04-22 12:50:00,-131.81,273009.6200000001,265891.3500000001,7118.270000000019
12047,2022-04-22 12:55:00,-1198.02,271811.6000000001,265891.3500000001,5920.25
12048,2022-04-22 13:00:00,1872.37,273683.9700000001,265891.3500000001,7792.619999999995
12049,2022-04-22 13:05:00,1214.89,274898.8600000001,265891.3500000001,9007.51000000001
12050,2022-04-22 13:10:00,1056.32,275955.1800000001,265891.3500000001,10063.830000000016
12051,2022-04-22 13:15:00,434.52,276389.7000000001,265891.3500000001,10498.350000000035
12052,2022-04-22 13:20:00,531.39,276921.09000000014,265891.3500000001,11029.740000000049
12053,2022-04-22 13:25:00,1447.25,278368.34000000014,265891.3500000001,12476.990000000049
12054,2022-04-22 13:30:00,704.8,279073.14000000013,265891.3500000001,13181.790000000037
12055,2022-04-22 13:35:00,1936.79,281009.9300000001,265891.3500000001,15118.580000000016
12056,2022-04-22 13:40:00,48.68,281058.6100000001,265891.3500000001,15167.26000000001
12057,2022-04-22 13:45:00,-972.3,280086.3100000001,265891.3500000001,14194.960000000021
12058,2022-04-22 13:50:00,-743.0,279343.3100000001,265891.3500000001,13451.960000000021
12059,2022-04-22 13:55:00,-1767.84,277575.4700000001,265891.3500000001,11684.119999999995
12060,2022-04-22 14:00:00,1270.94,278846.4100000001,265891.3500000001,12955.059999999998
12061,2022-04-22 14:05:00,-1275.84,277570.57000000007,265891.3500000001,11679.219999999972
12062,2022-04-22 14:10:00,-790.02,276780.55000000005,265891.3500000001,10889.199999999953
12063,2022-04-22 14:15:00,-1975.6,274804.95000000007,265891.3500000001,8913.599999999977
12064,2022-04-22 14:20:00,-1951.96,272852.99000000005,265891.3500000001,6961.639999999956
12065,2022-04-22 14:25:00,-1952.93,270900.06000000006,265891.3500000001,5008.709999999963
12066,2022-04-22 14:30:00,-1942.52,268957.54000000004,265891.3500000001,3066.189999999944
12067,2022-04-22 14:35:00,1463.38,270420.92000000004,265891.3500000001,4529.569999999949
12068,2022-04-22 14:40:00,-902.44,269518.48000000004,265891.3500000001,3627.1299999999464
12069,2022-04-22 14:45:00,851.57,270370.05000000005,265891.3500000001,4478.699999999953
12070,2022-04-22 14:50:00,156.64,270526.69000000006,265891.3500000001,4635.339999999967
12071,2022-04-22 14:55:00,157.51,270684.20000000007,265891.3500000001,4792.849999999977
12072,2022-04-22 15:00:00,386.18,271070.38000000006,265891.3500000001,5179.02999999997
12073,2022-04-22 15:05:00,1169.22,272239.60000000003,265891.3500000001,6348.249999999942
12074,2022-04-22 15:10:00,1067.94,273307.54000000004,265891.3500000001,7416.189999999944
12075,2022-04-22 15:15:00,-843.22,272464.32000000007,265891.3500000001,6572.969999999972
12076,2022-04-22 15:20:00,-122.57,272341.75000000006,265891.3500000001,6450.399999999965
12077,2022-04-22 15:25:00,1138.92,273480.67000000004,265891.3500000001,7589.319999999949
12078,2022-04-22 15:30:00,-1290.85,272189.82000000007,265891.3500000001,6298.469999999972
12079,2022-04-22 15:35:00,-591.49,271598.3300000001,265891.3500000001,5706.979999999981
12080,2022-04-22 15:40:00,-1840.52,269757.81000000006,265891.3500000001,3866.4599999999627
12081,2022-04-22 15:45:00,-1932.02,267825.79000000004,265891.3500000001,1934.4399999999441
12082,2022-04-22 15:50:00,-641.1,267184.69000000006,265891.3500000001,1293.3399999999674
12083,2022-04-22 15:55:00,-441.57,266743.12000000005,265891.3500000001,851.7699999999604
12084,2022-04-22 16:00:00,1755.88,268499.00000000006,265891.3500000001,2607.649999999965
12085,2022-04-22 16:05:00,-1481.79,267017.2100000001,265891.3500000001,1125.859999999986
12086,2022-04-22 16:10:00,-704.88,266312.3300000001,265891.3500000001,420.9799999999814
12087,2022-04-22 16:15:00,-672.93,265639.4000000001,265891.3500000001,-251.95000000001164
12088,2022-04-22 16:20:00,1159.58,266798.9800000001,265891.3500000001,907.6300000000047
12089,2022-04-22 16:25:00,-513.69,266285.2900000001,265891.3500000001,393.9400000000023
12090,2022-04-22 16:30:00,-1163.87,265121.4200000001,265891.3500000001,-769.929999999993
12091,2022-04-22 16:35:00,1007.07,266128.4900000001,265891.3500000001,237.14000000001397
12092,2022-04-22 16:40:00,-1385.73,264742.7600000001,265891.3500000001,-1148.5899999999674
12093,2022-04-22 16:45:00,-1219.85,263522.91000000015,265891.3500000001,-2368.439999999944
12094,2022-04-22 16:50:00,505.73,264028.64000000013,265891.3500000001,-1862.7099999999627
12095,2022-04-22 16:55:00,863.76,264892.40000000014,265891.3500000001,-998.9499999999534
12096,2022-04-23 08:00:00,1163.14,266055.54000000015,264892.40000000014,1163.140000000014
12097,2022-04-23 08:05:00,-1199.26,264856.28000000014,264892.40000000014,-36.11999999999534
12098,2022-04-23 08:10:00,318.62,265174.90000000014,264892.40000000014,282.5
12099,2022-04-23 08:15:00,559.49,265734.39000000013,264892.40000000014,841.9899999999907
12100,2022-04-23 08:20:00,-1897.44,263836.9500000001,264892.40000000014,-1055.4500000000116
12101,2022-04-23 08:25:00,1323.09,265160.04000000015,264892.40000000014,267.64000000001397
12102,2022-04-23 08:30:00,210.97,265371.0100000001,264892.40000000014,478.60999999998603
12103,2022-04-23 08:35:00,-104.23,265266.78000000014,264892.40000000014,374.38000000000466
12104,2022-04-23 08:40:00,1261.94,266528.72000000015,264892.40000000014,1636.320000000007
12105,2022-04-23 08:45:00,1143.52,267672.24000000017,264892.40000000014,2779.8400000000256
12106,2022-04-23 08:50:00,1237.68,268909.92000000016,264892.40000000014,4017.5200000000186
12107,2022-04-23 08:55:00,1302.92,270212.84000000014,264892.40000000014,5320.440000000002
12108,2022-04-23 09:00:00,488.71,270701.55000000016,264892.40000000014,5809.150000000023
12109,2022-04-23 09:05:00,661.7,271363.2500000002,264892.40000000014,6470.850000000035
12110,2022-04-23 09:10:00,-157.52,271205.73000000016,264892.40000000014,6313.330000000016
12111,2022-04-23 09:15:00,-422.35,270783.3800000002,264892.40000000014,5890.98000000004
12112,2022-04-23 09:20:00,-1611.89,269171.49000000017,264892.40000000014,4279.090000000026
12113,2022-04-23 09:25:00,-616.74,268554.7500000002,264892.40000000014,3662.350000000035
12114,2022-04-23 09:30:00,-201.32,268353.43000000017,264892.40000000014,3461.030000000028
12115,2022-04-23 09:35:00,-361.52,267991.91000000015,264892.40000000014,3099.5100000000093
12116,2022-04-23 09:40:00,-565.58,267426.33000000013,264892.40000000014,2533.929999999993
12117,2022-04-23 09:45:00,1552.04,268978.3700000001,264892.40000000014,4085.969999999972
12118,2022-04-23 09:50:00,1999.26,270977.6300000001,264892.40000000014,6085.229999999981
12119,2022-04-23 09:55:00,555.33,271532.96000000014,264892.40000000014,6640.559999999998
12120,2022-04-23 10:00:00,-0.33,271532.6300000001,264892.40000000014,6640.229999999981
12121,2022-04-23 10:05:00,1787.25,273319.8800000001,264892.40000000014,8427.479999999981
12122,2022-04-23 10:10:00,1052.15,274372.03000000014,264892.40000000014,9479.630000000005
12123,2022-04-23 10:15:00,1855.47,276227.5000000001,264892.40000000014,11335.099999999977
12124,2022-04-23 10:20:00,47.6,276275.1000000001,264892.40000000014,11382.699999999953
12125,2022-04-23 10:25:00,-1839.06,274436.0400000001,264892.40000000014,9543.639999999956
12126,2022-04-23 10:30:00,282.25,274718.2900000001,264892.40000000014,9825.889999999956
12127,2022-04-23 10:35:00,-135.08,274583.2100000001,264892.40000000014,9690.80999999994
12128,2022-04-23 10:40:00,-277.96,274305.25000000006,264892.40000000014,9412.849999999919
12129,2022-04-23 10:45:00,690.05,274995.30000000005,264892.40000000014,10102.899999999907
12130,2022-04-23 10:50:00,1419.85,276415.15,264892.40000000014,11522.749999999884
12131,2022-04-23 10:55:00,-295.37,276119.78,264892.40000000014,11227.379999999888
12132,2022-04-23 11:00:00,68.59,276188.37000000005,264892.40000000014,11295.969999999914
12133,2022-04-23 11:05:00,1047.59,277235.9600000001,264892.40000000014,12343.55999999994
12134,2022-04-23 11:10:00,-335.35,276900.6100000001,264892.40000000014,12008.209999999963
12135,2022-04-23 11:15:00,1890.55,278791.1600000001,264892.40000000014,13898.759999999951
12136,2022-04-23 11:20:00,-166.85,278624.3100000001,264892.40000000014,13731.909999999974
12137,2022-04-23 11:25:00,1611.7,280236.0100000001,264892.40000000014,15343.609999999986
12138,2022-04-23 11:30:00,500.12,280736.1300000001,264892.40000000014,15843.729999999981
12139,2022-04-23 11:35:00,895.29,281631.4200000001,264892.40000000014,16739.01999999996
12140,2022-04-23 11:40:00,183.31,281814.7300000001,264892.40000000014,16922.329999999958
12141,2022-04-23 11:45:00,-40.39,281774.3400000001,264892.40000000014,16881.939999999944
12142,2022-04-23 11:50:00,1909.24,283683.5800000001,264892.40000000014,18791.179999999935
12143,2022-04-23 11:55:00,-1416.33,282267.25000000006,264892.40000000014,17374.84999999992
12144,2022-04-23 12:00:00,1980.92,284248.17000000004,264892.40000000014,19355.769999999902
12145,2022-04-23 12:05:00,854.11,285102.28,264892.40000000014,20209.87999999989
12146,2022-04-23 12:10:00,1595.27,286697.55000000005,264892.40000000014,21805.149999999907
12147,2022-04-23 12:15:00,-1914.04,284783.51000000007,264892.40000000014,19891.109999999928
12148,2022-04-23 12:20:00,76.74,284860.25000000006,264892.40000000014,19967.84999999992
12149,2022-04-23 12:25:00,-64.54,284795.7100000001,264892.40000000014,19903.30999999994
12150,2022-04-23 12:30:00,1179.54,285975.25000000006,264892.40000000014,21082.84999999992
12151,2022-04-23 12:35:00,1753.98,287729.23000000004,264892.40000000014,22836.8299999999
12152,2022-04-23 12:40:00,-225.93,287503.30000000005,264892.40000000014,22610.899999999907
12153,2022-04-23 12:45:00,-129.69,287373.61000000004,264892.40000000014,22481.209999999905
12154,2022-04-23 12:50:00,1421.55,288795.16000000003,264892.40000000014,23902.759999999893
12155,2022-04-23 12:55:00,819.57,289614.73000000004,264892.40000000014,24722.3299999999
12156,2022-04-23 13:00:00,-781.63,288833.10000000003,264892.40000000014,23940.699999999895
12157,2022-04-23 13:05:00,618.17,289451.27,264892.40000000014,24558.86999999988
12158,2022-04-23 13:10:00,-371.44,289079.83,264892.40000000014,24187.429999999877
12159,2022-04-23 13:15:00,-48.07,289031.76,264892.40000000014,24139.35999999987
12160,2022-04-23 13:20:00,-910.96,288120.8,264892.40000000014,23228.39999999985
12161,2022-04-23 13:25:00,-829.24,287291.56,264892.40000000014,22399.159999999858
12162,2022-04-23 13:30:00,-1476.11,285815.45,264892.40000000014,20923.049999999872
12163,2022-04-23 13:35:00,-408.43,285407.02,264892.40000000014,20514.61999999988
12164,2022-04-23 13:40:00,-1090.96,284316.06,264892.40000000014,19423.659999999858
12165,2022-04-23 13:45:00,324.7,284640.76,264892.40000000014,19748.35999999987
12166,2022-04-23 13:50:00,1613.06,286253.82,264892.40000000014,21361.419999999867
12167,2022-04-23 13:55:00,-256.77,285997.05,264892.40000000014,21104.64999999985
12168,2022-04-23 14:00:00,-1471.48,284525.57,264892.40000000014,19633.169999999867
12169,2022-04-23 14:05:00,178.91,284704.48,264892.40000000014,19812.07999999984
12170,2022-04-23 14:10:00,569.27,285273.75,264892.40000000014,20381.34999999986
12171,2022-04-23 14:15:00,639.45,285913.2,264892.40000000014,21020.799999999872
12172,2022-04-23 14:20:00,-24.7,285888.5,264892.40000000014,20996.09999999986
12173,2022-04-23 14:25:00,-9.42,285879.08,264892.40000000014,20986.679999999877
12174,2022-04-23 14:30:00,-391.26,285487.82,264892.40000000014,20595.419999999867
12175,2022-04-23 14:35:00,-1466.25,284021.57,264892.40000000014,19129.169999999867
12176,2022-04-23 14:40:00,-1752.66,282268.91000000003,264892.40000000014,17376.509999999893
12177,2022-04-23 14:45:00,-773.0,281495.91000000003,264892.40000000014,16603.509999999893
12178,2022-04-23 14:50:00,475.81,281971.72000000003,264892.40000000014,17079.31999999989
12179,2022-04-23 14:55:00,-1654.53,280317.19,264892.40000000014,15424.789999999863
12180,2022-04-23 15:00:00,-1074.61,279242.58,264892.40000000014,14350.179999999877
12181,2022-04-23 15:05:00,-1568.61,277673.97000000003,264892.40000000014,12781.56999999989
12182,2022-04-23 15:10:00,-1373.41,276300.56000000006,264892.40000000014,11408.159999999916
12183,2022-04-23 15:15:00,-1106.3,275194.26000000007,264892.40000000014,10301.859999999928
12184,2022-04-23 15:20:00,500.24,275694.50000000006,264892.40000000014,10802.099999999919
12185,2022-04-23 15:25:00,-303.4,275391.10000000003,264892.40000000014,10498.699999999895
12186,2022-04-23 15:30:00,1321.11,276712.21,264892.40000000014,11819.809999999881
12187,2022-04-23 15:35:00,-1448.49,275263.72000000003,264892.40000000014,10371.31999999989
12188,2022-04-23 15:40:00,1453.96,276717.68000000005,264892.40000000014,11825.279999999912
12189,2022-04-23 15:45:00,-1292.37,275425.31000000006,264892.40000000014,10532.909999999916
12190,2022-04-23 15:50:00,-1647.88,273777.43000000005,264892.40000000014,8885.029999999912
12191,2022-04-23 15:55:00,395.08,274172.51000000007,264892.40000000014,9280.109999999928
12192,2022-04-23 16:00:00,1533.71,275706.2200000001,264892.40000000014,10813.819999999949
12193,2022-04-23 16:05:00,-302.24,275403.9800000001,264892.40000000014,10511.579999999958
12194,2022-04-23 16:10:00,1760.44,277164.4200000001,264892.40000000014,12272.01999999996
12195,2022-04-23 16:15:00,-788.45,276375.9700000001,264892.40000000014,11483.569999999949
12196,2022-04-23 16:20:00,1579.09,277955.0600000001,264892.40000000014,13062.659999999974
12197,2022-04-23 16:25:00,-1249.56,276705.5000000001,264892.40000000014,11813.099999999977
12198,2022-04-23 16:30:00,-1857.69,274847.8100000001,264892.40000000014,9955.409999999974
12199,2022-04-23 16:35:00,1430.92,276278.7300000001,264892.40000000014,11386.329999999958
12200,2022-04-23 16:40:00,-788.28,275490.45000000007,264892.40000000014,10598.04999999993
12201,2022-04-23 16:45:00,-643.43,274847.0200000001,264892.40000000014,9954.619999999937
12202,2022-04-23 16:50:00,1613.74,276460.76000000007,264892.40000000014,11568.359999999928
12203,2022-04-23 16:55:00,211.82,276672.5800000001,264892.40000000014,11780.179999999935
12204,2022-04-24 08:00:00,1143.25,277815.8300000001,276672.5800000001,1143.25
12205,2022-04-24 08:05:00,-107.94,277707.8900000001,276672.5800000001,1035.3099999999977
12206,2022-04-24 08:10:00,-319.08,277388.81000000006,276672.5800000001,716.2299999999814
12207,2022-04-24 08:15:00,-377.75,277011.06000000006,276672.5800000001,338.4799999999814
12208,2022-04-24 08:20:00,1745.34,278756.4000000001,276672.5800000001,2083.820000000007
12209,2022-04-24 08:25:00,1935.08,280691.4800000001,276672.5800000001,4018.9000000000233
12210,2022-04-24 08:30:00,-102.53,280588.95000000007,276672.5800000001,3916.3699999999953
12211,2022-04-24 08:35:00,-1933.66,278655.2900000001,276672.5800000001,1982.710000000021
12212,2022-04-24 08:40:00,-1283.95,277371.3400000001,276672.5800000001,698.7600000000093
12213,2022-04-24 08:45:00,1621.57,278992.9100000001,276672.5800000001,2320.3300000000163
12214,2022-04-24 08:50:00,-1429.12,277563.7900000001,276672.5800000001,891.210000000021
12215,2022-04-24 08:55:00,-62.19,277501.6000000001,276672.5800000001,829.0200000000186
12216,2022-04-24 09:00:00,817.25,278318.8500000001,276672.5800000001,1646.2700000000186
12217,2022-04-24 09:05:00,-1941.43,276377.4200000001,276672.5800000001,-295.1599999999744
12218,2022-04-24 09:10:00,263.09,276640.5100000001,276672.5800000001,-32.06999999994878
12219,2022-04-24 09:15:00,1251.73,277892.2400000001,276672.5800000001,1219.6600000000326
12220,2022-04-24 09:20:00,837.83,278730.0700000001,276672.5800000001,2057.490000000049
12221,2022-04-24 09:25:00,687.2,279417.27000000014,276672.5800000001,2744.6900000000605
12222,2022-04-24 09:30:00,1753.82,281171.09000000014,276672.5800000001,4498.5100000000675
12223,2022-04-24 09:35:00,1624.02,282795.11000000016,276672.5800000001,6122.530000000086
12224,2022-04-24 09:40:00,-381.26,282413.85000000015,276672.5800000001,5741.270000000077
12225,2022-04-24 09:45:00,-1526.58,280887.27000000014,276672.5800000001,4214.6900000000605
12226,2022-04-24 09:50:00,1597.16,282484.4300000001,276672.5800000001,5811.850000000035
12227,2022-04-24 09:55:00,196.19,282680.6200000001,276672.5800000001,6008.040000000037
12228,2022-04-24 10:00:00,359.73,283040.3500000001,276672.5800000001,6367.770000000019
12229,2022-04-24 10:05:00,1054.72,284095.07000000007,276672.5800000001,7422.489999999991
12230,2022-04-24 10:10:00,1837.18,285932.25000000006,276672.5800000001,9259.669999999984
12231,2022-04-24 10:15:00,-1661.66,284270.5900000001,276672.5800000001,7598.010000000009
12232,2022-04-24 10:20:00,-880.73,283389.8600000001,276672.5800000001,6717.280000000028
12233,2022-04-24 10:25:00,325.26,283715.1200000001,276672.5800000001,7042.540000000037
12234,2022-04-24 10:30:00,-593.22,283121.90000000014,276672.5800000001,6449.320000000065
12235,2022-04-24 10:35:00,-382.99,282738.91000000015,276672.5800000001,6066.3300000000745
12236,2022-04-24 10:40:00,1998.76,284737.67000000016,276672.5800000001,8065.090000000084
12237,2022-04-24 10:45:00,924.43,285662.10000000015,276672.5800000001,8989.520000000077
12238,2022-04-24 10:50:00,-1352.31,284309.79000000015,276672.5800000001,7637.210000000079
12239,2022-04-24 10:55:00,1177.24,285487.03000000014,276672.5800000001,8814.45000000007
12240,2022-04-24 11:00:00,-1112.18,284374.85000000015,276672.5800000001,7702.270000000077
12241,2022-04-24 11:05:00,-1203.3,283171.55000000016,276672.5800000001,6498.9700000000885
12242,2022-04-24 11:10:00,780.2,283951.7500000002,276672.5800000001,7279.1700000001
12243,2022-04-24 11:15:00,1808.81,285760.5600000002,276672.5800000001,9087.980000000098
12244,2022-04-24 11:20:00,-1454.36,284306.2000000002,276672.5800000001,7633.620000000112
12245,2022-04-24 11:25:00,1143.21,285449.4100000002,276672.5800000001,8776.830000000133
12246,2022-04-24 11:30:00,172.19,285621.6000000002,276672.5800000001,8949.020000000135
12247,2022-04-24 11:35:00,-740.98,284880.6200000002,276672.5800000001,8208.040000000154
12248,2022-04-24 11:40:00,-506.29,284374.33000000025,276672.5800000001,7701.750000000175
12249,2022-04-24 11:45:00,479.67,284854.00000000023,276672.5800000001,8181.420000000158
12250,2022-04-24 11:50:00,510.14,285364.14000000025,276672.5800000001,8691.560000000172
12251,2022-04-24 11:55:00,1257.31,286621.45000000024,276672.5800000001,9948.87000000017
12252,2022-04-24 12:00:00,-54.65,286566.8000000002,276672.5800000001,9894.220000000147
12253,2022-04-24 12:05:00,302.38,286869.1800000002,276672.5800000001,10196.600000000151
12254,2022-04-24 12:10:00,1032.35,287901.5300000002,276672.5800000001,11228.950000000128
12255,2022-04-24 12:15:00,-861.48,287040.0500000002,276672.5800000001,10367.470000000147
12256,2022-04-24 12:20:00,-1475.84,285564.2100000002,276672.5800000001,8891.630000000121
12257,2022-04-24 12:25:00,860.25,286424.4600000002,276672.5800000001,9751.880000000121
12258,2022-04-24 12:30:00,-1796.97,284627.4900000002,276672.5800000001,7954.910000000149
12259,2022-04-24 12:35:00,-971.19,283656.3000000002,276672.5800000001,6983.720000000147
12260,2022-04-24 12:40:00,-145.72,283510.58000000025,276672.5800000001,6838.000000000175
12261,2022-04-24 12:45:00,-1868.39,281642.19000000024,276672.5800000001,4969.610000000161
12262,2022-04-24 12:50:00,-140.45,281501.7400000002,276672.5800000001,4829.160000000149
12263,2022-04-24 12:55:00,-1492.76,280008.9800000002,276672.5800000001,3336.4000000001397
12264,2022-04-24 13:00:00,17.27,280026.25000000023,276672.5800000001,3353.6700000001583
12265,2022-04-24 13:05:00,-1117.12,278909.13000000024,276672.5800000001,2236.550000000163
12266,2022-04-24 13:10:00,-1442.77,277466.3600000002,276672.5800000001,793.7800000001444
12267,2022-04-24 13:15:00,464.61,277930.9700000002,276672.5800000001,1258.3900000001304
12268,2022-04-24 13:20:00,817.41,278748.3800000002,276672.5800000001,2075.800000000105
12269,2022-04-24 13:25:00,200.93,278949.3100000002,276672.5800000001,2276.730000000098
12270,2022-04-24 13:30:00,-1193.59,277755.72000000015,276672.5800000001,1083.1400000000722
12271,2022-04-24 13:35:00,1970.49,279726.21000000014,276672.5800000001,3053.630000000063
12272,2022-04-24 13:40:00,95.51,279821.72000000015,276672.5800000001,3149.140000000072
12273,2022-04-24 13:45:00,1499.89,281321.61000000016,276672.5800000001,4649.030000000086
12274,2022-04-24 13:50:00,60.91,281382.52000000014,276672.5800000001,4709.9400000000605
12275,2022-04-24 13:55:00,-1804.29,279578.23000000016,276672.5800000001,2905.6500000000815
12276,2022-04-24 14:00:00,965.32,280543.55000000016,276672.5800000001,3870.9700000000885
12277,2022-04-24 14:05:00,-1339.98,279203.5700000002,276672.5800000001,2530.990000000107
12278,2022-04-24 14:10:00,-310.61,278892.9600000002,276672.5800000001,2220.380000000121
12279,2022-04-24 14:15:00,43.87,278936.8300000002,276672.5800000001,2264.2500000001164
12280,2022-04-24 14:20:00,-833.87,278102.9600000002,276672.5800000001,1430.380000000121
12281,2022-04-24 14:25:00,1697.23,279800.1900000002,276672.5800000001,3127.6100000001024
12282,2022-04-24 14:30:00,638.73,280438.92000000016,276672.5800000001,3766.340000000084
12283,2022-04-24 14:35:00,592.92,281031.84000000014,276672.5800000001,4359.2600000000675
12284,2022-04-24 14:40:00,1721.73,282753.5700000001,276672.5800000001,6080.990000000049
12285,2022-04-24 14:45:00,-89.91,282663.66000000015,276672.5800000001,5991.0800000000745
12286,2022-04-24 14:50:00,409.69,283073.35000000015,276672.5800000001,6400.770000000077
12287,2022-04-24 14:55:00,913.7,283987.05000000016,276672.5800000001,7314.4700000000885
12288,2022-04-24 15:00:00,642.54,284629.59000000014,276672.5800000001,7957.0100000000675
12289,2022-04-24 15:05:00,-1579.02,283050.5700000001,276672.5800000001,6377.990000000049
12290,2022-04-24 15:10:00,-312.49,282738.08000000013,276672.5800000001,6065.500000000058
12291,2022-04-24 15:15:00,-1879.2,280858.8800000001,276672.5800000001,4186.300000000047
12292,2022-04-24 15:20:00,-1605.56,279253.3200000001,276672.5800000001,2580.740000000049
12293,2022-04-24 15:25:00,1828.78,281082.10000000015,276672.5800000001,4409.520000000077
12294,2022-04-24 15:30:00,670.4,281752.5000000002,276672.5800000001,5079.9200000001
12295,2022-04-24 15:35:00,1230.67,282983.17000000016,276672.5800000001,6310.590000000084
12296,2022-04-24 15:40:00,-619.84,282363.33000000013,276672.5800000001,5690.750000000058
12297,2022-04-24 15:45:00,-754.43,281608.90000000014,276672.5800000001,4936.320000000065
12298,2022-04-24 15:50:00,1572.37,283181.27000000014,276672.5800000001,6508.6900000000605
12299,2022-04-24 15:55:00,-326.29,282854.98000000016,276672.5800000001,6182.4000000000815
12300,2022-04-24 16:00:00,1129.05,283984.03000000014,276672.5800000001,7311.45000000007
12301,2022-04-24 16:05:00,-1397.3,282586.73000000016,276672.5800000001,5914.1500000000815
12302,2022-04-24 16:10:00,1055.26,283641.99000000017,276672.5800000001,6969.410000000091
12303,2022-04-24 16:15:00,-1223.18,282418.8100000002,276672.5800000001,5746.230000000098
12304,2022-04-24 16:20:00,-15.05,282403.7600000002,276672.5800000001,5731.180000000109
12305,2022-04-24 16:25:00,-426.62,281977.1400000002,276672.5800000001,5304.560000000114
12306,2022-04-24 16:30:00,442.51,282419.6500000002,276672.5800000001,5747.070000000123
12307,2022-04-24 16:35:00,-673.94,281745.7100000002,276672.5800000001,5073.130000000121
12308,2022-04-24 16:40:00,900.59,282646.3000000002,276672.5800000001,5973.720000000147
12309,2022-04-24 16:45:00,18.34,282664.64000000025,276672.5800000001,5992.060000000172
12310,2022-04-24 16:50:00,1177.27,283841.91000000027,276672.5800000001,7169.330000000191
12311,2022-04-24 16:55:00,-1814.87,282027.04000000027,276672.5800000001,5354.460000000196
12312,2022-04-25 08:00:00,-1839.02,280188.02000000025,282027.04000000027,-1839.0200000000186
12313,2022-04-25 08:05:00,-1931.37,278256.65000000026,282027.04000000027,-3770.390000000014
12314,2022-04-25 08:10:00,-1335.2,276921.45000000024,282027.04000000027,-5105.590000000026
12315,2022-04-25 08:15:00,-182.05,276739.40000000026,282027.04000000027,-5287.640000000014
12316,2022-04-25 08:20:00,-203.97,276535.4300000003,282027.04000000027,-5491.609999999986
12317,2022-04-25 08:25:00,-527.44,276007.9900000003,282027.04000000027,-6019.049999999988
12318,2022-04-25 08:30:00,367.37,276375.3600000003,282027.04000000027,-5651.679999999993
12319,2022-04-25 08:35:00,-906.89,275468.47000000026,282027.04000000027,-6558.570000000007
12320,2022-04-25 08:40:00,728.77,276197.2400000003,282027.04000000027,-5829.799999999988
12321,2022-04-25 08:45:00,-299.13,275898.1100000003,282027.04000000027,-6128.929999999993
12322,2022-04-25 08:50:00,-188.64,275709.47000000026,282027.04000000027,-6317.570000000007
12323,2022-04-25 08:55:00,1833.84,277543.3100000003,282027.04000000027,-4483.729999999981
12324,2022-04-25 09:00:00,-40.35,277502.9600000003,282027.04000000027,-4524.079999999958
12325,2022-04-25 09:05:00,-764.94,276738.0200000003,282027.04000000027,-5289.01999999996
12326,2022-04-25 09:10:00,1908.59,278646.61000000034,282027.04000000027,-3380.429999999935
12327,2022-04-25 09:15:00,595.63,279242.24000000034,282027.04000000027,-2784.79999999993
12328,2022-04-25 09:20:00,-1745.46,277496.7800000003,282027.04000000027,-4530.259999999951
12329,2022-04-25 09:25:00,639.81,278136.5900000003,282027.04000000027,-3890.4499999999534
12330,2022-04-25 09:30:00,-1874.09,276262.5000000003,282027.04000000027,-5764.539999999979
12331,2022-04-25 09:35:00,-98.83,276163.6700000003,282027.04000000027,-5863.369999999995
12332,2022-04-25 09:40:00,-1194.36,274969.3100000003,282027.04000000027,-7057.729999999981
12333,2022-04-25 09:45:00,1643.11,276612.4200000003,282027.04000000027,-5414.619999999995
12334,2022-04-25 09:50:00,1179.68,277792.10000000027,282027.04000000027,-4234.940000000002
12335,2022-04-25 09:55:00,106.61,277898.71000000025,282027.04000000027,-4128.330000000016
12336,2022-04-25 10:00:00,-1240.0,276658.71000000025,282027.04000000027,-5368.330000000016
12337,2022-04-25 10:05:00,1956.13,278614.84000000026,282027.04000000027,-3412.2000000000116
12338,2022-04-25 10:10:00,121.11,278735.95000000024,282027.04000000027,-3291.0900000000256
12339,2022-04-25 10:15:00,-175.67,278560.28000000026,282027.04000000027,-3466.7600000000093
12340,2022-04-25 10:20:00,-708.64,277851.64000000025,282027.04000000027,-4175.400000000023
12341,2022-04-25 10:25:00,1586.74,279438.38000000024,282027.04000000027,-2588.6600000000326
12342,2022-04-25 10:30:00,225.79,279664.1700000002,282027.04000000027,-2362.8700000000536
12343,2022-04-25 10:35:00,580.18,280244.3500000002,282027.04000000027,-1782.6900000000605
12344,2022-04-25 10:40:00,-1996.69,278247.6600000002,282027.04000000027,-3779.380000000063
12345,2022-04-25 10:45:00,204.45,278452.1100000002,282027.04000000027,-3574.930000000051
12346,2022-04-25 10:50:00,-1428.45,277023.6600000002,282027.04000000027,-5003.380000000063
12347,2022-04-25 10:55:00,-463.65,276560.0100000002,282027.04000000027,-5467.030000000086
12348,2022-04-25 11:00:00,552.19,277112.2000000002,282027.04000000027,-4914.840000000084
12349,2022-04-25 11:05:00,1624.61,278736.8100000002,282027.04000000027,-3290.230000000098
12350,2022-04-25 11:10:00,1990.52,280727.3300000002,282027.04000000027,-1299.7100000000792
12351,2022-04-25 11:15:00,-25.4,280701.93000000017,282027.04000000027,-1325.1100000001024
12352,2022-04-25 11:20:00,186.2,280888.1300000002,282027.04000000027,-1138.9100000000908
12353,2022-04-25 11:25:00,-757.12,280131.0100000002,282027.04000000027,-1896.0300000000861
12354,2022-04-25 11:30:00,-1515.33,278615.68000000017,282027.04000000027,-3411.3600000001024
12355,2022-04-25 11:35:00,-615.37,278000.3100000002,282027.04000000027,-4026.730000000098
12356,2022-04-25 11:40:00,-66.3,277934.0100000002,282027.04000000027,-4093.030000000086
12357,2022-04-25 11:45:00,-181.24,277752.7700000002,282027.04000000027,-4274.270000000077
12358,2022-04-25 11:50:00,-1039.0,276713.7700000002,282027.04000000027,-5313.270000000077
12359,2022-04-25 11:55:00,190.39,276904.1600000002,282027.04000000027,-5122.880000000063
12360,2022-04-25 12:00:00,287.28,277191.44000000024,282027.04000000027,-4835.600000000035
12361,2022-04-25 12:05:00,1352.21,278543.65000000026,282027.04000000027,-3483.390000000014
12362,2022-04-25 12:10:00,-1620.83,276922.82000000024,282027.04000000027,-5104.22000000003
12363,2022-04-25 12:15:00,314.13,277236.95000000024,282027.04000000027,-4790.090000000026
12364,2022-04-25 12:20:00,1440.67,278677.6200000002,282027.04000000027,-3349.420000000042
12365,2022-04-25 12:25:00,-336.48,278341.14000000025,282027.04000000027,-3685.9000000000233
12366,2022-04-25 12:30:00,-1619.17,276721.97000000026,282027.04000000027,-5305.070000000007
12367,2022-04-25 12:35:00,13.53,276735.5000000003,282027.04000000027,-5291.539999999979
12368,2022-04-25 12:40:00,-1528.3,275207.2000000003,282027.04000000027,-6819.839999999967
12369,2022-04-25 12:45:00,-505.09,274702.1100000003,282027.04000000027,-7324.929999999993
12370,2022-04-25 12:50:00,1590.43,276292.54000000027,282027.04000000027,-5734.5
12371,2022-04-25 12:55:00,-660.97,275631.5700000003,282027.04000000027,-6395.469999999972
12372,2022-04-25 13:00:00,816.32,276447.8900000003,282027.04000000027,-5579.149999999965
12373,2022-04-25 13:05:00,-395.42,276052.4700000003,282027.04000000027,-5974.569999999949
12374,2022-04-25 13:10:00,637.6,276690.0700000003,282027.04000000027,-5336.969999999972
12375,2022-04-25 13:15:00,-629.07,276061.0000000003,282027.04000000027,-5966.039999999979
12376,2022-04-25 13:20:00,-903.36,275157.6400000003,282027.04000000027,-6869.399999999965
12377,2022-04-25 13:25:00,250.68,275408.3200000003,282027.04000000027,-6618.719999999972
12378,2022-04-25 13:30:00,152.78,275561.1000000003,282027.04000000027,-6465.939999999944
12379,2022-04-25 13:35:00,-982.93,274578.17000000033,282027.04000000027,-7448.869999999937
12380,2022-04-25 13:40:00,-585.12,273993.05000000034,282027.04000000027,-8033.9899999999325
12381,2022-04-25 13:45:00,-932.25,273060.80000000034,282027.04000000027,-8966.239999999932
12382,2022-04-25 13:50:00,1814.06,274874.86000000034,282027.04000000027,-7152.179999999935
12383,2022-04-25 13:55:00,-1959.7,272915.1600000003,282027.04000000027,-9111.879999999946
12384,2022-04-25 14:00:00,1916.68,274831.8400000003,282027.04000000027,-7195.199999999953
12385,2022-04-25 14:05:00,1747.67,276579.5100000003,282027.04000000027,-5447.52999999997
12386,2022-04-25 14:10:00,-965.66,275613.8500000003,282027.04000000027,-6413.189999999944
12387,2022-04-25 14:15:00,-1827.33,273786.5200000003,282027.04000000027,-8240.51999999996
12388,2022-04-25 14:20:00,256.07,274042.5900000003,282027.04000000027,-7984.449999999953
12389,2022-04-25 14:25:00,-1931.47,272111.12000000034,282027.04000000027,-9915.919999999925
12390,2022-04-25 14:30:00,905.27,273016.39000000036,282027.04000000027,-9010.649999999907
12391,2022-04-25 14:35:00,-1183.49,271832.9000000004,282027.04000000027,-10194.139999999898
12392,2022-04-25 14:40:00,1397.59,273230.4900000004,282027.04000000027,-8796.549999999872
12393,2022-04-25 14:45:00,-1531.82,271698.6700000004,282027.04000000027,-10328.369999999879
12394,2022-04-25 14:50:00,1389.24,273087.9100000004,282027.04000000027,-8939.129999999888
12395,2022-04-25 14:55:00,-385.6,272702.3100000004,282027.04000000027,-9324.729999999865
12396,2022-04-25 15:00:00,1840.66,274542.9700000004,282027.04000000027,-7484.069999999891
12397,2022-04-25 15:05:00,662.96,275205.9300000004,282027.04000000027,-6821.10999999987
12398,2022-04-25 15:10:00,-972.72,274233.2100000004,282027.04000000027,-7793.829999999842
12399,2022-04-25 15:15:00,1310.63,275543.84000000043,282027.04000000027,-6483.199999999837
12400,2022-04-25 15:20:00,200.1,275743.9400000004,282027.04000000027,-6283.09999999986
12401,2022-04-25 15:25:00,-217.81,275526.1300000004,282027.04000000027,-6500.909999999858
12402,2022-04-25 15:30:00,-444.07,275082.0600000004,282027.04000000027,-6944.979999999865
12403,2022-04-25 15:35:00,-393.82,274688.2400000004,282027.04000000027,-7338.799999999872
12404,2022-04-25 15:40:00,887.73,275575.9700000004,282027.04000000027,-6451.069999999891
12405,2022-04-25 15:45:00,877.01,276452.9800000004,282027.04000000027,-5574.059999999881
12406,2022-04-25 15:50:00,1655.59,278108.5700000004,282027.04000000027,-3918.4699999998556
12407,2022-04-25 15:55:00,1434.39,279542.9600000004,282027.04000000027,-2484.0799999998417
12408,2022-04-25 16:00:00,1291.32,280834.28000000044,282027.04000000027,-1192.7599999998347
12409,2022-04-25 16:05:00,1426.33,282260.61000000045,282027.04000000027,233.5700000001816
12410,2022-04-25 16:10:00,1181.29,283441.90000000043,282027.04000000027,1414.8600000001607
12411,2022-04-25 16:15:00,1771.72,285213.6200000004,282027.04000000027,3186.5800000001327
12412,2022-04-25 16:20:00,1314.79,286528.4100000004,282027.04000000027,4501.370000000112
12413,2022-04-25 16:25:00,266.44,286794.8500000004,282027.04000000027,4767.810000000114
12414,2022-04-25 16:30:00,-1355.4,285439.45000000036,282027.04000000027,3412.410000000091
12415,2022-04-25 16:35:00,339.04,285778.49000000034,282027.04000000027,3751.45000000007
12416,2022-04-25 16:40:00,-1935.17,283843.32000000036,282027.04000000027,1816.2800000000861
12417,2022-04-25 16:45:00,792.54,284635.86000000034,282027.04000000027,2608.820000000065
12418,2022-04-25 16:50:00,1951.01,286586.87000000034,282027.04000000027,4559.8300000000745
12419,2022-04-25 16:55:00,1505.15,288092.02000000037,282027.04000000027,6064.980000000098
12420,2022-04-26 08:00:00,-1729.33,286362.69000000035,288092.02000000037,-1729.3300000000163
12421,2022-04-26 08:05:00,-898.66,285464.0300000004,288092.02000000037,-2627.9899999999907
12422,2022-04-26 08:10:00,331.73,285795.76000000036,288092.02000000037,-2296.2600000000093
12423,2022-04-26 08:15:00,-44.91,285750.8500000004,288092.02000000037,-2341.1699999999837
12424,2022-04-26 08:20:00,1038.37,286789.2200000004,288092.02000000037,-1302.7999999999884
12425,2022-04-26 08:25:00,1343.36,288132.58000000037,288092.02000000037,40.55999999999767
12426,2022-04-26 08:30:00,326.75,288459.33000000037,288092.02000000037,367.3099999999977
12427,2022-04-26 08:35:00,408.73,288868.06000000035,288092.02000000037,776.039999999979
12428,2022-04-26 08:40:00,-886.28,287981.7800000003,288092.02000000037,-110.2400000000489
12429,2022-04-26 08:45:00,1943.41,289925.1900000003,288092.02000000037,1833.1699999999255
12430,2022-04-26 08:50:00,-588.6,289336.5900000003,288092.02000000037,1244.5699999999488
12431,2022-04-26 08:55:00,-1451.92,287884.67000000033,288092.02000000037,-207.35000000003492
12432,2022-04-26 09:00:00,-471.95,287412.7200000003,288092.02000000037,-679.3000000000466
12433,2022-04-26 09:05:00,-166.87,287245.8500000003,288092.02000000037,-846.1700000000419
12434,2022-04-26 09:10:00,533.94,287779.7900000003,288092.02000000037,-312.2300000000396
12435,2022-04-26 09:15:00,-1514.88,286264.9100000003,288092.02000000037,-1827.1100000000442
12436,2022-04-26 09:20:00,415.58,286680.49000000034,288092.02000000037,-1411.530000000028
12437,2022-04-26 09:25:00,-1415.85,285264.64000000036,288092.02000000037,-2827.3800000000047
12438,2022-04-26 09:30:00,-4.71,285259.93000000034,288092.02000000037,-2832.0900000000256
12439,2022-04-26 09:35:00,-283.44,284976.49000000034,288092.02000000037,-3115.530000000028
12440,2022-04-26 09:40:00,-1081.43,283895.06000000035,288092.02000000037,-4196.960000000021
12441,2022-04-26 09:45:00,-488.86,283406.20000000036,288092.02000000037,-4685.820000000007
12442,2022-04-26 09:50:00,1610.39,285016.5900000004,288092.02000000037,-3075.429999999993
12443,2022-04-26 09:55:00,-951.66,284064.9300000004,288092.02000000037,-4027.0899999999674
12444,2022-04-26 10:00:00,283.83,284348.7600000004,288092.02000000037,-3743.259999999951
12445,2022-04-26 10:05:00,614.02,284962.78000000044,288092.02000000037,-3129.2399999999325
12446,2022-04-26 10:10:00,-389.33,284573.4500000004,288092.02000000037,-3518.569999999949
12447,2022-04-26 10:15:00,-89.05,284484.40000000043,288092.02000000037,-3607.619999999937
12448,2022-04-26 10:20:00,-1439.74,283044.66000000044,288092.02000000037,-5047.359999999928
12449,2022-04-26 10:25:00,-1882.6,281162.06000000046,288092.02000000037,-6929.9599999999045
12450,2022-04-26 10:30:00,1093.57,282255.63000000047,288092.02000000037,-5836.389999999898
12451,2022-04-26 10:35:00,-293.17,281962.4600000005,288092.02000000037,-6129.559999999881
12452,2022-04-26 10:40:00,233.36,282195.8200000005,288092.02000000037,-5896.199999999895
12453,2022-04-26 10:45:00,-1830.16,280365.6600000005,288092.02000000037,-7726.35999999987
12454,2022-04-26 10:50:00,-397.69,279967.9700000005,288092.02000000037,-8124.049999999872
12455,2022-04-26 10:55:00,-1952.45,278015.5200000005,288092.02000000037,-10076.499999999884
12456,2022-04-26 11:00:00,770.49,278786.0100000005,288092.02000000037,-9306.009999999893
12457,2022-04-26 11:05:00,-466.86,278319.1500000005,288092.02000000037,-9772.869999999879
12458,2022-04-26 11:10:00,-116.33,278202.8200000005,288092.02000000037,-9889.199999999895
12459,2022-04-26 11:15:00,-798.01,277404.81000000046,288092.02000000037,-10687.209999999905
12460,2022-04-26 11:20:00,-1687.7,275717.11000000045,288092.02000000037,-12374.909999999916
12461,2022-04-26 11:25:00,-326.97,275390.1400000005,288092.02000000037,-12701.879999999888
12462,2022-04-26 11:30:00,-1066.69,274323.4500000005,288092.02000000037,-13768.56999999989
12463,2022-04-26 11:35:00,1837.13,276160.5800000005,288092.02000000037,-11931.439999999886
12464,2022-04-26 11:40:00,-678.3,275482.2800000005,288092.02000000037,-12609.739999999874
12465,2022-04-26 11:45:00,-314.54,275167.7400000005,288092.02000000037,-12924.279999999853
12466,2022-04-26 11:50:00,-1337.34,273830.4000000005,288092.02000000037,-14261.619999999879
12467,2022-04-26 11:55:00,421.46,274251.8600000005,288092.02000000037,-13840.159999999858
12468,2022-04-26 12:00:00,-57.52,274194.3400000005,288092.02000000037,-13897.679999999877
12469,2022-04-26 12:05:00,-434.38,273759.9600000005,288092.02000000037,-14332.059999999881
12470,2022-04-26 12:10:00,-658.15,273101.81000000046,288092.02000000037,-14990.209999999905
12471,2022-04-26 12:15:00,516.13,273617.94000000047,288092.02000000037,-14474.0799999999
12472,2022-04-26 12:20:00,-246.26,273371.68000000046,288092.02000000037,-14720.33999999991
12473,2022-04-26 12:25:00,1477.92,274849.60000000044,288092.02000000037,-13242.419999999925
12474,2022-04-26 12:30:00,561.9,275411.50000000047,288092.02000000037,-12680.519999999902
12475,2022-04-26 12:35:00,1980.62,277392.12000000046,288092.02000000037,-10699.899999999907
12476,2022-04-26 12:40:00,-1029.34,276362.78000000044,288092.02000000037,-11729.239999999932
12477,2022-04-26 12:45:00,-1417.55,274945.23000000045,288092.02000000037,-13146.78999999992
12478,2022-04-26 12:50:00,1342.14,276287.37000000046,288092.02000000037,-11804.649999999907
12479,2022-04-26 12:55:00,182.32,276469.69000000047,288092.02000000037,-11622.3299999999
12480,2022-04-26 13:00:00,1417.68,277887.37000000046,288092.02000000037,-10204.649999999907
12481,2022-04-26 13:05:00,-632.48,277254.8900000005,288092.02000000037,-10837.129999999888
12482,2022-04-26 13:10:00,-1429.03,275825.86000000045,288092.02000000037,-12266.159999999916
12483,2022-04-26 13:15:00,842.16,276668.0200000004,288092.02000000037,-11423.999999999942
12484,2022-04-26 13:20:00,-791.88,275876.1400000004,288092.02000000037,-12215.879999999946
12485,2022-04-26 13:25:00,-1151.22,274724.92000000045,288092.02000000037,-13367.099999999919
12486,2022-04-26 13:30:00,-1516.71,273208.2100000004,288092.02000000037,-14883.80999999994
12487,2022-04-26 13:35:00,166.75,273374.9600000004,288092.02000000037,-14717.05999999994
12488,2022-04-26 13:40:00,-1592.21,271782.7500000004,288092.02000000037,-16309.26999999996
12489,2022-04-26 13:45:00,-828.08,270954.6700000004,288092.02000000037,-17137.349999999977
12490,2022-04-26 13:50:00,-75.78,270878.89000000036,288092.02000000037,-17213.130000000005
12491,2022-04-26 13:55:00,-1725.69,269153.20000000036,288092.02000000037,-18938.820000000007
12492,2022-04-26 14:00:00,1790.18,270943.38000000035,288092.02000000037,-17148.640000000014
12493,2022-04-26 14:05:00,1776.1,272719.48000000033,288092.02000000037,-15372.540000000037
12494,2022-04-26 14:10:00,-984.33,271735.1500000003,288092.02000000037,-16356.870000000054
12495,2022-04-26 14:15:00,593.07,272328.2200000003,288092.02000000037,-15763.800000000047
12496,2022-04-26 14:20:00,-1982.4,270345.8200000003,288092.02000000037,-17746.20000000007
12497,2022-04-26 14:25:00,-751.65,269594.1700000003,288092.02000000037,-18497.850000000093
12498,2022-04-26 14:30:00,1696.36,271290.53000000026,288092.02000000037,-16801.490000000107
12499,2022-04-26 14:35:00,-1936.47,269354.0600000003,288092.02000000037,-18737.96000000008
12500,2022-04-26 14:40:00,740.92,270094.9800000003,288092.02000000037,-17997.040000000095
12501,2022-04-26 14:45:00,689.01,270783.9900000003,288092.02000000037,-17308.030000000086
12502,2022-04-26 14:50:00,32.18,270816.1700000003,288092.02000000037,-17275.850000000093
12503,2022-04-26 14:55:00,-319.8,270496.3700000003,288092.02000000037,-17595.65000000008
12504,2022-04-26 15:00:00,1126.91,271623.28000000026,288092.02000000037,-16468.740000000107
12505,2022-04-26 15:05:00,-1916.74,269706.54000000027,288092.02000000037,-18385.480000000098
12506,2022-04-26 15:10:00,472.59,270179.1300000003,288092.02000000037,-17912.890000000072
12507,2022-04-26 15:15:00,-1479.15,268699.9800000003,288092.02000000037,-19392.040000000095
12508,2022-04-26 15:20:00,1341.25,270041.2300000003,288092.02000000037,-18050.790000000095
12509,2022-04-26 15:25:00,854.82,270896.0500000003,288092.02000000037,-17195.97000000009
12510,2022-04-26 15:30:00,1203.83,272099.8800000003,288092.02000000037,-15992.140000000072
12511,2022-04-26 15:35:00,-933.26,271166.6200000003,288092.02000000037,-16925.40000000008
12512,2022-04-26 15:40:00,-1601.68,269564.9400000003,288092.02000000037,-18527.080000000075
12513,2022-04-26 15:45:00,1275.54,270840.4800000003,288092.02000000037,-17251.540000000095
12514,2022-04-26 15:50:00,1083.03,271923.5100000003,288092.02000000037,-16168.510000000068
12515,2022-04-26 15:55:00,-1574.11,270349.4000000003,288092.02000000037,-17742.620000000054
12516,2022-04-26 16:00:00,824.45,271173.8500000003,288092.02000000037,-16918.170000000042
12517,2022-04-26 16:05:00,1195.51,272369.36000000034,288092.02000000037,-15722.660000000033
12518,2022-04-26 16:10:00,1214.82,273584.18000000034,288092.02000000037,-14507.840000000026
12519,2022-04-26 16:15:00,1492.84,275077.02000000037,288092.02000000037,-13015.0
12520,2022-04-26 16:20:00,-1603.35,273473.6700000004,288092.02000000037,-14618.349999999977
12521,2022-04-26 16:25:00,-1428.03,272045.64000000036,288092.02000000037,-16046.380000000005
12522,2022-04-26 16:30:00,1591.11,273636.75000000035,288092.02000000037,-14455.270000000019
12523,2022-04-26 16:35:00,537.59,274174.3400000004,288092.02000000037,-13917.679999999993
12524,2022-04-26 16:40:00,-734.11,273440.2300000004,288092.02000000037,-14651.789999999979
12525,2022-04-26 16:45:00,1281.46,274721.6900000004,288092.02000000037,-13370.329999999958
12526,2022-04-26 16:50:00,582.71,275304.40000000043,288092.02000000037,-12787.619999999937
12527,2022-04-26 16:55:00,-194.89,275109.5100000004,288092.02000000037,-12982.509999999951
12528,2022-04-27 08:00:00,1139.12,276248.6300000004,275109.5100000004,1139.1199999999953
12529,2022-04-27 08:05:00,-897.86,275350.7700000004,275109.5100000004,241.2600000000093
12530,2022-04-27 08:10:00,-582.12,274768.65000000043,275109.5100000004,-340.85999999998603
12531,2022-04-27 08:15:00,872.04,275640.6900000004,275109.5100000004,531.179999999993
12532,2022-04-27 08:20:00,-493.17,275147.5200000004,275109.5100000004,38.01000000000931
12533,2022-04-27 08:25:00,-78.33,275069.1900000004,275109.5100000004,-40.320000000006985
12534,2022-04-27 08:30:00,-1689.82,273379.3700000004,275109.5100000004,-1730.140000000014
12535,2022-04-27 08:35:00,999.09,274378.4600000004,275109.5100000004,-731.0499999999884
12536,2022-04-27 08:40:00,-46.22,274332.24000000046,275109.5100000004,-777.2699999999604
12537,2022-04-27 08:45:00,-659.19,273673.05000000045,275109.5100000004,-1436.4599999999627
12538,2022-04-27 08:50:00,-1240.25,272432.80000000045,275109.5100000004,-2676.7099999999627
12539,2022-04-27 08:55:00,-440.57,271992.23000000045,275109.5100000004,-3117.2799999999697
12540,2022-04-27 09:00:00,-397.71,271594.5200000004,275109.5100000004,-3514.9899999999907
12541,2022-04-27 09:05:00,551.23,272145.7500000004,275109.5100000004,-2963.7600000000093
12542,2022-04-27 09:10:00,-844.8,271300.9500000004,275109.5100000004,-3808.5599999999977
12543,2022-04-27 09:15:00,56.94,271357.8900000004,275109.5100000004,-3751.6199999999953
12544,2022-04-27 09:20:00,-626.61,270731.28000000044,275109.5100000004,-4378.229999999981
12545,2022-04-27 09:25:00,-1216.42,269514.86000000045,275109.5100000004,-5594.649999999965
12546,2022-04-27 09:30:00,-1606.8,267908.06000000046,275109.5100000004,-7201.449999999953
12547,2022-04-27 09:35:00,-973.36,266934.7000000005,275109.5100000004,-8174.8099999999395
12548,2022-04-27 09:40:00,1415.56,268350.2600000005,275109.5100000004,-6759.249999999942
12549,2022-04-27 09:45:00,-1042.84,267307.42000000045,275109.5100000004,-7802.089999999967
12550,2022-04-27 09:50:00,-203.19,267104.23000000045,275109.5100000004,-8005.27999999997
12551,2022-04-27 09:55:00,1112.89,268217.12000000046,275109.5100000004,-6892.389999999956
12552,2022-04-27 10:00:00,1807.56,270024.68000000046,275109.5100000004,-5084.829999999958
12553,2022-04-27 10:05:00,-72.24,269952.44000000047,275109.5100000004,-5157.069999999949
12554,2022-04-27 10:10:00,-840.92,269111.5200000005,275109.5100000004,-5997.9899999999325
12555,2022-04-27 10:15:00,1285.03,270396.5500000005,275109.5100000004,-4712.9599999999045
12556,2022-04-27 10:20:00,323.78,270720.33000000054,275109.5100000004,-4389.179999999877
12557,2022-04-27 10:25:00,1320.42,272040.7500000005,275109.5100000004,-3068.759999999893
12558,2022-04-27 10:30:00,1433.65,273474.40000000055,275109.5100000004,-1635.1099999998696
12559,2022-04-27 10:35:00,1651.81,275126.21000000054,275109.5100000004,16.700000000128057
12560,2022-04-27 10:40:00,-1623.34,273502.8700000005,275109.5100000004,-1606.6399999998976
12561,2022-04-27 10:45:00,1745.04,275247.9100000005,275109.5100000004,138.4000000000815
12562,2022-04-27 10:50:00,-926.36,274321.5500000005,275109.5100000004,-787.9599999999045
12563,2022-04-27 10:55:00,837.8,275159.3500000005,275109.5100000004,49.84000000008382
12564,2022-04-27 11:00:00,-1169.21,273990.1400000005,275109.5100000004,-1119.3699999999371
12565,2022-04-27 11:05:00,1859.05,275849.19000000047,275109.5100000004,739.6800000000512
12566,2022-04-27 11:10:00,1788.85,277638.04000000044,275109.5100000004,2528.530000000028
12567,2022-04-27 11:15:00,-1196.62,276441.42000000045,275109.5100000004,1331.9100000000326
12568,2022-04-27 11:20:00,-1302.82,275138.60000000044,275109.5100000004,29.09000000002561
12569,2022-04-27 11:25:00,168.79,275307.3900000004,275109.5100000004,197.88000000000466
12570,2022-04-27 11:30:00,948.7,276256.09000000043,275109.5100000004,1146.5800000000163
12571,2022-04-27 11:35:00,722.49,276978.5800000004,275109.5100000004,1869.070000000007
12572,2022-04-27 11:40:00,-111.53,276867.0500000004,275109.5100000004,1757.539999999979
12573,2022-04-27 11:45:00,179.91,277046.96000000037,275109.5100000004,1937.4499999999534
12574,2022-04-27 11:50:00,1486.2,278533.1600000004,275109.5100000004,3423.649999999965
12575,2022-04-27 11:55:00,-1014.11,277519.0500000004,275109.5100000004,2409.539999999979
12576,2022-04-27 12:00:00,-518.07,277000.9800000004,275109.5100000004,1891.469999999972
12577,2022-04-27 12:05:00,-1747.08,275253.9000000004,275109.5100000004,144.38999999995576
12578,2022-04-27 12:10:00,-454.1,274799.8000000004,275109.5100000004,-309.71000000002095
12579,2022-04-27 12:15:00,1584.7,276384.5000000004,275109.5100000004,1274.9899999999907
12580,2022-04-27 12:20:00,-1421.41,274963.09000000043,275109.5100000004,-146.4199999999837
12581,2022-04-27 12:25:00,-848.0,274115.09000000043,275109.5100000004,-994.4199999999837
12582,2022-04-27 12:30:00,1095.03,275210.12000000046,275109.5100000004,100.61000000004424
12583,2022-04-27 12:35:00,-1705.16,273504.9600000005,275109.5100000004,-1604.5499999999302
12584,2022-04-27 12:40:00,1473.25,274978.2100000005,275109.5100000004,-131.29999999993015
12585,2022-04-27 12:45:00,324.6,275302.81000000046,275109.5100000004,193.30000000004657
12586,2022-04-27 12:50:00,434.49,275737.30000000045,275109.5100000004,627.7900000000373
12587,2022-04-27 12:55:00,-1982.14,273755.16000000044,275109.5100000004,-1354.3499999999767
12588,2022-04-27 13:00:00,-1605.84,272149.3200000004,275109.5100000004,-2960.1900000000023
12589,2022-04-27 13:05:00,-756.35,271392.97000000044,275109.5100000004,-3716.539999999979
12590,2022-04-27 13:10:00,-387.35,271005.62000000046,275109.5100000004,-4103.889999999956
12591,2022-04-27 13:15:00,-1187.79,269817.8300000005,275109.5100000004,-5291.679999999935
12592,2022-04-27 13:20:00,995.28,270813.1100000005,275109.5100000004,-4296.399999999907
12593,2022-04-27 13:25:00,-141.22,270671.89000000054,275109.5100000004,-4437.619999999879
12594,2022-04-27 13:30:00,1059.08,271730.97000000055,275109.5100000004,-3378.5399999998626
12595,2022-04-27 13:35:00,545.75,272276.72000000055,275109.5100000004,-2832.7899999998626
12596,2022-04-27 13:40:00,-1579.7,270697.02000000054,275109.5100000004,-4412.489999999874
12597,2022-04-27 13:45:00,1350.85,272047.8700000005,275109.5100000004,-3061.6399999998976
12598,2022-04-27 13:50:00,-1698.19,270349.6800000005,275109.5100000004,-4759.8299999999
12599,2022-04-27 13:55:00,-926.7,269422.9800000005,275109.5100000004,-5686.5299999999115
12600,2022-04-27 14:00:00,1216.43,270639.4100000005,275109.5100000004,-4470.0999999999185
12601,2022-04-27 14:05:00,539.0,271178.4100000005,275109.5100000004,-3931.0999999999185
12602,2022-04-27 14:10:00,-1959.03,269219.38000000047,275109.5100000004,-5890.129999999946
12603,2022-04-27 14:15:00,852.47,270071.85000000044,275109.5100000004,-5037.659999999974
12604,2022-04-27 14:20:00,-517.4,269554.4500000004,275109.5100000004,-5555.059999999998
12605,2022-04-27 14:25:00,-1940.9,267613.5500000004,275109.5100000004,-7495.960000000021
12606,2022-04-27 14:30:00,541.69,268155.2400000004,275109.5100000004,-6954.270000000019
12607,2022-04-27 14:35:00,1780.36,269935.6000000004,275109.5100000004,-5173.910000000033
12608,2022-04-27 14:40:00,-1497.69,268437.9100000004,275109.5100000004,-6671.600000000035
12609,2022-04-27 14:45:00,-1155.73,267282.1800000004,275109.5100000004,-7827.330000000016
12610,2022-04-27 14:50:00,1967.78,269249.9600000004,275109.5100000004,-5859.549999999988
12611,2022-04-27 14:55:00,-216.02,269033.9400000004,275109.5100000004,-6075.570000000007
12612,2022-04-27 15:00:00,1446.52,270480.4600000004,275109.5100000004,-4629.049999999988
12613,2022-04-27 15:05:00,-1845.96,268634.5000000004,275109.5100000004,-6475.010000000009
12614,2022-04-27 15:10:00,-1299.73,267334.7700000004,275109.5100000004,-7774.739999999991
12615,2022-04-27 15:15:00,1908.65,269243.42000000045,275109.5100000004,-5866.089999999967
12616,2022-04-27 15:20:00,-1032.82,268210.60000000044,275109.5100000004,-6898.909999999974
12617,2022-04-27 15:25:00,-1463.23,266747.37000000046,275109.5100000004,-8362.139999999956
12618,2022-04-27 15:30:00,-1153.84,265593.53000000044,275109.5100000004,-9515.979999999981
12619,2022-04-27 15:35:00,653.16,266246.6900000004,275109.5100000004,-8862.820000000007
12620,2022-04-27 15:40:00,-1243.41,265003.28000000044,275109.5100000004,-10106.229999999981
12621,2022-04-27 15:45:00,867.13,265870.41000000044,275109.5100000004,-9239.099999999977
12622,2022-04-27 15:50:00,756.13,266626.54000000044,275109.5100000004,-8482.969999999972
12623,2022-04-27 15:55:00,-1495.01,265131.53000000044,275109.5100000004,-9977.979999999981
12624,2022-04-27 16:00:00,1700.82,266832.35000000044,275109.5100000004,-8277.159999999974
12625,2022-04-27 16:05:00,1830.66,268663.0100000004,275109.5100000004,-6446.5
12626,2022-04-27 16:10:00,-566.48,268096.53000000044,275109.5100000004,-7012.979999999981
12627,2022-04-27 16:15:00,961.15,269057.68000000046,275109.5100000004,-6051.829999999958
12628,2022-04-27 16:20:00,1517.06,270574.74000000046,275109.5100000004,-4534.76999999996
12629,2022-04-27 16:25:00,-406.17,270168.5700000005,275109.5100000004,-4940.939999999944
12630,2022-04-27 16:30:00,510.62,270679.19000000047,275109.5100000004,-4430.319999999949
12631,2022-04-27 16:35:00,-857.4,269821.79000000044,275109.5100000004,-5287.719999999972
12632,2022-04-27 16:40:00,40.71,269862.50000000047,275109.5100000004,-5247.009999999951
12633,2022-04-27 16:45:00,-54.93,269807.5700000005,275109.5100000004,-5301.939999999944
12634,2022-04-27 16:50:00,1127.83,270935.4000000005,275109.5100000004,-4174.109999999928
12635,2022-04-27 16:55:00,1251.8,272187.2000000005,275109.5100000004,-2922.3099999999395
12636,2022-04-28 08:00:00,124.09,272311.2900000005,272187.2000000005,124.09000000002561
12637,2022-04-28 08:05:00,-1419.26,270892.0300000005,272187.2000000005,-1295.1699999999837
12638,2022-04-28 08:10:00,803.97,271696.00000000047,272187.2000000005,-491.20000000001164
12639,2022-04-28 08:15:00,607.46,272303.4600000005,272187.2000000005,116.26000000000931
12640,2022-04-28 08:20:00,-1868.21,270435.25000000047,272187.2000000005,-1751.9500000000116
12641,2022-04-28 08:25:00,802.83,271238.0800000005,272187.2000000005,-949.1199999999953
12642,2022-04-28 08:30:00,-997.95,270240.13000000047,272187.2000000005,-1947.070000000007
12643,2022-04-28 08:35:00,511.26,270751.3900000005,272187.2000000005,-1435.8099999999977
12644,2022-04-28 08:40:00,-1382.35,269369.0400000005,272187.2000000005,-2818.1599999999744
12645,2022-04-28 08:45:00,-703.15,268665.8900000005,272187.2000000005,-3521.3099999999977
12646,2022-04-28 08:50:00,-1292.88,267373.0100000005,272187.2000000005,-4814.190000000002
12647,2022-04-28 08:55:00,-424.12,266948.8900000005,272187.2000000005,-5238.309999999998
12648,2022-04-28 09:00:00,673.74,267622.63000000047,272187.2000000005,-4564.570000000007
12649,2022-04-28 09:05:00,26.85,267649.48000000045,272187.2000000005,-4537.72000000003
12650,2022-04-28 09:10:00,-222.81,267426.67000000045,272187.2000000005,-4760.530000000028
12651,2022-04-28 09:15:00,324.32,267750.99000000046,272187.2000000005,-4436.210000000021
12652,2022-04-28 09:20:00,-814.52,266936.47000000044,272187.2000000005,-5250.73000000004
12653,2022-04-28 09:25:00,1844.18,268780.65000000043,272187.2000000005,-3406.5500000000466
12654,2022-04-28 09:30:00,856.64,269637.29000000044,272187.2000000005,-2549.9100000000326
12655,2022-04-28 09:35:00,-73.05,269564.24000000046,272187.2000000005,-2622.960000000021
12656,2022-04-28 09:40:00,-1620.59,267943.65000000043,272187.2000000005,-4243.550000000047
12657,2022-04-28 09:45:00,-1175.26,266768.3900000004,272187.2000000005,-5418.810000000056
12658,2022-04-28 09:50:00,1241.92,268010.3100000004,272187.2000000005,-4176.890000000072
12659,2022-04-28 09:55:00,459.73,268470.0400000004,272187.2000000005,-3717.160000000091
12660,2022-04-28 10:00:00,-1002.21,267467.83000000037,272187.2000000005,-4719.370000000112
12661,2022-04-28 10:05:00,1711.9,269179.7300000004,272187.2000000005,-3007.4700000000885
12662,2022-04-28 10:10:00,1287.81,270467.5400000004,272187.2000000005,-1719.6600000000908
12663,2022-04-28 10:15:00,537.7,271005.2400000004,272187.2000000005,-1181.9600000000792
12664,2022-04-28 10:20:00,-841.38,270163.8600000004,272187.2000000005,-2023.3400000000838
12665,2022-04-28 10:25:00,-1401.0,268762.8600000004,272187.2000000005,-3424.340000000084
12666,2022-04-28 10:30:00,-131.68,268631.1800000004,272187.2000000005,-3556.020000000077
12667,2022-04-28 10:35:00,345.87,268977.0500000004,272187.2000000005,-3210.1500000000815
12668,2022-04-28 10:40:00,1522.65,270499.7000000004,272187.2000000005,-1687.5000000000582
12669,2022-04-28 10:45:00,-1946.23,268553.47000000044,272187.2000000005,-3633.7300000000396
12670,2022-04-28 10:50:00,-816.49,267736.98000000045,272187.2000000005,-4450.22000000003
12671,2022-04-28 10:55:00,949.46,268686.44000000047,272187.2000000005,-3500.7600000000093
12672,2022-04-28 11:00:00,-1503.51,267182.93000000046,272187.2000000005,-5004.270000000019
12673,2022-04-28 11:05:00,-894.23,266288.7000000005,272187.2000000005,-5898.5
12674,2022-04-28 11:10:00,-646.02,265642.68000000046,272187.2000000005,-6544.520000000019
12675,2022-04-28 11:15:00,-1396.38,264246.30000000045,272187.2000000005,-7940.900000000023
12676,2022-04-28 11:20:00,-1478.17,262768.13000000047,272187.2000000005,-9419.070000000007
12677,2022-04-28 11:25:00,-1206.67,261561.46000000046,272187.2000000005,-10625.74000000002
12678,2022-04-28 11:30:00,935.42,262496.88000000047,272187.2000000005,-9690.320000000007
12679,2022-04-28 11:35:00,-149.5,262347.38000000047,272187.2000000005,-9839.820000000007
12680,2022-04-28 11:40:00,834.99,263182.37000000046,272187.2000000005,-9004.830000000016
12681,2022-04-28 11:45:00,-1131.17,262051.20000000045,272187.2000000005,-10136.00000000003
12682,2022-04-28 11:50:00,-312.38,261738.82000000044,272187.2000000005,-10448.380000000034
12683,2022-04-28 11:55:00,1099.8,262838.62000000046,272187.2000000005,-9348.580000000016
12684,2022-04-28 12:00:00,739.78,263578.4000000005,272187.2000000005,-8608.799999999988
12685,2022-04-28 12:05:00,-360.43,263217.9700000005,272187.2000000005,-8969.229999999981
12686,2022-04-28 12:10:00,-731.56,262486.4100000005,272187.2000000005,-9700.789999999979
12687,2022-04-28 12:15:00,-1945.89,260540.52000000048,272187.2000000005,-11646.679999999993
12688,2022-04-28 12:20:00,-1776.6,258763.92000000048,272187.2000000005,-13423.279999999999
12689,2022-04-28 12:25:00,-1775.52,256988.4000000005,272187.2000000005,-15198.799999999988
12690,2022-04-28 12:30:00,-1510.16,255478.2400000005,272187.2000000005,-16708.959999999992
12691,2022-04-28 12:35:00,439.62,255917.86000000048,272187.2000000005,-16269.339999999997
12692,2022-04-28 12:40:00,-1643.74,254274.1200000005,272187.2000000005,-17913.079999999987
12693,2022-04-28 12:45:00,-1625.1,252649.02000000048,272187.2000000005,-19538.179999999993
12694,2022-04-28 12:50:00,1846.42,254495.4400000005,272187.2000000005,-17691.75999999998
12695,2022-04-28 12:55:00,-1755.72,252739.7200000005,272187.2000000005,-19447.47999999998
12696,2022-04-28 13:00:00,-1149.65,251590.0700000005,272187.2000000005,-20597.129999999976
12697,2022-04-28 13:05:00,540.13,252130.2000000005,272187.2000000005,-20056.99999999997
12698,2022-04-28 13:10:00,587.69,252717.8900000005,272187.2000000005,-19469.30999999997
12699,2022-04-28 13:15:00,893.89,253611.78000000052,272187.2000000005,-18575.419999999955
12700,2022-04-28 13:20:00,-786.17,252825.6100000005,272187.2000000005,-19361.589999999967
12701,2022-04-28 13:25:00,-196.6,252629.0100000005,272187.2000000005,-19558.189999999973
12702,2022-04-28 13:30:00,-216.73,252412.2800000005,272187.2000000005,-19774.919999999984
12703,2022-04-28 13:35:00,-908.77,251503.5100000005,272187.2000000005,-20683.689999999973
12704,2022-04-28 13:40:00,-926.1,250577.4100000005,272187.2000000005,-21609.78999999998
12705,2022-04-28 13:45:00,56.63,250634.0400000005,272187.2000000005,-21553.159999999974
12706,2022-04-28 13:50:00,-1032.53,249601.5100000005,272187.2000000005,-22585.689999999973
12707,2022-04-28 13:55:00,-1189.24,248412.2700000005,272187.2000000005,-23774.929999999964
12708,2022-04-28 14:00:00,-917.6,247494.6700000005,272187.2000000005,-24692.52999999997
12709,2022-04-28 14:05:00,1603.62,249098.2900000005,272187.2000000005,-23088.909999999974
12710,2022-04-28 14:10:00,1425.21,250523.5000000005,272187.2000000005,-21663.699999999983
12711,2022-04-28 14:15:00,-1927.64,248595.86000000048,272187.2000000005,-23591.339999999997
12712,2022-04-28 14:20:00,576.99,249172.85000000047,272187.2000000005,-23014.350000000006
12713,2022-04-28 14:25:00,-1407.72,247765.13000000047,272187.2000000005,-24422.070000000007
12714,2022-04-28 14:30:00,-1114.53,246650.60000000047,272187.2000000005,-25536.600000000006
12715,2022-04-28 14:35:00,967.59,247618.19000000047,272187.2000000005,-24569.01000000001
12716,2022-04-28 14:40:00,1475.95,249094.14000000048,272187.2000000005,-23093.059999999998
12717,2022-04-28 14:45:00,-73.03,249021.11000000048,272187.2000000005,-23166.089999999997
12718,2022-04-28 14:50:00,-986.82,248034.29000000047,272187.2000000005,-24152.910000000003
12719,2022-04-28 14:55:00,20.97,248055.26000000047,272187.2000000005,-24131.940000000002
12720,2022-04-28 15:00:00,-496.49,247558.77000000048,272187.2000000005,-24628.429999999993
12721,2022-04-28 15:05:00,501.09,248059.86000000048,272187.2000000005,-24127.339999999997
12722,2022-04-28 15:10:00,671.89,248731.7500000005,272187.2000000005,-23455.449999999983
12723,2022-04-28 15:15:00,-1599.93,247131.8200000005,272187.2000000005,-25055.379999999976
12724,2022-04-28 15:20:00,-1154.37,245977.4500000005,272187.2000000005,-26209.74999999997
12725,2022-04-28 15:25:00,-515.49,245461.96000000052,272187.2000000005,-26725.23999999996
12726,2022-04-28 15:30:00,1843.25,247305.21000000052,272187.2000000005,-24881.98999999996
12727,2022-04-28 15:35:00,-657.92,246647.2900000005,272187.2000000005,-25539.909999999974
12728,2022-04-28 15:40:00,426.59,247073.8800000005,272187.2000000005,-25113.319999999978
12729,2022-04-28 15:45:00,1646.07,248719.9500000005,272187.2000000005,-23467.24999999997
12730,2022-04-28 15:50:00,1425.98,250145.93000000052,272187.2000000005,-22041.26999999996
12731,2022-04-28 15:55:00,-1342.37,248803.56000000052,272187.2000000005,-23383.639999999956
12732,2022-04-28 16:00:00,-1489.66,247313.90000000052,272187.2000000005,-24873.29999999996
12733,2022-04-28 16:05:00,564.72,247878.62000000052,272187.2000000005,-24308.579999999958
12734,2022-04-28 16:10:00,-1721.43,246157.19000000053,272187.2000000005,-26030.00999999995
12735,2022-04-28 16:15:00,-1894.28,244262.91000000053,272187.2000000005,-27924.28999999995
12736,2022-04-28 16:20:00,-1717.42,242545.49000000051,272187.2000000005,-29641.709999999963
12737,2022-04-28 16:25:00,1121.83,243667.3200000005,272187.2000000005,-28519.879999999976
12738,2022-04-28 16:30:00,-356.39,243310.9300000005,272187.2000000005,-28876.26999999999
12739,2022-04-28 16:35:00,1476.8,244787.73000000048,272187.2000000005,-27399.47
12740,2022-04-28 16:40:00,-1375.51,243412.22000000047,272187.2000000005,-28774.98000000001
12741,2022-04-28 16:45:00,1921.46,245333.68000000046,272187.2000000005,-26853.52000000002
12742,2022-04-28 16:50:00,1009.59,246343.27000000046,272187.2000000005,-25843.930000000022
12743,2022-04-28 16:55:00,-1142.7,245200.57000000044,272187.2000000005,-26986.630000000034
12744,2022-04-29 08:00:00,-691.18,244509.39000000045,245200.57000000044,-691.179999999993
12745,2022-04-29 08:05:00,785.46,245294.85000000044,245200.57000000044,94.27999999999884
12746,2022-04-29 08:10:00,-469.69,244825.16000000044,245200.57000000044,-375.4100000000035
12747,2022-04-29 08:15:00,1739.02,246564.18000000043,245200.57000000044,1363.609999999986
12748,2022-04-29 08:20:00,-413.43,246150.75000000044,245200.57000000044,950.179999999993
12749,2022-04-29 08:25:00,-1053.49,245097.26000000045,245200.57000000044,-103.30999999999767
12750,2022-04-29 08:30:00,-1726.49,243370.77000000046,245200.57000000044,-1829.7999999999884
12751,2022-04-29 08:35:00,-115.35,243255.42000000045,245200.57000000044,-1945.1499999999942
12752,2022-04-29 08:40:00,-1469.95,241785.47000000044,245200.57000000044,-3415.100000000006
12753,2022-04-29 08:45:00,1311.92,243097.39000000045,245200.57000000044,-2103.179999999993
12754,2022-04-29 08:50:00,-526.27,242571.12000000046,245200.57000000044,-2629.4499999999825
12755,2022-04-29 08:55:00,911.36,243482.48000000045,245200.57000000044,-1718.0899999999965
12756,2022-04-29 09:00:00,1509.3,244991.78000000044,245200.57000000044,-208.79000000000815
12757,2022-04-29 09:05:00,1721.97,246713.75000000044,245200.57000000044,1513.179999999993
12758,2022-04-29 09:10:00,-1593.19,245120.56000000043,245200.57000000044,-80.01000000000931
12759,2022-04-29 09:15:00,-173.52,244947.04000000044,245200.57000000044,-253.52999999999884
12760,2022-04-29 09:20:00,-1911.1,243035.94000000044,245200.57000000044,-2164.6300000000047
12761,2022-04-29 09:25:00,-608.36,242427.58000000045,245200.57000000044,-2772.9899999999907
12762,2022-04-29 09:30:00,-1168.08,241259.50000000047,245200.57000000044,-3941.069999999978
12763,2022-04-29 09:35:00,1381.74,242641.24000000046,245200.57000000044,-2559.329999999987
12764,2022-04-29 09:40:00,1870.04,244511.28000000046,245200.57000000044,-689.289999999979
12765,2022-04-29 09:45:00,1316.45,245827.73000000048,245200.57000000044,627.1600000000326
12766,2022-04-29 09:50:00,392.96,246220.69000000047,245200.57000000044,1020.1200000000244
12767,2022-04-29 09:55:00,-539.17,245681.52000000046,245200.57000000044,480.95000000001164
12768,2022-04-29 10:00:00,234.43,245915.95000000045,245200.57000000044,715.3800000000047
12769,2022-04-29 10:05:00,-805.15,245110.80000000045,245200.57000000044,-89.76999999998952
12770,2022-04-29 10:10:00,1123.56,246234.36000000045,245200.57000000044,1033.7900000000081
12771,2022-04-29 10:15:00,-1643.61,244590.75000000047,245200.57000000044,-609.8199999999779
12772,2022-04-29 10:20:00,-1858.32,242732.43000000046,245200.57000000044,-2468.139999999985
12773,2022-04-29 10:25:00,1382.64,244115.07000000047,245200.57000000044,-1085.499999999971
12774,2022-04-29 10:30:00,-1463.42,242651.65000000046,245200.57000000044,-2548.9199999999837
12775,2022-04-29 10:35:00,1046.37,243698.02000000046,245200.57000000044,-1502.5499999999884
12776,2022-04-29 10:40:00,1367.86,245065.88000000044,245200.57000000044,-134.69000000000233
12777,2022-04-29 10:45:00,1601.01,246666.89000000045,245200.57000000044,1466.320000000007
12778,2022-04-29 10:50:00,-745.13,245921.76000000045,245200.57000000044,721.1900000000023
12779,2022-04-29 10:55:00,-1678.39,244243.37000000043,245200.57000000044,-957.2000000000116
12780,2022-04-29 11:00:00,1521.29,245764.66000000044,245200.57000000044,564.0899999999965
12781,2022-04-29 11:05:00,197.88,245962.54000000044,245200.57000000044,761.9700000000012
12782,2022-04-29 11:10:00,734.28,246696.82000000044,245200.57000000044,1496.25
12783,2022-04-29 11:15:00,439.1,247135.92000000045,245200.57000000044,1935.3500000000058
12784,2022-04-29 11:20:00,-546.29,246589.63000000044,245200.57000000044,1389.0599999999977
12785,2022-04-29 11:25:00,419.88,247009.51000000045,245200.57000000044,1808.9400000000023
12786,2022-04-29 11:30:00,-1126.41,245883.10000000044,245200.57000000044,682.5299999999988
12787,2022-04-29 11:35:00,55.05,245938.15000000043,245200.57000000044,737.5799999999872
12788,2022-04-29 11:40:00,1323.78,247261.93000000043,245200.57000000044,2061.359999999986
12789,2022-04-29 11:45:00,-1855.71,245406.22000000044,245200.57000000044,205.64999999999418
12790,2022-04-29 11:50:00,607.9,246014.12000000043,245200.57000000044,813.5499999999884
12791,2022-04-29 11:55:00,-322.44,245691.68000000043,245200.57000000044,491.10999999998603
12792,2022-04-29 12:00:00,-1343.4,244348.28000000044,245200.57000000044,-852.2900000000081
12793,2022-04-29 12:05:00,-360.47,243987.81000000043,245200.57000000044,-1212.7600000000093
12794,2022-04-29 12:10:00,-1115.88,242871.93000000043,245200.57000000044,-2328.640000000014
12795,2022-04-29 12:15:00,-1596.45,241275.48000000042,245200.57000000044,-3925.0900000000256
12796,2022-04-29 12:20:00,1440.97,242716.45000000042,245200.57000000044,-2484.1200000000244
12797,2022-04-29 12:25:00,-1257.64,241458.8100000004,245200.57000000044,-3741.7600000000384
12798,2022-04-29 12:30:00,1568.13,243026.9400000004,245200.57000000044,-2173.6300000000338
12799,2022-04-29 12:35:00,-153.46,242873.48000000042,245200.57000000044,-2327.0900000000256
12800,2022-04-29 12:40:00,1336.61,244210.0900000004,245200.57000000044,-990.4800000000396
12801,2022-04-29 12:45:00,1811.48,246021.5700000004,245200.57000000044,820.9999999999709
12802,2022-04-29 12:50:00,-295.97,245725.6000000004,245200.57000000044,525.0299999999697
12803,2022-04-29 12:55:00,-882.23,244843.3700000004,245200.57000000044,-357.20000000004075
12804,2022-04-29 13:00:00,1934.02,246777.3900000004,245200.57000000044,1576.8199999999488
12805,2022-04-29 13:05:00,134.88,246912.2700000004,245200.57000000044,1711.6999999999534
12806,2022-04-29 13:10:00,-1993.66,244918.6100000004,245200.57000000044,-281.96000000005006
12807,2022-04-29 13:15:00,-1633.21,243285.4000000004,245200.57000000044,-1915.170000000042
12808,2022-04-29 13:20:00,-278.97,243006.4300000004,245200.57000000044,-2194.140000000043
12809,2022-04-29 13:25:00,-1023.78,241982.6500000004,245200.57000000044,-3217.920000000042
12810,2022-04-29 13:30:00,-806.16,241176.4900000004,245200.57000000044,-4024.0800000000454
12811,2022-04-29 13:35:00,954.34,242130.8300000004,245200.57000000044,-3069.740000000049
12812,2022-04-29 13:40:00,-1622.63,240508.2000000004,245200.57000000044,-4692.370000000054
12813,2022-04-29 13:45:00,-1191.2,239317.00000000038,245200.57000000044,-5883.570000000065
12814,2022-04-29 13:50:00,-1379.23,237937.77000000037,245200.57000000044,-7262.800000000076
12815,2022-04-29 13:55:00,-1523.38,236414.39000000036,245200.57000000044,-8786.18000000008
12816,2022-04-29 14:00:00,1955.78,238370.17000000036,245200.57000000044,-6830.4000000000815
12817,2022-04-29 14:05:00,-424.35,237945.82000000036,245200.57000000044,-7254.750000000087
12818,2022-04-29 14:10:00,1879.38,239825.20000000036,245200.57000000044,-5375.370000000083
12819,2022-04-29 14:15:00,244.71,240069.91000000035,245200.57000000044,-5130.660000000091
12820,2022-04-29 14:20:00,-185.74,239884.17000000036,245200.57000000044,-5316.4000000000815
12821,2022-04-29 14:25:00,-1183.85,238700.32000000036,245200.57000000044,-6500.250000000087
12822,2022-04-29 14:30:00,1265.32,239965.64000000036,245200.57000000044,-5234.93000000008
12823,2022-04-29 14:35:00,581.2,240546.84000000037,245200.57000000044,-4653.730000000069
12824,2022-04-29 14:40:00,1644.77,242191.61000000036,245200.57000000044,-3008.960000000079
12825,2022-04-29 14:45:00,1260.42,243452.03000000038,245200.57000000044,-1748.5400000000664
12826,2022-04-29 14:50:00,-456.32,242995.71000000037,245200.57000000044,-2204.8600000000733
12827,2022-04-29 14:55:00,-1351.1,241644.61000000036,245200.57000000044,-3555.960000000079
12828,2022-04-29 15:00:00,-151.7,241492.91000000035,245200.57000000044,-3707.660000000091
12829,2022-04-29 15:05:00,1647.17,243140.08000000037,245200.57000000044,-2060.490000000078
12830,2022-04-29 15:10:00,54.63,243194.71000000037,245200.57000000044,-2005.8600000000733
12831,2022-04-29 15:15:00,333.79,243528.50000000038,245200.57000000044,-1672.0700000000652
12832,2022-04-29 15:20:00,-395.15,243133.35000000038,245200.57000000044,-2067.2200000000594
12833,2022-04-29 15:25:00,-1312.81,241820.5400000004,245200.57000000044,-3380.030000000057
12834,2022-04-29 15:30:00,-1117.73,240702.81000000038,245200.57000000044,-4497.7600000000675
12835,2022-04-29 15:35:00,-829.91,239872.90000000037,245200.57000000044,-5327.670000000071
12836,2022-04-29 15:40:00,1846.99,241719.89000000036,245200.57000000044,-3480.6800000000803
12837,2022-04-29 15:45:00,-888.22,240831.67000000036,245200.57000000044,-4368.9000000000815
12838,2022-04-29 15:50:00,-255.95,240575.72000000035,245200.57000000044,-4624.850000000093
12839,2022-04-29 15:55:00,-1330.78,239244.94000000035,245200.57000000044,-5955.630000000092
12840,2022-04-29 16:00:00,1579.44,240824.38000000035,245200.57000000044,-4376.19000000009
12841,2022-04-29 16:05:00,1280.55,242104.93000000034,245200.57000000044,-3095.6400000001013
12842,2022-04-29 16:10:00,225.55,242330.48000000033,245200.57000000044,-2870.090000000113
12843,2022-04-29 16:15:00,702.21,243032.69000000032,245200.57000000044,-2167.880000000121
12844,2022-04-29 16:20:00,911.0,243943.69000000032,245200.57000000044,-1256.880000000121
12845,2022-04-29 16:25:00,-1123.34,242820.35000000033,245200.57000000044,-2380.2200000001176
12846,2022-04-29 16:30:00,-864.94,241955.41000000032,245200.57000000044,-3245.16000000012
12847,2022-04-29 16:35:00,-542.72,241412.69000000032,245200.57000000044,-3787.880000000121
12848,2022-04-29 16:40:00,674.58,242087.2700000003,245200.57000000044,-3113.300000000134
12849,2022-04-29 16:45:00,-844.64,241242.6300000003,245200.57000000044,-3957.940000000148
12850,2022-04-29 16:50:00,-612.57,240630.0600000003,245200.57000000044,-4570.510000000155
12851,2022-04-29 16:55:00,567.86,241197.92000000027,245200.57000000044,-4002.650000000169
12852,2022-04-30 08:00:00,-1559.76,239638.16000000027,241197.92000000027,-1559.7600000000093
12853,2022-04-30 08:05:00,-105.54,239532.62000000026,241197.92000000027,-1665.3000000000175
12854,2022-04-30 08:10:00,1411.93,240944.55000000025,241197.92000000027,-253.37000000002445
12855,2022-04-30 08:15:00,-1473.0,239471.55000000025,241197.92000000027,-1726.3700000000244
12856,2022-04-30 08:20:00,1300.63,240772.18000000025,241197.92000000027,-425.7400000000198
12857,2022-04-30 08:25:00,1767.36,242539.54000000024,241197.92000000027,1341.6199999999662
12858,2022-04-30 08:30:00,250.49,242790.03000000023,241197.92000000027,1592.109999999957
12859,2022-04-30 08:35:00,1180.26,243970.29000000024,241197.92000000027,2772.3699999999662
12860,2022-04-30 08:40:00,-1002.94,242967.35000000024,241197.92000000027,1769.429999999964
12861,2022-04-30 08:45:00,-762.6,242204.75000000023,241197.92000000027,1006.8299999999581
12862,2022-04-30 08:50:00,-704.07,241500.68000000023,241197.92000000027,302.7599999999511
12863,2022-04-30 08:55:00,1979.54,243480.22000000023,241197.92000000027,2282.2999999999593
12864,2022-04-30 09:00:00,-855.4,242624.82000000024,241197.92000000027,1426.899999999965
12865,2022-04-30 09:05:00,-1014.69,241610.13000000024,241197.92000000027,412.20999999996275
12866,2022-04-30 09:10:00,-131.88,241478.25000000023,241197.92000000027,280.3299999999581
12867,2022-04-30 09:15:00,-1355.14,240123.11000000022,241197.92000000027,-1074.8100000000559
12868,2022-04-30 09:20:00,1999.85,242122.96000000022,241197.92000000027,925.0399999999499
12869,2022-04-30 09:25:00,-194.62,241928.34000000023,241197.92000000027,730.4199999999546
12870,2022-04-30 09:30:00,-1709.52,240218.82000000024,241197.92000000027,-979.1000000000349
12871,2022-04-30 09:35:00,-700.33,239518.49000000025,241197.92000000027,-1679.4300000000221
12872,2022-04-30 09:40:00,-437.16,239081.33000000025,241197.92000000027,-2116.5900000000256
12873,2022-04-30 09:45:00,-1116.92,237964.41000000024,241197.92000000027,-3233.5100000000384
12874,2022-04-30 09:50:00,-593.78,237370.63000000024,241197.92000000027,-3827.2900000000373
12875,2022-04-30 09:55:00,-1224.85,236145.78000000023,241197.92000000027,-5052.140000000043
12876,2022-04-30 10:00:00,-308.1,235837.68000000023,241197.92000000027,-5360.240000000049
12877,2022-04-30 10:05:00,1848.53,237686.21000000022,241197.92000000027,-3511.71000000005
12878,2022-04-30 10:10:00,-805.39,236880.8200000002,241197.92000000027,-4317.100000000064
12879,2022-04-30 10:15:00,337.22,237218.0400000002,241197.92000000027,-3979.880000000063
12880,2022-04-30 10:20:00,1502.32,238720.36000000022,241197.92000000027,-2477.560000000056
12881,2022-04-30 10:25:00,-338.0,238382.36000000022,241197.92000000027,-2815.560000000056
12882,2022-04-30 10:30:00,1088.81,239471.17000000022,241197.92000000027,-1726.7500000000582
12883,2022-04-30 10:35:00,1508.53,240979.70000000022,241197.92000000027,-218.22000000005937
12884,2022-04-30 10:40:00,1375.15,242354.8500000002,241197.92000000027,1156.9299999999348
12885,2022-04-30 10:45:00,-1730.68,240624.17000000022,241197.92000000027,-573.7500000000582
12886,2022-04-30 10:50:00,1081.78,241705.95000000022,241197.92000000027,508.0299999999406
12887,2022-04-30 10:55:00,-1007.58,240698.37000000023,241197.92000000027,-499.55000000004657
12888,2022-04-30 11:00:00,-1052.9,239645.47000000023,241197.92000000027,-1552.4500000000407
12889,2022-04-30 11:05:00,-186.56,239458.91000000024,241197.92000000027,-1739.0100000000384
12890,2022-04-30 11:10:00,-1901.34,237557.57000000024,241197.92000000027,-3640.350000000035
12891,2022-04-30 11:15:00,1879.56,239437.13000000024,241197.92000000027,-1760.7900000000373
12892,2022-04-30 11:20:00,-1276.78,238160.35000000024,241197.92000000027,-3037.570000000036
12893,2022-04-30 11:25:00,-953.47,237206.88000000024,241197.92000000027,-3991.0400000000373
12894,2022-04-30 11:30:00,1072.64,238279.52000000025,241197.92000000027,-2918.4000000000233
12895,2022-04-30 11:35:00,-1188.42,237091.10000000024,241197.92000000027,-4106.820000000036
12896,2022-04-30 11:40:00,1027.51,238118.61000000025,241197.92000000027,-3079.310000000027
12897,2022-04-30 11:45:00,1876.41,239995.02000000025,241197.92000000027,-1202.9000000000233
12898,2022-04-30 11:50:00,560.67,240555.69000000026,241197.92000000027,-642.2300000000105
12899,2022-04-30 11:55:00,-1753.31,238802.38000000027,241197.92000000027,-2395.540000000008
12900,2022-04-30 12:00:00,-1992.34,236810.04000000027,241197.92000000027,-4387.880000000005
12901,2022-04-30 12:05:00,-545.31,236264.73000000027,241197.92000000027,-4933.190000000002
12902,2022-04-30 12:10:00,931.16,237195.89000000028,241197.92000000027,-4002.029999999999
12903,2022-04-30 12:15:00,998.69,238194.58000000028,241197.92000000027,-3003.3399999999965
12904,2022-04-30 12:20:00,-258.59,237935.99000000028,241197.92000000027,-3261.929999999993
12905,2022-04-30 12:25:00,-104.6,237831.39000000028,241197.92000000027,-3366.529999999999
12906,2022-04-30 12:30:00,73.21,237904.60000000027,241197.92000000027,-3293.320000000007
12907,2022-04-30 12:35:00,513.12,238417.72000000026,241197.92000000027,-2780.2000000000116
12908,2022-04-30 12:40:00,515.34,238933.06000000026,241197.92000000027,-2264.860000000015
12909,2022-04-30 12:45:00,1243.34,240176.40000000026,241197.92000000027,-1021.5200000000186
12910,2022-04-30 12:50:00,-1217.35,238959.05000000025,241197.92000000027,-2238.8700000000244
12911,2022-04-30 12:55:00,1753.48,240712.53000000026,241197.92000000027,-485.39000000001397
12912,2022-04-30 13:00:00,1522.57,242235.10000000027,241197.92000000027,1037.179999999993
12913,2022-04-30 13:05:00,-1278.37,240956.73000000027,241197.92000000027,-241.19000000000233
12914,2022-04-30 13:10:00,1947.08,242903.81000000026,241197.92000000027,1705.8899999999849
12915,2022-04-30 13:15:00,-1672.44,241231.37000000026,241197.92000000027,33.44999999998254
12916,2022-04-30 13:20:00,880.59,242111.96000000025,241197.92000000027,914.039999999979
12917,2022-04-30 13:25:00,-61.91,242050.05000000025,241197.92000000027,852.1299999999756
12918,2022-04-30 13:30:00,1514.12,243564.17000000025,241197.92000000027,2366.249999999971
12919,2022-04-30 13:35:00,438.38,244002.55000000025,241197.92000000027,2804.6299999999756
12920,2022-04-30 13:40:00,1010.41,245012.96000000025,241197.92000000027,3815.039999999979
12921,2022-04-30 13:45:00,648.79,245661.75000000026,241197.92000000027,4463.829999999987
12922,2022-04-30 13:50:00,-1530.0,244131.75000000026,241197.92000000027,2933.829999999987
12923,2022-04-30 13:55:00,1016.27,245148.02000000025,241197.92000000027,3950.0999999999767
12924,2022-04-30 14:00:00,-405.32,244742.70000000024,241197.92000000027,3544.7799999999697
12925,2022-04-30 14:05:00,1205.9,245948.60000000024,241197.92000000027,4750.679999999964
12926,2022-04-30 14:10:00,-920.0,245028.60000000024,241197.92000000027,3830.679999999964
12927,2022-04-30 14:15:00,-1273.99,243754.61000000025,241197.92000000027,2556.689999999973
12928,2022-04-30 14:20:00,1462.82,245217.43000000025,241197.92000000027,4019.50999999998
12929,2022-04-30 14:25:00,1602.85,246820.28000000026,241197.92000000027,5622.359999999986
12930,2022-04-30 14:30:00,-1736.98,245083.30000000025,241197.92000000027,3885.3799999999756
12931,2022-04-30 14:35:00,240.53,245323.83000000025,241197.92000000027,4125.909999999974
12932,2022-04-30 14:40:00,-1461.94,243861.89000000025,241197.92000000027,2663.969999999972
12933,2022-04-30 14:45:00,-5.8,243856.09000000026,241197.92000000027,2658.1699999999837
12934,2022-04-30 14:50:00,-590.66,243265.43000000025,241197.92000000027,2067.50999999998
12935,2022-04-30 14:55:00,-578.85,242686.58000000025,241197.92000000027,1488.6599999999744
12936,2022-04-30 15:00:00,-1548.22,241138.36000000025,241197.92000000027,-59.560000000026776
12937,2022-04-30 15:05:00,1054.3,242192.66000000024,241197.92000000027,994.7399999999616
12938,2022-04-30 15:10:00,-308.62,241884.04000000024,241197.92000000027,686.1199999999662
12939,2022-04-30 15:15:00,-1013.66,240870.38000000024,241197.92000000027,-327.54000000003725
12940,2022-04-30 15:20:00,-1326.5,239543.88000000024,241197.92000000027,-1654.0400000000373
12941,2022-04-30 15:25:00,1555.83,241099.71000000022,241197.92000000027,-98.21000000005006
12942,2022-04-30 15:30:00,1662.52,242762.2300000002,241197.92000000027,1564.3099999999395
12943,2022-04-30 15:35:00,71.98,242834.21000000022,241197.92000000027,1636.28999999995
12944,2022-04-30 15:40:00,-1186.29,241647.92000000022,241197.92000000027,449.9999999999418
12945,2022-04-30 15:45:00,188.06,241835.9800000002,241197.92000000027,638.0599999999395
12946,2022-04-30 15:50:00,1437.66,243273.64000000022,241197.92000000027,2075.719999999943
12947,2022-04-30 15:55:00,1667.25,244940.89000000022,241197.92000000027,3742.969999999943
12948,2022-04-30 16:00:00,-880.07,244060.8200000002,241197.92000000027,2862.899999999936
12949,2022-04-30 16:05:00,537.41,244598.2300000002,241197.92000000027,3400.3099999999395
12950,2022-04-30 16:10:00,205.0,244803.2300000002,241197.92000000027,3605.3099999999395
12951,2022-04-30 16:15:00,-1752.28,243050.95000000022,241197.92000000027,1853.0299999999406
12952,2022-04-30 16:20:00,1439.56,244490.5100000002,241197.92000000027,3292.5899999999383
12953,2022-04-30 16:25:00,-968.4,243522.11000000022,241197.92000000027,2324.189999999944
12954,2022-04-30 16:30:00,1863.52,245385.6300000002,241197.92000000027,4187.709999999934
12955,2022-04-30 16:35:00,-1799.61,243586.02000000022,241197.92000000027,2388.0999999999476
12956,2022-04-30 16:40:00,-93.79,243492.2300000002,241197.92000000027,2294.3099999999395
12957,2022-04-30 16:45:00,-1762.63,241729.6000000002,241197.92000000027,531.6799999999348
12958,2022-04-30 16:50:00,908.22,242637.8200000002,241197.92000000027,1439.899999999936
12959,2022-04-30 16:55:00,1799.17,244436.99000000022,241197.92000000027,3239.069999999949
12960,2022-05-01 08:00:00,1838.79,246275.78000000023,244436.99000000022,1838.7900000000081
12961,2022-05-01 08:05:00,-1998.71,244277.07000000024,244436.99000000022,-159.9199999999837
12962,2022-05-01 08:10:00,-1003.55,243273.52000000025,244436.99000000022,-1163.469999999972
12963,2022-05-01 08:15:00,567.69,243841.21000000025,244436.99000000022,-595.7799999999697
12964,2022-05-01 08:20:00,400.66,244241.87000000026,244436.99000000022,-195.11999999996624
12965,2022-05-01 08:25:00,-1588.09,242653.78000000026,244436.99000000022,-1783.2099999999627
12966,2022-05-01 08:30:00,423.48,243077.26000000027,244436.99000000022,-1359.7299999999523
12967,2022-05-01 08:35:00,464.86,243542.12000000026,244436.99000000022,-894.8699999999662
12968,2022-05-01 08:40:00,1295.85,244837.97000000026,244436.99000000022,400.9800000000396
12969,2022-05-01 08:45:00,-44.75,244793.22000000026,244436.99000000022,356.2300000000396
12970,2022-05-01 08:50:00,-898.79,243894.43000000025,244436.99000000022,-542.5599999999686
12971,2022-05-01 08:55:00,1116.94,245011.37000000026,244436.99000000022,574.3800000000338
12972,2022-05-01 09:00:00,-969.24,244042.13000000027,244436.99000000022,-394.8599999999569
12973,2022-05-01 09:05:00,-930.86,243111.27000000028,244436.99000000022,-1325.719999999943
12974,2022-05-01 09:10:00,-1843.24,241268.0300000003,244436.99000000022,-3168.9599999999336
12975,2022-05-01 09:15:00,-100.52,241167.5100000003,244436.99000000022,-3269.479999999923
12976,2022-05-01 09:20:00,-1271.71,239895.8000000003,244436.99000000022,-4541.189999999915
12977,2022-05-01 09:25:00,-1588.17,238307.6300000003,244436.99000000022,-6129.359999999928
12978,2022-05-01 09:30:00,-797.61,237510.0200000003,244436.99000000022,-6926.969999999914
12979,2022-05-01 09:35:00,739.06,238249.0800000003,244436.99000000022,-6187.909999999916
12980,2022-05-01 09:40:00,1624.67,239873.75000000032,244436.99000000022,-4563.239999999903
12981,2022-05-01 09:45:00,1228.51,241102.26000000033,244436.99000000022,-3334.729999999894
12982,2022-05-01 09:50:00,1263.8,242366.06000000032,244436.99000000022,-2070.9299999999057
12983,2022-05-01 09:55:00,-835.1,241530.9600000003,244436.99000000022,-2906.0299999999115
12984,2022-05-01 10:00:00,995.65,242526.6100000003,244436.99000000022,-1910.3799999999173
12985,2022-05-01 10:05:00,481.06,243007.6700000003,244436.99000000022,-1429.3199999999197
12986,2022-05-01 10:10:00,622.62,243630.2900000003,244436.99000000022,-806.6999999999243
12987,2022-05-01 10:15:00,-1460.64,242169.65000000029,244436.99000000022,-2267.3399999999383
12988,2022-05-01 10:20:00,1007.9,243177.55000000028,244436.99000000022,-1259.4399999999441
12989,2022-05-01 10:25:00,-407.31,242770.24000000028,244436.99000000022,-1666.7499999999418
12990,2022-05-01 10:30:00,926.69,243696.93000000028,244436.99000000022,-740.0599999999395
12991,2022-05-01 10:35:00,490.79,244187.7200000003,244436.99000000022,-249.26999999993131
12992,2022-05-01 10:40:00,1617.97,245805.6900000003,244436.99000000022,1368.7000000000698
12993,2022-05-01 10:45:00,483.57,246289.2600000003,244436.99000000022,1852.2700000000768
12994,2022-05-01 10:50:00,-702.25,245587.0100000003,244436.99000000022,1150.0200000000768
12995,2022-05-01 10:55:00,-1897.66,243689.3500000003,244436.99000000022,-747.6399999999267
12996,2022-05-01 11:00:00,-1790.07,241899.2800000003,244436.99000000022,-2537.7099999999336
12997,2022-05-01 11:05:00,-386.89,241512.39000000028,244436.99000000022,-2924.5999999999476
12998,2022-05-01 11:10:00,-275.91,241236.48000000027,244436.99000000022,-3200.509999999951
12999,2022-05-01 11:15:00,177.32,241413.80000000028,244436.99000000022,-3023.189999999944
13000,2022-05-01 11:20:00,-856.68,240557.1200000003,244436.99000000022,-3879.869999999937
13001,2022-05-01 11:25:00,673.83,241230.95000000027,244436.99000000022,-3206.03999999995
13002,2022-05-01 11:30:00,1068.96,242299.91000000027,244436.99000000022,-2137.079999999958
13003,2022-05-01 11:35:00,185.42,242485.33000000028,244436.99000000022,-1951.6599999999453
13004,2022-05-01 11:40:00,-1663.7,240821.63000000027,244436.99000000022,-3615.359999999957
13005,2022-05-01 11:45:00,-1352.9,239468.73000000027,244436.99000000022,-4968.259999999951
13006,2022-05-01 11:50:00,1035.58,240504.31000000026,244436.99000000022,-3932.679999999964
13007,2022-05-01 11:55:00,234.39,240738.70000000027,244436.99000000022,-3698.28999999995
13008,2022-05-01 12:00:00,-1587.92,239150.78000000026,244436.99000000022,-5286.209999999963
13009,2022-05-01 12:05:00,-1776.05,237374.73000000027,244436.99000000022,-7062.259999999951
13010,2022-05-01 12:10:00,-1842.25,235532.48000000027,244436.99000000022,-8904.509999999951
13011,2022-05-01 12:15:00,-1487.64,234044.84000000026,244436.99000000022,-10392.149999999965
13012,2022-05-01 12:20:00,-78.19,233966.65000000026,244436.99000000022,-10470.339999999967
13013,2022-05-01 12:25:00,-1432.58,232534.07000000027,244436.99000000022,-11902.919999999955
13014,2022-05-01 12:30:00,-713.84,231820.23000000027,244436.99000000022,-12616.759999999951
13015,2022-05-01 12:35:00,1071.33,232891.56000000026,244436.99000000022,-11545.429999999964
13016,2022-05-01 12:40:00,-775.73,232115.83000000025,244436.99000000022,-12321.159999999974
13017,2022-05-01 12:45:00,-966.62,231149.21000000025,244436.99000000022,-13287.77999999997
13018,2022-05-01 12:50:00,-1209.24,229939.97000000026,244436.99000000022,-14497.01999999996
13019,2022-05-01 12:55:00,-368.55,229571.42000000027,244436.99000000022,-14865.569999999949
13020,2022-05-01 13:00:00,1127.76,230699.18000000028,244436.99000000022,-13737.80999999994
13021,2022-05-01 13:05:00,794.83,231494.01000000027,244436.99000000022,-12942.979999999952
13022,2022-05-01 13:10:00,1652.32,233146.33000000028,244436.99000000022,-11290.659999999945
13023,2022-05-01 13:15:00,-64.54,233081.79000000027,244436.99000000022,-11355.199999999953
13024,2022-05-01 13:20:00,1757.39,234839.18000000028,244436.99000000022,-9597.80999999994
13025,2022-05-01 13:25:00,-1526.15,233313.0300000003,244436.99000000022,-11123.959999999934
13026,2022-05-01 13:30:00,780.77,234093.80000000028,244436.99000000022,-10343.189999999944
13027,2022-05-01 13:35:00,1610.44,235704.24000000028,244436.99000000022,-8732.749999999942
13028,2022-05-01 13:40:00,-1405.05,234299.1900000003,244436.99000000022,-10137.79999999993
13029,2022-05-01 13:45:00,1966.75,236265.9400000003,244436.99000000022,-8171.04999999993
13030,2022-05-01 13:50:00,361.42,236627.3600000003,244436.99000000022,-7809.629999999917
13031,2022-05-01 13:55:00,-265.7,236361.6600000003,244436.99000000022,-8075.329999999929
13032,2022-05-01 14:00:00,-346.81,236014.8500000003,244436.99000000022,-8422.139999999927
13033,2022-05-01 14:05:00,-1566.7,234448.15000000029,244436.99000000022,-9988.839999999938
13034,2022-05-01 14:10:00,1153.05,235601.20000000027,244436.99000000022,-8835.78999999995
13035,2022-05-01 14:15:00,470.8,236072.00000000026,244436.99000000022,-8364.989999999962
13036,2022-05-01 14:20:00,-512.44,235559.56000000026,244436.99000000022,-8877.429999999964
13037,2022-05-01 14:25:00,-1214.63,234344.93000000025,244436.99000000022,-10092.059999999969
13038,2022-05-01 14:30:00,1678.87,236023.80000000025,244436.99000000022,-8413.189999999973
13039,2022-05-01 14:35:00,-1181.69,234842.11000000025,244436.99000000022,-9594.879999999976
13040,2022-05-01 14:40:00,-708.59,234133.52000000025,244436.99000000022,-10303.469999999972
13041,2022-05-01 14:45:00,548.52,234682.04000000024,244436.99000000022,-9754.949999999983
13042,2022-05-01 14:50:00,1931.16,236613.20000000024,244436.99000000022,-7823.789999999979
13043,2022-05-01 14:55:00,-1804.32,234808.88000000024,244436.99000000022,-9628.109999999986
13044,2022-05-01 15:00:00,687.14,235496.02000000025,244436.99000000022,-8940.969999999972
13045,2022-05-01 15:05:00,-1759.19,233736.83000000025,244436.99000000022,-10700.159999999974
13046,2022-05-01 15:10:00,-743.71,232993.12000000026,244436.99000000022,-11443.869999999966
13047,2022-05-01 15:15:00,4.43,232997.55000000025,244436.99000000022,-11439.439999999973
13048,2022-05-01 15:20:00,1289.38,234286.93000000025,244436.99000000022,-10150.059999999969
13049,2022-05-01 15:25:00,-782.09,233504.84000000026,244436.99000000022,-10932.149999999965
13050,2022-05-01 15:30:00,-1422.2,232082.64000000025,244436.99000000022,-12354.349999999977
13051,2022-05-01 15:35:00,-468.07,231614.57000000024,244436.99000000022,-12822.419999999984
13052,2022-05-01 15:40:00,1051.41,232665.98000000024,244436.99000000022,-11771.00999999998
13053,2022-05-01 15:45:00,1748.16,234414.14000000025,244436.99000000022,-10022.849999999977
13054,2022-05-01 15:50:00,-1266.83,233147.31000000026,244436.99000000022,-11289.679999999964
13055,2022-05-01 15:55:00,1179.67,234326.98000000027,244436.99000000022,-10110.009999999951
13056,2022-05-01 16:00:00,1102.02,235429.00000000026,244436.99000000022,-9007.989999999962
13057,2022-05-01 16:05:00,1466.16,236895.16000000027,244436.99000000022,-7541.829999999958
13058,2022-05-01 16:10:00,-1725.35,235169.81000000026,244436.99000000022,-9267.179999999964
13059,2022-05-01 16:15:00,1810.53,236980.34000000026,244436.99000000022,-7456.649999999965
13060,2022-05-01 16:20:00,-1127.77,235852.57000000027,244436.99000000022,-8584.419999999955
13061,2022-05-01 16:25:00,425.87,236278.44000000026,244436.99000000022,-8158.549999999959
13062,2022-05-01 16:30:00,1403.94,237682.38000000027,244436.99000000022,-6754.609999999957
13063,2022-05-01 16:35:00,1632.89,239315.27000000028,244436.99000000022,-5121.719999999943
13064,2022-05-01 16:40:00,-1499.76,237815.51000000027,244436.99000000022,-6621.479999999952
13065,2022-05-01 16:45:00,493.74,238309.25000000026,244436.99000000022,-6127.739999999962
13066,2022-05-01 16:50:00,-424.2,237885.05000000025,244436.99000000022,-6551.939999999973
13067,2022-05-01 16:55:00,1830.58,239715.63000000024,244436.99000000022,-4721.359999999986
13068,2022-05-02 08:00:00,-1290.29,238425.34000000023,239715.63000000024,-1290.2900000000081
13069,2022-05-02 08:05:00,-383.82,238041.52000000022,239715.63000000024,-1674.1100000000151
13070,2022-05-02 08:10:00,175.41,238216.93000000023,239715.63000000024,-1498.7000000000116
13071,2022-05-02 08:15:00,221.8,238438.7300000002,239715.63000000024,-1276.9000000000233
13072,2022-05-02 08:20:00,567.97,239006.70000000022,239715.63000000024,-708.9300000000221
13073,2022-05-02 08:25:00,-893.68,238113.02000000022,239715.63000000024,-1602.6100000000151
13074,2022-05-02 08:30:00,10.08,238123.1000000002,239715.63000000024,-1592.530000000028
13075,2022-05-02 08:35:00,1942.66,240065.7600000002,239715.63000000024,350.12999999997555
13076,2022-05-02 08:40:00,-726.98,239338.7800000002,239715.63000000024,-376.8500000000349
13077,2022-05-02 08:45:00,1290.03,240628.8100000002,239715.63000000024,913.1799999999639
13078,2022-05-02 08:50:00,-1926.41,238702.4000000002,239715.63000000024,-1013.2300000000396
13079,2022-05-02 08:55:00,830.89,239533.2900000002,239715.63000000024,-182.3400000000256
13080,2022-05-02 09:00:00,728.63,240261.92000000022,239715.63000000024,546.289999999979
13081,2022-05-02 09:05:00,-1529.43,238732.49000000022,239715.63000000024,-983.140000000014
13082,2022-05-02 09:10:00,1727.08,240459.5700000002,239715.63000000024,743.9399999999732
13083,2022-05-02 09:15:00,16.57,240476.14000000022,239715.63000000024,760.5099999999802
13084,2022-05-02 09:20:00,1093.82,241569.96000000022,239715.63000000024,1854.3299999999872
13085,2022-05-02 09:25:00,-1480.78,240089.18000000023,239715.63000000024,373.54999999998836
13086,2022-05-02 09:30:00,-1687.81,238401.37000000023,239715.63000000024,-1314.2600000000093
13087,2022-05-02 09:35:00,-1796.54,236604.83000000022,239715.63000000024,-3110.8000000000175
13088,2022-05-02 09:40:00,1369.7,237974.53000000023,239715.63000000024,-1741.1000000000058
13089,2022-05-02 09:45:00,31.59,238006.12000000023,239715.63000000024,-1709.5100000000093
13090,2022-05-02 09:50:00,710.43,238716.55000000022,239715.63000000024,-999.0800000000163
13091,2022-05-02 09:55:00,268.66,238985.21000000022,239715.63000000024,-730.4200000000128
13092,2022-05-02 10:00:00,1251.48,240236.69000000024,239715.63000000024,521.0599999999977
13093,2022-05-02 10:05:00,-398.21,239838.48000000024,239715.63000000024,122.85000000000582
13094,2022-05-02 10:10:00,-455.48,239383.00000000023,239715.63000000024,-332.63000000000466
13095,2022-05-02 10:15:00,-676.03,238706.97000000023,239715.63000000024,-1008.6600000000035
13096,2022-05-02 10:20:00,1941.48,240648.45000000024,239715.63000000024,932.820000000007
13097,2022-05-02 10:25:00,-805.87,239842.58000000025,239715.63000000024,126.95000000001164
13098,2022-05-02 10:30:00,-1530.87,238311.71000000025,239715.63000000024,-1403.9199999999837
13099,2022-05-02 10:35:00,751.99,239063.70000000024,239715.63000000024,-651.929999999993
13100,2022-05-02 10:40:00,847.75,239911.45000000024,239715.63000000024,195.82000000000698
13101,2022-05-02 10:45:00,-1642.01,238269.44000000024,239715.63000000024,-1446.1900000000023
13102,2022-05-02 10:50:00,698.04,238967.48000000024,239715.63000000024,-748.1499999999942
13103,2022-05-02 10:55:00,-302.38,238665.10000000024,239715.63000000024,-1050.5299999999988
13104,2022-05-02 11:00:00,-981.99,237683.11000000025,239715.63000000024,-2032.5199999999895
13105,2022-05-02 11:05:00,1159.75,238842.86000000025,239715.63000000024,-872.7699999999895
13106,2022-05-02 11:10:00,-370.69,238472.17000000025,239715.63000000024,-1243.4599999999919
13107,2022-05-02 11:15:00,42.29,238514.46000000025,239715.63000000024,-1201.1699999999837
13108,2022-05-02 11:20:00,1817.29,240331.75000000026,239715.63000000024,616.1200000000244
13109,2022-05-02 11:25:00,-1171.06,239160.69000000026,239715.63000000024,-554.9399999999732
13110,2022-05-02 11:30:00,1994.13,241154.82000000027,239715.63000000024,1439.1900000000314
13111,2022-05-02 11:35:00,82.39,241237.21000000028,239715.63000000024,1521.5800000000454
13112,2022-05-02 11:40:00,-22.41,241214.80000000028,239715.63000000024,1499.170000000042
13113,2022-05-02 11:45:00,1700.64,242915.4400000003,239715.63000000024,3199.810000000056
13114,2022-05-02 11:50:00,-617.07,242298.3700000003,239715.63000000024,2582.740000000049
13115,2022-05-02 11:55:00,-1655.14,240643.23000000027,239715.63000000024,927.6000000000349
13116,2022-05-02 12:00:00,1376.14,242019.3700000003,239715.63000000024,2303.740000000049
13117,2022-05-02 12:05:00,-1916.58,240102.7900000003,239715.63000000024,387.1600000000617
13118,2022-05-02 12:10:00,-723.05,239379.7400000003,239715.63000000024,-335.88999999992666
13119,2022-05-02 12:15:00,-564.55,238815.19000000032,239715.63000000024,-900.439999999915
13120,2022-05-02 12:20:00,-987.87,237827.32000000033,239715.63000000024,-1888.3099999999104
13121,2022-05-02 12:25:00,1681.19,239508.51000000033,239715.63000000024,-207.11999999990803
13122,2022-05-02 12:30:00,-126.67,239381.84000000032,239715.63000000024,-333.78999999992084
13123,2022-05-02 12:35:00,-1576.61,237805.23000000033,239715.63000000024,-1910.3999999999069
13124,2022-05-02 12:40:00,-615.99,237189.24000000034,239715.63000000024,-2526.3899999998976
13125,2022-05-02 12:45:00,-254.28,236934.96000000034,239715.63000000024,-2780.6699999998964
13126,2022-05-02 12:50:00,1834.2,238769.16000000035,239715.63000000024,-946.4699999998847
13127,2022-05-02 12:55:00,-434.16,238335.00000000035,239715.63000000024,-1380.6299999998882
13128,2022-05-02 13:00:00,-1179.97,237155.03000000035,239715.63000000024,-2560.5999999998894
13129,2022-05-02 13:05:00,1775.56,238930.59000000035,239715.63000000024,-785.0399999998917
13130,2022-05-02 13:10:00,1882.93,240813.52000000034,239715.63000000024,1097.8900000001013
13131,2022-05-02 13:15:00,-1673.77,239139.75000000035,239715.63000000024,-575.8799999998882
13132,2022-05-02 13:20:00,-855.48,238284.27000000034,239715.63000000024,-1431.3599999998987
13133,2022-05-02 13:25:00,-188.57,238095.70000000033,239715.63000000024,-1619.9299999999057
13134,2022-05-02 13:30:00,-1207.0,236888.70000000033,239715.63000000024,-2826.9299999999057
13135,2022-05-02 13:35:00,99.27,236987.97000000032,239715.63000000024,-2727.659999999916
13136,2022-05-02 13:40:00,-1017.83,235970.14000000033,239715.63000000024,-3745.4899999999034
13137,2022-05-02 13:45:00,-1847.11,234123.03000000035,239715.63000000024,-5592.599999999889
13138,2022-05-02 13:50:00,1375.25,235498.28000000035,239715.63000000024,-4217.349999999889
13139,2022-05-02 13:55:00,-1619.45,233878.83000000034,239715.63000000024,-5836.799999999901
13140,2022-05-02 14:00:00,497.42,234376.25000000035,239715.63000000024,-5339.379999999888
13141,2022-05-02 14:05:00,247.87,234624.12000000034,239715.63000000024,-5091.509999999893
13142,2022-05-02 14:10:00,-310.46,234313.66000000035,239715.63000000024,-5401.969999999885
13143,2022-05-02 14:15:00,1688.29,236001.95000000036,239715.63000000024,-3713.6799999998766
13144,2022-05-02 14:20:00,746.59,236748.54000000036,239715.63000000024,-2967.08999999988
13145,2022-05-02 14:25:00,-105.08,236643.46000000037,239715.63000000024,-3072.1699999998673
13146,2022-05-02 14:30:00,-1268.51,235374.95000000036,239715.63000000024,-4340.679999999877
13147,2022-05-02 14:35:00,319.33,235694.28000000035,239715.63000000024,-4021.3499999998894
13148,2022-05-02 14:40:00,678.13,236372.41000000035,239715.63000000024,-3343.2199999998847
13149,2022-05-02 14:45:00,1987.46,238359.87000000034,239715.63000000024,-1355.759999999893
13150,2022-05-02 14:50:00,549.92,238909.79000000036,239715.63000000024,-805.8399999998801
13151,2022-05-02 14:55:00,460.89,239370.68000000037,239715.63000000024,-344.9499999998661
13152,2022-05-02 15:00:00,-1494.65,237876.03000000038,239715.63000000024,-1839.5999999998603
13153,2022-05-02 15:05:00,-1081.73,236794.30000000037,239715.63000000024,-2921.329999999871
13154,2022-05-02 15:10:00,596.7,237391.00000000038,239715.63000000024,-2324.629999999859
13155,2022-05-02 15:15:00,305.11,237696.11000000036,239715.63000000024,-2019.519999999873
13156,2022-05-02 15:20:00,-884.11,236812.00000000038,239715.63000000024,-2903.629999999859
13157,2022-05-02 15:25:00,-1004.18,235807.82000000039,239715.63000000024,-3907.809999999852
13158,2022-05-02 15:30:00,389.79,236197.6100000004,239715.63000000024,-3518.019999999844
13159,2022-05-02 15:35:00,296.05,236493.66000000038,239715.63000000024,-3221.9699999998556
13160,2022-05-02 15:40:00,1727.87,238221.53000000038,239715.63000000024,-1494.0999999998603
13161,2022-05-02 15:45:00,-1339.86,236881.6700000004,239715.63000000024,-2833.9599999998463
13162,2022-05-02 15:50:00,-692.69,236188.9800000004,239715.63000000024,-3526.6499999998487
13163,2022-05-02 15:55:00,-1651.1,234537.88000000038,239715.63000000024,-5177.7499999998545
13164,2022-05-02 16:00:00,-655.51,233882.37000000037,239715.63000000024,-5833.259999999864
13165,2022-05-02 16:05:00,1206.53,235088.90000000037,239715.63000000024,-4626.729999999865
13166,2022-05-02 16:10:00,1200.7,236289.60000000038,239715.63000000024,-3426.0299999998533
13167,2022-05-02 16:15:00,1004.02,237293.62000000037,239715.63000000024,-2422.009999999864
13168,2022-05-02 16:20:00,926.08,238219.70000000036,239715.63000000024,-1495.9299999998766
13169,2022-05-02 16:25:00,-1130.74,237088.96000000037,239715.63000000024,-2626.6699999998673
13170,2022-05-02 16:30:00,-624.39,236464.57000000036,239715.63000000024,-3251.0599999998813
13171,2022-05-02 16:35:00,714.38,237178.95000000036,239715.63000000024,-2536.6799999998766
13172,2022-05-02 16:40:00,-1202.25,235976.70000000036,239715.63000000024,-3738.9299999998766
13173,2022-05-02 16:45:00,12.68,235989.38000000035,239715.63000000024,-3726.2499999998836
13174,2022-05-02 16:50:00,425.53,236414.91000000035,239715.63000000024,-3300.7199999998847
13175,2022-05-02 16:55:00,-531.61,235883.30000000037,239715.63000000024,-3832.329999999871
13176,2022-05-03 08:00:00,105.28,235988.58000000037,235883.30000000037,105.27999999999884
13177,2022-05-03 08:05:00,-1329.19,234659.39000000036,235883.30000000037,-1223.9100000000035
13178,2022-05-03 08:10:00,-1336.01,233323.38000000035,235883.30000000037,-2559.920000000013
13179,2022-05-03 08:15:00,-584.65,232738.73000000036,235883.30000000037,-3144.570000000007
13180,2022-05-03 08:20:00,1002.53,233741.26000000036,235883.30000000037,-2142.040000000008
13181,2022-05-03 08:25:00,-1243.32,232497.94000000035,235883.30000000037,-3385.360000000015
13182,2022-05-03 08:30:00,293.81,232791.75000000035,235883.30000000037,-3091.5500000000175
13183,2022-05-03 08:35:00,-1253.58,231538.17000000036,235883.30000000037,-4345.130000000005
13184,2022-05-03 08:40:00,1268.12,232806.29000000036,235883.30000000037,-3077.0100000000093
13185,2022-05-03 08:45:00,-364.25,232442.04000000036,235883.30000000037,-3441.2600000000093
13186,2022-05-03 08:50:00,1030.65,233472.69000000035,235883.30000000037,-2410.610000000015
13187,2022-05-03 08:55:00,-1728.65,231744.04000000036,235883.30000000037,-4139.260000000009
13188,2022-05-03 09:00:00,552.05,232296.09000000035,235883.30000000037,-3587.210000000021
13189,2022-05-03 09:05:00,862.86,233158.95000000033,235883.30000000037,-2724.350000000035
13190,2022-05-03 09:10:00,1350.22,234509.17000000033,235883.30000000037,-1374.1300000000338
13191,2022-05-03 09:15:00,-439.09,234070.08000000034,235883.30000000037,-1813.2200000000303
13192,2022-05-03 09:20:00,400.0,234470.08000000034,235883.30000000037,-1413.2200000000303
13193,2022-05-03 09:25:00,-3.67,234466.41000000032,235883.30000000037,-1416.890000000043
13194,2022-05-03 09:30:00,-115.92,234350.4900000003,235883.30000000037,-1532.8100000000559
13195,2022-05-03 09:35:00,958.49,235308.9800000003,235883.30000000037,-574.3200000000652
13196,2022-05-03 09:40:00,750.87,236059.8500000003,235883.30000000037,176.54999999993015
13197,2022-05-03 09:45:00,304.73,236364.5800000003,235883.30000000037,481.2799999999406
13198,2022-05-03 09:50:00,1876.18,238240.7600000003,235883.30000000037,2357.4599999999336
13199,2022-05-03 09:55:00,1008.97,239249.7300000003,235883.30000000037,3366.429999999935
13200,2022-05-03 10:00:00,-841.81,238407.9200000003,235883.30000000037,2524.619999999937
13201,2022-05-03 10:05:00,-1831.87,236576.0500000003,235883.30000000037,692.7499999999418
13202,2022-05-03 10:10:00,-1183.71,235392.34000000032,235883.30000000037,-490.96000000005006
13203,2022-05-03 10:15:00,845.28,236237.62000000032,235883.30000000037,354.3199999999488
13204,2022-05-03 10:20:00,755.88,236993.50000000032,235883.30000000037,1110.1999999999534
13205,2022-05-03 10:25:00,-1180.71,235812.79000000033,235883.30000000037,-70.51000000003842
13206,2022-05-03 10:30:00,386.83,236199.62000000032,235883.30000000037,316.3199999999488
13207,2022-05-03 10:35:00,37.22,236236.84000000032,235883.30000000037,353.53999999994994
13208,2022-05-03 10:40:00,-1503.28,234733.56000000032,235883.30000000037,-1149.740000000049
13209,2022-05-03 10:45:00,1918.58,236652.1400000003,235883.30000000037,768.8399999999383
13210,2022-05-03 10:50:00,766.84,237418.9800000003,235883.30000000037,1535.6799999999348
13211,2022-05-03 10:55:00,1256.79,238675.7700000003,235883.30000000037,2792.469999999943
13212,2022-05-03 11:00:00,127.32,238803.09000000032,235883.30000000037,2919.78999999995
13213,2022-05-03 11:05:00,-184.61,238618.48000000033,235883.30000000037,2735.179999999964
13214,2022-05-03 11:10:00,-419.13,238199.35000000033,235883.30000000037,2316.0499999999593
13215,2022-05-03 11:15:00,-1223.13,236976.22000000032,235883.30000000037,1092.9199999999546
13216,2022-05-03 11:20:00,-1480.66,235495.56000000032,235883.30000000037,-387.7400000000489
13217,2022-05-03 11:25:00,-263.59,235231.97000000032,235883.30000000037,-651.3300000000454
13218,2022-05-03 11:30:00,704.58,235936.5500000003,235883.30000000037,53.24999999994179
13219,2022-05-03 11:35:00,152.05,236088.6000000003,235883.30000000037,205.29999999993015
13220,2022-05-03 11:40:00,-93.73,235994.8700000003,235883.30000000037,111.56999999991967
13221,2022-05-03 11:45:00,-636.8,235358.0700000003,235883.30000000037,-525.2300000000687
13222,2022-05-03 11:50:00,-1345.71,234012.3600000003,235883.30000000037,-1870.9400000000605
13223,2022-05-03 11:55:00,1393.16,235405.5200000003,235883.30000000037,-477.78000000005704
13224,2022-05-03 12:00:00,-1289.86,234115.66000000032,235883.30000000037,-1767.640000000043
13225,2022-05-03 12:05:00,1976.11,236091.7700000003,235883.30000000037,208.46999999994296
13226,2022-05-03 12:10:00,-606.21,235485.56000000032,235883.30000000037,-397.7400000000489
13227,2022-05-03 12:15:00,-1339.06,234146.50000000032,235883.30000000037,-1736.8000000000466
13228,2022-05-03 12:20:00,-508.85,233637.6500000003,235883.30000000037,-2245.6500000000524
13229,2022-05-03 12:25:00,87.18,233724.8300000003,235883.30000000037,-2158.4700000000594
13230,2022-05-03 12:30:00,-1938.74,231786.09000000032,235883.30000000037,-4097.21000000005
13231,2022-05-03 12:35:00,-1749.96,230036.13000000032,235883.30000000037,-5847.170000000042
13232,2022-05-03 12:40:00,-1031.99,229004.14000000033,235883.30000000037,-6879.160000000033
13233,2022-05-03 12:45:00,1805.41,230809.55000000034,235883.30000000037,-5073.750000000029
13234,2022-05-03 12:50:00,-340.91,230468.64000000033,235883.30000000037,-5414.660000000033
13235,2022-05-03 12:55:00,1213.08,231681.72000000032,235883.30000000037,-4201.580000000045
13236,2022-05-03 13:00:00,1044.46,232726.1800000003,235883.30000000037,-3157.1200000000536
13237,2022-05-03 13:05:00,1834.18,234560.3600000003,235883.30000000037,-1322.9400000000605
13238,2022-05-03 13:10:00,-291.1,234269.2600000003,235883.30000000037,-1614.0400000000664
13239,2022-05-03 13:15:00,-896.51,233372.7500000003,235883.30000000037,-2510.5500000000757
13240,2022-05-03 13:20:00,495.47,233868.2200000003,235883.30000000037,-2015.0800000000745
13241,2022-05-03 13:25:00,1431.19,235299.4100000003,235883.30000000037,-583.8900000000722
13242,2022-05-03 13:30:00,1088.96,236388.3700000003,235883.30000000037,505.0699999999197
13243,2022-05-03 13:35:00,-1413.79,234974.58000000028,235883.30000000037,-908.7200000000885
13244,2022-05-03 13:40:00,671.49,235646.07000000027,235883.30000000037,-237.2300000000978
13245,2022-05-03 13:45:00,114.09,235760.16000000027,235883.30000000037,-123.14000000010128
13246,2022-05-03 13:50:00,1277.81,237037.97000000026,235883.30000000037,1154.6699999998964
13247,2022-05-03 13:55:00,-913.12,236124.85000000027,235883.30000000037,241.54999999990105
13248,2022-05-03 14:00:00,-413.08,235711.77000000028,235883.30000000037,-171.53000000008615
13249,2022-05-03 14:05:00,-391.26,235320.51000000027,235883.30000000037,-562.7900000000955
13250,2022-05-03 14:10:00,934.82,236255.33000000028,235883.30000000037,372.0299999999115
13251,2022-05-03 14:15:00,154.5,236409.83000000028,235883.30000000037,526.5299999999115
13252,2022-05-03 14:20:00,1770.39,238180.2200000003,235883.30000000037,2296.9199999999255
13253,2022-05-03 14:25:00,1398.02,239578.24000000028,235883.30000000037,3694.939999999915
13254,2022-05-03 14:30:00,-467.13,239111.11000000028,235883.30000000037,3227.8099999999104
13255,2022-05-03 14:35:00,-532.79,238578.32000000027,235883.30000000037,2695.019999999902
13256,2022-05-03 14:40:00,-441.27,238137.05000000028,235883.30000000037,2253.7499999999127
13257,2022-05-03 14:45:00,-668.78,237468.27000000028,235883.30000000037,1584.9699999999139
13258,2022-05-03 14:50:00,1941.71,239409.98000000027,235883.30000000037,3526.6799999999057
13259,2022-05-03 14:55:00,-1084.96,238325.02000000028,235883.30000000037,2441.719999999914
13260,2022-05-03 15:00:00,15.35,238340.3700000003,235883.30000000037,2457.0699999999197
13261,2022-05-03 15:05:00,-1172.34,237168.0300000003,235883.30000000037,1284.7299999999232
13262,2022-05-03 15:10:00,1273.12,238441.15000000029,235883.30000000037,2557.8499999999185
13263,2022-05-03 15:15:00,-473.7,237967.45000000027,235883.30000000037,2084.149999999907
13264,2022-05-03 15:20:00,1497.63,239465.08000000028,235883.30000000037,3581.7799999999115
13265,2022-05-03 15:25:00,-1401.66,238063.42000000027,235883.30000000037,2180.119999999908
13266,2022-05-03 15:30:00,1023.4,239086.82000000027,235883.30000000037,3203.519999999902
13267,2022-05-03 15:35:00,807.86,239894.68000000025,235883.30000000037,4011.3799999998882
13268,2022-05-03 15:40:00,-1888.76,238005.92000000025,235883.30000000037,2122.619999999879
13269,2022-05-03 15:45:00,-1537.09,236468.83000000025,235883.30000000037,585.5299999998824
13270,2022-05-03 15:50:00,554.36,237023.19000000024,235883.30000000037,1139.8899999998685
13271,2022-05-03 15:55:00,1005.04,238028.23000000024,235883.30000000037,2144.9299999998766
13272,2022-05-03 16:00:00,1792.14,239820.37000000026,235883.30000000037,3937.0699999998906
13273,2022-05-03 16:05:00,-415.16,239405.21000000025,235883.30000000037,3521.909999999887
13274,2022-05-03 16:10:00,-1450.49,237954.72000000026,235883.30000000037,2071.4199999998964
13275,2022-05-03 16:15:00,-527.86,237426.86000000028,235883.30000000037,1543.5599999999104
13276,2022-05-03 16:20:00,1641.88,239068.74000000028,235883.30000000037,3185.439999999915
13277,2022-05-03 16:25:00,1252.1,240320.8400000003,235883.30000000037,4437.539999999921
13278,2022-05-03 16:30:00,927.43,241248.27000000028,235883.30000000037,5364.969999999914
13279,2022-05-03 16:35:00,1107.34,242355.61000000028,235883.30000000037,6472.30999999991
13280,2022-05-03 16:40:00,1692.57,244048.18000000028,235883.30000000037,8164.879999999917
13281,2022-05-03 16:45:00,-1547.21,242500.9700000003,235883.30000000037,6617.6699999999255
13282,2022-05-03 16:50:00,-1775.94,240725.0300000003,235883.30000000037,4841.729999999923
13283,2022-05-03 16:55:00,1588.08,242313.11000000028,235883.30000000037,6429.80999999991
13284,2022-05-04 08:00:00,-1410.49,240902.6200000003,242313.11000000028,-1410.4899999999907
13285,2022-05-04 08:05:00,692.71,241595.33000000028,242313.11000000028,-717.7799999999988
13286,2022-05-04 08:10:00,268.53,241863.86000000028,242313.11000000028,-449.25
13287,2022-05-04 08:15:00,1194.45,243058.3100000003,242313.11000000028,745.2000000000116
13288,2022-05-04 08:20:00,-1884.59,241173.7200000003,242313.11000000028,-1139.3899999999849
13289,2022-05-04 08:25:00,-1746.97,239426.7500000003,242313.11000000028,-2886.359999999986
13290,2022-05-04 08:30:00,-701.57,238725.18000000028,242313.11000000028,-3587.929999999993
13291,2022-05-04 08:35:00,1039.42,239764.6000000003,242313.11000000028,-2548.50999999998
13292,2022-05-04 08:40:00,1385.04,241149.6400000003,242313.11000000028,-1163.469999999972
13293,2022-05-04 08:45:00,515.44,241665.0800000003,242313.11000000028,-648.0299999999697
13294,2022-05-04 08:50:00,-1000.21,240664.87000000032,242313.11000000028,-1648.2399999999616
13295,2022-05-04 08:55:00,321.61,240986.4800000003,242313.11000000028,-1326.6299999999756
13296,2022-05-04 09:00:00,926.35,241912.8300000003,242313.11000000028,-400.27999999996973
13297,2022-05-04 09:05:00,864.11,242776.9400000003,242313.11000000028,463.8300000000163
13298,2022-05-04 09:10:00,324.68,243101.6200000003,242313.11000000028,788.5100000000093
13299,2022-05-04 09:15:00,1149.85,244251.4700000003,242313.11000000028,1938.3600000000151
13300,2022-05-04 09:20:00,-1454.93,242796.5400000003,242313.11000000028,483.4300000000221
13301,2022-05-04 09:25:00,-628.15,242168.3900000003,242313.11000000028,-144.71999999997206
13302,2022-05-04 09:30:00,605.36,242773.7500000003,242313.11000000028,460.64000000001397
13303,2022-05-04 09:35:00,1386.12,244159.8700000003,242313.11000000028,1846.7600000000093
13304,2022-05-04 09:40:00,1374.25,245534.1200000003,242313.11000000028,3221.0100000000093
13305,2022-05-04 09:45:00,-714.97,244819.15000000029,242313.11000000028,2506.040000000008
13306,2022-05-04 09:50:00,-940.19,243878.96000000028,242313.11000000028,1565.8500000000058
13307,2022-05-04 09:55:00,-1707.31,242171.65000000029,242313.11000000028,-141.45999999999185
13308,2022-05-04 10:00:00,-1035.78,241135.8700000003,242313.11000000028,-1177.2399999999907
13309,2022-05-04 10:05:00,1034.49,242170.36000000028,242313.11000000028,-142.75
13310,2022-05-04 10:10:00,91.16,242261.52000000028,242313.11000000028,-51.58999999999651
13311,2022-05-04 10:15:00,-81.56,242179.96000000028,242313.11000000028,-133.14999999999418
13312,2022-05-04 10:20:00,-516.37,241663.5900000003,242313.11000000028,-649.5199999999895
13313,2022-05-04 10:25:00,874.45,242538.0400000003,242313.11000000028,224.93000000002212
13314,2022-05-04 10:30:00,1724.81,244262.8500000003,242313.11000000028,1949.7400000000198
13315,2022-05-04 10:35:00,1096.92,245359.7700000003,242313.11000000028,3046.6600000000326
13316,2022-05-04 10:40:00,24.42,245384.19000000032,242313.11000000028,3071.0800000000454
13317,2022-05-04 10:45:00,-968.45,244415.7400000003,242313.11000000028,2102.6300000000338
13318,2022-05-04 10:50:00,494.45,244910.19000000032,242313.11000000028,2597.0800000000454
13319,2022-05-04 10:55:00,1794.47,246704.66000000032,242313.11000000028,4391.550000000047
13320,2022-05-04 11:00:00,-688.88,246015.78000000032,242313.11000000028,3702.670000000042
13321,2022-05-04 11:05:00,553.78,246569.56000000032,242313.11000000028,4256.450000000041
13322,2022-05-04 11:10:00,-937.81,245631.75000000032,242313.11000000028,3318.640000000043
13323,2022-05-04 11:15:00,1146.04,246777.79000000033,242313.11000000028,4464.680000000051
13324,2022-05-04 11:20:00,324.72,247102.51000000033,242313.11000000028,4789.400000000052
13325,2022-05-04 11:25:00,1155.85,248258.36000000034,242313.11000000028,5945.250000000058
13326,2022-05-04 11:30:00,537.2,248795.56000000035,242313.11000000028,6482.45000000007
13327,2022-05-04 11:35:00,1735.23,250530.79000000036,242313.11000000028,8217.68000000008
13328,2022-05-04 11:40:00,-1384.13,249146.66000000035,242313.11000000028,6833.550000000076
13329,2022-05-04 11:45:00,-1330.93,247815.73000000036,242313.11000000028,5502.620000000083
13330,2022-05-04 11:50:00,-275.7,247540.03000000035,242313.11000000028,5226.920000000071
13331,2022-05-04 11:55:00,-1253.8,246286.23000000036,242313.11000000028,3973.1200000000827
13332,2022-05-04 12:00:00,1508.19,247794.42000000036,242313.11000000028,5481.310000000085
13333,2022-05-04 12:05:00,-688.09,247106.33000000037,242313.11000000028,4793.2200000000885
13334,2022-05-04 12:10:00,-865.34,246240.99000000037,242313.11000000028,3927.880000000092
13335,2022-05-04 12:15:00,-1814.53,244426.46000000037,242313.11000000028,2113.350000000093
13336,2022-05-04 12:20:00,-1709.88,242716.58000000037,242313.11000000028,403.4700000000885
13337,2022-05-04 12:25:00,2.16,242718.74000000037,242313.11000000028,405.63000000009197
13338,2022-05-04 12:30:00,-681.04,242037.70000000036,242313.11000000028,-275.4099999999162
13339,2022-05-04 12:35:00,-848.62,241189.08000000037,242313.11000000028,-1124.0299999999115
13340,2022-05-04 12:40:00,-572.81,240616.27000000037,242313.11000000028,-1696.8399999999092
13341,2022-05-04 12:45:00,1222.01,241838.28000000038,242313.11000000028,-474.8299999998999
13342,2022-05-04 12:50:00,997.14,242835.4200000004,242313.11000000028,522.3100000001141
13343,2022-05-04 12:55:00,241.1,243076.5200000004,242313.11000000028,763.4100000001199
13344,2022-05-04 13:00:00,-1129.64,241946.88000000038,242313.11000000028,-366.22999999989406
13345,2022-05-04 13:05:00,980.43,242927.31000000038,242313.11000000028,614.200000000099
13346,2022-05-04 13:10:00,490.51,243417.82000000039,242313.11000000028,1104.7100000001083
13347,2022-05-04 13:15:00,-1579.33,241838.4900000004,242313.11000000028,-474.6199999998789
13348,2022-05-04 13:20:00,18.08,241856.57000000039,242313.11000000028,-456.53999999989173
13349,2022-05-04 13:25:00,-392.51,241464.06000000038,242313.11000000028,-849.049999999901
13350,2022-05-04 13:30:00,-1061.52,240402.5400000004,242313.11000000028,-1910.5699999998906
13351,2022-05-04 13:35:00,1815.15,242217.69000000038,242313.11000000028,-95.41999999989639
13352,2022-05-04 13:40:00,807.23,243024.9200000004,242313.11000000028,711.8100000001141
13353,2022-05-04 13:45:00,280.68,243305.60000000038,242313.11000000028,992.4900000001071
13354,2022-05-04 13:50:00,-845.49,242460.1100000004,242313.11000000028,147.00000000011642
13355,2022-05-04 13:55:00,1614.98,244075.0900000004,242313.11000000028,1761.980000000127
13356,2022-05-04 14:00:00,-134.99,243940.1000000004,242313.11000000028,1626.9900000001362
13357,2022-05-04 14:05:00,923.26,244863.36000000042,242313.11000000028,2550.2500000001455
13358,2022-05-04 14:10:00,1153.99,246017.3500000004,242313.11000000028,3704.240000000136
13359,2022-05-04 14:15:00,302.13,246319.48000000042,242313.11000000028,4006.370000000141
13360,2022-05-04 14:20:00,1284.7,247604.18000000043,242313.11000000028,5291.0700000001525
13361,2022-05-04 14:25:00,1940.88,249545.06000000043,242313.11000000028,7231.950000000157
13362,2022-05-04 14:30:00,1410.99,250956.05000000042,242313.11000000028,8642.940000000148
13363,2022-05-04 14:35:00,-404.81,250551.24000000043,242313.11000000028,8238.13000000015
13364,2022-05-04 14:40:00,431.1,250982.34000000043,242313.11000000028,8669.230000000156
13365,2022-05-04 14:45:00,1973.98,252956.32000000044,242313.11000000028,10643.210000000166
13366,2022-05-04 14:50:00,-1927.45,251028.87000000043,242313.11000000028,8715.760000000155
13367,2022-05-04 14:55:00,-373.54,250655.33000000042,242313.11000000028,8342.220000000147
13368,2022-05-04 15:00:00,-1706.81,248948.52000000043,242313.11000000028,6635.410000000149
13369,2022-05-04 15:05:00,-1486.01,247462.51000000042,242313.11000000028,5149.40000000014
13370,2022-05-04 15:10:00,31.46,247493.9700000004,242313.11000000028,5180.860000000132
13371,2022-05-04 15:15:00,-1377.12,246116.8500000004,242313.11000000028,3803.740000000136
13372,2022-05-04 15:20:00,57.12,246173.9700000004,242313.11000000028,3860.8600000001315
13373,2022-05-04 15:25:00,551.71,246725.6800000004,242313.11000000028,4412.570000000123
13374,2022-05-04 15:30:00,-764.77,245960.9100000004,242313.11000000028,3647.800000000134
13375,2022-05-04 15:35:00,1692.8,247653.7100000004,242313.11000000028,5340.600000000122
13376,2022-05-04 15:40:00,664.01,248317.7200000004,242313.11000000028,6004.610000000132
13377,2022-05-04 15:45:00,-585.05,247732.67000000042,242313.11000000028,5419.560000000143
13378,2022-05-04 15:50:00,-968.55,246764.12000000043,242313.11000000028,4451.010000000155
13379,2022-05-04 15:55:00,1977.13,248741.25000000044,242313.11000000028,6428.1400000001595
13380,2022-05-04 16:00:00,1039.96,249781.21000000043,242313.11000000028,7468.100000000151
13381,2022-05-04 16:05:00,1472.88,251254.09000000043,242313.11000000028,8940.980000000156
13382,2022-05-04 16:10:00,-961.32,250292.77000000043,242313.11000000028,7979.660000000149
13383,2022-05-04 16:15:00,-1526.05,248766.72000000044,242313.11000000028,6453.610000000161
13384,2022-05-04 16:20:00,1259.92,250026.64000000045,242313.11000000028,7713.5300000001735
13385,2022-05-04 16:25:00,1429.55,251456.19000000044,242313.11000000028,9143.080000000162
13386,2022-05-04 16:30:00,1312.76,252768.95000000045,242313.11000000028,10455.840000000171
13387,2022-05-04 16:35:00,1799.79,254568.74000000046,242313.11000000028,12255.63000000018
13388,2022-05-04 16:40:00,310.45,254879.19000000047,242313.11000000028,12566.080000000191
13389,2022-05-04 16:45:00,1505.48,256384.67000000048,242313.11000000028,14071.560000000201
13390,2022-05-04 16:50:00,471.99,256856.66000000047,242313.11000000028,14543.550000000192
13391,2022-05-04 16:55:00,851.93,257708.59000000046,242313.11000000028,15395.480000000185
13392,2022-05-05 08:00:00,-1724.66,255983.93000000046,257708.59000000046,-1724.6600000000035
13393,2022-05-05 08:05:00,-1471.16,254512.77000000046,257708.59000000046,-3195.820000000007
13394,2022-05-05 08:10:00,-1287.46,253225.31000000046,257708.59000000046,-4483.279999999999
13395,2022-05-05 08:15:00,-1504.88,251720.43000000046,257708.59000000046,-5988.1600000000035
13396,2022-05-05 08:20:00,-610.8,251109.63000000047,257708.59000000046,-6598.959999999992
13397,2022-05-05 08:25:00,-1986.24,249123.39000000048,257708.59000000046,-8585.199999999983
13398,2022-05-05 08:30:00,-91.98,249031.41000000047,257708.59000000046,-8677.179999999993
13399,2022-05-05 08:35:00,-1850.45,247180.96000000046,257708.59000000046,-10527.630000000005
13400,2022-05-05 08:40:00,-320.29,246860.67000000045,257708.59000000046,-10847.920000000013
13401,2022-05-05 08:45:00,1071.79,247932.46000000046,257708.59000000046,-9776.130000000005
13402,2022-05-05 08:50:00,-1438.67,246493.79000000044,257708.59000000046,-11214.800000000017
13403,2022-05-05 08:55:00,414.76,246908.55000000045,257708.59000000046,-10800.040000000008
13404,2022-05-05 09:00:00,995.07,247903.62000000046,257708.59000000046,-9804.970000000001
13405,2022-05-05 09:05:00,1831.14,249734.76000000047,257708.59000000046,-7973.829999999987
13406,2022-05-05 09:10:00,-1314.28,248420.48000000048,257708.59000000046,-9288.109999999986
13407,2022-05-05 09:15:00,1611.76,250032.2400000005,257708.59000000046,-7676.349999999977
13408,2022-05-05 09:20:00,-1736.72,248295.52000000048,257708.59000000046,-9413.069999999978
13409,2022-05-05 09:25:00,-1597.59,246697.9300000005,257708.59000000046,-11010.659999999974
13410,2022-05-05 09:30:00,-15.08,246682.8500000005,257708.59000000046,-11025.739999999962
13411,2022-05-05 09:35:00,1547.4,248230.2500000005,257708.59000000046,-9478.339999999967
13412,2022-05-05 09:40:00,-745.7,247484.55000000048,257708.59000000046,-10224.039999999979
13413,2022-05-05 09:45:00,-1709.94,245774.61000000048,257708.59000000046,-11933.979999999981
13414,2022-05-05 09:50:00,1951.37,247725.98000000048,257708.59000000046,-9982.609999999986
13415,2022-05-05 09:55:00,1463.49,249189.47000000047,257708.59000000046,-8519.119999999995
13416,2022-05-05 10:00:00,-760.64,248428.83000000045,257708.59000000046,-9279.76000000001
13417,2022-05-05 10:05:00,-1989.74,246439.09000000046,257708.59000000046,-11269.5
13418,2022-05-05 10:10:00,-862.29,245576.80000000045,257708.59000000046,-12131.790000000008
13419,2022-05-05 10:15:00,1918.88,247495.68000000046,257708.59000000046,-10212.910000000003
13420,2022-05-05 10:20:00,-657.05,246838.63000000047,257708.59000000046,-10869.959999999992
13421,2022-05-05 10:25:00,-491.22,246347.41000000047,257708.59000000046,-11361.179999999993
13422,2022-05-05 10:30:00,1832.85,248180.26000000047,257708.59000000046,-9528.329999999987
13423,2022-05-05 10:35:00,-424.46,247755.80000000048,257708.59000000046,-9952.789999999979
13424,2022-05-05 10:40:00,1959.88,249715.6800000005,257708.59000000046,-7992.909999999974
13425,2022-05-05 10:45:00,-1524.84,248190.8400000005,257708.59000000046,-9517.74999999997
13426,2022-05-05 10:50:00,1024.35,249215.1900000005,257708.59000000046,-8493.399999999965
13427,2022-05-05 10:55:00,489.29,249704.4800000005,257708.59000000046,-8004.109999999957
13428,2022-05-05 11:00:00,1905.28,251609.7600000005,257708.59000000046,-6098.829999999958
13429,2022-05-05 11:05:00,-1930.66,249679.1000000005,257708.59000000046,-8029.489999999962
13430,2022-05-05 11:10:00,798.78,250477.8800000005,257708.59000000046,-7230.709999999963
13431,2022-05-05 11:15:00,-116.93,250360.9500000005,257708.59000000046,-7347.639999999956
13432,2022-05-05 11:20:00,1937.38,252298.3300000005,257708.59000000046,-5410.259999999951
13433,2022-05-05 11:25:00,453.0,252751.3300000005,257708.59000000046,-4957.259999999951
13434,2022-05-05 11:30:00,1110.41,253861.74000000051,257708.59000000046,-3846.8499999999476
13435,2022-05-05 11:35:00,-1234.99,252626.75000000052,257708.59000000046,-5081.839999999938
13436,2022-05-05 11:40:00,1173.24,253799.99000000051,257708.59000000046,-3908.5999999999476
13437,2022-05-05 11:45:00,420.43,254220.4200000005,257708.59000000046,-3488.1699999999546
13438,2022-05-05 11:50:00,156.72,254377.1400000005,257708.59000000046,-3331.4499999999534
13439,2022-05-05 11:55:00,-1871.57,252505.5700000005,257708.59000000046,-5203.01999999996
13440,2022-05-05 12:00:00,-1305.18,251200.3900000005,257708.59000000046,-6508.199999999953
13441,2022-05-05 12:05:00,-1854.2,249346.1900000005,257708.59000000046,-8362.399999999965
13442,2022-05-05 12:10:00,479.01,249825.2000000005,257708.59000000046,-7883.389999999956
13443,2022-05-05 12:15:00,1083.54,250908.74000000051,257708.59000000046,-6799.849999999948
13444,2022-05-05 12:20:00,242.73,251151.47000000053,257708.59000000046,-6557.119999999937
13445,2022-05-05 12:25:00,-1831.81,249319.66000000053,257708.59000000046,-8388.929999999935
13446,2022-05-05 12:30:00,-1055.55,248264.11000000054,257708.59000000046,-9444.479999999923
13447,2022-05-05 12:35:00,783.31,249047.42000000054,257708.59000000046,-8661.169999999925
13448,2022-05-05 12:40:00,1036.81,250084.23000000053,257708.59000000046,-7624.359999999928
13449,2022-05-05 12:45:00,-1873.77,248210.46000000054,257708.59000000046,-9498.129999999917
13450,2022-05-05 12:50:00,120.6,248331.06000000055,257708.59000000046,-9377.529999999912
13451,2022-05-05 12:55:00,-586.35,247744.71000000054,257708.59000000046,-9963.879999999917
13452,2022-05-05 13:00:00,-1168.56,246576.15000000055,257708.59000000046,-11132.439999999915
13453,2022-05-05 13:05:00,1077.81,247653.96000000054,257708.59000000046,-10054.629999999917
13454,2022-05-05 13:10:00,270.35,247924.31000000055,257708.59000000046,-9784.279999999912
13455,2022-05-05 13:15:00,494.28,248418.59000000055,257708.59000000046,-9289.999999999913
13456,2022-05-05 13:20:00,-112.7,248305.89000000054,257708.59000000046,-9402.699999999924
13457,2022-05-05 13:25:00,-237.37,248068.52000000054,257708.59000000046,-9640.06999999992
13458,2022-05-05 13:30:00,-1817.9,246250.62000000055,257708.59000000046,-11457.969999999914
13459,2022-05-05 13:35:00,-2.79,246247.83000000054,257708.59000000046,-11460.759999999922
13460,2022-05-05 13:40:00,-418.66,245829.17000000054,257708.59000000046,-11879.419999999925
13461,2022-05-05 13:45:00,-560.66,245268.51000000053,257708.59000000046,-12440.079999999929
13462,2022-05-05 13:50:00,-483.34,244785.17000000054,257708.59000000046,-12923.419999999925
13463,2022-05-05 13:55:00,-527.66,244257.51000000053,257708.59000000046,-13451.079999999929
13464,2022-05-05 14:00:00,777.61,245035.12000000052,257708.59000000046,-12673.469999999943
13465,2022-05-05 14:05:00,145.62,245180.74000000051,257708.59000000046,-12527.849999999948
13466,2022-05-05 14:10:00,965.42,246146.16000000053,257708.59000000046,-11562.429999999935
13467,2022-05-05 14:15:00,598.32,246744.48000000053,257708.59000000046,-10964.109999999928
13468,2022-05-05 14:20:00,108.2,246852.68000000055,257708.59000000046,-10855.909999999916
13469,2022-05-05 14:25:00,1376.1,248228.78000000055,257708.59000000046,-9479.80999999991
13470,2022-05-05 14:30:00,-1404.36,246824.42000000057,257708.59000000046,-10884.169999999896
13471,2022-05-05 14:35:00,-609.78,246214.64000000057,257708.59000000046,-11493.949999999895
13472,2022-05-05 14:40:00,-743.82,245470.82000000056,257708.59000000046,-12237.769999999902
13473,2022-05-05 14:45:00,1170.88,246641.70000000056,257708.59000000046,-11066.889999999898
13474,2022-05-05 14:50:00,-1748.37,244893.33000000057,257708.59000000046,-12815.259999999893
13475,2022-05-05 14:55:00,467.54,245360.87000000058,257708.59000000046,-12347.719999999885
13476,2022-05-05 15:00:00,44.18,245405.05000000057,257708.59000000046,-12303.539999999892
13477,2022-05-05 15:05:00,-1232.34,244172.71000000057,257708.59000000046,-13535.879999999888
13478,2022-05-05 15:10:00,-1453.6,242719.11000000057,257708.59000000046,-14989.479999999894
13479,2022-05-05 15:15:00,726.26,243445.37000000058,257708.59000000046,-14263.219999999885
13480,2022-05-05 15:20:00,695.93,244141.30000000057,257708.59000000046,-13567.289999999892
13481,2022-05-05 15:25:00,840.22,244981.52000000057,257708.59000000046,-12727.06999999989
13482,2022-05-05 15:30:00,-1935.21,243046.31000000058,257708.59000000046,-14662.279999999882
13483,2022-05-05 15:35:00,1880.98,244927.2900000006,257708.59000000046,-12781.299999999872
13484,2022-05-05 15:40:00,1532.89,246460.1800000006,257708.59000000046,-11248.409999999858
13485,2022-05-05 15:45:00,-1750.47,244709.7100000006,257708.59000000046,-12998.87999999986
13486,2022-05-05 15:50:00,1956.08,246665.7900000006,257708.59000000046,-11042.799999999872
13487,2022-05-05 15:55:00,-558.43,246107.3600000006,257708.59000000046,-11601.229999999865
13488,2022-05-05 16:00:00,1483.68,247591.0400000006,257708.59000000046,-10117.549999999872
13489,2022-05-05 16:05:00,-1850.43,245740.6100000006,257708.59000000046,-11967.979999999865
13490,2022-05-05 16:10:00,195.96,245936.5700000006,257708.59000000046,-11772.019999999873
13491,2022-05-05 16:15:00,-435.14,245501.43000000058,257708.59000000046,-12207.159999999887
13492,2022-05-05 16:20:00,-1669.15,243832.28000000058,257708.59000000046,-13876.309999999881
13493,2022-05-05 16:25:00,1868.7,245700.9800000006,257708.59000000046,-12007.60999999987
13494,2022-05-05 16:30:00,-111.64,245589.34000000058,257708.59000000046,-12119.249999999884
13495,2022-05-05 16:35:00,-1146.98,244442.36000000057,257708.59000000046,-13266.229999999894
13496,2022-05-05 16:40:00,-1461.57,242980.79000000056,257708.59000000046,-14727.799999999901
13497,2022-05-05 16:45:00,-910.3,242070.49000000057,257708.59000000046,-15638.09999999989
13498,2022-05-05 16:50:00,-1454.05,240616.44000000058,257708.59000000046,-17092.149999999878
13499,2022-05-05 16:55:00,-566.2,240050.24000000057,257708.59000000046,-17658.34999999989
13500,2022-05-06 08:00:00,636.68,240686.92000000057,240050.24000000057,636.679999999993
13501,2022-05-06 08:05:00,-1185.23,239501.69000000056,240050.24000000057,-548.5500000000175
13502,2022-05-06 08:10:00,-701.19,238800.50000000055,240050.24000000057,-1249.7400000000198
13503,2022-05-06 08:15:00,-1782.98,237017.52000000054,240050.24000000057,-3032.7200000000303
13504,2022-05-06 08:20:00,1774.43,238791.95000000054,240050.24000000057,-1258.2900000000373
13505,2022-05-06 08:25:00,-1141.68,237650.27000000054,240050.24000000057,-2399.9700000000303
13506,2022-05-06 08:30:00,120.4,237770.67000000054,240050.24000000057,-2279.570000000036
13507,2022-05-06 08:35:00,-1870.81,235899.86000000054,240050.24000000057,-4150.380000000034
13508,2022-05-06 08:40:00,1574.35,237474.21000000054,240050.24000000057,-2576.030000000028
13509,2022-05-06 08:45:00,-1302.59,236171.62000000055,240050.24000000057,-3878.6200000000244
13510,2022-05-06 08:50:00,1114.02,237285.64000000054,240050.24000000057,-2764.600000000035
13511,2022-05-06 08:55:00,1059.61,238345.25000000052,240050.24000000057,-1704.990000000049
13512,2022-05-06 09:00:00,-1531.38,236813.87000000052,240050.24000000057,-3236.3700000000536
13513,2022-05-06 09:05:00,1246.59,238060.46000000052,240050.24000000057,-1989.780000000057
13514,2022-05-06 09:10:00,929.26,238989.72000000053,240050.24000000057,-1060.5200000000477
13515,2022-05-06 09:15:00,1229.0,240218.72000000053,240050.24000000057,168.47999999995227
13516,2022-05-06 09:20:00,1156.95,241375.67000000054,240050.24000000057,1325.429999999964
13517,2022-05-06 09:25:00,-1785.58,239590.09000000055,240050.24000000057,-460.1500000000233
13518,2022-05-06 09:30:00,169.88,239759.97000000055,240050.24000000057,-290.2700000000186
13519,2022-05-06 09:35:00,1650.03,241410.00000000055,240050.24000000057,1359.7599999999802
13520,2022-05-06 09:40:00,-179.75,241230.25000000055,240050.24000000057,1180.0099999999802
13521,2022-05-06 09:45:00,-103.8,241126.45000000056,240050.24000000057,1076.2099999999919
13522,2022-05-06 09:50:00,186.6,241313.05000000057,240050.24000000057,1262.8099999999977
13523,2022-05-06 09:55:00,1821.67,243134.72000000058,240050.24000000057,3084.4800000000105
13524,2022-05-06 10:00:00,1282.52,244417.24000000057,240050.24000000057,4367.0
13525,2022-05-06 10:05:00,1997.29,246414.53000000058,240050.24000000057,6364.290000000008
13526,2022-05-06 10:10:00,-980.66,245433.87000000058,240050.24000000057,5383.630000000005
13527,2022-05-06 10:15:00,-353.44,245080.43000000058,240050.24000000057,5030.190000000002
13528,2022-05-06 10:20:00,-1800.22,243280.21000000057,240050.24000000057,3229.970000000001
13529,2022-05-06 10:25:00,-447.89,242832.32000000056,240050.24000000057,2782.079999999987
13530,2022-05-06 10:30:00,1121.7,243954.02000000057,240050.24000000057,3903.779999999999
13531,2022-05-06 10:35:00,31.23,243985.25000000058,240050.24000000057,3935.0100000000093
13532,2022-05-06 10:40:00,-920.72,243064.53000000058,240050.24000000057,3014.290000000008
13533,2022-05-06 10:45:00,1246.95,244311.4800000006,240050.24000000057,4261.24000000002
13534,2022-05-06 10:50:00,235.97,244547.4500000006,240050.24000000057,4497.210000000021
13535,2022-05-06 10:55:00,27.58,244575.03000000058,240050.24000000057,4524.790000000008
13536,2022-05-06 11:00:00,1769.61,246344.64000000057,240050.24000000057,6294.399999999994
13537,2022-05-06 11:05:00,-1571.16,244773.48000000056,240050.24000000057,4723.239999999991
13538,2022-05-06 11:10:00,-917.61,243855.87000000058,240050.24000000057,3805.6300000000047
13539,2022-05-06 11:15:00,413.4,244269.27000000057,240050.24000000057,4219.029999999999
13540,2022-05-06 11:20:00,1184.7,245453.97000000058,240050.24000000057,5403.7300000000105
13541,2022-05-06 11:25:00,1279.16,246733.1300000006,240050.24000000057,6682.890000000014
13542,2022-05-06 11:30:00,86.53,246819.6600000006,240050.24000000057,6769.420000000013
13543,2022-05-06 11:35:00,132.21,246951.87000000058,240050.24000000057,6901.630000000005
13544,2022-05-06 11:40:00,271.21,247223.08000000057,240050.24000000057,7172.8399999999965
13545,2022-05-06 11:45:00,1582.8,248805.88000000056,240050.24000000057,8755.639999999985
13546,2022-05-06 11:50:00,-912.73,247893.15000000055,240050.24000000057,7842.909999999974
13547,2022-05-06 11:55:00,566.22,248459.37000000055,240050.24000000057,8409.129999999976
13548,2022-05-06 12:00:00,-1315.86,247143.51000000056,240050.24000000057,7093.2699999999895
13549,2022-05-06 12:05:00,1696.57,248840.08000000057,240050.24000000057,8789.839999999997
13550,2022-05-06 12:10:00,-117.79,248722.29000000056,240050.24000000057,8672.049999999988
13551,2022-05-06 12:15:00,-338.81,248383.48000000056,240050.24000000057,8333.23999999999
13552,2022-05-06 12:20:00,344.98,248728.46000000057,240050.24000000057,8678.220000000001
13553,2022-05-06 12:25:00,1849.98,250578.44000000058,240050.24000000057,10528.200000000012
13554,2022-05-06 12:30:00,-1944.08,248634.3600000006,240050.24000000057,8584.120000000024
13555,2022-05-06 12:35:00,1173.37,249807.7300000006,240050.24000000057,9757.49000000002
13556,2022-05-06 12:40:00,-1943.49,247864.2400000006,240050.24000000057,7814.000000000029
13557,2022-05-06 12:45:00,1203.69,249067.9300000006,240050.24000000057,9017.690000000031
13558,2022-05-06 12:50:00,8.04,249075.9700000006,240050.24000000057,9025.73000000004
13559,2022-05-06 12:55:00,985.92,250061.89000000063,240050.24000000057,10011.650000000052
13560,2022-05-06 13:00:00,291.22,250353.11000000063,240050.24000000057,10302.870000000054
13561,2022-05-06 13:05:00,-1358.17,248994.9400000006,240050.24000000057,8944.70000000004
13562,2022-05-06 13:10:00,1242.69,250237.63000000062,240050.24000000057,10187.390000000043
13563,2022-05-06 13:15:00,-1954.89,248282.7400000006,240050.24000000057,8232.50000000003
13564,2022-05-06 13:20:00,-1089.9,247192.8400000006,240050.24000000057,7142.600000000035
13565,2022-05-06 13:25:00,-1735.6,245457.2400000006,240050.24000000057,5407.000000000029
13566,2022-05-06 13:30:00,1940.0,247397.2400000006,240050.24000000057,7347.000000000029
13567,2022-05-06 13:35:00,-1492.24,245905.0000000006,240050.24000000057,5854.760000000038
13568,2022-05-06 13:40:00,-16.41,245888.5900000006,240050.24000000057,5838.350000000035
13569,2022-05-06 13:45:00,-664.01,245224.5800000006,240050.24000000057,5174.340000000026
13570,2022-05-06 13:50:00,-513.22,244711.3600000006,240050.24000000057,4661.120000000024
13571,2022-05-06 13:55:00,-242.63,244468.7300000006,240050.24000000057,4418.49000000002
13572,2022-05-06 14:00:00,1384.48,245853.2100000006,240050.24000000057,5802.97000000003
13573,2022-05-06 14:05:00,-1863.2,243990.0100000006,240050.24000000057,3939.7700000000186
13574,2022-05-06 14:10:00,-1266.35,242723.6600000006,240050.24000000057,2673.420000000013
13575,2022-05-06 14:15:00,1709.09,244432.75000000058,240050.24000000057,4382.510000000009
13576,2022-05-06 14:20:00,-275.88,244156.87000000058,240050.24000000057,4106.630000000005
13577,2022-05-06 14:25:00,1589.23,245746.1000000006,240050.24000000057,5695.860000000015
13578,2022-05-06 14:30:00,1136.99,246883.09000000058,240050.24000000057,6832.850000000006
13579,2022-05-06 14:35:00,771.35,247654.44000000058,240050.24000000057,7604.200000000012
13580,2022-05-06 14:40:00,577.04,248231.4800000006,240050.24000000057,8181.24000000002
13581,2022-05-06 14:45:00,1352.82,249584.3000000006,240050.24000000057,9534.060000000027
13582,2022-05-06 14:50:00,1280.03,250864.3300000006,240050.24000000057,10814.090000000026
13583,2022-05-06 14:55:00,1951.77,252816.1000000006,240050.24000000057,12765.860000000015
13584,2022-05-06 15:00:00,205.51,253021.6100000006,240050.24000000057,12971.370000000024
13585,2022-05-06 15:05:00,-1005.57,252016.0400000006,240050.24000000057,11965.800000000017
13586,2022-05-06 15:10:00,1330.12,253346.1600000006,240050.24000000057,13295.920000000013
13587,2022-05-06 15:15:00,1868.9,255215.06000000058,240050.24000000057,15164.820000000007
13588,2022-05-06 15:20:00,574.62,255789.68000000058,240050.24000000057,15739.440000000002
13589,2022-05-06 15:25:00,1210.61,257000.29000000056,240050.24000000057,16950.04999999999
13590,2022-05-06 15:30:00,183.1,257183.39000000057,240050.24000000057,17133.149999999994
13591,2022-05-06 15:35:00,-1820.28,255363.11000000057,240050.24000000057,15312.869999999995
13592,2022-05-06 15:40:00,-1675.21,253687.90000000058,240050.24000000057,13637.660000000003
13593,2022-05-06 15:45:00,-794.62,252893.28000000058,240050.24000000057,12843.040000000008
13594,2022-05-06 15:50:00,713.01,253606.2900000006,240050.24000000057,13556.050000000017
13595,2022-05-06 15:55:00,-662.29,252944.00000000058,240050.24000000057,12893.76000000001
13596,2022-05-06 16:00:00,-828.43,252115.5700000006,240050.24000000057,12065.330000000016
13597,2022-05-06 16:05:00,111.85,252227.4200000006,240050.24000000057,12177.180000000022
13598,2022-05-06 16:10:00,-1492.58,250734.8400000006,240050.24000000057,10684.600000000035
13599,2022-05-06 16:15:00,170.16,250905.0000000006,240050.24000000057,10854.760000000038
13600,2022-05-06 16:20:00,-764.45,250140.5500000006,240050.24000000057,10090.310000000027
13601,2022-05-06 16:25:00,-997.37,249143.1800000006,240050.24000000057,9092.940000000031
13602,2022-05-06 16:30:00,78.45,249221.63000000062,240050.24000000057,9171.390000000043
13603,2022-05-06 16:35:00,1674.38,250896.01000000062,240050.24000000057,10845.770000000048
13604,2022-05-06 16:40:00,-1072.48,249823.5300000006,240050.24000000057,9773.290000000037
13605,2022-05-06 16:45:00,463.88,250287.41000000061,240050.24000000057,10237.170000000042
13606,2022-05-06 16:50:00,-1941.5,248345.91000000061,240050.24000000057,8295.670000000042
13607,2022-05-06 16:55:00,153.16,248499.07000000062,240050.24000000057,8448.830000000045
13608,2022-05-07 08:00:00,1666.42,250165.49000000063,248499.07000000062,1666.4200000000128
13609,2022-05-07 08:05:00,-267.96,249897.53000000064,248499.07000000062,1398.460000000021
13610,2022-05-07 08:10:00,-853.67,249043.86000000063,248499.07000000062,544.7900000000081
13611,2022-05-07 08:15:00,-782.44,248261.42000000062,248499.07000000062,-237.64999999999418
13612,2022-05-07 08:20:00,-886.6,247374.82000000062,248499.07000000062,-1124.25
13613,2022-05-07 08:25:00,583.08,247957.9000000006,248499.07000000062,-541.1700000000128
13614,2022-05-07 08:30:00,-1273.45,246684.4500000006,248499.07000000062,-1814.6200000000244
13615,2022-05-07 08:35:00,-221.95,246462.50000000058,248499.07000000062,-2036.570000000036
13616,2022-05-07 08:40:00,137.56,246600.06000000058,248499.07000000062,-1899.0100000000384
13617,2022-05-07 08:45:00,329.61,246929.67000000057,248499.07000000062,-1569.4000000000524
13618,2022-05-07 08:50:00,-975.4,245954.27000000057,248499.07000000062,-2544.8000000000466
13619,2022-05-07 08:55:00,-284.51,245669.76000000056,248499.07000000062,-2829.310000000056
13620,2022-05-07 09:00:00,1875.7,247545.46000000057,248499.07000000062,-953.6100000000442
13621,2022-05-07 09:05:00,384.37,247929.83000000057,248499.07000000062,-569.2400000000489
13622,2022-05-07 09:10:00,239.05,248168.88000000056,248499.07000000062,-330.19000000006054
13623,2022-05-07 09:15:00,1951.0,250119.88000000056,248499.07000000062,1620.8099999999395
13624,2022-05-07 09:20:00,1754.93,251874.81000000055,248499.07000000062,3375.7399999999325
13625,2022-05-07 09:25:00,-609.82,251264.99000000054,248499.07000000062,2765.9199999999255
13626,2022-05-07 09:30:00,-1074.9,250190.09000000055,248499.07000000062,1691.0199999999313
13627,2022-05-07 09:35:00,-1421.05,248769.04000000056,248499.07000000062,269.96999999994296
13628,2022-05-07 09:40:00,-236.81,248532.23000000056,248499.07000000062,33.159999999945285
13629,2022-05-07 09:45:00,-1576.62,246955.61000000057,248499.07000000062,-1543.46000000005
13630,2022-05-07 09:50:00,-1591.95,245363.66000000056,248499.07000000062,-3135.4100000000617
13631,2022-05-07 09:55:00,1895.8,247259.46000000054,248499.07000000062,-1239.6100000000733
13632,2022-05-07 10:00:00,-301.3,246958.16000000056,248499.07000000062,-1540.9100000000617
13633,2022-05-07 10:05:00,-1315.39,245642.77000000054,248499.07000000062,-2856.3000000000757
13634,2022-05-07 10:10:00,1256.65,246899.42000000054,248499.07000000062,-1599.6500000000815
13635,2022-05-07 10:15:00,-984.22,245915.20000000054,248499.07000000062,-2583.8700000000827
13636,2022-05-07 10:20:00,-1131.34,244783.86000000054,248499.07000000062,-3715.210000000079
13637,2022-05-07 10:25:00,-1165.49,243618.37000000055,248499.07000000062,-4880.70000000007
13638,2022-05-07 10:30:00,-440.72,243177.65000000055,248499.07000000062,-5321.420000000071
13639,2022-05-07 10:35:00,1638.27,244815.92000000054,248499.07000000062,-3683.1500000000815
13640,2022-05-07 10:40:00,308.59,245124.51000000053,248499.07000000062,-3374.560000000085
13641,2022-05-07 10:45:00,-262.27,244862.24000000054,248499.07000000062,-3636.8300000000745
13642,2022-05-07 10:50:00,-1050.89,243811.35000000053,248499.07000000062,-4687.7200000000885
13643,2022-05-07 10:55:00,14.28,243825.63000000053,248499.07000000062,-4673.44000000009
13644,2022-05-07 11:00:00,-1946.34,241879.29000000053,248499.07000000062,-6619.780000000086
13645,2022-05-07 11:05:00,-519.9,241359.39000000054,248499.07000000062,-7139.68000000008
13646,2022-05-07 11:10:00,-1373.58,239985.81000000055,248499.07000000062,-8513.260000000068
13647,2022-05-07 11:15:00,1500.42,241486.23000000056,248499.07000000062,-7012.840000000055
13648,2022-05-07 11:20:00,50.19,241536.42000000057,248499.07000000062,-6962.650000000052
13649,2022-05-07 11:25:00,1034.7,242571.12000000058,248499.07000000062,-5927.950000000041
13650,2022-05-07 11:30:00,1763.54,244334.6600000006,248499.07000000062,-4164.410000000033
13651,2022-05-07 11:35:00,1375.28,245709.94000000058,248499.07000000062,-2789.1300000000338
13652,2022-05-07 11:40:00,-934.33,244775.6100000006,248499.07000000062,-3723.460000000021
13653,2022-05-07 11:45:00,585.21,245360.8200000006,248499.07000000062,-3138.250000000029
13654,2022-05-07 11:50:00,-1249.74,244111.0800000006,248499.07000000062,-4387.99000000002
13655,2022-05-07 11:55:00,-1996.59,242114.4900000006,248499.07000000062,-6384.580000000016
13656,2022-05-07 12:00:00,1264.72,243379.2100000006,248499.07000000062,-5119.860000000015
13657,2022-05-07 12:05:00,1919.82,245299.0300000006,248499.07000000062,-3200.040000000008
13658,2022-05-07 12:10:00,1942.78,247241.8100000006,248499.07000000062,-1257.2600000000093
13659,2022-05-07 12:15:00,-832.47,246409.3400000006,248499.07000000062,-2089.7300000000105
13660,2022-05-07 12:20:00,-1983.81,244425.5300000006,248499.07000000062,-4073.540000000008
13661,2022-05-07 12:25:00,1434.73,245860.26000000062,248499.07000000062,-2638.8099999999977
13662,2022-05-07 12:30:00,-1810.42,244049.8400000006,248499.07000000062,-4449.2300000000105
13663,2022-05-07 12:35:00,-1521.91,242527.9300000006,248499.07000000062,-5971.140000000014
13664,2022-05-07 12:40:00,830.13,243358.0600000006,248499.07000000062,-5141.010000000009
13665,2022-05-07 12:45:00,1166.17,244524.23000000062,248499.07000000062,-3974.8399999999965
13666,2022-05-07 12:50:00,1929.75,246453.98000000062,248499.07000000062,-2045.0899999999965
13667,2022-05-07 12:55:00,-502.21,245951.77000000063,248499.07000000062,-2547.2999999999884
13668,2022-05-07 13:00:00,1975.69,247927.46000000063,248499.07000000062,-571.609999999986
13669,2022-05-07 13:05:00,1582.19,249509.65000000063,248499.07000000062,1010.5800000000163
13670,2022-05-07 13:10:00,658.54,250168.19000000064,248499.07000000062,1669.1200000000244
13671,2022-05-07 13:15:00,538.75,250706.94000000064,248499.07000000062,2207.8700000000244
13672,2022-05-07 13:20:00,-76.47,250630.47000000064,248499.07000000062,2131.4000000000233
13673,2022-05-07 13:25:00,1448.35,252078.82000000065,248499.07000000062,3579.750000000029
13674,2022-05-07 13:30:00,-1065.66,251013.16000000064,248499.07000000062,2514.0900000000256
13675,2022-05-07 13:35:00,-553.53,250459.63000000064,248499.07000000062,1960.5600000000268
13676,2022-05-07 13:40:00,928.73,251388.36000000066,248499.07000000062,2889.2900000000373
13677,2022-05-07 13:45:00,47.58,251435.94000000064,248499.07000000062,2936.8700000000244
13678,2022-05-07 13:50:00,-1822.21,249613.73000000065,248499.07000000062,1114.6600000000326
13679,2022-05-07 13:55:00,-177.87,249435.86000000066,248499.07000000062,936.7900000000373
13680,2022-05-07 14:00:00,-1715.18,247720.68000000066,248499.07000000062,-778.3899999999558
13681,2022-05-07 14:05:00,-197.95,247522.73000000065,248499.07000000062,-976.3399999999674
13682,2022-05-07 14:10:00,75.96,247598.69000000064,248499.07000000062,-900.3799999999756
13683,2022-05-07 14:15:00,-401.76,247196.93000000063,248499.07000000062,-1302.1399999999849
13684,2022-05-07 14:20:00,-983.15,246213.78000000064,248499.07000000062,-2285.289999999979
13685,2022-05-07 14:25:00,1660.59,247874.37000000064,248499.07000000062,-624.6999999999825
13686,2022-05-07 14:30:00,-375.13,247499.24000000063,248499.07000000062,-999.8299999999872
13687,2022-05-07 14:35:00,3.51,247502.75000000064,248499.07000000062,-996.3199999999779
13688,2022-05-07 14:40:00,1885.8,249388.55000000063,248499.07000000062,889.4800000000105
13689,2022-05-07 14:45:00,-1872.38,247516.17000000062,248499.07000000062,-982.8999999999942
13690,2022-05-07 14:50:00,1563.93,249080.10000000062,248499.07000000062,581.0299999999988
13691,2022-05-07 14:55:00,287.07,249367.17000000062,248499.07000000062,868.1000000000058
13692,2022-05-07 15:00:00,-1059.66,248307.51000000062,248499.07000000062,-191.55999999999767
13693,2022-05-07 15:05:00,265.92,248573.43000000063,248499.07000000062,74.36000000001513
13694,2022-05-07 15:10:00,-381.11,248192.32000000065,248499.07000000062,-306.7499999999709
13695,2022-05-07 15:15:00,1724.35,249916.67000000065,248499.07000000062,1417.600000000035
13696,2022-05-07 15:20:00,-1319.8,248596.87000000066,248499.07000000062,97.80000000004657
13697,2022-05-07 15:25:00,-442.33,248154.54000000068,248499.07000000062,-344.5299999999406
13698,2022-05-07 15:30:00,1983.61,250138.15000000066,248499.07000000062,1639.0800000000454
13699,2022-05-07 15:35:00,-336.67,249801.48000000065,248499.07000000062,1302.4100000000326
13700,2022-05-07 15:40:00,848.72,250650.20000000065,248499.07000000062,2151.1300000000338
13701,2022-05-07 15:45:00,1630.81,252281.01000000065,248499.07000000062,3781.9400000000314
13702,2022-05-07 15:50:00,-1084.08,251196.93000000066,248499.07000000062,2697.8600000000442
13703,2022-05-07 15:55:00,-779.98,250416.95000000065,248499.07000000062,1917.8800000000338
13704,2022-05-07 16:00:00,325.28,250742.23000000065,248499.07000000062,2243.1600000000326
13705,2022-05-07 16:05:00,644.87,251387.10000000065,248499.07000000062,2888.030000000028
13706,2022-05-07 16:10:00,940.89,252327.99000000066,248499.07000000062,3828.920000000042
13707,2022-05-07 16:15:00,1888.9,254216.89000000065,248499.07000000062,5717.820000000036
13708,2022-05-07 16:20:00,905.61,255122.50000000064,248499.07000000062,6623.430000000022
13709,2022-05-07 16:25:00,-862.09,254260.41000000064,248499.07000000062,5761.340000000026
13710,2022-05-07 16:30:00,-1892.23,252368.18000000063,248499.07000000062,3869.110000000015
13711,2022-05-07 16:35:00,-1079.04,251289.14000000063,248499.07000000062,2790.070000000007
13712,2022-05-07 16:40:00,-340.57,250948.57000000062,248499.07000000062,2449.5
13713,2022-05-07 16:45:00,1068.35,252016.92000000062,248499.07000000062,3517.850000000006
13714,2022-05-07 16:50:00,-1884.34,250132.58000000063,248499.07000000062,1633.5100000000093
13715,2022-05-07 16:55:00,562.94,250695.52000000063,248499.07000000062,2196.4500000000116
13716,2022-05-08 08:00:00,-699.28,249996.24000000063,250695.52000000063,-699.2799999999988
13717,2022-05-08 08:05:00,-1353.42,248642.82000000062,250695.52000000063,-2052.7000000000116
13718,2022-05-08 08:10:00,-1509.66,247133.16000000061,250695.52000000063,-3562.360000000015
13719,2022-05-08 08:15:00,801.7,247934.86000000063,250695.52000000063,-2760.6600000000035
13720,2022-05-08 08:20:00,558.69,248493.55000000063,250695.52000000063,-2201.970000000001
13721,2022-05-08 08:25:00,-1735.59,246757.96000000063,250695.52000000063,-3937.5599999999977
13722,2022-05-08 08:30:00,-1212.88,245545.08000000063,250695.52000000063,-5150.440000000002
13723,2022-05-08 08:35:00,401.96,245947.04000000062,250695.52000000063,-4748.4800000000105
13724,2022-05-08 08:40:00,-77.46,245869.58000000063,250695.52000000063,-4825.940000000002
13725,2022-05-08 08:45:00,-1007.65,244861.93000000063,250695.52000000063,-5833.5899999999965
13726,2022-05-08 08:50:00,1817.89,246679.82000000065,250695.52000000063,-4015.6999999999825
13727,2022-05-08 08:55:00,1476.09,248155.91000000064,250695.52000000063,-2539.609999999986
13728,2022-05-08 09:00:00,848.81,249004.72000000064,250695.52000000063,-1690.7999999999884
13729,2022-05-08 09:05:00,-1225.1,247779.62000000064,250695.52000000063,-2915.899999999994
13730,2022-05-08 09:10:00,1513.96,249293.58000000063,250695.52000000063,-1401.9400000000023
13731,2022-05-08 09:15:00,1673.98,250967.56000000064,250695.52000000063,272.04000000000815
13732,2022-05-08 09:20:00,1840.43,252807.99000000063,250695.52000000063,2112.470000000001
13733,2022-05-08 09:25:00,-558.49,252249.50000000064,250695.52000000063,1553.9800000000105
13734,2022-05-08 09:30:00,-808.59,251440.91000000064,250695.52000000063,745.390000000014
13735,2022-05-08 09:35:00,-1074.42,250366.49000000063,250695.52000000063,-329.02999999999884
13736,2022-05-08 09:40:00,-1788.44,248578.05000000063,250695.52000000063,-2117.470000000001
13737,2022-05-08 09:45:00,-1985.83,246592.22000000064,250695.52000000063,-4103.299999999988
13738,2022-05-08 09:50:00,-775.78,245816.44000000064,250695.52000000063,-4879.079999999987
13739,2022-05-08 09:55:00,-1455.43,244361.01000000065,250695.52000000063,-6334.50999999998
13740,2022-05-08 10:00:00,-456.42,243904.59000000064,250695.52000000063,-6790.929999999993
13741,2022-05-08 10:05:00,216.91,244121.50000000064,250695.52000000063,-6574.0199999999895
13742,2022-05-08 10:10:00,1848.59,245970.09000000064,250695.52000000063,-4725.429999999993
13743,2022-05-08 10:15:00,-1398.58,244571.51000000065,250695.52000000063,-6124.00999999998
13744,2022-05-08 10:20:00,1149.63,245721.14000000065,250695.52000000063,-4974.379999999976
13745,2022-05-08 10:25:00,-553.49,245167.65000000066,250695.52000000063,-5527.869999999966
13746,2022-05-08 10:30:00,-1611.36,243556.29000000068,250695.52000000063,-7139.229999999952
13747,2022-05-08 10:35:00,-1260.73,242295.56000000067,250695.52000000063,-8399.959999999963
13748,2022-05-08 10:40:00,-1745.67,240549.89000000065,250695.52000000063,-10145.629999999976
13749,2022-05-08 10:45:00,-1844.13,238705.76000000065,250695.52000000063,-11989.75999999998
13750,2022-05-08 10:50:00,503.61,239209.37000000064,250695.52000000063,-11486.149999999994
13751,2022-05-08 10:55:00,541.27,239750.64000000063,250695.52000000063,-10944.880000000005
13752,2022-05-08 11:00:00,-245.66,239504.98000000062,250695.52000000063,-11190.540000000008
13753,2022-05-08 11:05:00,1058.46,240563.4400000006,250695.52000000063,-10132.080000000016
13754,2022-05-08 11:10:00,-1346.02,239217.42000000062,250695.52000000063,-11478.100000000006
13755,2022-05-08 11:15:00,658.96,239876.38000000062,250695.52000000063,-10819.140000000014
13756,2022-05-08 11:20:00,353.29,240229.67000000062,250695.52000000063,-10465.850000000006
13757,2022-05-08 11:25:00,1002.34,241232.01000000062,250695.52000000063,-9463.51000000001
13758,2022-05-08 11:30:00,-1518.78,239713.23000000062,250695.52000000063,-10982.290000000008
13759,2022-05-08 11:35:00,-1311.77,238401.46000000063,250695.52000000063,-12294.059999999998
13760,2022-05-08 11:40:00,-725.16,237676.30000000063,250695.52000000063,-13019.220000000001
13761,2022-05-08 11:45:00,-910.42,236765.88000000062,250695.52000000063,-13929.640000000014
13762,2022-05-08 11:50:00,-1236.37,235529.51000000062,250695.52000000063,-15166.01000000001
13763,2022-05-08 11:55:00,705.7,236235.21000000063,250695.52000000063,-14460.309999999998
13764,2022-05-08 12:00:00,-1876.98,234358.23000000062,250695.52000000063,-16337.290000000008
13765,2022-05-08 12:05:00,1248.45,235606.68000000063,250695.52000000063,-15088.839999999997
13766,2022-05-08 12:10:00,-478.06,235128.62000000064,250695.52000000063,-15566.899999999994
13767,2022-05-08 12:15:00,869.2,235997.82000000065,250695.52000000063,-14697.699999999983
13768,2022-05-08 12:20:00,92.09,236089.91000000064,250695.52000000063,-14605.609999999986
13769,2022-05-08 12:25:00,-942.58,235147.33000000066,250695.52000000063,-15548.189999999973
13770,2022-05-08 12:30:00,-1591.59,233555.74000000066,250695.52000000063,-17139.77999999997
13771,2022-05-08 12:35:00,-683.31,232872.43000000066,250695.52000000063,-17823.089999999967
13772,2022-05-08 12:40:00,-181.28,232691.15000000066,250695.52000000063,-18004.369999999966
13773,2022-05-08 12:45:00,-673.31,232017.84000000067,250695.52000000063,-18677.679999999964
13774,2022-05-08 12:50:00,1710.41,233728.25000000067,250695.52000000063,-16967.26999999996
13775,2022-05-08 12:55:00,1367.15,235095.40000000066,250695.52000000063,-15600.119999999966
13776,2022-05-08 13:00:00,-19.24,235076.16000000067,250695.52000000063,-15619.359999999957
13777,2022-05-08 13:05:00,157.01,235233.17000000068,250695.52000000063,-15462.349999999948
13778,2022-05-08 13:10:00,-1221.24,234011.9300000007,250695.52000000063,-16683.58999999994
13779,2022-05-08 13:15:00,1587.45,235599.3800000007,250695.52000000063,-15096.139999999927
13780,2022-05-08 13:20:00,1563.16,237162.5400000007,250695.52000000063,-13532.979999999923
13781,2022-05-08 13:25:00,1216.4,238378.9400000007,250695.52000000063,-12316.579999999929
13782,2022-05-08 13:30:00,-179.83,238199.1100000007,250695.52000000063,-12496.409999999916
13783,2022-05-08 13:35:00,1342.66,239541.77000000072,250695.52000000063,-11153.749999999913
13784,2022-05-08 13:40:00,690.38,240232.15000000072,250695.52000000063,-10463.369999999908
13785,2022-05-08 13:45:00,1084.72,241316.87000000072,250695.52000000063,-9378.649999999907
13786,2022-05-08 13:50:00,1155.0,242471.87000000072,250695.52000000063,-8223.649999999907
13787,2022-05-08 13:55:00,-1651.94,240819.93000000072,250695.52000000063,-9875.58999999991
13788,2022-05-08 14:00:00,1802.94,242622.87000000072,250695.52000000063,-8072.649999999907
13789,2022-05-08 14:05:00,1523.89,244146.76000000074,250695.52000000063,-6548.759999999893
13790,2022-05-08 14:10:00,-1919.98,242226.78000000073,250695.52000000063,-8468.739999999903
13791,2022-05-08 14:15:00,1213.26,243440.04000000074,250695.52000000063,-7255.479999999894
13792,2022-05-08 14:20:00,1603.62,245043.66000000073,250695.52000000063,-5651.859999999899
13793,2022-05-08 14:25:00,-1919.71,243123.95000000074,250695.52000000063,-7571.569999999891
13794,2022-05-08 14:30:00,1820.37,244944.32000000073,250695.52000000063,-5751.199999999895
13795,2022-05-08 14:35:00,1751.51,246695.83000000074,250695.52000000063,-3999.689999999886
13796,2022-05-08 14:40:00,-1951.47,244744.36000000074,250695.52000000063,-5951.159999999887
13797,2022-05-08 14:45:00,-494.82,244249.54000000074,250695.52000000063,-6445.979999999894
13798,2022-05-08 14:50:00,-1259.97,242989.57000000073,250695.52000000063,-7705.949999999895
13799,2022-05-08 14:55:00,1912.46,244902.03000000073,250695.52000000063,-5793.489999999903
13800,2022-05-08 15:00:00,-1421.94,243480.09000000072,250695.52000000063,-7215.429999999906
13801,2022-05-08 15:05:00,-205.64,243274.4500000007,250695.52000000063,-7421.06999999992
13802,2022-05-08 15:10:00,134.69,243409.1400000007,250695.52000000063,-7286.379999999917
13803,2022-05-08 15:15:00,-1393.96,242015.18000000072,250695.52000000063,-8680.33999999991
13804,2022-05-08 15:20:00,-160.11,241855.07000000073,250695.52000000063,-8840.449999999895
13805,2022-05-08 15:25:00,-135.09,241719.98000000074,250695.52000000063,-8975.539999999892
13806,2022-05-08 15:30:00,1758.64,243478.62000000075,250695.52000000063,-7216.899999999878
13807,2022-05-08 15:35:00,-1793.68,241684.94000000076,250695.52000000063,-9010.57999999987
13808,2022-05-08 15:40:00,7.6,241692.54000000076,250695.52000000063,-9002.979999999865
13809,2022-05-08 15:45:00,90.73,241783.27000000078,250695.52000000063,-8912.249999999854
13810,2022-05-08 15:50:00,270.04,242053.31000000078,250695.52000000063,-8642.209999999846
13811,2022-05-08 15:55:00,-946.0,241107.31000000078,250695.52000000063,-9588.209999999846
13812,2022-05-08 16:00:00,-914.24,240193.0700000008,250695.52000000063,-10502.449999999837
13813,2022-05-08 16:05:00,1084.14,241277.2100000008,250695.52000000063,-9418.309999999823
13814,2022-05-08 16:10:00,-1149.82,240127.3900000008,250695.52000000063,-10568.12999999983
13815,2022-05-08 16:15:00,-1430.94,238696.4500000008,250695.52000000063,-11999.069999999832
13816,2022-05-08 16:20:00,714.65,239411.1000000008,250695.52000000063,-11284.419999999838
13817,2022-05-08 16:25:00,1431.51,240842.6100000008,250695.52000000063,-9852.909999999829
13818,2022-05-08 16:30:00,-365.05,240477.5600000008,250695.52000000063,-10217.959999999817
13819,2022-05-08 16:35:00,1547.73,242025.29000000082,250695.52000000063,-8670.229999999807
13820,2022-05-08 16:40:00,-836.84,241188.45000000083,250695.52000000063,-9507.069999999803
13821,2022-05-08 16:45:00,-235.2,240953.25000000081,250695.52000000063,-9742.269999999815
13822,2022-05-08 16:50:00,-1403.78,239549.47000000082,250695.52000000063,-11146.049999999814
13823,2022-05-08 16:55:00,-1421.7,238127.7700000008,250695.52000000063,-12567.749999999825
13824,2022-05-09 08:00:00,1195.51,239323.2800000008,238127.7700000008,1195.5100000000093
13825,2022-05-09 08:05:00,1316.92,240640.20000000083,238127.7700000008,2512.430000000022
13826,2022-05-09 08:10:00,118.68,240758.88000000082,238127.7700000008,2631.110000000015
13827,2022-05-09 08:15:00,1256.48,242015.36000000083,238127.7700000008,3887.5900000000256
13828,2022-05-09 08:20:00,1829.85,243845.21000000084,238127.7700000008,5717.440000000031
13829,2022-05-09 08:25:00,-1810.57,242034.64000000083,238127.7700000008,3906.8700000000244
13830,2022-05-09 08:30:00,-1834.04,240200.60000000082,238127.7700000008,2072.8300000000163
13831,2022-05-09 08:35:00,-1422.37,238778.23000000083,238127.7700000008,650.460000000021
13832,2022-05-09 08:40:00,-1729.71,237048.52000000083,238127.7700000008,-1079.249999999971
13833,2022-05-09 08:45:00,146.84,237195.36000000083,238127.7700000008,-932.4099999999744
13834,2022-05-09 08:50:00,-1334.63,235860.73000000083,238127.7700000008,-2267.039999999979
13835,2022-05-09 08:55:00,-1601.5,234259.23000000083,238127.7700000008,-3868.539999999979
13836,2022-05-09 09:00:00,1607.6,235866.83000000083,238127.7700000008,-2260.939999999973
13837,2022-05-09 09:05:00,1611.18,237478.01000000082,238127.7700000008,-649.7599999999802
13838,2022-05-09 09:10:00,1642.59,239120.60000000082,238127.7700000008,992.8300000000163
13839,2022-05-09 09:15:00,912.19,240032.79000000082,238127.7700000008,1905.0200000000186
13840,2022-05-09 09:20:00,-324.8,239707.99000000083,238127.7700000008,1580.2200000000303
13841,2022-05-09 09:25:00,1805.94,241513.93000000084,238127.7700000008,3386.1600000000326
13842,2022-05-09 09:30:00,290.5,241804.43000000084,238127.7700000008,3676.6600000000326
13843,2022-05-09 09:35:00,-1315.43,240489.00000000084,238127.7700000008,2361.2300000000396
13844,2022-05-09 09:40:00,-555.1,239933.90000000084,238127.7700000008,1806.1300000000338
13845,2022-05-09 09:45:00,1865.24,241799.14000000083,238127.7700000008,3671.3700000000244
13846,2022-05-09 09:50:00,631.6,242430.74000000083,238127.7700000008,4302.97000000003
13847,2022-05-09 09:55:00,1400.26,243831.00000000084,238127.7700000008,5703.23000000004
13848,2022-05-09 10:00:00,-33.86,243797.14000000086,238127.7700000008,5669.370000000054
13849,2022-05-09 10:05:00,-1038.09,242759.05000000086,238127.7700000008,4631.280000000057
13850,2022-05-09 10:10:00,-908.32,241850.73000000085,238127.7700000008,3722.96000000005
13851,2022-05-09 10:15:00,-35.53,241815.20000000086,238127.7700000008,3687.430000000051
13852,2022-05-09 10:20:00,-331.51,241483.69000000085,238127.7700000008,3355.920000000042
13853,2022-05-09 10:25:00,-1836.96,239646.73000000085,238127.7700000008,1518.96000000005
13854,2022-05-09 10:30:00,-1173.62,238473.11000000086,238127.7700000008,345.3400000000547
13855,2022-05-09 10:35:00,-1588.55,236884.56000000087,238127.7700000008,-1243.2099999999336
13856,2022-05-09 10:40:00,1779.11,238663.67000000086,238127.7700000008,535.9000000000524
13857,2022-05-09 10:45:00,-873.98,237789.69000000085,238127.7700000008,-338.0799999999581
13858,2022-05-09 10:50:00,1525.0,239314.69000000085,238127.7700000008,1186.920000000042
13859,2022-05-09 10:55:00,-129.69,239185.00000000084,238127.7700000008,1057.2300000000396
13860,2022-05-09 11:00:00,728.48,239913.48000000085,238127.7700000008,1785.71000000005
13861,2022-05-09 11:05:00,1635.68,241549.16000000085,238127.7700000008,3421.390000000043
13862,2022-05-09 11:10:00,-1354.2,240194.96000000084,238127.7700000008,2067.1900000000314
13863,2022-05-09 11:15:00,1175.26,241370.22000000085,238127.7700000008,3242.4500000000407
13864,2022-05-09 11:20:00,1667.16,243037.38000000085,238127.7700000008,4909.610000000044
13865,2022-05-09 11:25:00,-1490.72,241546.66000000085,238127.7700000008,3418.890000000043
13866,2022-05-09 11:30:00,-1119.13,240427.53000000084,238127.7700000008,2299.7600000000384
13867,2022-05-09 11:35:00,1101.88,241529.41000000085,238127.7700000008,3401.640000000043
13868,2022-05-09 11:40:00,-636.68,240892.73000000085,238127.7700000008,2764.96000000005
13869,2022-05-09 11:45:00,-1958.88,238933.85000000085,238127.7700000008,806.0800000000454
13870,2022-05-09 11:50:00,926.68,239860.53000000084,238127.7700000008,1732.7600000000384
13871,2022-05-09 11:55:00,-945.81,238914.72000000085,238127.7700000008,786.9500000000407
13872,2022-05-09 12:00:00,1985.45,240900.17000000086,238127.7700000008,2772.4000000000524
13873,2022-05-09 12:05:00,431.59,241331.76000000085,238127.7700000008,3203.990000000049
13874,2022-05-09 12:10:00,1055.1,242386.86000000086,238127.7700000008,4259.090000000055
13875,2022-05-09 12:15:00,546.2,242933.06000000087,238127.7700000008,4805.290000000066
13876,2022-05-09 12:20:00,-333.55,242599.51000000088,238127.7700000008,4471.740000000078
13877,2022-05-09 12:25:00,631.04,243230.5500000009,238127.7700000008,5102.780000000086
13878,2022-05-09 12:30:00,-818.35,242412.20000000088,238127.7700000008,4284.43000000008
13879,2022-05-09 12:35:00,-702.79,241709.41000000088,238127.7700000008,3581.640000000072
13880,2022-05-09 12:40:00,287.44,241996.85000000088,238127.7700000008,3869.0800000000745
13881,2022-05-09 12:45:00,1388.65,243385.50000000087,238127.7700000008,5257.730000000069
13882,2022-05-09 12:50:00,-497.63,242887.87000000087,238127.7700000008,4760.100000000064
13883,2022-05-09 12:55:00,-1277.9,241609.97000000087,238127.7700000008,3482.20000000007
13884,2022-05-09 13:00:00,-1317.05,240292.9200000009,238127.7700000008,2165.1500000000815
13885,2022-05-09 13:05:00,615.44,240908.3600000009,238127.7700000008,2780.590000000084
13886,2022-05-09 13:10:00,1632.1,242540.4600000009,238127.7700000008,4412.69000000009
13887,2022-05-09 13:15:00,1534.31,244074.7700000009,238127.7700000008,5947.000000000087
13888,2022-05-09 13:20:00,1145.22,245219.9900000009,238127.7700000008,7092.2200000000885
13889,2022-05-09 13:25:00,1218.47,246438.4600000009,238127.7700000008,8310.69000000009
13890,2022-05-09 13:30:00,-418.76,246019.70000000088,238127.7700000008,7891.93000000008
13891,2022-05-09 13:35:00,-337.68,245682.0200000009,238127.7700000008,7554.250000000087
13892,2022-05-09 13:40:00,371.65,246053.6700000009,238127.7700000008,7925.9000000000815
13893,2022-05-09 13:45:00,-818.05,245235.6200000009,238127.7700000008,7107.850000000093
13894,2022-05-09 13:50:00,775.09,246010.7100000009,238127.7700000008,7882.94000000009
13895,2022-05-09 13:55:00,53.01,246063.7200000009,238127.7700000008,7935.950000000099
13896,2022-05-09 14:00:00,-1981.89,244081.8300000009,238127.7700000008,5954.060000000085
13897,2022-05-09 14:05:00,-184.49,243897.3400000009,238127.7700000008,5769.570000000094
13898,2022-05-09 14:10:00,-424.11,243473.2300000009,238127.7700000008,5345.460000000108
13899,2022-05-09 14:15:00,14.61,243487.8400000009,238127.7700000008,5360.070000000094
13900,2022-05-09 14:20:00,-784.84,242703.0000000009,238127.7700000008,4575.230000000098
13901,2022-05-09 14:25:00,1478.58,244181.5800000009,238127.7700000008,6053.810000000085
13902,2022-05-09 14:30:00,660.68,244842.26000000088,238127.7700000008,6714.490000000078
13903,2022-05-09 14:35:00,-746.57,244095.69000000088,238127.7700000008,5967.920000000071
13904,2022-05-09 14:40:00,825.28,244920.97000000087,238127.7700000008,6793.20000000007
13905,2022-05-09 14:45:00,-1590.77,243330.20000000088,238127.7700000008,5202.43000000008
13906,2022-05-09 14:50:00,1201.07,244531.2700000009,238127.7700000008,6403.500000000087
13907,2022-05-09 14:55:00,-470.0,244061.2700000009,238127.7700000008,5933.500000000087
13908,2022-05-09 15:00:00,-1915.95,242145.32000000088,238127.7700000008,4017.5500000000757
13909,2022-05-09 15:05:00,1378.65,243523.97000000087,238127.7700000008,5396.20000000007
13910,2022-05-09 15:10:00,-1498.53,242025.44000000088,238127.7700000008,3897.670000000071
13911,2022-05-09 15:15:00,-538.09,241487.35000000088,238127.7700000008,3359.5800000000745
13912,2022-05-09 15:20:00,-277.59,241209.76000000088,238127.7700000008,3081.990000000078
13913,2022-05-09 15:25:00,-360.02,240849.7400000009,238127.7700000008,2721.9700000000885
13914,2022-05-09 15:30:00,1169.66,242019.4000000009,238127.7700000008,3891.630000000092
13915,2022-05-09 15:35:00,-442.78,241576.6200000009,238127.7700000008,3448.850000000093
13916,2022-05-09 15:40:00,-920.58,240656.0400000009,238127.7700000008,2528.270000000106
13917,2022-05-09 15:45:00,1314.45,241970.49000000092,238127.7700000008,3842.7200000001176
13918,2022-05-09 15:50:00,-256.16,241714.33000000092,238127.7700000008,3586.560000000114
13919,2022-05-09 15:55:00,-1635.92,240078.4100000009,238127.7700000008,1950.6400000001013
13920,2022-05-09 16:00:00,1614.55,241692.9600000009,238127.7700000008,3565.1900000000896
13921,2022-05-09 16:05:00,-1092.87,240600.0900000009,238127.7700000008,2472.3200000000943
13922,2022-05-09 16:10:00,-1606.8,238993.2900000009,238127.7700000008,865.5200000001059
13923,2022-05-09 16:15:00,593.26,239586.55000000092,238127.7700000008,1458.7800000001153
13924,2022-05-09 16:20:00,1931.47,241518.02000000092,238127.7700000008,3390.2500000001164
13925,2022-05-09 16:25:00,5.37,241523.39000000092,238127.7700000008,3395.6200000001118
13926,2022-05-09 16:30:00,-484.53,241038.86000000092,238127.7700000008,2911.090000000113
13927,2022-05-09 16:35:00,-1505.98,239532.8800000009,238127.7700000008,1405.1100000001024
13928,2022-05-09 16:40:00,-411.31,239121.5700000009,238127.7700000008,993.8000000001048
13929,2022-05-09 16:45:00,583.09,239704.6600000009,238127.7700000008,1576.8900000001013
13930,2022-05-09 16:50:00,-1153.95,238550.7100000009,238127.7700000008,422.94000000008964
13931,2022-05-09 16:55:00,251.07,238801.7800000009,238127.7700000008,674.0100000000966
13932,2022-05-10 08:00:00,-1680.53,237121.2500000009,238801.7800000009,-1680.5299999999988
13933,2022-05-10 08:05:00,472.21,237593.4600000009,238801.7800000009,-1208.320000000007
13934,2022-05-10 08:10:00,-325.9,237267.5600000009,238801.7800000009,-1534.2200000000012
13935,2022-05-10 08:15:00,-1795.19,235472.3700000009,238801.7800000009,-3329.4100000000035
13936,2022-05-10 08:20:00,-1938.91,233533.4600000009,238801.7800000009,-5268.320000000007
13937,2022-05-10 08:25:00,-237.21,233296.2500000009,238801.7800000009,-5505.529999999999
13938,2022-05-10 08:30:00,1011.14,234307.39000000092,238801.7800000009,-4494.389999999985
13939,2022-05-10 08:35:00,1856.08,236163.4700000009,238801.7800000009,-2638.3099999999977
13940,2022-05-10 08:40:00,433.98,236597.4500000009,238801.7800000009,-2204.329999999987
13941,2022-05-10 08:45:00,-426.68,236170.77000000092,238801.7800000009,-2631.00999999998
13942,2022-05-10 08:50:00,356.5,236527.27000000092,238801.7800000009,-2274.50999999998
13943,2022-05-10 08:55:00,1744.79,238272.06000000093,238801.7800000009,-529.7199999999721
13944,2022-05-10 09:00:00,1453.02,239725.08000000092,238801.7800000009,923.3000000000175
13945,2022-05-10 09:05:00,383.57,240108.65000000093,238801.7800000009,1306.8700000000244
13946,2022-05-10 09:10:00,-793.4,239315.25000000093,238801.7800000009,513.4700000000303
13947,2022-05-10 09:15:00,-500.92,238814.33000000092,238801.7800000009,12.550000000017462
13948,2022-05-10 09:20:00,1149.01,239963.34000000093,238801.7800000009,1161.5600000000268
13949,2022-05-10 09:25:00,-1038.13,238925.21000000092,238801.7800000009,123.43000000002212
13950,2022-05-10 09:30:00,-606.48,238318.7300000009,238801.7800000009,-483.04999999998836
13951,2022-05-10 09:35:00,-1186.29,237132.4400000009,238801.7800000009,-1669.3399999999965
13952,2022-05-10 09:40:00,-732.36,236400.08000000092,238801.7800000009,-2401.6999999999825
13953,2022-05-10 09:45:00,1575.08,237975.1600000009,238801.7800000009,-826.6199999999953
13954,2022-05-10 09:50:00,1568.75,239543.9100000009,238801.7800000009,742.1300000000047
13955,2022-05-10 09:55:00,1100.98,240644.89000000092,238801.7800000009,1843.1100000000151
13956,2022-05-10 10:00:00,1957.96,242602.8500000009,238801.7800000009,3801.070000000007
13957,2022-05-10 10:05:00,-368.91,242233.9400000009,238801.7800000009,3432.1600000000035
13958,2022-05-10 10:10:00,-1692.63,240541.3100000009,238801.7800000009,1739.5299999999988
13959,2022-05-10 10:15:00,-154.63,240386.6800000009,238801.7800000009,1584.8999999999942
13960,2022-05-10 10:20:00,-1445.29,238941.3900000009,238801.7800000009,139.60999999998603
13961,2022-05-10 10:25:00,-1818.67,237122.72000000087,238801.7800000009,-1679.0600000000268
13962,2022-05-10 10:30:00,584.38,237707.10000000088,238801.7800000009,-1094.6800000000221
13963,2022-05-10 10:35:00,-394.11,237312.9900000009,238801.7800000009,-1488.7900000000081
13964,2022-05-10 10:40:00,1983.49,239296.48000000088,238801.7800000009,494.69999999998254
13965,2022-05-10 10:45:00,-1034.89,238261.59000000087,238801.7800000009,-540.1900000000314
13966,2022-05-10 10:50:00,-945.38,237316.21000000086,238801.7800000009,-1485.570000000036
13967,2022-05-10 10:55:00,758.78,238074.99000000086,238801.7800000009,-726.7900000000373
13968,2022-05-10 11:00:00,164.17,238239.16000000088,238801.7800000009,-562.6200000000244
13969,2022-05-10 11:05:00,489.19,238728.35000000088,238801.7800000009,-73.43000000002212
13970,2022-05-10 11:10:00,-1491.99,237236.3600000009,238801.7800000009,-1565.4200000000128
13971,2022-05-10 11:15:00,-454.75,236781.6100000009,238801.7800000009,-2020.1700000000128
13972,2022-05-10 11:20:00,1296.59,238078.20000000088,238801.7800000009,-723.5800000000163
13973,2022-05-10 11:25:00,-993.77,237084.4300000009,238801.7800000009,-1717.3500000000058
13974,2022-05-10 11:30:00,-660.8,236423.6300000009,238801.7800000009,-2378.149999999994
13975,2022-05-10 11:35:00,-1585.33,234838.30000000092,238801.7800000009,-3963.4799999999814
13976,2022-05-10 11:40:00,-213.97,234624.33000000092,238801.7800000009,-4177.4499999999825
13977,2022-05-10 11:45:00,-1312.92,233311.4100000009,238801.7800000009,-5490.369999999995
13978,2022-05-10 11:50:00,392.35,233703.7600000009,238801.7800000009,-5098.0199999999895
13979,2022-05-10 11:55:00,1176.68,234880.4400000009,238801.7800000009,-3921.3399999999965
13980,2022-05-10 12:00:00,1845.18,236725.6200000009,238801.7800000009,-2076.1600000000035
13981,2022-05-10 12:05:00,730.52,237456.1400000009,238801.7800000009,-1345.640000000014
13982,2022-05-10 12:10:00,1416.91,238873.0500000009,238801.7800000009,71.26999999998952
13983,2022-05-10 12:15:00,885.04,239758.0900000009,238801.7800000009,956.3099999999977
13984,2022-05-10 12:20:00,-1087.68,238670.4100000009,238801.7800000009,-131.36999999999534
13985,2022-05-10 12:25:00,525.3,239195.7100000009,238801.7800000009,393.929999999993
13986,2022-05-10 12:30:00,-283.73,238911.98000000088,238801.7800000009,110.19999999998254
13987,2022-05-10 12:35:00,-137.84,238774.1400000009,238801.7800000009,-27.64000000001397
13988,2022-05-10 12:40:00,-807.07,237967.07000000088,238801.7800000009,-834.710000000021
13989,2022-05-10 12:45:00,1075.58,239042.65000000087,238801.7800000009,240.86999999996624
13990,2022-05-10 12:50:00,892.23,239934.88000000088,238801.7800000009,1133.0999999999767
13991,2022-05-10 12:55:00,-1862.44,238072.44000000088,238801.7800000009,-729.3400000000256
13992,2022-05-10 13:00:00,-1116.56,236955.88000000088,238801.7800000009,-1845.9000000000233
13993,2022-05-10 13:05:00,-1322.12,235633.76000000088,238801.7800000009,-3168.0200000000186
13994,2022-05-10 13:10:00,-1370.16,234263.60000000088,238801.7800000009,-4538.180000000022
13995,2022-05-10 13:15:00,-1800.95,232462.65000000087,238801.7800000009,-6339.130000000034
13996,2022-05-10 13:20:00,720.45,233183.10000000088,238801.7800000009,-5618.680000000022
13997,2022-05-10 13:25:00,-1637.5,231545.60000000088,238801.7800000009,-7256.180000000022
13998,2022-05-10 13:30:00,-1277.68,230267.9200000009,238801.7800000009,-8533.860000000015
13999,2022-05-10 13:35:00,-1369.39,228898.53000000087,238801.7800000009,-9903.25000000003
14000,2022-05-10 13:40:00,-1719.6,227178.93000000087,238801.7800000009,-11622.850000000035
14001,2022-05-10 13:45:00,-1140.37,226038.56000000087,238801.7800000009,-12763.22000000003
14002,2022-05-10 13:50:00,-480.23,225558.33000000086,238801.7800000009,-13243.45000000004
14003,2022-05-10 13:55:00,-1296.64,224261.69000000085,238801.7800000009,-14540.090000000055
14004,2022-05-10 14:00:00,57.12,224318.81000000084,238801.7800000009,-14482.97000000006
14005,2022-05-10 14:05:00,-1778.42,222540.39000000083,238801.7800000009,-16261.390000000072
14006,2022-05-10 14:10:00,-1496.66,221043.73000000083,238801.7800000009,-17758.050000000076
14007,2022-05-10 14:15:00,-1243.46,219800.27000000083,238801.7800000009,-19001.510000000068
14008,2022-05-10 14:20:00,1031.68,220831.95000000083,238801.7800000009,-17969.830000000075
14009,2022-05-10 14:25:00,-1973.99,218857.96000000084,238801.7800000009,-19943.820000000065
14010,2022-05-10 14:30:00,934.74,219792.70000000083,238801.7800000009,-19009.080000000075
14011,2022-05-10 14:35:00,-50.32,219742.38000000082,238801.7800000009,-19059.40000000008
14012,2022-05-10 14:40:00,-1244.02,218498.36000000083,238801.7800000009,-20303.42000000007
14013,2022-05-10 14:45:00,-347.87,218150.49000000083,238801.7800000009,-20651.290000000066
14014,2022-05-10 14:50:00,895.78,219046.27000000083,238801.7800000009,-19755.510000000068
14015,2022-05-10 14:55:00,768.12,219814.39000000083,238801.7800000009,-18987.390000000072
14016,2022-05-10 15:00:00,1593.54,221407.93000000084,238801.7800000009,-17393.850000000064
14017,2022-05-10 15:05:00,-60.9,221347.03000000084,238801.7800000009,-17454.75000000006
14018,2022-05-10 15:10:00,-531.46,220815.57000000085,238801.7800000009,-17986.21000000005
14019,2022-05-10 15:15:00,590.12,221405.69000000085,238801.7800000009,-17396.090000000055
14020,2022-05-10 15:20:00,1504.57,222910.26000000085,238801.7800000009,-15891.520000000048
14021,2022-05-10 15:25:00,-605.06,222305.20000000086,238801.7800000009,-16496.580000000045
14022,2022-05-10 15:30:00,767.85,223073.05000000086,238801.7800000009,-15728.73000000004
14023,2022-05-10 15:35:00,-940.34,222132.71000000086,238801.7800000009,-16669.070000000036
14024,2022-05-10 15:40:00,1725.14,223857.85000000088,238801.7800000009,-14943.930000000022
14025,2022-05-10 15:45:00,-643.03,223214.82000000088,238801.7800000009,-15586.960000000021
14026,2022-05-10 15:50:00,347.33,223562.15000000087,238801.7800000009,-15239.630000000034
14027,2022-05-10 15:55:00,-1341.56,222220.59000000087,238801.7800000009,-16581.19000000003
14028,2022-05-10 16:00:00,556.01,222776.60000000088,238801.7800000009,-16025.180000000022
14029,2022-05-10 16:05:00,1501.66,224278.26000000088,238801.7800000009,-14523.520000000019
14030,2022-05-10 16:10:00,-817.14,223461.12000000087,238801.7800000009,-15340.660000000033
14031,2022-05-10 16:15:00,649.13,224110.25000000087,238801.7800000009,-14691.530000000028
14032,2022-05-10 16:20:00,557.5,224667.75000000087,238801.7800000009,-14134.030000000028
14033,2022-05-10 16:25:00,-1742.85,222924.90000000087,238801.7800000009,-15876.880000000034
14034,2022-05-10 16:30:00,1293.85,224218.75000000087,238801.7800000009,-14583.030000000028
14035,2022-05-10 16:35:00,-1234.66,222984.09000000087,238801.7800000009,-15817.690000000031
14036,2022-05-10 16:40:00,1717.11,224701.20000000086,238801.7800000009,-14100.580000000045
14037,2022-05-10 16:45:00,-718.37,223982.83000000086,238801.7800000009,-14818.95000000004
14038,2022-05-10 16:50:00,1849.71,225832.54000000085,238801.7800000009,-12969.240000000049
14039,2022-05-10 16:55:00,343.88,226176.42000000086,238801.7800000009,-12625.360000000044
14040,2022-05-11 08:00:00,-1598.64,224577.78000000084,226176.42000000086,-1598.640000000014
14041,2022-05-11 08:05:00,447.5,225025.28000000084,226176.42000000086,-1151.140000000014
14042,2022-05-11 08:10:00,-349.65,224675.63000000085,226176.42000000086,-1500.7900000000081
14043,2022-05-11 08:15:00,-360.78,224314.85000000085,226176.42000000086,-1861.570000000007
14044,2022-05-11 08:20:00,-479.42,223835.43000000084,226176.42000000086,-2340.99000000002
14045,2022-05-11 08:25:00,-1576.21,222259.22000000085,226176.42000000086,-3917.2000000000116
14046,2022-05-11 08:30:00,856.27,223115.49000000083,226176.42000000086,-3060.930000000022
14047,2022-05-11 08:35:00,1115.54,224231.03000000084,226176.42000000086,-1945.390000000014
14048,2022-05-11 08:40:00,-1031.36,223199.67000000086,226176.42000000086,-2976.75
14049,2022-05-11 08:45:00,796.74,223996.41000000085,226176.42000000086,-2180.0100000000093
14050,2022-05-11 08:50:00,-1133.53,222862.88000000085,226176.42000000086,-3313.540000000008
14051,2022-05-11 08:55:00,-1171.44,221691.44000000085,226176.42000000086,-4484.9800000000105
14052,2022-05-11 09:00:00,-445.85,221245.59000000084,226176.42000000086,-4930.830000000016
14053,2022-05-11 09:05:00,-975.29,220270.30000000083,226176.42000000086,-5906.120000000024
14054,2022-05-11 09:10:00,390.71,220661.01000000082,226176.42000000086,-5515.410000000033
14055,2022-05-11 09:15:00,-860.37,219800.64000000083,226176.42000000086,-6375.780000000028
14056,2022-05-11 09:20:00,-537.49,219263.15000000084,226176.42000000086,-6913.270000000019
14057,2022-05-11 09:25:00,-1206.66,218056.49000000083,226176.42000000086,-8119.930000000022
14058,2022-05-11 09:30:00,-1708.66,216347.83000000083,226176.42000000086,-9828.590000000026
14059,2022-05-11 09:35:00,418.62,216766.45000000083,226176.42000000086,-9409.97000000003
14060,2022-05-11 09:40:00,652.04,217418.49000000083,226176.42000000086,-8757.930000000022
14061,2022-05-11 09:45:00,-1808.12,215610.37000000084,226176.42000000086,-10566.050000000017
14062,2022-05-11 09:50:00,-387.95,215222.42000000083,226176.42000000086,-10954.00000000003
14063,2022-05-11 09:55:00,3.79,215226.21000000084,226176.42000000086,-10950.210000000021
14064,2022-05-11 10:00:00,-782.74,214443.47000000085,226176.42000000086,-11732.950000000012
14065,2022-05-11 10:05:00,1025.07,215468.54000000085,226176.42000000086,-10707.880000000005
14066,2022-05-11 10:10:00,-705.32,214763.22000000085,226176.42000000086,-11413.200000000012
14067,2022-05-11 10:15:00,-826.18,213937.04000000085,226176.42000000086,-12239.380000000005
14068,2022-05-11 10:20:00,1723.83,215660.87000000084,226176.42000000086,-10515.550000000017
14069,2022-05-11 10:25:00,3.31,215664.18000000084,226176.42000000086,-10512.24000000002
14070,2022-05-11 10:30:00,-307.46,215356.72000000085,226176.42000000086,-10819.700000000012
14071,2022-05-11 10:35:00,988.74,216345.46000000084,226176.42000000086,-9830.960000000021
14072,2022-05-11 10:40:00,224.14,216569.60000000085,226176.42000000086,-9606.820000000007
14073,2022-05-11 10:45:00,-529.44,216040.16000000085,226176.42000000086,-10136.26000000001
14074,2022-05-11 10:50:00,-683.19,215356.97000000085,226176.42000000086,-10819.450000000012
14075,2022-05-11 10:55:00,-205.44,215151.53000000084,226176.42000000086,-11024.890000000014
14076,2022-05-11 11:00:00,-1399.23,213752.30000000083,226176.42000000086,-12424.120000000024
14077,2022-05-11 11:05:00,-1547.47,212204.83000000083,226176.42000000086,-13971.590000000026
14078,2022-05-11 11:10:00,-404.15,211800.68000000084,226176.42000000086,-14375.74000000002
14079,2022-05-11 11:15:00,796.61,212597.29000000082,226176.42000000086,-13579.130000000034
14080,2022-05-11 11:20:00,7.69,212604.98000000083,226176.42000000086,-13571.440000000031
14081,2022-05-11 11:25:00,-49.03,212555.95000000083,226176.42000000086,-13620.47000000003
14082,2022-05-11 11:30:00,-295.53,212260.42000000083,226176.42000000086,-13916.00000000003
14083,2022-05-11 11:35:00,1117.44,213377.86000000083,226176.42000000086,-12798.560000000027
14084,2022-05-11 11:40:00,-399.41,212978.45000000083,226176.42000000086,-13197.97000000003
14085,2022-05-11 11:45:00,1298.33,214276.7800000008,226176.42000000086,-11899.640000000043
14086,2022-05-11 11:50:00,1155.21,215431.9900000008,226176.42000000086,-10744.430000000051
14087,2022-05-11 11:55:00,1630.64,217062.63000000082,226176.42000000086,-9113.790000000037
14088,2022-05-11 12:00:00,1206.4,218269.0300000008,226176.42000000086,-7907.390000000043
14089,2022-05-11 12:05:00,1370.13,219639.16000000082,226176.42000000086,-6537.260000000038
14090,2022-05-11 12:10:00,364.15,220003.3100000008,226176.42000000086,-6173.110000000044
14091,2022-05-11 12:15:00,1028.6,221031.91000000082,226176.42000000086,-5144.510000000038
14092,2022-05-11 12:20:00,-1263.89,219768.0200000008,226176.42000000086,-6408.400000000052
14093,2022-05-11 12:25:00,-231.94,219536.0800000008,226176.42000000086,-6640.340000000055
14094,2022-05-11 12:30:00,950.3,220486.3800000008,226176.42000000086,-5690.040000000066
14095,2022-05-11 12:35:00,-1378.86,219107.5200000008,226176.42000000086,-7068.900000000052
14096,2022-05-11 12:40:00,1172.88,220280.4000000008,226176.42000000086,-5896.020000000048
14097,2022-05-11 12:45:00,-1155.14,219125.2600000008,226176.42000000086,-7051.160000000062
14098,2022-05-11 12:50:00,4.23,219129.4900000008,226176.42000000086,-7046.930000000051
14099,2022-05-11 12:55:00,201.31,219330.8000000008,226176.42000000086,-6845.620000000054
14100,2022-05-11 13:00:00,1254.25,220585.0500000008,226176.42000000086,-5591.370000000054
14101,2022-05-11 13:05:00,1172.19,221757.2400000008,226176.42000000086,-4419.180000000051
14102,2022-05-11 13:10:00,-1013.04,220744.2000000008,226176.42000000086,-5432.220000000059
14103,2022-05-11 13:15:00,-1754.46,218989.7400000008,226176.42000000086,-7186.680000000051
14104,2022-05-11 13:20:00,-1018.77,217970.97000000082,226176.42000000086,-8205.45000000004
14105,2022-05-11 13:25:00,1236.82,219207.79000000082,226176.42000000086,-6968.630000000034
14106,2022-05-11 13:30:00,1421.08,220628.8700000008,226176.42000000086,-5547.550000000047
14107,2022-05-11 13:35:00,-740.88,219887.9900000008,226176.42000000086,-6288.430000000051
14108,2022-05-11 13:40:00,-192.91,219695.0800000008,226176.42000000086,-6481.340000000055
14109,2022-05-11 13:45:00,882.21,220577.2900000008,226176.42000000086,-5599.130000000063
14110,2022-05-11 13:50:00,-1930.05,218647.2400000008,226176.42000000086,-7529.180000000051
14111,2022-05-11 13:55:00,-912.41,217734.8300000008,226176.42000000086,-8441.590000000055
14112,2022-05-11 14:00:00,42.23,217777.0600000008,226176.42000000086,-8399.360000000044
14113,2022-05-11 14:05:00,709.26,218486.32000000082,226176.42000000086,-7690.100000000035
14114,2022-05-11 14:10:00,1.57,218487.89000000083,226176.42000000086,-7688.530000000028
14115,2022-05-11 14:15:00,-479.02,218008.87000000084,226176.42000000086,-8167.5500000000175
14116,2022-05-11 14:20:00,1622.42,219631.29000000085,226176.42000000086,-6545.130000000005
14117,2022-05-11 14:25:00,-1413.99,218217.30000000086,226176.42000000086,-7959.119999999995
14118,2022-05-11 14:30:00,-26.73,218190.57000000085,226176.42000000086,-7985.850000000006
14119,2022-05-11 14:35:00,1272.23,219462.80000000086,226176.42000000086,-6713.619999999995
14120,2022-05-11 14:40:00,274.48,219737.28000000087,226176.42000000086,-6439.139999999985
14121,2022-05-11 14:45:00,-1562.16,218175.12000000087,226176.42000000086,-8001.299999999988
14122,2022-05-11 14:50:00,134.89,218310.01000000088,226176.42000000086,-7866.409999999974
14123,2022-05-11 14:55:00,-199.72,218110.29000000088,226176.42000000086,-8066.129999999976
14124,2022-05-11 15:00:00,-1217.25,216893.04000000088,226176.42000000086,-9283.379999999976
14125,2022-05-11 15:05:00,-136.76,216756.28000000087,226176.42000000086,-9420.139999999985
14126,2022-05-11 15:10:00,1168.68,217924.96000000086,226176.42000000086,-8251.459999999992
14127,2022-05-11 15:15:00,-349.26,217575.70000000086,226176.42000000086,-8600.720000000001
14128,2022-05-11 15:20:00,1135.12,218710.82000000085,226176.42000000086,-7465.600000000006
14129,2022-05-11 15:25:00,527.28,219238.10000000085,226176.42000000086,-6938.320000000007
14130,2022-05-11 15:30:00,-903.68,218334.42000000086,226176.42000000086,-7842.0
14131,2022-05-11 15:35:00,-1765.75,216568.67000000086,226176.42000000086,-9607.75
14132,2022-05-11 15:40:00,879.22,217447.89000000086,226176.42000000086,-8728.529999999999
14133,2022-05-11 15:45:00,72.67,217520.56000000087,226176.42000000086,-8655.859999999986
14134,2022-05-11 15:50:00,-148.31,217372.25000000087,226176.42000000086,-8804.169999999984
14135,2022-05-11 15:55:00,-1602.52,215769.73000000088,226176.42000000086,-10406.689999999973
14136,2022-05-11 16:00:00,1406.98,217176.7100000009,226176.42000000086,-8999.709999999963
14137,2022-05-11 16:05:00,-324.2,216852.51000000088,226176.42000000086,-9323.909999999974
14138,2022-05-11 16:10:00,69.12,216921.63000000088,226176.42000000086,-9254.789999999979
14139,2022-05-11 16:15:00,528.38,217450.01000000088,226176.42000000086,-8726.409999999974
14140,2022-05-11 16:20:00,1507.45,218957.4600000009,226176.42000000086,-7218.959999999963
14141,2022-05-11 16:25:00,-869.75,218087.7100000009,226176.42000000086,-8088.709999999963
14142,2022-05-11 16:30:00,1863.91,219951.6200000009,226176.42000000086,-6224.799999999959
14143,2022-05-11 16:35:00,976.35,220927.9700000009,226176.42000000086,-5248.449999999953
14144,2022-05-11 16:40:00,712.46,221640.4300000009,226176.42000000086,-4535.989999999962
14145,2022-05-11 16:45:00,-1912.21,219728.2200000009,226176.42000000086,-6448.199999999953
14146,2022-05-11 16:50:00,1200.16,220928.3800000009,226176.42000000086,-5248.03999999995
14147,2022-05-11 16:55:00,214.49,221142.8700000009,226176.42000000086,-5033.549999999959
14148,2022-05-12 08:00:00,-472.45,220670.4200000009,221142.8700000009,-472.45000000001164
14149,2022-05-12 08:05:00,725.27,221395.69000000088,221142.8700000009,252.81999999997788
14150,2022-05-12 08:10:00,1189.35,222585.04000000088,221142.8700000009,1442.1699999999837
14151,2022-05-12 08:15:00,-1194.54,221390.50000000087,221142.8700000009,247.62999999997555
14152,2022-05-12 08:20:00,104.29,221494.79000000088,221142.8700000009,351.9199999999837
14153,2022-05-12 08:25:00,-757.5,220737.29000000088,221142.8700000009,-405.5800000000163
14154,2022-05-12 08:30:00,-557.47,220179.82000000088,221142.8700000009,-963.0500000000175
14155,2022-05-12 08:35:00,-369.64,219810.18000000087,221142.8700000009,-1332.6900000000314
14156,2022-05-12 08:40:00,-1885.17,217925.01000000085,221142.8700000009,-3217.8600000000442
14157,2022-05-12 08:45:00,114.47,218039.48000000085,221142.8700000009,-3103.390000000043
14158,2022-05-12 08:50:00,1237.32,219276.80000000086,221142.8700000009,-1866.070000000036
14159,2022-05-12 08:55:00,-1683.14,217593.66000000085,221142.8700000009,-3549.21000000005
14160,2022-05-12 09:00:00,-1406.35,216187.31000000084,221142.8700000009,-4955.560000000056
14161,2022-05-12 09:05:00,-103.43,216083.88000000085,221142.8700000009,-5058.990000000049
14162,2022-05-12 09:10:00,1372.23,217456.11000000086,221142.8700000009,-3686.7600000000384
14163,2022-05-12 09:15:00,-438.12,217017.99000000086,221142.8700000009,-4124.880000000034
14164,2022-05-12 09:20:00,62.43,217080.42000000086,221142.8700000009,-4062.4500000000407
14165,2022-05-12 09:25:00,326.43,217406.85000000085,221142.8700000009,-3736.0200000000477
14166,2022-05-12 09:30:00,760.65,218167.50000000084,221142.8700000009,-2975.3700000000536
14167,2022-05-12 09:35:00,1153.97,219321.47000000085,221142.8700000009,-1821.4000000000524
14168,2022-05-12 09:40:00,344.38,219665.85000000085,221142.8700000009,-1477.0200000000477
14169,2022-05-12 09:45:00,-218.06,219447.79000000085,221142.8700000009,-1695.0800000000454
14170,2022-05-12 09:50:00,-1767.6,217680.19000000085,221142.8700000009,-3462.680000000051
14171,2022-05-12 09:55:00,-945.36,216734.83000000086,221142.8700000009,-4408.040000000037
14172,2022-05-12 10:00:00,-1122.76,215612.07000000085,221142.8700000009,-5530.800000000047
14173,2022-05-12 10:05:00,1280.5,216892.57000000085,221142.8700000009,-4250.300000000047
14174,2022-05-12 10:10:00,-254.11,216638.46000000086,221142.8700000009,-4504.410000000033
14175,2022-05-12 10:15:00,-304.56,216333.90000000087,221142.8700000009,-4808.97000000003
14176,2022-05-12 10:20:00,-11.78,216322.12000000087,221142.8700000009,-4820.750000000029
14177,2022-05-12 10:25:00,-1651.92,214670.20000000086,221142.8700000009,-6472.670000000042
14178,2022-05-12 10:30:00,-960.76,213709.44000000085,221142.8700000009,-7433.430000000051
14179,2022-05-12 10:35:00,1611.51,215320.95000000086,221142.8700000009,-5821.920000000042
14180,2022-05-12 10:40:00,1688.46,217009.41000000085,221142.8700000009,-4133.46000000005
14181,2022-05-12 10:45:00,-1025.5,215983.91000000085,221142.8700000009,-5158.96000000005
14182,2022-05-12 10:50:00,306.51,216290.42000000086,221142.8700000009,-4852.450000000041
14183,2022-05-12 10:55:00,1524.52,217814.94000000085,221142.8700000009,-3327.930000000051
14184,2022-05-12 11:00:00,1079.55,218894.49000000083,221142.8700000009,-2248.380000000063
14185,2022-05-12 11:05:00,679.44,219573.93000000084,221142.8700000009,-1568.9400000000605
14186,2022-05-12 11:10:00,1290.24,220864.17000000083,221142.8700000009,-278.70000000006985
14187,2022-05-12 11:15:00,1174.97,222039.14000000083,221142.8700000009,896.2699999999313
14188,2022-05-12 11:20:00,-1498.94,220540.20000000083,221142.8700000009,-602.670000000071
14189,2022-05-12 11:25:00,-1099.61,219440.59000000084,221142.8700000009,-1702.280000000057
14190,2022-05-12 11:30:00,1634.39,221074.98000000085,221142.8700000009,-67.89000000004307
14191,2022-05-12 11:35:00,1615.43,222690.41000000085,221142.8700000009,1547.53999999995
14192,2022-05-12 11:40:00,-1756.62,220933.79000000085,221142.8700000009,-209.0800000000454
14193,2022-05-12 11:45:00,-1521.75,219412.04000000085,221142.8700000009,-1730.8300000000454
14194,2022-05-12 11:50:00,-1768.39,217643.65000000084,221142.8700000009,-3499.2200000000594
14195,2022-05-12 11:55:00,-588.32,217055.33000000083,221142.8700000009,-4087.5400000000664
14196,2022-05-12 12:00:00,1146.03,218201.36000000083,221142.8700000009,-2941.5100000000675
14197,2022-05-12 12:05:00,-91.63,218109.73000000083,221142.8700000009,-3033.140000000072
14198,2022-05-12 12:10:00,545.74,218655.47000000082,221142.8700000009,-2487.4000000000815
14199,2022-05-12 12:15:00,1035.19,219690.66000000082,221142.8700000009,-1452.2100000000792
14200,2022-05-12 12:20:00,219.2,219909.86000000083,221142.8700000009,-1233.0100000000675
14201,2022-05-12 12:25:00,-1380.19,218529.67000000083,221142.8700000009,-2613.20000000007
14202,2022-05-12 12:30:00,-1184.07,217345.60000000082,221142.8700000009,-3797.270000000077
14203,2022-05-12 12:35:00,-749.11,216596.49000000083,221142.8700000009,-4546.380000000063
14204,2022-05-12 12:40:00,1405.9,218002.39000000083,221142.8700000009,-3140.4800000000687
14205,2022-05-12 12:45:00,-264.9,217737.49000000083,221142.8700000009,-3405.380000000063
14206,2022-05-12 12:50:00,215.55,217953.04000000082,221142.8700000009,-3189.8300000000745
14207,2022-05-12 12:55:00,1404.48,219357.52000000083,221142.8700000009,-1785.350000000064
14208,2022-05-12 13:00:00,-599.04,218758.48000000083,221142.8700000009,-2384.390000000072
14209,2022-05-12 13:05:00,1133.79,219892.27000000083,221142.8700000009,-1250.600000000064
14210,2022-05-12 13:10:00,594.88,220487.15000000084,221142.8700000009,-655.7200000000594
14211,2022-05-12 13:15:00,1999.1,222486.25000000084,221142.8700000009,1343.3799999999464
14212,2022-05-12 13:20:00,-1643.39,220842.86000000083,221142.8700000009,-300.0100000000675
14213,2022-05-12 13:25:00,122.85,220965.71000000084,221142.8700000009,-177.1600000000617
14214,2022-05-12 13:30:00,335.59,221301.30000000083,221142.8700000009,158.4299999999348
14215,2022-05-12 13:35:00,1148.28,222449.58000000083,221142.8700000009,1306.7099999999336
14216,2022-05-12 13:40:00,1288.9,223738.48000000083,221142.8700000009,2595.609999999928
14217,2022-05-12 13:45:00,1264.81,225003.29000000082,221142.8700000009,3860.4199999999255
14218,2022-05-12 13:50:00,1697.8,226701.0900000008,221142.8700000009,5558.219999999914
14219,2022-05-12 13:55:00,389.25,227090.3400000008,221142.8700000009,5947.469999999914
14220,2022-05-12 14:00:00,-1840.35,225249.9900000008,221142.8700000009,4107.119999999908
14221,2022-05-12 14:05:00,1449.25,226699.2400000008,221142.8700000009,5556.369999999908
14222,2022-05-12 14:10:00,1044.03,227743.2700000008,221142.8700000009,6600.399999999907
14223,2022-05-12 14:15:00,-1043.02,226700.25000000081,221142.8700000009,5557.379999999917
14224,2022-05-12 14:20:00,668.43,227368.6800000008,221142.8700000009,6225.80999999991
14225,2022-05-12 14:25:00,-1610.56,225758.1200000008,221142.8700000009,4615.249999999913
14226,2022-05-12 14:30:00,800.03,226558.1500000008,221142.8700000009,5415.2799999999115
14227,2022-05-12 14:35:00,1702.81,228260.9600000008,221142.8700000009,7118.089999999909
14228,2022-05-12 14:40:00,-1669.13,226591.8300000008,221142.8700000009,5448.9599999999045
14229,2022-05-12 14:45:00,-67.86,226523.97000000082,221142.8700000009,5381.0999999999185
14230,2022-05-12 14:50:00,-743.49,225780.48000000083,221142.8700000009,4637.609999999928
14231,2022-05-12 14:55:00,-1353.35,224427.13000000082,221142.8700000009,3284.259999999922
14232,2022-05-12 15:00:00,-756.09,223671.04000000082,221142.8700000009,2528.1699999999255
14233,2022-05-12 15:05:00,-1504.07,222166.97000000082,221142.8700000009,1024.0999999999185
14234,2022-05-12 15:10:00,183.11,222350.0800000008,221142.8700000009,1207.2099999999045
14235,2022-05-12 15:15:00,406.26,222756.3400000008,221142.8700000009,1613.4699999999139
14236,2022-05-12 15:20:00,-306.7,222449.6400000008,221142.8700000009,1306.7699999999022
14237,2022-05-12 15:25:00,-390.31,222059.3300000008,221142.8700000009,916.4599999999045
14238,2022-05-12 15:30:00,1804.69,223864.0200000008,221142.8700000009,2721.149999999907
14239,2022-05-12 15:35:00,-938.52,222925.50000000081,221142.8700000009,1782.6299999999173
14240,2022-05-12 15:40:00,-565.51,222359.9900000008,221142.8700000009,1217.119999999908
14241,2022-05-12 15:45:00,-318.96,222041.0300000008,221142.8700000009,898.1599999999162
14242,2022-05-12 15:50:00,-1117.55,220923.48000000083,221142.8700000009,-219.39000000007218
14243,2022-05-12 15:55:00,1767.23,222690.71000000084,221142.8700000009,1547.8399999999383
14244,2022-05-12 16:00:00,671.59,223362.30000000083,221142.8700000009,2219.429999999935
14245,2022-05-12 16:05:00,-1970.73,221391.57000000082,221142.8700000009,248.69999999992433
14246,2022-05-12 16:10:00,1783.93,223175.50000000081,221142.8700000009,2032.6299999999173
14247,2022-05-12 16:15:00,-395.0,222780.50000000081,221142.8700000009,1637.6299999999173
14248,2022-05-12 16:20:00,-1412.11,221368.39000000083,221142.8700000009,225.51999999993131
14249,2022-05-12 16:25:00,-87.62,221280.77000000083,221142.8700000009,137.89999999993597
14250,2022-05-12 16:30:00,-1662.35,219618.42000000083,221142.8700000009,-1524.4500000000698
14251,2022-05-12 16:35:00,1925.59,221544.01000000082,221142.8700000009,401.13999999992666
14252,2022-05-12 16:40:00,724.47,222268.48000000083,221142.8700000009,1125.6099999999278
14253,2022-05-12 16:45:00,-115.06,222153.42000000083,221142.8700000009,1010.5499999999302
14254,2022-05-12 16:50:00,1267.16,223420.58000000083,221142.8700000009,2277.7099999999336
14255,2022-05-12 16:55:00,1608.76,225029.34000000084,221142.8700000009,3886.469999999943
14256,2022-05-13 08:00:00,-45.43,224983.91000000085,225029.34000000084,-45.429999999993015
14257,2022-05-13 08:05:00,579.6,225563.51000000085,225029.34000000084,534.1700000000128
14258,2022-05-13 08:10:00,1759.06,227322.57000000085,225029.34000000084,2293.2300000000105
14259,2022-05-13 08:15:00,252.84,227575.41000000085,225029.34000000084,2546.070000000007
14260,2022-05-13 08:20:00,-1934.95,225640.46000000084,225029.34000000084,611.1199999999953
14261,2022-05-13 08:25:00,-1368.14,224272.32000000082,225029.34000000084,-757.0200000000186
14262,2022-05-13 08:30:00,276.61,224548.9300000008,225029.34000000084,-480.4100000000326
14263,2022-05-13 08:35:00,1510.24,226059.1700000008,225029.34000000084,1029.829999999958
14264,2022-05-13 08:40:00,1703.21,227762.3800000008,225029.34000000084,2733.03999999995
14265,2022-05-13 08:45:00,1431.32,229193.7000000008,225029.34000000084,4164.359999999957
14266,2022-05-13 08:50:00,-517.38,228676.3200000008,225029.34000000084,3646.9799999999523
14267,2022-05-13 08:55:00,25.11,228701.43000000078,225029.34000000084,3672.0899999999383
14268,2022-05-13 09:00:00,-1908.91,226792.52000000078,225029.34000000084,1763.1799999999348
14269,2022-05-13 09:05:00,248.67,227041.1900000008,225029.34000000084,2011.8499999999476
14270,2022-05-13 09:10:00,-827.35,226213.84000000078,225029.34000000084,1184.4999999999418
14271,2022-05-13 09:15:00,512.12,226725.96000000078,225029.34000000084,1696.6199999999371
14272,2022-05-13 09:20:00,-1527.56,225198.40000000078,225029.34000000084,169.05999999993946
14273,2022-05-13 09:25:00,-1058.58,224139.8200000008,225029.34000000084,-889.5200000000477
14274,2022-05-13 09:30:00,-813.87,223325.9500000008,225029.34000000084,-1703.390000000043
14275,2022-05-13 09:35:00,-1873.36,221452.5900000008,225029.34000000084,-3576.750000000029
14276,2022-05-13 09:40:00,1584.03,223036.6200000008,225029.34000000084,-1992.7200000000303
14277,2022-05-13 09:45:00,-1426.05,221610.57000000082,225029.34000000084,-3418.7700000000186
14278,2022-05-13 09:50:00,-521.81,221088.76000000082,225029.34000000084,-3940.5800000000163
14279,2022-05-13 09:55:00,332.31,221421.07000000082,225029.34000000084,-3608.2700000000186
14280,2022-05-13 10:00:00,439.73,221860.80000000083,225029.34000000084,-3168.540000000008
14281,2022-05-13 10:05:00,497.57,222358.37000000084,225029.34000000084,-2670.970000000001
14282,2022-05-13 10:10:00,1746.62,224104.99000000083,225029.34000000084,-924.3500000000058
14283,2022-05-13 10:15:00,1839.08,225944.07000000082,225029.34000000084,914.7299999999814
14284,2022-05-13 10:20:00,-279.07,225665.00000000081,225029.34000000084,635.6599999999744
14285,2022-05-13 10:25:00,-1574.63,224090.3700000008,225029.34000000084,-938.9700000000303
14286,2022-05-13 10:30:00,1500.29,225590.66000000082,225029.34000000084,561.3199999999779
14287,2022-05-13 10:35:00,-937.19,224653.47000000082,225029.34000000084,-375.87000000002445
14288,2022-05-13 10:40:00,977.09,225630.5600000008,225029.34000000084,601.2199999999721
14289,2022-05-13 10:45:00,-1300.59,224329.97000000082,225029.34000000084,-699.3700000000244
14290,2022-05-13 10:50:00,-1125.17,223204.8000000008,225029.34000000084,-1824.5400000000373
14291,2022-05-13 10:55:00,-303.93,222900.8700000008,225029.34000000084,-2128.4700000000303
14292,2022-05-13 11:00:00,766.8,223667.6700000008,225029.34000000084,-1361.670000000042
14293,2022-05-13 11:05:00,1914.47,225582.1400000008,225029.34000000084,552.7999999999593
14294,2022-05-13 11:10:00,651.42,226233.5600000008,225029.34000000084,1204.219999999972
14295,2022-05-13 11:15:00,-1961.49,224272.07000000082,225029.34000000084,-757.2700000000186
14296,2022-05-13 11:20:00,469.88,224741.95000000083,225029.34000000084,-287.39000000001397
14297,2022-05-13 11:25:00,774.2,225516.15000000084,225029.34000000084,486.8099999999977
14298,2022-05-13 11:30:00,-190.66,225325.49000000083,225029.34000000084,296.1499999999942
14299,2022-05-13 11:35:00,463.22,225788.71000000084,225029.34000000084,759.3699999999953
14300,2022-05-13 11:40:00,1239.88,227028.59000000084,225029.34000000084,1999.25
14301,2022-05-13 11:45:00,-1584.3,225444.29000000085,225029.34000000084,414.95000000001164
14302,2022-05-13 11:50:00,-1114.04,224330.25000000084,225029.34000000084,-699.0899999999965
14303,2022-05-13 11:55:00,-1171.89,223158.36000000083,225029.34000000084,-1870.9800000000105
14304,2022-05-13 12:00:00,998.83,224157.19000000082,225029.34000000084,-872.1500000000233
14305,2022-05-13 12:05:00,1310.54,225467.73000000083,225029.34000000084,438.38999999998487
14306,2022-05-13 12:10:00,-98.14,225369.5900000008,225029.34000000084,340.2499999999709
14307,2022-05-13 12:15:00,1877.16,227246.75000000081,225029.34000000084,2217.4099999999744
14308,2022-05-13 12:20:00,1367.22,228613.97000000082,225029.34000000084,3584.6299999999756
14309,2022-05-13 12:25:00,-1348.78,227265.19000000082,225029.34000000084,2235.8499999999767
14310,2022-05-13 12:30:00,63.01,227328.20000000083,225029.34000000084,2298.859999999986
14311,2022-05-13 12:35:00,1429.46,228757.66000000082,225029.34000000084,3728.319999999978
14312,2022-05-13 12:40:00,1520.37,230278.0300000008,225029.34000000084,5248.689999999973
14313,2022-05-13 12:45:00,-309.0,229969.0300000008,225029.34000000084,4939.689999999973
14314,2022-05-13 12:50:00,-404.76,229564.2700000008,225029.34000000084,4534.929999999964
14315,2022-05-13 12:55:00,-1890.0,227674.2700000008,225029.34000000084,2644.929999999964
14316,2022-05-13 13:00:00,-1502.01,226172.2600000008,225029.34000000084,1142.9199999999546
14317,2022-05-13 13:05:00,233.97,226406.2300000008,225029.34000000084,1376.8899999999558
14318,2022-05-13 13:10:00,1685.72,228091.9500000008,225029.34000000084,3062.609999999957
14319,2022-05-13 13:15:00,-367.1,227724.8500000008,225029.34000000084,2695.509999999951
14320,2022-05-13 13:20:00,186.01,227910.8600000008,225029.34000000084,2881.5199999999604
14321,2022-05-13 13:25:00,-1015.05,226895.8100000008,225029.34000000084,1866.469999999972
14322,2022-05-13 13:30:00,1171.42,228067.23000000083,225029.34000000084,3037.889999999985
14323,2022-05-13 13:35:00,-1363.33,226703.90000000084,225029.34000000084,1674.5599999999977
14324,2022-05-13 13:40:00,1581.33,228285.23000000083,225029.34000000084,3255.889999999985
14325,2022-05-13 13:45:00,1549.54,229834.77000000083,225029.34000000084,4805.429999999993
14326,2022-05-13 13:50:00,302.04,230136.81000000084,225029.34000000084,5107.470000000001
14327,2022-05-13 13:55:00,-1663.84,228472.97000000085,225029.34000000084,3443.6300000000047
14328,2022-05-13 14:00:00,-120.41,228352.56000000084,225029.34000000084,3323.220000000001
14329,2022-05-13 14:05:00,-1624.43,226728.13000000085,225029.34000000084,1698.7900000000081
14330,2022-05-13 14:10:00,-103.32,226624.81000000084,225029.34000000084,1595.4700000000012
14331,2022-05-13 14:15:00,1873.92,228498.73000000085,225029.34000000084,3469.390000000014
14332,2022-05-13 14:20:00,-604.98,227893.75000000084,225029.34000000084,2864.4100000000035
14333,2022-05-13 14:25:00,-37.27,227856.48000000085,225029.34000000084,2827.140000000014
14334,2022-05-13 14:30:00,254.48,228110.96000000086,225029.34000000084,3081.6200000000244
14335,2022-05-13 14:35:00,-1564.61,226546.35000000088,225029.34000000084,1517.0100000000384
14336,2022-05-13 14:40:00,-810.22,225736.13000000088,225029.34000000084,706.7900000000373
14337,2022-05-13 14:45:00,154.11,225890.24000000086,225029.34000000084,860.9000000000233
14338,2022-05-13 14:50:00,69.0,225959.24000000086,225029.34000000084,929.9000000000233
14339,2022-05-13 14:55:00,-1764.73,224194.51000000085,225029.34000000084,-834.8299999999872
14340,2022-05-13 15:00:00,-473.49,223721.02000000086,225029.34000000084,-1308.3199999999779
14341,2022-05-13 15:05:00,-790.61,222930.41000000088,225029.34000000084,-2098.929999999964
14342,2022-05-13 15:10:00,-1935.28,220995.13000000088,225029.34000000084,-4034.2099999999627
14343,2022-05-13 15:15:00,-858.03,220137.10000000088,225029.34000000084,-4892.239999999962
14344,2022-05-13 15:20:00,266.78,220403.88000000088,225029.34000000084,-4625.459999999963
14345,2022-05-13 15:25:00,-380.47,220023.41000000088,225029.34000000084,-5005.929999999964
14346,2022-05-13 15:30:00,-1534.69,218488.72000000087,225029.34000000084,-6540.619999999966
14347,2022-05-13 15:35:00,1286.48,219775.20000000088,225029.34000000084,-5254.139999999956
14348,2022-05-13 15:40:00,1495.63,221270.8300000009,225029.34000000084,-3758.509999999951
14349,2022-05-13 15:45:00,1503.45,222774.2800000009,225029.34000000084,-2255.0599999999395
14350,2022-05-13 15:50:00,1907.99,224682.2700000009,225029.34000000084,-347.0699999999488
14351,2022-05-13 15:55:00,1451.57,226133.8400000009,225029.34000000084,1104.5000000000582
14352,2022-05-13 16:00:00,943.27,227077.1100000009,225029.34000000084,2047.7700000000477
14353,2022-05-13 16:05:00,-566.92,226510.19000000088,225029.34000000084,1480.850000000035
14354,2022-05-13 16:10:00,186.92,226697.1100000009,225029.34000000084,1667.7700000000477
14355,2022-05-13 16:15:00,-671.73,226025.38000000088,225029.34000000084,996.0400000000373
14356,2022-05-13 16:20:00,-352.12,225673.26000000088,225029.34000000084,643.9200000000419
14357,2022-05-13 16:25:00,-162.85,225510.41000000088,225029.34000000084,481.0700000000361
14358,2022-05-13 16:30:00,286.11,225796.52000000086,225029.34000000084,767.1800000000221
14359,2022-05-13 16:35:00,331.87,226128.39000000086,225029.34000000084,1099.0500000000175
14360,2022-05-13 16:40:00,1092.02,227220.41000000085,225029.34000000084,2191.070000000007
14361,2022-05-13 16:45:00,385.92,227606.33000000086,225029.34000000084,2576.99000000002
14362,2022-05-13 16:50:00,-247.83,227358.50000000087,225029.34000000084,2329.1600000000326
14363,2022-05-13 16:55:00,-1136.69,226221.81000000087,225029.34000000084,1192.4700000000303
14364,2022-05-14 08:00:00,1528.67,227750.48000000088,226221.81000000087,1528.6700000000128
14365,2022-05-14 08:05:00,-1587.39,226163.09000000087,226221.81000000087,-58.720000000001164
14366,2022-05-14 08:10:00,180.83,226343.92000000086,226221.81000000087,122.10999999998603
14367,2022-05-14 08:15:00,-817.73,225526.19000000085,226221.81000000087,-695.6200000000244
14368,2022-05-14 08:20:00,-998.53,224527.66000000085,226221.81000000087,-1694.1500000000233
14369,2022-05-14 08:25:00,86.17,224613.83000000086,226221.81000000087,-1607.9800000000105
14370,2022-05-14 08:30:00,170.66,224784.49000000086,226221.81000000087,-1437.320000000007
14371,2022-05-14 08:35:00,777.88,225562.37000000087,226221.81000000087,-659.4400000000023
14372,2022-05-14 08:40:00,-432.08,225130.29000000088,226221.81000000087,-1091.5199999999895
14373,2022-05-14 08:45:00,870.36,226000.65000000087,226221.81000000087,-221.1600000000035
14374,2022-05-14 08:50:00,-229.8,225770.85000000088,226221.81000000087,-450.95999999999185
14375,2022-05-14 08:55:00,-667.48,225103.37000000087,226221.81000000087,-1118.4400000000023
14376,2022-05-14 09:00:00,676.88,225780.25000000087,226221.81000000087,-441.5599999999977
14377,2022-05-14 09:05:00,1226.78,227007.03000000087,226221.81000000087,785.2200000000012
14378,2022-05-14 09:10:00,-1669.1,225337.93000000087,226221.81000000087,-883.8800000000047
14379,2022-05-14 09:15:00,-507.93,224830.00000000087,226221.81000000087,-1391.8099999999977
14380,2022-05-14 09:20:00,-1576.82,223253.18000000087,226221.81000000087,-2968.6300000000047
14381,2022-05-14 09:25:00,466.3,223719.48000000085,226221.81000000087,-2502.3300000000163
14382,2022-05-14 09:30:00,1083.17,224802.65000000087,226221.81000000087,-1419.1600000000035
14383,2022-05-14 09:35:00,1909.06,226711.71000000086,226221.81000000087,489.8999999999942
14384,2022-05-14 09:40:00,-1369.49,225342.22000000087,226221.81000000087,-879.5899999999965
14385,2022-05-14 09:45:00,-364.4,224977.82000000088,226221.81000000087,-1243.9899999999907
14386,2022-05-14 09:50:00,93.32,225071.1400000009,226221.81000000087,-1150.6699999999837
14387,2022-05-14 09:55:00,611.52,225682.66000000088,226221.81000000087,-539.1499999999942
14388,2022-05-14 10:00:00,1537.98,227220.6400000009,226221.81000000087,998.8300000000163
14389,2022-05-14 10:05:00,1234.55,228455.19000000088,226221.81000000087,2233.3800000000047
14390,2022-05-14 10:10:00,-817.55,227637.6400000009,226221.81000000087,1415.8300000000163
14391,2022-05-14 10:15:00,-1867.52,225770.1200000009,226221.81000000087,-451.6899999999732
14392,2022-05-14 10:20:00,1347.91,227118.0300000009,226221.81000000087,896.2200000000303
14393,2022-05-14 10:25:00,495.36,227613.3900000009,226221.81000000087,1391.5800000000163
14394,2022-05-14 10:30:00,1661.22,229274.6100000009,226221.81000000087,3052.8000000000175
14395,2022-05-14 10:35:00,-1983.65,227290.9600000009,226221.81000000087,1069.1500000000233
14396,2022-05-14 10:40:00,-539.46,226751.5000000009,226221.81000000087,529.6900000000314
14397,2022-05-14 10:45:00,1242.76,227994.2600000009,226221.81000000087,1772.4500000000407
14398,2022-05-14 10:50:00,-1199.55,226794.71000000092,226221.81000000087,572.9000000000524
14399,2022-05-14 10:55:00,-1082.08,225712.63000000094,226221.81000000087,-509.1799999999348
14400,2022-05-14 11:00:00,1414.16,227126.79000000094,226221.81000000087,904.9800000000687
14401,2022-05-14 11:05:00,-1456.6,225670.19000000093,226221.81000000087,-551.6199999999371
14402,2022-05-14 11:10:00,1168.69,226838.88000000094,226221.81000000087,617.0700000000652
14403,2022-05-14 11:15:00,-861.68,225977.20000000094,226221.81000000087,-244.60999999992782
14404,2022-05-14 11:20:00,1106.9,227084.10000000094,226221.81000000087,862.2900000000664
14405,2022-05-14 11:25:00,-1753.64,225330.46000000092,226221.81000000087,-891.3499999999476
14406,2022-05-14 11:30:00,-923.99,224406.47000000093,226221.81000000087,-1815.3399999999383
14407,2022-05-14 11:35:00,1387.16,225793.63000000094,226221.81000000087,-428.1799999999348
14408,2022-05-14 11:40:00,-1787.63,224006.00000000093,226221.81000000087,-2215.8099999999395
14409,2022-05-14 11:45:00,715.47,224721.47000000093,226221.81000000087,-1500.3399999999383
14410,2022-05-14 11:50:00,1003.04,225724.51000000094,226221.81000000087,-497.29999999993015
14411,2022-05-14 11:55:00,-1606.95,224117.56000000093,226221.81000000087,-2104.249999999942
14412,2022-05-14 12:00:00,200.73,224318.29000000094,226221.81000000087,-1903.5199999999313
14413,2022-05-14 12:05:00,1868.69,226186.98000000094,226221.81000000087,-34.82999999992899
14414,2022-05-14 12:10:00,-1418.05,224768.93000000095,226221.81000000087,-1452.8799999999173
14415,2022-05-14 12:15:00,599.11,225368.04000000094,226221.81000000087,-853.7699999999313
14416,2022-05-14 12:20:00,-466.38,224901.66000000093,226221.81000000087,-1320.149999999936
14417,2022-05-14 12:25:00,-786.66,224115.00000000093,226221.81000000087,-2106.8099999999395
14418,2022-05-14 12:30:00,-1822.07,222292.93000000092,226221.81000000087,-3928.8799999999464
14419,2022-05-14 12:35:00,1727.38,224020.31000000093,226221.81000000087,-2201.499999999942
14420,2022-05-14 12:40:00,-548.61,223471.70000000094,226221.81000000087,-2750.109999999928
14421,2022-05-14 12:45:00,645.91,224117.61000000095,226221.81000000087,-2104.1999999999243
14422,2022-05-14 12:50:00,-630.98,223486.63000000094,226221.81000000087,-2735.179999999935
14423,2022-05-14 12:55:00,-1725.95,221760.68000000092,226221.81000000087,-4461.129999999946
14424,2022-05-14 13:00:00,-296.69,221463.99000000092,226221.81000000087,-4757.819999999949
14425,2022-05-14 13:05:00,1933.39,223397.38000000094,226221.81000000087,-2824.429999999935
14426,2022-05-14 13:10:00,393.13,223790.51000000094,226221.81000000087,-2431.29999999993
14427,2022-05-14 13:15:00,-1424.68,222365.83000000095,226221.81000000087,-3855.979999999923
14428,2022-05-14 13:20:00,-1951.83,220414.00000000096,226221.81000000087,-5807.80999999991
14429,2022-05-14 13:25:00,1582.49,221996.49000000095,226221.81000000087,-4225.31999999992
14430,2022-05-14 13:30:00,-1913.78,220082.71000000095,226221.81000000087,-6139.0999999999185
14431,2022-05-14 13:35:00,-227.44,219855.27000000095,226221.81000000087,-6366.539999999921
14432,2022-05-14 13:40:00,-1103.76,218751.51000000094,226221.81000000087,-7470.29999999993
14433,2022-05-14 13:45:00,1349.4,220100.91000000093,226221.81000000087,-6120.899999999936
14434,2022-05-14 13:50:00,758.16,220859.07000000094,226221.81000000087,-5362.7399999999325
14435,2022-05-14 13:55:00,-1738.21,219120.86000000095,226221.81000000087,-7100.949999999924
14436,2022-05-14 14:00:00,321.5,219442.36000000095,226221.81000000087,-6779.449999999924
14437,2022-05-14 14:05:00,1761.74,221204.10000000094,226221.81000000087,-5017.709999999934
14438,2022-05-14 14:10:00,14.92,221219.02000000095,226221.81000000087,-5002.789999999921
14439,2022-05-14 14:15:00,1404.0,222623.02000000095,226221.81000000087,-3598.789999999921
14440,2022-05-14 14:20:00,1996.86,224619.88000000094,226221.81000000087,-1601.9299999999348
14441,2022-05-14 14:25:00,77.85,224697.73000000094,226221.81000000087,-1524.079999999929
14442,2022-05-14 14:30:00,-1746.14,222951.59000000093,226221.81000000087,-3270.219999999943
14443,2022-05-14 14:35:00,-375.84,222575.75000000093,226221.81000000087,-3646.0599999999395
14444,2022-05-14 14:40:00,583.43,223159.18000000092,226221.81000000087,-3062.6299999999464
14445,2022-05-14 14:45:00,986.47,224145.65000000093,226221.81000000087,-2076.1599999999453
14446,2022-05-14 14:50:00,1959.52,226105.17000000092,226221.81000000087,-116.63999999995576
14447,2022-05-14 14:55:00,368.36,226473.5300000009,226221.81000000087,251.72000000003027
14448,2022-05-14 15:00:00,-278.27,226195.2600000009,226221.81000000087,-26.549999999959255
14449,2022-05-14 15:05:00,-1831.79,224363.4700000009,226221.81000000087,-1858.3399999999674
14450,2022-05-14 15:10:00,1230.48,225593.9500000009,226221.81000000087,-627.8599999999569
14451,2022-05-14 15:15:00,-1359.71,224234.24000000092,226221.81000000087,-1987.5699999999488
14452,2022-05-14 15:20:00,-997.85,223236.39000000092,226221.81000000087,-2985.4199999999546
14453,2022-05-14 15:25:00,-1604.07,221632.3200000009,226221.81000000087,-4589.489999999962
14454,2022-05-14 15:30:00,934.55,222566.8700000009,226221.81000000087,-3654.939999999973
14455,2022-05-14 15:35:00,-1506.9,221059.9700000009,226221.81000000087,-5161.839999999967
14456,2022-05-14 15:40:00,-1875.97,219184.0000000009,226221.81000000087,-7037.809999999969
14457,2022-05-14 15:45:00,-365.13,218818.8700000009,226221.81000000087,-7402.939999999973
14458,2022-05-14 15:50:00,1413.57,220232.4400000009,226221.81000000087,-5989.369999999966
14459,2022-05-14 15:55:00,1421.01,221653.4500000009,226221.81000000087,-4568.359999999957
14460,2022-05-14 16:00:00,-1766.33,219887.12000000093,226221.81000000087,-6334.689999999944
14461,2022-05-14 16:05:00,574.02,220461.14000000092,226221.81000000087,-5760.669999999955
14462,2022-05-14 16:10:00,617.0,221078.14000000092,226221.81000000087,-5143.669999999955
14463,2022-05-14 16:15:00,1150.97,222229.11000000092,226221.81000000087,-3992.6999999999534
14464,2022-05-14 16:20:00,-1203.37,221025.74000000092,226221.81000000087,-5196.069999999949
14465,2022-05-14 16:25:00,-1622.74,219403.00000000093,226221.81000000087,-6818.8099999999395
14466,2022-05-14 16:30:00,1827.62,221230.62000000093,226221.81000000087,-4991.189999999944
14467,2022-05-14 16:35:00,1523.75,222754.37000000093,226221.81000000087,-3467.439999999944
14468,2022-05-14 16:40:00,-1837.64,220916.7300000009,226221.81000000087,-5305.079999999958
14469,2022-05-14 16:45:00,1116.06,222032.7900000009,226221.81000000087,-4189.01999999996
14470,2022-05-14 16:50:00,235.43,222268.2200000009,226221.81000000087,-3953.5899999999674
14471,2022-05-14 16:55:00,1111.32,223379.5400000009,226221.81000000087,-2842.2699999999604
14472,2022-05-15 08:00:00,-1917.53,221462.0100000009,223379.5400000009,-1917.5299999999988
14473,2022-05-15 08:05:00,1440.43,222902.4400000009,223379.5400000009,-477.1000000000058
14474,2022-05-15 08:10:00,-495.92,222406.5200000009,223379.5400000009,-973.0200000000186
14475,2022-05-15 08:15:00,1946.08,224352.60000000088,223379.5400000009,973.0599999999686
14476,2022-05-15 08:20:00,626.0,224978.60000000088,223379.5400000009,1599.0599999999686
14477,2022-05-15 08:25:00,1044.02,226022.62000000087,223379.5400000009,2643.079999999958
14478,2022-05-15 08:30:00,1724.44,227747.06000000087,223379.5400000009,4367.51999999996
14479,2022-05-15 08:35:00,1688.78,229435.84000000087,223379.5400000009,6056.299999999959
14480,2022-05-15 08:40:00,1293.68,230729.52000000086,223379.5400000009,7349.979999999952
14481,2022-05-15 08:45:00,125.25,230854.77000000086,223379.5400000009,7475.229999999952
14482,2022-05-15 08:50:00,180.45,231035.22000000087,223379.5400000009,7655.679999999964
14483,2022-05-15 08:55:00,-1873.97,229161.25000000087,223379.5400000009,5781.709999999963
14484,2022-05-15 09:00:00,486.34,229647.59000000087,223379.5400000009,6268.049999999959
14485,2022-05-15 09:05:00,383.23,230030.82000000088,223379.5400000009,6651.27999999997
14486,2022-05-15 09:10:00,-349.96,229680.8600000009,223379.5400000009,6301.319999999978
14487,2022-05-15 09:15:00,-442.1,229238.76000000088,223379.5400000009,5859.219999999972
14488,2022-05-15 09:20:00,-1782.07,227456.69000000088,223379.5400000009,4077.149999999965
14489,2022-05-15 09:25:00,-948.83,226507.8600000009,223379.5400000009,3128.319999999978
14490,2022-05-15 09:30:00,1076.74,227584.60000000088,223379.5400000009,4205.059999999969
14491,2022-05-15 09:35:00,1997.34,229581.94000000088,223379.5400000009,6202.399999999965
14492,2022-05-15 09:40:00,1749.97,231331.91000000088,223379.5400000009,7952.369999999966
14493,2022-05-15 09:45:00,-1226.48,230105.43000000087,223379.5400000009,6725.889999999956
14494,2022-05-15 09:50:00,-142.3,229963.13000000088,223379.5400000009,6583.589999999967
14495,2022-05-15 09:55:00,714.31,230677.44000000088,223379.5400000009,7297.899999999965
14496,2022-05-15 10:00:00,-1479.17,229198.27000000086,223379.5400000009,5818.729999999952
14497,2022-05-15 10:05:00,-30.83,229167.44000000088,223379.5400000009,5787.899999999965
14498,2022-05-15 10:10:00,1852.23,231019.6700000009,223379.5400000009,7640.129999999976
14499,2022-05-15 10:15:00,-169.41,230850.26000000088,223379.5400000009,7470.719999999972
14500,2022-05-15 10:20:00,1189.97,232040.23000000088,223379.5400000009,8660.689999999973
14501,2022-05-15 10:25:00,1838.45,233878.6800000009,223379.5400000009,10499.139999999985
14502,2022-05-15 10:30:00,-1652.83,232225.8500000009,223379.5400000009,8846.309999999998
14503,2022-05-15 10:35:00,1896.51,234122.36000000092,223379.5400000009,10742.820000000007
14504,2022-05-15 10:40:00,-489.78,233632.58000000092,223379.5400000009,10253.040000000008
14505,2022-05-15 10:45:00,-798.09,232834.49000000092,223379.5400000009,9454.950000000012
14506,2022-05-15 10:50:00,-912.73,231921.7600000009,223379.5400000009,8542.220000000001
14507,2022-05-15 10:55:00,373.73,232295.49000000092,223379.5400000009,8915.950000000012
14508,2022-05-15 11:00:00,-1668.15,230627.34000000093,223379.5400000009,7247.8000000000175
14509,2022-05-15 11:05:00,781.45,231408.79000000094,223379.5400000009,8029.250000000029
14510,2022-05-15 11:10:00,1086.19,232494.98000000094,223379.5400000009,9115.440000000031
14511,2022-05-15 11:15:00,416.73,232911.71000000095,223379.5400000009,9532.170000000042
14512,2022-05-15 11:20:00,1518.43,234430.14000000095,223379.5400000009,11050.600000000035
14513,2022-05-15 11:25:00,1760.35,236190.49000000095,223379.5400000009,12810.95000000004
14514,2022-05-15 11:30:00,-356.18,235834.31000000096,223379.5400000009,12454.770000000048
14515,2022-05-15 11:35:00,-382.99,235451.32000000097,223379.5400000009,12071.780000000057
14516,2022-05-15 11:40:00,207.68,235659.00000000096,223379.5400000009,12279.46000000005
14517,2022-05-15 11:45:00,-1528.5,234130.50000000096,223379.5400000009,10750.96000000005
14518,2022-05-15 11:50:00,-1865.87,232264.63000000097,223379.5400000009,8885.090000000055
14519,2022-05-15 11:55:00,-1167.18,231097.45000000097,223379.5400000009,7717.910000000062
14520,2022-05-15 12:00:00,-582.82,230514.63000000097,223379.5400000009,7135.090000000055
14521,2022-05-15 12:05:00,-487.93,230026.70000000097,223379.5400000009,6647.160000000062
14522,2022-05-15 12:10:00,-1546.64,228480.06000000096,223379.5400000009,5100.520000000048
14523,2022-05-15 12:15:00,-451.32,228028.74000000095,223379.5400000009,4649.200000000041
14524,2022-05-15 12:20:00,912.71,228941.45000000094,223379.5400000009,5561.910000000033
14525,2022-05-15 12:25:00,1427.85,230369.30000000095,223379.5400000009,6989.760000000038
14526,2022-05-15 12:30:00,-540.05,229829.25000000096,223379.5400000009,6449.71000000005
14527,2022-05-15 12:35:00,-1405.71,228423.54000000097,223379.5400000009,5044.000000000058
14528,2022-05-15 12:40:00,1091.9,229515.44000000096,223379.5400000009,6135.900000000052
14529,2022-05-15 12:45:00,1927.55,231442.99000000095,223379.5400000009,8063.450000000041
14530,2022-05-15 12:50:00,1890.52,233333.51000000094,223379.5400000009,9953.97000000003
14531,2022-05-15 12:55:00,135.41,233468.92000000094,223379.5400000009,10089.380000000034
14532,2022-05-15 13:00:00,-1397.49,232071.43000000095,223379.5400000009,8691.890000000043
14533,2022-05-15 13:05:00,-1254.93,230816.50000000096,223379.5400000009,7436.96000000005
14534,2022-05-15 13:10:00,-1195.99,229620.51000000097,223379.5400000009,6240.970000000059
14535,2022-05-15 13:15:00,187.05,229807.56000000096,223379.5400000009,6428.020000000048
14536,2022-05-15 13:20:00,-18.25,229789.31000000096,223379.5400000009,6409.770000000048
14537,2022-05-15 13:25:00,-348.05,229441.26000000097,223379.5400000009,6061.720000000059
14538,2022-05-15 13:30:00,1823.71,231264.97000000096,223379.5400000009,7885.430000000051
14539,2022-05-15 13:35:00,119.7,231384.67000000097,223379.5400000009,8005.130000000063
14540,2022-05-15 13:40:00,-286.07,231098.60000000097,223379.5400000009,7719.060000000056
14541,2022-05-15 13:45:00,-1078.98,230019.62000000096,223379.5400000009,6640.080000000045
14542,2022-05-15 13:50:00,324.07,230343.69000000096,223379.5400000009,6964.150000000052
14543,2022-05-15 13:55:00,561.28,230904.97000000096,223379.5400000009,7525.430000000051
14544,2022-05-15 14:00:00,-1882.69,229022.28000000096,223379.5400000009,5642.740000000049
14545,2022-05-15 14:05:00,-1855.27,227167.01000000097,223379.5400000009,3787.4700000000594
14546,2022-05-15 14:10:00,819.65,227986.66000000096,223379.5400000009,4607.120000000054
14547,2022-05-15 14:15:00,541.67,228528.33000000098,223379.5400000009,5148.790000000066
14548,2022-05-15 14:20:00,1509.03,230037.36000000098,223379.5400000009,6657.820000000065
14549,2022-05-15 14:25:00,-194.69,229842.67000000097,223379.5400000009,6463.130000000063
14550,2022-05-15 14:30:00,-568.58,229274.090000001,223379.5400000009,5894.550000000076
14551,2022-05-15 14:35:00,1766.8,231040.89000000097,223379.5400000009,7661.350000000064
14552,2022-05-15 14:40:00,-1070.4,229970.49000000098,223379.5400000009,6590.95000000007
14553,2022-05-15 14:45:00,-796.79,229173.70000000097,223379.5400000009,5794.160000000062
14554,2022-05-15 14:50:00,-1170.43,228003.27000000098,223379.5400000009,4623.730000000069
14555,2022-05-15 14:55:00,1733.05,229736.32000000097,223379.5400000009,6356.780000000057
14556,2022-05-15 15:00:00,-724.63,229011.69000000096,223379.5400000009,5632.150000000052
14557,2022-05-15 15:05:00,-1300.28,227711.41000000096,223379.5400000009,4331.870000000054
14558,2022-05-15 15:10:00,-174.52,227536.89000000097,223379.5400000009,4157.350000000064
14559,2022-05-15 15:15:00,-1499.72,226037.17000000097,223379.5400000009,2657.630000000063
14560,2022-05-15 15:20:00,599.21,226636.38000000097,223379.5400000009,3256.8400000000547
14561,2022-05-15 15:25:00,-275.04,226361.34000000096,223379.5400000009,2981.8000000000466
14562,2022-05-15 15:30:00,-1306.67,225054.67000000094,223379.5400000009,1675.1300000000338
14563,2022-05-15 15:35:00,1820.42,226875.09000000096,223379.5400000009,3495.5500000000466
14564,2022-05-15 15:40:00,1450.02,228325.11000000095,223379.5400000009,4945.570000000036
14565,2022-05-15 15:45:00,-594.09,227731.02000000095,223379.5400000009,4351.48000000004
14566,2022-05-15 15:50:00,1877.32,229608.34000000096,223379.5400000009,6228.800000000047
14567,2022-05-15 15:55:00,1287.62,230895.96000000095,223379.5400000009,7516.420000000042
14568,2022-05-15 16:00:00,-147.32,230748.64000000095,223379.5400000009,7369.100000000035
14569,2022-05-15 16:05:00,676.49,231425.13000000094,223379.5400000009,8045.590000000026
14570,2022-05-15 16:10:00,-757.13,230668.00000000093,223379.5400000009,7288.460000000021
14571,2022-05-15 16:15:00,-1192.72,229475.28000000093,223379.5400000009,6095.74000000002
14572,2022-05-15 16:20:00,-1348.04,228127.24000000092,223379.5400000009,4747.700000000012
14573,2022-05-15 16:25:00,1813.82,229941.06000000093,223379.5400000009,6561.520000000019
14574,2022-05-15 16:30:00,391.71,230332.77000000092,223379.5400000009,6953.2300000000105
14575,2022-05-15 16:35:00,446.46,230779.2300000009,223379.5400000009,7399.690000000002
14576,2022-05-15 16:40:00,-945.16,229834.0700000009,223379.5400000009,6454.529999999999
14577,2022-05-15 16:45:00,-659.93,229174.14000000092,223379.5400000009,5794.600000000006
14578,2022-05-15 16:50:00,401.52,229575.6600000009,223379.5400000009,6196.119999999995
14579,2022-05-15 16:55:00,-1164.34,228411.3200000009,223379.5400000009,5031.779999999999
14580,2022-05-16 08:00:00,1906.71,230318.0300000009,228411.3200000009,1906.7099999999919
14581,2022-05-16 08:05:00,-528.88,229789.1500000009,228411.3200000009,1377.8299999999872
14582,2022-05-16 08:10:00,1233.05,231022.20000000088,228411.3200000009,2610.8799999999756
14583,2022-05-16 08:15:00,-251.3,230770.9000000009,228411.3200000009,2359.579999999987
14584,2022-05-16 08:20:00,-1939.28,228831.6200000009,228411.3200000009,420.29999999998836
14585,2022-05-16 08:25:00,760.58,229592.20000000088,228411.3200000009,1180.8799999999756
14586,2022-05-16 08:30:00,362.84,229955.04000000088,228411.3200000009,1543.719999999972
14587,2022-05-16 08:35:00,-159.46,229795.5800000009,228411.3200000009,1384.2599999999802
14588,2022-05-16 08:40:00,-1091.63,228703.95000000088,228411.3200000009,292.62999999997555
14589,2022-05-16 08:45:00,-810.74,227893.2100000009,228411.3200000009,-518.1100000000151
14590,2022-05-16 08:50:00,-560.69,227332.5200000009,228411.3200000009,-1078.8000000000175
14591,2022-05-16 08:55:00,-1667.3,225665.2200000009,228411.3200000009,-2746.100000000006
14592,2022-05-16 09:00:00,-1064.71,224600.5100000009,228411.3200000009,-3810.8099999999977
14593,2022-05-16 09:05:00,-1719.44,222881.0700000009,228411.3200000009,-5530.25
14594,2022-05-16 09:10:00,-1311.74,221569.33000000092,228411.3200000009,-6841.989999999991
14595,2022-05-16 09:15:00,-1040.83,220528.50000000093,228411.3200000009,-7882.819999999978
14596,2022-05-16 09:20:00,-554.07,219974.43000000092,228411.3200000009,-8436.889999999985
14597,2022-05-16 09:25:00,-1827.6,218146.83000000092,228411.3200000009,-10264.48999999999
14598,2022-05-16 09:30:00,1872.33,220019.1600000009,228411.3200000009,-8392.160000000003
14599,2022-05-16 09:35:00,-1624.55,218394.61000000092,228411.3200000009,-10016.709999999992
14600,2022-05-16 09:40:00,1690.1,220084.71000000092,228411.3200000009,-8326.609999999986
14601,2022-05-16 09:45:00,1364.69,221449.40000000093,228411.3200000009,-6961.919999999984
14602,2022-05-16 09:50:00,1176.44,222625.84000000093,228411.3200000009,-5785.479999999981
14603,2022-05-16 09:55:00,-1803.69,220822.15000000093,228411.3200000009,-7589.169999999984
14604,2022-05-16 10:00:00,519.61,221341.7600000009,228411.3200000009,-7069.559999999998
14605,2022-05-16 10:05:00,-250.05,221091.71000000092,228411.3200000009,-7319.609999999986
14606,2022-05-16 10:10:00,988.06,222079.77000000092,228411.3200000009,-6331.549999999988
14607,2022-05-16 10:15:00,123.83,222203.6000000009,228411.3200000009,-6207.720000000001
14608,2022-05-16 10:20:00,-1696.52,220507.08000000092,228411.3200000009,-7904.239999999991
14609,2022-05-16 10:25:00,-581.92,219925.1600000009,228411.3200000009,-8486.160000000003
14610,2022-05-16 10:30:00,-63.75,219861.4100000009,228411.3200000009,-8549.910000000003
14611,2022-05-16 10:35:00,-241.46,219619.9500000009,228411.3200000009,-8791.369999999995
14612,2022-05-16 10:40:00,-212.48,219407.4700000009,228411.3200000009,-9003.850000000006
14613,2022-05-16 10:45:00,-893.2,218514.2700000009,228411.3200000009,-9897.050000000017
14614,2022-05-16 10:50:00,553.88,219068.1500000009,228411.3200000009,-9343.170000000013
14615,2022-05-16 10:55:00,-1549.43,217518.7200000009,228411.3200000009,-10892.600000000006
14616,2022-05-16 11:00:00,-1895.24,215623.4800000009,228411.3200000009,-12787.839999999997
14617,2022-05-16 11:05:00,1326.99,216950.4700000009,228411.3200000009,-11460.850000000006
14618,2022-05-16 11:10:00,280.62,217231.0900000009,228411.3200000009,-11180.23000000001
14619,2022-05-16 11:15:00,1264.77,218495.8600000009,228411.3200000009,-9915.460000000021
14620,2022-05-16 11:20:00,1847.94,220343.8000000009,228411.3200000009,-8067.520000000019
14621,2022-05-16 11:25:00,1833.73,222177.5300000009,228411.3200000009,-6233.790000000008
14622,2022-05-16 11:30:00,377.54,222555.0700000009,228411.3200000009,-5856.25
14623,2022-05-16 11:35:00,-632.7,221922.3700000009,228411.3200000009,-6488.950000000012
14624,2022-05-16 11:40:00,-803.29,221119.0800000009,228411.3200000009,-7292.24000000002
14625,2022-05-16 11:45:00,1421.25,222540.3300000009,228411.3200000009,-5870.99000000002
14626,2022-05-16 11:50:00,1757.23,224297.5600000009,228411.3200000009,-4113.760000000009
14627,2022-05-16 11:55:00,-1395.19,222902.3700000009,228411.3200000009,-5508.950000000012
14628,2022-05-16 12:00:00,-1619.67,221282.70000000088,228411.3200000009,-7128.620000000024
14629,2022-05-16 12:05:00,261.55,221544.25000000087,228411.3200000009,-6867.070000000036
14630,2022-05-16 12:10:00,-820.62,220723.63000000088,228411.3200000009,-7687.690000000031
14631,2022-05-16 12:15:00,1657.53,222381.16000000088,228411.3200000009,-6030.160000000033
14632,2022-05-16 12:20:00,1380.36,223761.52000000086,228411.3200000009,-4649.800000000047
14633,2022-05-16 12:25:00,-1824.11,221937.41000000088,228411.3200000009,-6473.910000000033
14634,2022-05-16 12:30:00,967.3,222904.71000000086,228411.3200000009,-5506.610000000044
14635,2022-05-16 12:35:00,-1036.89,221867.82000000085,228411.3200000009,-6543.500000000058
14636,2022-05-16 12:40:00,1551.91,223419.73000000085,228411.3200000009,-4991.590000000055
14637,2022-05-16 12:45:00,593.96,224013.69000000085,228411.3200000009,-4397.630000000063
14638,2022-05-16 12:50:00,1790.87,225804.56000000084,228411.3200000009,-2606.7600000000675
14639,2022-05-16 12:55:00,-1276.76,224527.80000000083,228411.3200000009,-3883.520000000077
14640,2022-05-16 13:00:00,586.63,225114.43000000084,228411.3200000009,-3296.890000000072
14641,2022-05-16 13:05:00,1732.22,226846.65000000084,228411.3200000009,-1564.670000000071
14642,2022-05-16 13:10:00,-1893.38,224953.27000000083,228411.3200000009,-3458.0500000000757
14643,2022-05-16 13:15:00,1147.59,226100.86000000083,228411.3200000009,-2310.460000000079
14644,2022-05-16 13:20:00,887.47,226988.33000000083,228411.3200000009,-1422.990000000078
14645,2022-05-16 13:25:00,-936.65,226051.68000000084,228411.3200000009,-2359.640000000072
14646,2022-05-16 13:30:00,-1666.57,224385.11000000083,228411.3200000009,-4026.210000000079
14647,2022-05-16 13:35:00,24.39,224409.50000000084,228411.3200000009,-4001.820000000065
14648,2022-05-16 13:40:00,969.4,225378.90000000084,228411.3200000009,-3032.420000000071
14649,2022-05-16 13:45:00,1283.84,226662.74000000083,228411.3200000009,-1748.5800000000745
14650,2022-05-16 13:50:00,-963.09,225699.65000000084,228411.3200000009,-2711.670000000071
14651,2022-05-16 13:55:00,995.59,226695.24000000083,228411.3200000009,-1716.0800000000745
14652,2022-05-16 14:00:00,593.61,227288.85000000082,228411.3200000009,-1122.4700000000885
14653,2022-05-16 14:05:00,799.98,228088.83000000083,228411.3200000009,-322.490000000078
14654,2022-05-16 14:10:00,-1011.72,227077.11000000083,228411.3200000009,-1334.2100000000792
14655,2022-05-16 14:15:00,953.06,228030.17000000083,228411.3200000009,-381.1500000000815
14656,2022-05-16 14:20:00,-1523.72,226506.45000000083,228411.3200000009,-1904.8700000000827
14657,2022-05-16 14:25:00,-1625.04,224881.41000000082,228411.3200000009,-3529.910000000091
14658,2022-05-16 14:30:00,1854.07,226735.48000000083,228411.3200000009,-1675.8400000000838
14659,2022-05-16 14:35:00,1488.89,228224.37000000084,228411.3200000009,-186.95000000006985
14660,2022-05-16 14:40:00,-539.77,227684.60000000085,228411.3200000009,-726.7200000000594
14661,2022-05-16 14:45:00,-149.3,227535.30000000086,228411.3200000009,-876.0200000000477
14662,2022-05-16 14:50:00,-1387.25,226148.05000000086,228411.3200000009,-2263.2700000000477
14663,2022-05-16 14:55:00,1702.26,227850.31000000087,228411.3200000009,-561.0100000000384
14664,2022-05-16 15:00:00,1792.8,229643.11000000086,228411.3200000009,1231.78999999995
14665,2022-05-16 15:05:00,1186.44,230829.55000000086,228411.3200000009,2418.2299999999523
14666,2022-05-16 15:10:00,-1561.66,229267.89000000086,228411.3200000009,856.5699999999488
14667,2022-05-16 15:15:00,-353.93,228913.96000000086,228411.3200000009,502.63999999995576
14668,2022-05-16 15:20:00,474.39,229388.35000000088,228411.3200000009,977.0299999999697
14669,2022-05-16 15:25:00,1072.03,230460.38000000088,228411.3200000009,2049.0599999999686
14670,2022-05-16 15:30:00,-514.04,229946.34000000087,228411.3200000009,1535.0199999999604
14671,2022-05-16 15:35:00,1864.8,231811.14000000086,228411.3200000009,3399.819999999949
14672,2022-05-16 15:40:00,1659.1,233470.24000000086,228411.3200000009,5058.919999999955
14673,2022-05-16 15:45:00,1439.51,234909.75000000087,228411.3200000009,6498.429999999964
14674,2022-05-16 15:50:00,457.11,235366.86000000086,228411.3200000009,6955.53999999995
14675,2022-05-16 15:55:00,105.1,235471.96000000086,228411.3200000009,7060.639999999956
14676,2022-05-16 16:00:00,-863.87,234608.09000000087,228411.3200000009,6196.76999999996
14677,2022-05-16 16:05:00,1741.14,236349.23000000088,228411.3200000009,7937.909999999974
14678,2022-05-16 16:10:00,584.82,236934.0500000009,228411.3200000009,8522.729999999981
14679,2022-05-16 16:15:00,1030.93,237964.98000000088,228411.3200000009,9553.659999999974
14680,2022-05-16 16:20:00,-1748.21,236216.7700000009,228411.3200000009,7805.4499999999825
14681,2022-05-16 16:25:00,1075.89,237292.6600000009,228411.3200000009,8881.339999999997
14682,2022-05-16 16:30:00,1481.94,238774.6000000009,228411.3200000009,10363.279999999999
14683,2022-05-16 16:35:00,1808.34,240582.9400000009,228411.3200000009,12171.619999999995
14684,2022-05-16 16:40:00,1068.51,241651.4500000009,228411.3200000009,13240.130000000005
14685,2022-05-16 16:45:00,513.28,242164.7300000009,228411.3200000009,13753.410000000003
14686,2022-05-16 16:50:00,-59.91,242104.8200000009,228411.3200000009,13693.5
14687,2022-05-16 16:55:00,-1472.37,240632.4500000009,228411.3200000009,12221.130000000005
14688,2022-05-17 08:00:00,-1232.05,239400.40000000093,240632.4500000009,-1232.0499999999884
14689,2022-05-17 08:05:00,454.03,239854.43000000092,240632.4500000009,-778.0199999999895
14690,2022-05-17 08:10:00,-1338.38,238516.05000000092,240632.4500000009,-2116.399999999994
14691,2022-05-17 08:15:00,-307.02,238209.03000000093,240632.4500000009,-2423.4199999999837
14692,2022-05-17 08:20:00,-1516.74,236692.29000000094,240632.4500000009,-3940.1599999999744
14693,2022-05-17 08:25:00,-404.75,236287.54000000094,240632.4500000009,-4344.909999999974
14694,2022-05-17 08:30:00,-1656.87,234630.67000000094,240632.4500000009,-6001.77999999997
14695,2022-05-17 08:35:00,1714.65,236345.32000000094,240632.4500000009,-4287.129999999976
14696,2022-05-17 08:40:00,1239.52,237584.84000000093,240632.4500000009,-3047.609999999986
14697,2022-05-17 08:45:00,567.62,238152.46000000092,240632.4500000009,-2479.9899999999907
14698,2022-05-17 08:50:00,1475.41,239627.87000000093,240632.4500000009,-1004.5799999999872
14699,2022-05-17 08:55:00,382.9,240010.77000000092,240632.4500000009,-621.679999999993
14700,2022-05-17 09:00:00,-314.72,239696.05000000092,240632.4500000009,-936.3999999999942
14701,2022-05-17 09:05:00,-412.51,239283.5400000009,240632.4500000009,-1348.9100000000035
14702,2022-05-17 09:10:00,1700.15,240983.6900000009,240632.4500000009,351.2399999999907
14703,2022-05-17 09:15:00,-313.04,240670.6500000009,240632.4500000009,38.19999999998254
14704,2022-05-17 09:20:00,1196.17,241866.8200000009,240632.4500000009,1234.3699999999953
14705,2022-05-17 09:25:00,-803.96,241062.86000000092,240632.4500000009,430.4100000000035
14706,2022-05-17 09:30:00,-443.88,240618.9800000009,240632.4500000009,-13.470000000001164
14707,2022-05-17 09:35:00,-778.54,239840.4400000009,240632.4500000009,-792.0100000000093
14708,2022-05-17 09:40:00,-1706.84,238133.6000000009,240632.4500000009,-2498.850000000006
14709,2022-05-17 09:45:00,432.46,238566.0600000009,240632.4500000009,-2066.390000000014
14710,2022-05-17 09:50:00,1589.44,240155.5000000009,240632.4500000009,-476.95000000001164
14711,2022-05-17 09:55:00,-127.03,240028.4700000009,240632.4500000009,-603.9800000000105
14712,2022-05-17 10:00:00,147.69,240176.1600000009,240632.4500000009,-456.29000000000815
14713,2022-05-17 10:05:00,1443.9,241620.0600000009,240632.4500000009,987.609999999986
14714,2022-05-17 10:10:00,-1754.0,239866.0600000009,240632.4500000009,-766.390000000014
14715,2022-05-17 10:15:00,-636.43,239229.6300000009,240632.4500000009,-1402.820000000007
14716,2022-05-17 10:20:00,-1867.92,237361.7100000009,240632.4500000009,-3270.74000000002
14717,2022-05-17 10:25:00,1971.82,239333.5300000009,240632.4500000009,-1298.9200000000128
14718,2022-05-17 10:30:00,-794.41,238539.1200000009,240632.4500000009,-2093.3300000000163
14719,2022-05-17 10:35:00,-1891.73,236647.3900000009,240632.4500000009,-3985.060000000027
14720,2022-05-17 10:40:00,1319.53,237966.9200000009,240632.4500000009,-2665.530000000028
14721,2022-05-17 10:45:00,-813.76,237153.16000000088,240632.4500000009,-3479.2900000000373
14722,2022-05-17 10:50:00,1643.14,238796.3000000009,240632.4500000009,-1836.1500000000233
14723,2022-05-17 10:55:00,-1945.25,236851.0500000009,240632.4500000009,-3781.4000000000233
14724,2022-05-17 11:00:00,76.19,236927.2400000009,240632.4500000009,-3705.210000000021
14725,2022-05-17 11:05:00,866.42,237793.6600000009,240632.4500000009,-2838.790000000008
14726,2022-05-17 11:10:00,-484.45,237309.2100000009,240632.4500000009,-3323.24000000002
14727,2022-05-17 11:15:00,34.09,237343.3000000009,240632.4500000009,-3289.1500000000233
14728,2022-05-17 11:20:00,-432.05,236911.2500000009,240632.4500000009,-3721.2000000000116
14729,2022-05-17 11:25:00,-718.94,236192.3100000009,240632.4500000009,-4440.140000000014
14730,2022-05-17 11:30:00,75.47,236267.7800000009,240632.4500000009,-4364.670000000013
14731,2022-05-17 11:35:00,-1118.97,235148.8100000009,240632.4500000009,-5483.640000000014
14732,2022-05-17 11:40:00,1397.1,236545.9100000009,240632.4500000009,-4086.540000000008
14733,2022-05-17 11:45:00,1677.35,238223.2600000009,240632.4500000009,-2409.1900000000023
14734,2022-05-17 11:50:00,282.62,238505.8800000009,240632.4500000009,-2126.570000000007
14735,2022-05-17 11:55:00,-1140.13,237365.7500000009,240632.4500000009,-3266.7000000000116
14736,2022-05-17 12:00:00,-751.87,236613.8800000009,240632.4500000009,-4018.570000000007
14737,2022-05-17 12:05:00,-367.79,236246.0900000009,240632.4500000009,-4386.360000000015
14738,2022-05-17 12:10:00,-284.71,235961.3800000009,240632.4500000009,-4671.070000000007
14739,2022-05-17 12:15:00,-1276.92,234684.4600000009,240632.4500000009,-5947.99000000002
14740,2022-05-17 12:20:00,-638.96,234045.5000000009,240632.4500000009,-6586.950000000012
14741,2022-05-17 12:25:00,-1483.35,232562.1500000009,240632.4500000009,-8070.3000000000175
14742,2022-05-17 12:30:00,842.43,233404.5800000009,240632.4500000009,-7227.870000000024
14743,2022-05-17 12:35:00,-505.48,232899.10000000088,240632.4500000009,-7733.350000000035
14744,2022-05-17 12:40:00,-673.07,232226.03000000087,240632.4500000009,-8406.420000000042
14745,2022-05-17 12:45:00,185.73,232411.76000000088,240632.4500000009,-8220.690000000031
14746,2022-05-17 12:50:00,1865.69,234277.45000000088,240632.4500000009,-6355.000000000029
14747,2022-05-17 12:55:00,1999.4,236276.85000000088,240632.4500000009,-4355.600000000035
14748,2022-05-17 13:00:00,679.2,236956.0500000009,240632.4500000009,-3676.4000000000233
14749,2022-05-17 13:05:00,478.6,237434.6500000009,240632.4500000009,-3197.8000000000175
14750,2022-05-17 13:10:00,-203.85,237230.8000000009,240632.4500000009,-3401.6500000000233
14751,2022-05-17 13:15:00,409.13,237639.9300000009,240632.4500000009,-2992.5200000000186
14752,2022-05-17 13:20:00,-1223.85,236416.0800000009,240632.4500000009,-4216.370000000024
14753,2022-05-17 13:25:00,1463.19,237879.2700000009,240632.4500000009,-2753.180000000022
14754,2022-05-17 13:30:00,-1406.46,236472.8100000009,240632.4500000009,-4159.640000000014
14755,2022-05-17 13:35:00,1849.18,238321.9900000009,240632.4500000009,-2310.460000000021
14756,2022-05-17 13:40:00,-1088.26,237233.73000000088,240632.4500000009,-3398.7200000000303
14757,2022-05-17 13:45:00,-111.1,237122.63000000088,240632.4500000009,-3509.820000000036
14758,2022-05-17 13:50:00,-602.99,236519.6400000009,240632.4500000009,-4112.810000000027
14759,2022-05-17 13:55:00,-558.16,235961.48000000088,240632.4500000009,-4670.97000000003
14760,2022-05-17 14:00:00,-1931.95,234029.53000000087,240632.4500000009,-6602.920000000042
14761,2022-05-17 14:05:00,-1971.55,232057.98000000088,240632.4500000009,-8574.47000000003
14762,2022-05-17 14:10:00,31.56,232089.54000000088,240632.4500000009,-8542.910000000033
14763,2022-05-17 14:15:00,1377.39,233466.9300000009,240632.4500000009,-7165.520000000019
14764,2022-05-17 14:20:00,-682.88,232784.0500000009,240632.4500000009,-7848.400000000023
14765,2022-05-17 14:25:00,983.02,233767.07000000088,240632.4500000009,-6865.380000000034
14766,2022-05-17 14:30:00,-1044.26,232722.81000000087,240632.4500000009,-7909.640000000043
14767,2022-05-17 14:35:00,476.95,233199.76000000088,240632.4500000009,-7432.690000000031
14768,2022-05-17 14:40:00,-1848.79,231350.97000000087,240632.4500000009,-9281.48000000004
14769,2022-05-17 14:45:00,40.09,231391.06000000087,240632.4500000009,-9241.390000000043
14770,2022-05-17 14:50:00,-206.11,231184.95000000088,240632.4500000009,-9447.50000000003
14771,2022-05-17 14:55:00,-987.12,230197.8300000009,240632.4500000009,-10434.620000000024
14772,2022-05-17 15:00:00,815.71,231013.54000000088,240632.4500000009,-9618.910000000033
14773,2022-05-17 15:05:00,-1427.28,229586.26000000088,240632.4500000009,-11046.190000000031
14774,2022-05-17 15:10:00,49.96,229636.22000000087,240632.4500000009,-10996.23000000004
14775,2022-05-17 15:15:00,-1432.97,228203.25000000087,240632.4500000009,-12429.20000000004
14776,2022-05-17 15:20:00,-1676.87,226526.38000000088,240632.4500000009,-14106.070000000036
14777,2022-05-17 15:25:00,-1359.69,225166.69000000088,240632.4500000009,-15465.760000000038
14778,2022-05-17 15:30:00,-112.69,225054.00000000087,240632.4500000009,-15578.45000000004
14779,2022-05-17 15:35:00,19.71,225073.71000000086,240632.4500000009,-15558.740000000049
14780,2022-05-17 15:40:00,-1279.13,223794.58000000086,240632.4500000009,-16837.870000000054
14781,2022-05-17 15:45:00,180.89,223975.47000000087,240632.4500000009,-16656.98000000004
14782,2022-05-17 15:50:00,146.17,224121.6400000009,240632.4500000009,-16510.810000000027
14783,2022-05-17 15:55:00,1897.37,226019.01000000088,240632.4500000009,-14613.440000000031
14784,2022-05-17 16:00:00,-1751.14,224267.87000000087,240632.4500000009,-16364.580000000045
14785,2022-05-17 16:05:00,-882.27,223385.60000000088,240632.4500000009,-17246.850000000035
14786,2022-05-17 16:10:00,46.29,223431.8900000009,240632.4500000009,-17200.560000000027
14787,2022-05-17 16:15:00,-1068.39,222363.50000000087,240632.4500000009,-18268.95000000004
14788,2022-05-17 16:20:00,1634.17,223997.6700000009,240632.4500000009,-16634.780000000028
14789,2022-05-17 16:25:00,-1056.78,222940.8900000009,240632.4500000009,-17691.560000000027
14790,2022-05-17 16:30:00,287.08,223227.97000000087,240632.4500000009,-17404.48000000004
14791,2022-05-17 16:35:00,1521.26,224749.23000000088,240632.4500000009,-15883.22000000003
14792,2022-05-17 16:40:00,1437.27,226186.50000000087,240632.4500000009,-14445.95000000004
14793,2022-05-17 16:45:00,-923.75,225262.75000000087,240632.4500000009,-15369.70000000004
14794,2022-05-17 16:50:00,1383.98,226646.73000000088,240632.4500000009,-13985.72000000003
14795,2022-05-17 16:55:00,-1018.42,225628.31000000087,240632.4500000009,-15004.140000000043
14796,2022-05-18 08:00:00,-1300.75,224327.56000000087,225628.31000000087,-1300.75
14797,2022-05-18 08:05:00,-874.56,223453.00000000087,225628.31000000087,-2175.3099999999977
14798,2022-05-18 08:10:00,1038.35,224491.35000000088,225628.31000000087,-1136.9599999999919
14799,2022-05-18 08:15:00,-1124.22,223367.13000000088,225628.31000000087,-2261.179999999993
14800,2022-05-18 08:20:00,-696.04,222671.09000000087,225628.31000000087,-2957.220000000001
14801,2022-05-18 08:25:00,403.19,223074.28000000087,225628.31000000087,-2554.029999999999
14802,2022-05-18 08:30:00,-682.72,222391.56000000087,225628.31000000087,-3236.75
14803,2022-05-18 08:35:00,384.86,222776.42000000086,225628.31000000087,-2851.890000000014
14804,2022-05-18 08:40:00,821.07,223597.49000000086,225628.31000000087,-2030.820000000007
14805,2022-05-18 08:45:00,1888.45,225485.94000000088,225628.31000000087,-142.36999999999534
14806,2022-05-18 08:50:00,-1283.7,224202.24000000086,225628.31000000087,-1426.070000000007
14807,2022-05-18 08:55:00,201.49,224403.73000000085,225628.31000000087,-1224.5800000000163
14808,2022-05-18 09:00:00,712.27,225116.00000000084,225628.31000000087,-512.3100000000268
14809,2022-05-18 09:05:00,-312.96,224803.04000000085,225628.31000000087,-825.2700000000186
14810,2022-05-18 09:10:00,38.58,224841.62000000084,225628.31000000087,-786.6900000000314
14811,2022-05-18 09:15:00,-1798.08,223043.54000000085,225628.31000000087,-2584.7700000000186
14812,2022-05-18 09:20:00,542.46,223586.00000000084,225628.31000000087,-2042.3100000000268
14813,2022-05-18 09:25:00,1770.09,225356.09000000084,225628.31000000087,-272.22000000003027
14814,2022-05-18 09:30:00,-1112.95,224243.14000000083,225628.31000000087,-1385.170000000042
14815,2022-05-18 09:35:00,-187.04,224056.10000000082,225628.31000000087,-1572.21000000005
14816,2022-05-18 09:40:00,-770.51,223285.5900000008,225628.31000000087,-2342.7200000000594
14817,2022-05-18 09:45:00,-819.95,222465.6400000008,225628.31000000087,-3162.670000000071
14818,2022-05-18 09:50:00,-172.49,222293.1500000008,225628.31000000087,-3335.1600000000617
14819,2022-05-18 09:55:00,154.91,222448.0600000008,225628.31000000087,-3180.250000000058
14820,2022-05-18 10:00:00,-329.2,222118.8600000008,225628.31000000087,-3509.45000000007
14821,2022-05-18 10:05:00,-1859.55,220259.3100000008,225628.31000000087,-5369.000000000058
14822,2022-05-18 10:10:00,1326.59,221585.9000000008,225628.31000000087,-4042.4100000000617
14823,2022-05-18 10:15:00,852.98,222438.88000000082,225628.31000000087,-3189.430000000051
14824,2022-05-18 10:20:00,1830.0,224268.88000000082,225628.31000000087,-1359.4300000000512
14825,2022-05-18 10:25:00,-81.17,224187.7100000008,225628.31000000087,-1440.600000000064
14826,2022-05-18 10:30:00,1942.72,226130.4300000008,225628.31000000087,502.11999999993714
14827,2022-05-18 10:35:00,692.01,226822.44000000082,225628.31000000087,1194.1299999999464
14828,2022-05-18 10:40:00,29.61,226852.0500000008,225628.31000000087,1223.7399999999325
14829,2022-05-18 10:45:00,1034.56,227886.6100000008,225628.31000000087,2258.29999999993
14830,2022-05-18 10:50:00,-1077.01,226809.6000000008,225628.31000000087,1181.2899999999208
14831,2022-05-18 10:55:00,1078.5,227888.1000000008,225628.31000000087,2259.789999999921
14832,2022-05-18 11:00:00,1840.36,229728.46000000078,225628.31000000087,4100.149999999907
14833,2022-05-18 11:05:00,71.41,229799.87000000078,225628.31000000087,4171.55999999991
14834,2022-05-18 11:10:00,-1926.18,227873.6900000008,225628.31000000087,2245.3799999999173
14835,2022-05-18 11:15:00,813.16,228686.8500000008,225628.31000000087,3058.539999999921
14836,2022-05-18 11:20:00,967.36,229654.21000000078,225628.31000000087,4025.899999999907
14837,2022-05-18 11:25:00,713.41,230367.62000000078,225628.31000000087,4739.30999999991
14838,2022-05-18 11:30:00,336.05,230703.67000000077,225628.31000000087,5075.359999999899
14839,2022-05-18 11:35:00,-475.18,230228.49000000078,225628.31000000087,4600.179999999906
14840,2022-05-18 11:40:00,1007.83,231236.32000000076,225628.31000000087,5608.009999999893
14841,2022-05-18 11:45:00,103.71,231340.03000000076,225628.31000000087,5711.719999999885
14842,2022-05-18 11:50:00,18.38,231358.41000000076,225628.31000000087,5730.099999999889
14843,2022-05-18 11:55:00,1166.33,232524.74000000075,225628.31000000087,6896.429999999877
14844,2022-05-18 12:00:00,1460.48,233985.22000000076,225628.31000000087,8356.909999999887
14845,2022-05-18 12:05:00,-1407.27,232577.95000000077,225628.31000000087,6949.639999999898
14846,2022-05-18 12:10:00,478.05,233056.00000000076,225628.31000000087,7427.689999999886
14847,2022-05-18 12:15:00,-1389.72,231666.28000000076,225628.31000000087,6037.969999999885
14848,2022-05-18 12:20:00,-1499.59,230166.69000000076,225628.31000000087,4538.379999999888
14849,2022-05-18 12:25:00,1629.09,231795.78000000076,225628.31000000087,6167.469999999885
14850,2022-05-18 12:30:00,1718.97,233514.75000000076,225628.31000000087,7886.439999999886
14851,2022-05-18 12:35:00,1629.63,235144.38000000076,225628.31000000087,9516.06999999989
14852,2022-05-18 12:40:00,571.8,235716.18000000075,225628.31000000087,10087.869999999879
14853,2022-05-18 12:45:00,78.34,235794.52000000075,225628.31000000087,10166.209999999875
14854,2022-05-18 12:50:00,-1634.42,234160.10000000073,225628.31000000087,8531.789999999863
14855,2022-05-18 12:55:00,-1017.31,233142.79000000074,225628.31000000087,7514.479999999865
14856,2022-05-18 13:00:00,585.44,233728.23000000074,225628.31000000087,8099.919999999867
14857,2022-05-18 13:05:00,-243.89,233484.34000000072,225628.31000000087,7856.029999999853
14858,2022-05-18 13:10:00,1825.34,235309.68000000072,225628.31000000087,9681.36999999985
14859,2022-05-18 13:15:00,-545.21,234764.47000000073,225628.31000000087,9136.159999999858
14860,2022-05-18 13:20:00,-317.07,234447.40000000072,225628.31000000087,8819.089999999851
14861,2022-05-18 13:25:00,-1547.79,232899.6100000007,225628.31000000087,7271.299999999843
14862,2022-05-18 13:30:00,-1531.86,231367.75000000073,225628.31000000087,5739.439999999857
14863,2022-05-18 13:35:00,-449.75,230918.00000000073,225628.31000000087,5289.689999999857
14864,2022-05-18 13:40:00,-620.28,230297.72000000073,225628.31000000087,4669.409999999858
14865,2022-05-18 13:45:00,1080.79,231378.51000000074,225628.31000000087,5750.199999999866
14866,2022-05-18 13:50:00,1826.13,233204.64000000074,225628.31000000087,7576.329999999871
14867,2022-05-18 13:55:00,918.66,234123.30000000075,225628.31000000087,8494.989999999874
14868,2022-05-18 14:00:00,1892.8,236016.10000000073,225628.31000000087,10387.789999999863
14869,2022-05-18 14:05:00,-98.11,235917.99000000075,225628.31000000087,10289.679999999877
14870,2022-05-18 14:10:00,1345.6,237263.59000000075,225628.31000000087,11635.279999999882
14871,2022-05-18 14:15:00,140.77,237404.36000000074,225628.31000000087,11776.049999999872
14872,2022-05-18 14:20:00,-817.14,236587.22000000073,225628.31000000087,10958.909999999858
14873,2022-05-18 14:25:00,1682.9,238270.12000000072,225628.31000000087,12641.809999999852
14874,2022-05-18 14:30:00,-609.55,237660.57000000073,225628.31000000087,12032.259999999864
14875,2022-05-18 14:35:00,-978.33,236682.24000000075,225628.31000000087,11053.929999999877
14876,2022-05-18 14:40:00,-146.97,236535.27000000075,225628.31000000087,10906.959999999875
14877,2022-05-18 14:45:00,302.22,236837.49000000075,225628.31000000087,11209.179999999877
14878,2022-05-18 14:50:00,1783.38,238620.87000000075,225628.31000000087,12992.559999999881
14879,2022-05-18 14:55:00,1325.56,239946.43000000075,225628.31000000087,14318.119999999879
14880,2022-05-18 15:00:00,-148.6,239797.83000000074,225628.31000000087,14169.519999999873
14881,2022-05-18 15:05:00,405.01,240202.84000000075,225628.31000000087,14574.529999999882
14882,2022-05-18 15:10:00,1801.19,242004.03000000076,225628.31000000087,16375.719999999885
14883,2022-05-18 15:15:00,-1085.0,240919.03000000076,225628.31000000087,15290.719999999885
14884,2022-05-18 15:20:00,1333.92,242252.95000000077,225628.31000000087,16624.639999999898
14885,2022-05-18 15:25:00,1538.05,243791.00000000076,225628.31000000087,18162.689999999886
14886,2022-05-18 15:30:00,-865.95,242925.05000000075,225628.31000000087,17296.739999999874
14887,2022-05-18 15:35:00,-299.57,242625.48000000074,225628.31000000087,16997.169999999867
14888,2022-05-18 15:40:00,-1776.75,240848.73000000074,225628.31000000087,15220.419999999867
14889,2022-05-18 15:45:00,-1513.96,239334.77000000075,225628.31000000087,13706.459999999875
14890,2022-05-18 15:50:00,-1399.06,237935.71000000075,225628.31000000087,12307.399999999878
14891,2022-05-18 15:55:00,-1223.72,236711.99000000075,225628.31000000087,11083.679999999877
14892,2022-05-18 16:00:00,-974.15,235737.84000000075,225628.31000000087,10109.529999999882
14893,2022-05-18 16:05:00,-331.55,235406.29000000076,225628.31000000087,9777.979999999894
14894,2022-05-18 16:10:00,1849.04,237255.33000000077,225628.31000000087,11627.019999999902
14895,2022-05-18 16:15:00,-858.86,236396.4700000008,225628.31000000087,10768.159999999916
14896,2022-05-18 16:20:00,951.13,237347.6000000008,225628.31000000087,11719.28999999992
14897,2022-05-18 16:25:00,-1862.58,235485.0200000008,225628.31000000087,9856.709999999934
14898,2022-05-18 16:30:00,-1103.14,234381.8800000008,225628.31000000087,8753.56999999992
14899,2022-05-18 16:35:00,-1824.44,232557.4400000008,225628.31000000087,6929.129999999917
14900,2022-05-18 16:40:00,1980.08,234537.52000000078,225628.31000000087,8909.209999999905
14901,2022-05-18 16:45:00,-893.35,233644.17000000077,225628.31000000087,8015.859999999899
14902,2022-05-18 16:50:00,1476.42,235120.59000000078,225628.31000000087,9492.279999999912
14903,2022-05-18 16:55:00,1027.34,236147.93000000078,225628.31000000087,10519.619999999908
14904,2022-05-19 08:00:00,56.92,236204.8500000008,236147.93000000078,56.920000000012806
14905,2022-05-19 08:05:00,-53.66,236151.1900000008,236147.93000000078,3.2600000000093132
14906,2022-05-19 08:10:00,303.1,236454.2900000008,236147.93000000078,306.36000000001513
14907,2022-05-19 08:15:00,1293.82,237748.1100000008,236147.93000000078,1600.1800000000221
14908,2022-05-19 08:20:00,1957.56,239705.6700000008,236147.93000000078,3557.74000000002
14909,2022-05-19 08:25:00,-175.94,239529.7300000008,236147.93000000078,3381.8000000000175
14910,2022-05-19 08:30:00,-1734.32,237795.4100000008,236147.93000000078,1647.4800000000105
14911,2022-05-19 08:35:00,1153.17,238948.5800000008,236147.93000000078,2800.6500000000233
14912,2022-05-19 08:40:00,844.85,239793.4300000008,236147.93000000078,3645.500000000029
14913,2022-05-19 08:45:00,1132.32,240925.75000000081,236147.93000000078,4777.820000000036
14914,2022-05-19 08:50:00,55.83,240981.5800000008,236147.93000000078,4833.650000000023
14915,2022-05-19 08:55:00,-1824.4,239157.1800000008,236147.93000000078,3009.250000000029
14916,2022-05-19 09:00:00,-907.35,238249.8300000008,236147.93000000078,2101.9000000000233
14917,2022-05-19 09:05:00,1403.63,239653.4600000008,236147.93000000078,3505.530000000028
14918,2022-05-19 09:10:00,-1119.26,238534.2000000008,236147.93000000078,2386.2700000000186
14919,2022-05-19 09:15:00,-1124.22,237409.9800000008,236147.93000000078,1262.0500000000175
14920,2022-05-19 09:20:00,1227.77,238637.7500000008,236147.93000000078,2489.820000000007
14921,2022-05-19 09:25:00,-1369.63,237268.12000000078,236147.93000000078,1120.1900000000023
14922,2022-05-19 09:30:00,334.78,237602.90000000078,236147.93000000078,1454.9700000000012
14923,2022-05-19 09:35:00,-1385.91,236216.99000000078,236147.93000000078,69.05999999999767
14924,2022-05-19 09:40:00,1669.77,237886.76000000077,236147.93000000078,1738.8299999999872
14925,2022-05-19 09:45:00,-1851.85,236034.91000000076,236147.93000000078,-113.02000000001863
14926,2022-05-19 09:50:00,-889.85,235145.06000000075,236147.93000000078,-1002.8700000000244
14927,2022-05-19 09:55:00,326.84,235471.90000000075,236147.93000000078,-676.0300000000279
14928,2022-05-19 10:00:00,-444.81,235027.09000000075,236147.93000000078,-1120.8400000000256
14929,2022-05-19 10:05:00,-362.0,234665.09000000075,236147.93000000078,-1482.8400000000256
14930,2022-05-19 10:10:00,-1815.36,232849.73000000077,236147.93000000078,-3298.2000000000116
14931,2022-05-19 10:15:00,1873.65,234723.38000000076,236147.93000000078,-1424.5500000000175
14932,2022-05-19 10:20:00,1577.82,236301.20000000077,236147.93000000078,153.26999999998952
14933,2022-05-19 10:25:00,1541.72,237842.92000000077,236147.93000000078,1694.9899999999907
14934,2022-05-19 10:30:00,-532.65,237310.27000000078,236147.93000000078,1162.3399999999965
14935,2022-05-19 10:35:00,1829.65,239139.92000000077,236147.93000000078,2991.9899999999907
14936,2022-05-19 10:40:00,-821.29,238318.63000000076,236147.93000000078,2170.6999999999825
14937,2022-05-19 10:45:00,-427.42,237891.21000000075,236147.93000000078,1743.2799999999697
14938,2022-05-19 10:50:00,1349.74,239240.95000000074,236147.93000000078,3093.0199999999604
14939,2022-05-19 10:55:00,-541.99,238698.96000000075,236147.93000000078,2551.0299999999697
14940,2022-05-19 11:00:00,-1810.4,236888.56000000075,236147.93000000078,740.6299999999756
14941,2022-05-19 11:05:00,-491.26,236397.30000000075,236147.93000000078,249.36999999996624
14942,2022-05-19 11:10:00,865.0,237262.30000000075,236147.93000000078,1114.3699999999662
14943,2022-05-19 11:15:00,-168.13,237094.17000000074,236147.93000000078,946.2399999999616
14944,2022-05-19 11:20:00,-605.39,236488.78000000073,236147.93000000078,340.8499999999476
14945,2022-05-19 11:25:00,-261.22,236227.56000000073,236147.93000000078,79.62999999994645
14946,2022-05-19 11:30:00,-1848.71,234378.85000000073,236147.93000000078,-1769.0800000000454
14947,2022-05-19 11:35:00,922.41,235301.26000000074,236147.93000000078,-846.6700000000419
14948,2022-05-19 11:40:00,546.85,235848.11000000074,236147.93000000078,-299.8200000000361
14949,2022-05-19 11:45:00,1712.55,237560.66000000073,236147.93000000078,1412.7299999999523
14950,2022-05-19 11:50:00,-1534.37,236026.29000000074,236147.93000000078,-121.64000000004307
14951,2022-05-19 11:55:00,708.55,236734.84000000072,236147.93000000078,586.9099999999453
14952,2022-05-19 12:00:00,-1666.4,235068.44000000073,236147.93000000078,-1079.490000000049
14953,2022-05-19 12:05:00,951.74,236020.18000000072,236147.93000000078,-127.75000000005821
14954,2022-05-19 12:10:00,-367.88,235652.30000000072,236147.93000000078,-495.63000000006286
14955,2022-05-19 12:15:00,1485.71,237138.0100000007,236147.93000000078,990.079999999929
14956,2022-05-19 12:20:00,1886.78,239024.7900000007,236147.93000000078,2876.859999999928
14957,2022-05-19 12:25:00,1819.1,240843.8900000007,236147.93000000078,4695.959999999934
14958,2022-05-19 12:30:00,-833.92,240009.9700000007,236147.93000000078,3862.039999999921
14959,2022-05-19 12:35:00,283.19,240293.1600000007,236147.93000000078,4145.229999999923
14960,2022-05-19 12:40:00,591.0,240884.1600000007,236147.93000000078,4736.229999999923
14961,2022-05-19 12:45:00,282.27,241166.4300000007,236147.93000000078,5018.499999999913
14962,2022-05-19 12:50:00,1181.68,242348.11000000068,236147.93000000078,6200.179999999906
14963,2022-05-19 12:55:00,1530.73,243878.8400000007,236147.93000000078,7730.909999999916
14964,2022-05-19 13:00:00,-43.2,243835.64000000068,236147.93000000078,7687.7099999999045
14965,2022-05-19 13:05:00,-1754.7,242080.94000000067,236147.93000000078,5933.009999999893
14966,2022-05-19 13:10:00,1235.22,243316.16000000067,236147.93000000078,7168.229999999894
14967,2022-05-19 13:15:00,1436.98,244753.14000000068,236147.93000000078,8605.209999999905
14968,2022-05-19 13:20:00,-619.03,244134.11000000068,236147.93000000078,7986.179999999906
14969,2022-05-19 13:25:00,-391.01,243743.10000000068,236147.93000000078,7595.169999999896
14970,2022-05-19 13:30:00,-1816.8,241926.3000000007,236147.93000000078,5778.369999999908
14971,2022-05-19 13:35:00,1970.18,243896.48000000068,236147.93000000078,7748.549999999901
14972,2022-05-19 13:40:00,445.88,244342.36000000068,236147.93000000078,8194.429999999906
14973,2022-05-19 13:45:00,-1105.81,243236.5500000007,236147.93000000078,7088.619999999908
14974,2022-05-19 13:50:00,226.67,243463.2200000007,236147.93000000078,7315.289999999921
14975,2022-05-19 13:55:00,660.53,244123.7500000007,236147.93000000078,7975.81999999992
14976,2022-05-19 14:00:00,-341.97,243781.7800000007,236147.93000000078,7633.8499999999185
14977,2022-05-19 14:05:00,399.55,244181.3300000007,236147.93000000078,8033.399999999907
14978,2022-05-19 14:10:00,-1846.08,242335.2500000007,236147.93000000078,6187.31999999992
14979,2022-05-19 14:15:00,-1267.5,241067.7500000007,236147.93000000078,4919.81999999992
14980,2022-05-19 14:20:00,-538.44,240529.3100000007,236147.93000000078,4381.379999999917
14981,2022-05-19 14:25:00,-1503.81,239025.5000000007,236147.93000000078,2877.5699999999197
14982,2022-05-19 14:30:00,-1724.3,237301.2000000007,236147.93000000078,1153.2699999999313
14983,2022-05-19 14:35:00,-1754.81,235546.3900000007,236147.93000000078,-601.5400000000664
14984,2022-05-19 14:40:00,-48.87,235497.52000000072,236147.93000000078,-650.4100000000617
14985,2022-05-19 14:45:00,1873.98,237371.50000000073,236147.93000000078,1223.5699999999488
14986,2022-05-19 14:50:00,-91.39,237280.1100000007,236147.93000000078,1132.1799999999348
14987,2022-05-19 14:55:00,1924.34,239204.4500000007,236147.93000000078,3056.5199999999313
14988,2022-05-19 15:00:00,163.12,239367.5700000007,236147.93000000078,3219.6399999999267
14989,2022-05-19 15:05:00,-1294.12,238073.4500000007,236147.93000000078,1925.5199999999313
14990,2022-05-19 15:10:00,-718.3,237355.15000000072,236147.93000000078,1207.219999999943
14991,2022-05-19 15:15:00,-1733.95,235621.2000000007,236147.93000000078,-526.7300000000687
14992,2022-05-19 15:20:00,802.41,236423.6100000007,236147.93000000078,275.6799999999348
14993,2022-05-19 15:25:00,-1081.4,235342.21000000072,236147.93000000078,-805.7200000000594
14994,2022-05-19 15:30:00,-1390.23,233951.9800000007,236147.93000000078,-2195.95000000007
14995,2022-05-19 15:35:00,376.27,234328.2500000007,236147.93000000078,-1819.6800000000803
14996,2022-05-19 15:40:00,-1789.75,232538.5000000007,236147.93000000078,-3609.4300000000803
14997,2022-05-19 15:45:00,1812.02,234350.5200000007,236147.93000000078,-1797.4100000000908
14998,2022-05-19 15:50:00,566.3,234916.82000000068,236147.93000000078,-1231.1100000001024
14999,2022-05-19 15:55:00,-1984.56,232932.26000000068,236147.93000000078,-3215.6700000001
15000,2022-05-19 16:00:00,-1495.43,231436.8300000007,236147.93000000078,-4711.100000000093
15001,2022-05-19 16:05:00,528.84,231965.67000000068,236147.93000000078,-4182.260000000097
15002,2022-05-19 16:10:00,-1457.47,230508.20000000068,236147.93000000078,-5639.730000000098
15003,2022-05-19 16:15:00,-293.1,230215.10000000068,236147.93000000078,-5932.830000000104
15004,2022-05-19 16:20:00,445.3,230660.40000000066,236147.93000000078,-5487.530000000115
15005,2022-05-19 16:25:00,443.26,231103.66000000067,236147.93000000078,-5044.270000000106
15006,2022-05-19 16:30:00,-1307.41,229796.25000000067,236147.93000000078,-6351.680000000109
15007,2022-05-19 16:35:00,368.69,230164.94000000067,236147.93000000078,-5982.990000000107
15008,2022-05-19 16:40:00,-1415.77,228749.17000000068,236147.93000000078,-7398.760000000097
15009,2022-05-19 16:45:00,967.83,229717.00000000067,236147.93000000078,-6430.930000000109
15010,2022-05-19 16:50:00,1227.0,230944.00000000067,236147.93000000078,-5203.930000000109
15011,2022-05-19 16:55:00,-1893.03,229050.97000000067,236147.93000000078,-7096.960000000108
15012,2022-05-20 08:00:00,1134.64,230185.61000000068,229050.97000000067,1134.640000000014
15013,2022-05-20 08:05:00,-1003.57,229182.04000000068,229050.97000000067,131.07000000000698
15014,2022-05-20 08:10:00,-1246.34,227935.70000000068,229050.97000000067,-1115.2699999999895
15015,2022-05-20 08:15:00,-325.52,227610.1800000007,229050.97000000067,-1440.789999999979
15016,2022-05-20 08:20:00,328.55,227938.73000000068,229050.97000000067,-1112.2399999999907
15017,2022-05-20 08:25:00,1653.89,229592.6200000007,229050.97000000067,541.6500000000233
15018,2022-05-20 08:30:00,367.88,229960.5000000007,229050.97000000067,909.5300000000279
15019,2022-05-20 08:35:00,800.82,230761.3200000007,229050.97000000067,1710.350000000035
15020,2022-05-20 08:40:00,1319.01,232080.33000000071,229050.97000000067,3029.3600000000442
15021,2022-05-20 08:45:00,-65.42,232014.9100000007,229050.97000000067,2963.9400000000314
15022,2022-05-20 08:50:00,1997.38,234012.2900000007,229050.97000000067,4961.320000000036
15023,2022-05-20 08:55:00,1067.74,235080.0300000007,229050.97000000067,6029.060000000027
15024,2022-05-20 09:00:00,-952.58,234127.4500000007,229050.97000000067,5076.48000000004
15025,2022-05-20 09:05:00,672.62,234800.0700000007,229050.97000000067,5749.100000000035
15026,2022-05-20 09:10:00,-1430.39,233369.6800000007,229050.97000000067,4318.710000000021
15027,2022-05-20 09:15:00,-1122.86,232246.8200000007,229050.97000000067,3195.850000000035
15028,2022-05-20 09:20:00,-1280.61,230966.21000000072,229050.97000000067,1915.240000000049
15029,2022-05-20 09:25:00,1588.53,232554.74000000072,229050.97000000067,3503.7700000000477
15030,2022-05-20 09:30:00,1048.31,233603.05000000072,229050.97000000067,4552.080000000045
15031,2022-05-20 09:35:00,-188.92,233414.1300000007,229050.97000000067,4363.160000000033
15032,2022-05-20 09:40:00,-35.92,233378.2100000007,229050.97000000067,4327.24000000002
15033,2022-05-20 09:45:00,263.26,233641.4700000007,229050.97000000067,4590.500000000029
15034,2022-05-20 09:50:00,512.57,234154.0400000007,229050.97000000067,5103.070000000036
15035,2022-05-20 09:55:00,1822.73,235976.77000000072,229050.97000000067,6925.800000000047
15036,2022-05-20 10:00:00,1388.76,237365.53000000073,229050.97000000067,8314.560000000056
15037,2022-05-20 10:05:00,-1139.58,236225.95000000074,229050.97000000067,7174.980000000069
15038,2022-05-20 10:10:00,1465.34,237691.29000000074,229050.97000000067,8640.320000000065
15039,2022-05-20 10:15:00,1704.44,239395.73000000074,229050.97000000067,10344.760000000068
15040,2022-05-20 10:20:00,-200.93,239194.80000000075,229050.97000000067,10143.830000000075
15041,2022-05-20 10:25:00,1794.62,240989.42000000074,229050.97000000067,11938.45000000007
15042,2022-05-20 10:30:00,193.53,241182.95000000074,229050.97000000067,12131.980000000069
15043,2022-05-20 10:35:00,197.82,241380.77000000075,229050.97000000067,12329.800000000076
15044,2022-05-20 10:40:00,-94.85,241285.92000000074,229050.97000000067,12234.95000000007
15045,2022-05-20 10:45:00,-1366.91,239919.01000000074,229050.97000000067,10868.040000000066
15046,2022-05-20 10:50:00,1397.08,241316.09000000072,229050.97000000067,12265.120000000054
15047,2022-05-20 10:55:00,-762.49,240553.60000000073,229050.97000000067,11502.630000000063
15048,2022-05-20 11:00:00,-822.08,239731.52000000075,229050.97000000067,10680.550000000076
15049,2022-05-20 11:05:00,1299.34,241030.86000000074,229050.97000000067,11979.890000000072
15050,2022-05-20 11:10:00,-1800.87,239229.99000000075,229050.97000000067,10179.020000000077
15051,2022-05-20 11:15:00,-241.57,238988.42000000074,229050.97000000067,9937.45000000007
15052,2022-05-20 11:20:00,394.19,239382.61000000074,229050.97000000067,10331.640000000072
15053,2022-05-20 11:25:00,-876.98,238505.63000000073,229050.97000000067,9454.660000000062
15054,2022-05-20 11:30:00,1770.8,240276.43000000072,229050.97000000067,11225.46000000005
15055,2022-05-20 11:35:00,1463.67,241740.10000000073,229050.97000000067,12689.130000000063
15056,2022-05-20 11:40:00,-1323.4,240416.70000000074,229050.97000000067,11365.730000000069
15057,2022-05-20 11:45:00,497.64,240914.34000000075,229050.97000000067,11863.370000000083
15058,2022-05-20 11:50:00,515.93,241430.27000000075,229050.97000000067,12379.300000000076
15059,2022-05-20 11:55:00,1161.72,242591.99000000075,229050.97000000067,13541.020000000077
15060,2022-05-20 12:00:00,-546.63,242045.36000000074,229050.97000000067,12994.390000000072
15061,2022-05-20 12:05:00,221.2,242266.56000000075,229050.97000000067,13215.590000000084
15062,2022-05-20 12:10:00,-1439.9,240826.66000000076,229050.97000000067,11775.69000000009
15063,2022-05-20 12:15:00,806.5,241633.16000000076,229050.97000000067,12582.19000000009
15064,2022-05-20 12:20:00,-1880.01,239753.15000000075,229050.97000000067,10702.18000000008
15065,2022-05-20 12:25:00,1967.76,241720.91000000076,229050.97000000067,12669.94000000009
15066,2022-05-20 12:30:00,1650.2,243371.11000000077,229050.97000000067,14320.140000000101
15067,2022-05-20 12:35:00,1560.75,244931.86000000077,229050.97000000067,15880.890000000101
15068,2022-05-20 12:40:00,-1008.06,243923.80000000077,229050.97000000067,14872.830000000104
15069,2022-05-20 12:45:00,709.52,244633.32000000076,229050.97000000067,15582.350000000093
15070,2022-05-20 12:50:00,603.08,245236.40000000075,229050.97000000067,16185.43000000008
15071,2022-05-20 12:55:00,-1462.16,243774.24000000075,229050.97000000067,14723.270000000077
15072,2022-05-20 13:00:00,148.94,243923.18000000075,229050.97000000067,14872.21000000008
15073,2022-05-20 13:05:00,784.3,244707.48000000074,229050.97000000067,15656.510000000068
15074,2022-05-20 13:10:00,85.02,244792.50000000073,229050.97000000067,15741.530000000057
15075,2022-05-20 13:15:00,-1152.9,243639.60000000073,229050.97000000067,14588.630000000063
15076,2022-05-20 13:20:00,-994.2,242645.40000000072,229050.97000000067,13594.430000000051
15077,2022-05-20 13:25:00,872.25,243517.65000000072,229050.97000000067,14466.680000000051
15078,2022-05-20 13:30:00,1998.0,245515.65000000072,229050.97000000067,16464.68000000005
15079,2022-05-20 13:35:00,-489.7,245025.9500000007,229050.97000000067,15974.98000000004
15080,2022-05-20 13:40:00,-865.32,244160.6300000007,229050.97000000067,15109.660000000033
15081,2022-05-20 13:45:00,-319.8,243840.83000000071,229050.97000000067,14789.860000000044
15082,2022-05-20 13:50:00,571.58,244412.4100000007,229050.97000000067,15361.440000000031
15083,2022-05-20 13:55:00,-801.44,243610.9700000007,229050.97000000067,14560.00000000003
15084,2022-05-20 14:00:00,74.01,243684.9800000007,229050.97000000067,14634.010000000038
15085,2022-05-20 14:05:00,1548.29,245233.27000000072,229050.97000000067,16182.300000000047
15086,2022-05-20 14:10:00,-1542.34,243690.93000000072,229050.97000000067,14639.96000000005
15087,2022-05-20 14:15:00,590.65,244281.58000000071,229050.97000000067,15230.610000000044
15088,2022-05-20 14:20:00,1699.82,245981.40000000072,229050.97000000067,16930.43000000005
15089,2022-05-20 14:25:00,661.49,246642.8900000007,229050.97000000067,17591.920000000042
15090,2022-05-20 14:30:00,1143.4,247786.2900000007,229050.97000000067,18735.320000000036
15091,2022-05-20 14:35:00,-1197.69,246588.6000000007,229050.97000000067,17537.630000000034
15092,2022-05-20 14:40:00,853.6,247442.2000000007,229050.97000000067,18391.23000000004
15093,2022-05-20 14:45:00,895.14,248337.34000000072,229050.97000000067,19286.370000000054
15094,2022-05-20 14:50:00,996.57,249333.91000000073,229050.97000000067,20282.94000000006
15095,2022-05-20 14:55:00,-1967.26,247366.65000000072,229050.97000000067,18315.68000000005
15096,2022-05-20 15:00:00,487.14,247853.79000000074,229050.97000000067,18802.820000000065
15097,2022-05-20 15:05:00,-412.22,247441.57000000073,229050.97000000067,18390.600000000064
15098,2022-05-20 15:10:00,724.39,248165.96000000075,229050.97000000067,19114.990000000078
15099,2022-05-20 15:15:00,-1990.23,246175.73000000074,229050.97000000067,17124.760000000068
15100,2022-05-20 15:20:00,899.57,247075.30000000075,229050.97000000067,18024.330000000075
15101,2022-05-20 15:25:00,1373.34,248448.64000000074,229050.97000000067,19397.67000000007
15102,2022-05-20 15:30:00,1371.97,249820.61000000074,229050.97000000067,20769.640000000072
15103,2022-05-20 15:35:00,-212.6,249608.01000000074,229050.97000000067,20557.040000000066
15104,2022-05-20 15:40:00,826.68,250434.69000000073,229050.97000000067,21383.72000000006
15105,2022-05-20 15:45:00,377.02,250811.71000000072,229050.97000000067,21760.74000000005
15106,2022-05-20 15:50:00,-1468.16,249343.55000000072,229050.97000000067,20292.580000000045
15107,2022-05-20 15:55:00,479.62,249823.1700000007,229050.97000000067,20772.20000000004
15108,2022-05-20 16:00:00,330.74,250153.9100000007,229050.97000000067,21102.94000000003
15109,2022-05-20 16:05:00,-1194.82,248959.0900000007,229050.97000000067,19908.120000000024
15110,2022-05-20 16:10:00,-1819.48,247139.61000000068,229050.97000000067,18088.640000000014
15111,2022-05-20 16:15:00,-712.12,246427.4900000007,229050.97000000067,17376.52000000002
15112,2022-05-20 16:20:00,-1009.2,245418.29000000068,229050.97000000067,16367.320000000007
15113,2022-05-20 16:25:00,-416.91,245001.38000000067,229050.97000000067,15950.410000000003
15114,2022-05-20 16:30:00,-65.05,244936.3300000007,229050.97000000067,15885.360000000015
15115,2022-05-20 16:35:00,1399.16,246335.4900000007,229050.97000000067,17284.52000000002
15116,2022-05-20 16:40:00,1293.38,247628.8700000007,229050.97000000067,18577.900000000023
15117,2022-05-20 16:45:00,-729.7,246899.17000000068,229050.97000000067,17848.20000000001
15118,2022-05-20 16:50:00,673.8,247572.97000000067,229050.97000000067,18522.0
15119,2022-05-20 16:55:00,-1784.93,245788.04000000068,229050.97000000067,16737.070000000007
15120,2022-05-21 08:00:00,-993.07,244794.97000000067,245788.04000000068,-993.070000000007
15121,2022-05-21 08:05:00,827.49,245622.46000000066,245788.04000000068,-165.5800000000163
15122,2022-05-21 08:10:00,-1971.49,243650.97000000067,245788.04000000068,-2137.070000000007
15123,2022-05-21 08:15:00,917.8,244568.77000000066,245788.04000000068,-1219.2700000000186
15124,2022-05-21 08:20:00,-1789.32,242779.45000000065,245788.04000000068,-3008.5900000000256
15125,2022-05-21 08:25:00,-1862.94,240916.51000000065,245788.04000000068,-4871.530000000028
15126,2022-05-21 08:30:00,156.96,241073.47000000064,245788.04000000068,-4714.570000000036
15127,2022-05-21 08:35:00,-999.0,240074.47000000064,245788.04000000068,-5713.570000000036
15128,2022-05-21 08:40:00,1764.07,241838.54000000065,245788.04000000068,-3949.500000000029
15129,2022-05-21 08:45:00,873.92,242712.46000000066,245788.04000000068,-3075.5800000000163
15130,2022-05-21 08:50:00,1674.76,244387.22000000067,245788.04000000068,-1400.820000000007
15131,2022-05-21 08:55:00,-1510.6,242876.62000000066,245788.04000000068,-2911.420000000013
15132,2022-05-21 09:00:00,-1046.3,241830.32000000068,245788.04000000068,-3957.720000000001
15133,2022-05-21 09:05:00,948.84,242779.16000000067,245788.04000000068,-3008.8800000000047
15134,2022-05-21 09:10:00,1366.22,244145.38000000067,245788.04000000068,-1642.6600000000035
15135,2022-05-21 09:15:00,1422.42,245567.8000000007,245788.04000000068,-220.2399999999907
15136,2022-05-21 09:20:00,1786.4,247354.20000000068,245788.04000000068,1566.1600000000035
15137,2022-05-21 09:25:00,1208.87,248563.07000000068,245788.04000000068,2775.029999999999
15138,2022-05-21 09:30:00,-1884.07,246679.00000000067,245788.04000000068,890.9599999999919
15139,2022-05-21 09:35:00,-463.54,246215.46000000066,245788.04000000068,427.4199999999837
15140,2022-05-21 09:40:00,-878.0,245337.46000000066,245788.04000000068,-450.5800000000163
15141,2022-05-21 09:45:00,1928.93,247266.39000000065,245788.04000000068,1478.3499999999767
15142,2022-05-21 09:50:00,401.58,247667.97000000064,245788.04000000068,1879.929999999964
15143,2022-05-21 09:55:00,-1820.54,245847.43000000063,245788.04000000068,59.38999999995576
15144,2022-05-21 10:00:00,1651.06,247498.49000000063,245788.04000000068,1710.4499999999534
15145,2022-05-21 10:05:00,-1092.24,246406.25000000064,245788.04000000068,618.2099999999627
15146,2022-05-21 10:10:00,-1861.14,244545.11000000063,245788.04000000068,-1242.9300000000512
15147,2022-05-21 10:15:00,351.25,244896.36000000063,245788.04000000068,-891.6800000000512
15148,2022-05-21 10:20:00,181.47,245077.83000000063,245788.04000000068,-710.2100000000501
15149,2022-05-21 10:25:00,970.57,246048.40000000063,245788.04000000068,260.3599999999569
15150,2022-05-21 10:30:00,-79.29,245969.11000000063,245788.04000000068,181.06999999994878
15151,2022-05-21 10:35:00,1751.78,247720.89000000063,245788.04000000068,1932.8499999999476
15152,2022-05-21 10:40:00,-536.17,247184.7200000006,245788.04000000068,1396.6799999999348
15153,2022-05-21 10:45:00,611.94,247796.66000000061,245788.04000000068,2008.6199999999371
15154,2022-05-21 10:50:00,265.65,248062.3100000006,245788.04000000068,2274.2699999999313
15155,2022-05-21 10:55:00,1105.11,249167.4200000006,245788.04000000068,3379.3799999999173
15156,2022-05-21 11:00:00,1031.6,250199.0200000006,245788.04000000068,4410.979999999923
15157,2022-05-21 11:05:00,1973.7,252172.7200000006,245788.04000000068,6384.679999999935
15158,2022-05-21 11:10:00,-1029.81,251142.91000000061,245788.04000000068,5354.869999999937
15159,2022-05-21 11:15:00,-19.83,251123.08000000063,245788.04000000068,5335.03999999995
15160,2022-05-21 11:20:00,286.35,251409.43000000063,245788.04000000068,5621.389999999956
15161,2022-05-21 11:25:00,487.47,251896.90000000063,245788.04000000068,6108.859999999957
15162,2022-05-21 11:30:00,135.93,252032.83000000063,245788.04000000068,6244.78999999995
15163,2022-05-21 11:35:00,-914.39,251118.4400000006,245788.04000000068,5330.399999999936
15164,2022-05-21 11:40:00,435.36,251553.8000000006,245788.04000000068,5765.759999999922
15165,2022-05-21 11:45:00,-1493.07,250060.7300000006,245788.04000000068,4272.689999999915
15166,2022-05-21 11:50:00,1627.32,251688.0500000006,245788.04000000068,5900.009999999922
15167,2022-05-21 11:55:00,-228.12,251459.9300000006,245788.04000000068,5671.889999999927
15168,2022-05-21 12:00:00,-1491.6,249968.3300000006,245788.04000000068,4180.289999999921
15169,2022-05-21 12:05:00,1868.42,251836.7500000006,245788.04000000068,6048.709999999934
15170,2022-05-21 12:10:00,265.52,252102.2700000006,245788.04000000068,6314.229999999923
15171,2022-05-21 12:15:00,-692.4,251409.8700000006,245788.04000000068,5621.829999999929
15172,2022-05-21 12:20:00,1760.68,253170.5500000006,245788.04000000068,7382.509999999922
15173,2022-05-21 12:25:00,319.01,253489.5600000006,245788.04000000068,7701.519999999931
15174,2022-05-21 12:30:00,-260.04,253229.5200000006,245788.04000000068,7441.479999999923
15175,2022-05-21 12:35:00,-1822.81,251406.7100000006,245788.04000000068,5618.6699999999255
15176,2022-05-21 12:40:00,1896.28,253302.9900000006,245788.04000000068,7514.949999999924
15177,2022-05-21 12:45:00,884.05,254187.0400000006,245788.04000000068,8398.999999999913
15178,2022-05-21 12:50:00,-1317.1,252869.94000000058,245788.04000000068,7081.899999999907
15179,2022-05-21 12:55:00,-1087.14,251782.80000000057,245788.04000000068,5994.759999999893
15180,2022-05-21 13:00:00,943.23,252726.03000000058,245788.04000000068,6937.989999999903
15181,2022-05-21 13:05:00,848.37,253574.40000000058,245788.04000000068,7786.359999999899
15182,2022-05-21 13:10:00,282.44,253856.84000000058,245788.04000000068,8068.799999999901
15183,2022-05-21 13:15:00,535.58,254392.42000000057,245788.04000000068,8604.379999999888
15184,2022-05-21 13:20:00,-564.25,253828.17000000057,245788.04000000068,8040.129999999888
15185,2022-05-21 13:25:00,1317.06,255145.23000000056,245788.04000000068,9357.189999999886
15186,2022-05-21 13:30:00,-964.94,254180.29000000056,245788.04000000068,8392.249999999884
15187,2022-05-21 13:35:00,-238.4,253941.89000000057,245788.04000000068,8153.849999999889
15188,2022-05-21 13:40:00,-199.79,253742.10000000056,245788.04000000068,7954.059999999881
15189,2022-05-21 13:45:00,643.12,254385.22000000055,245788.04000000068,8597.179999999877
15190,2022-05-21 13:50:00,-1728.77,252656.45000000056,245788.04000000068,6868.409999999887
15191,2022-05-21 13:55:00,1357.68,254014.13000000056,245788.04000000068,8226.08999999988
15192,2022-05-21 14:00:00,1949.44,255963.57000000056,245788.04000000068,10175.529999999882
15193,2022-05-21 14:05:00,536.59,256500.16000000056,245788.04000000068,10712.119999999879
15194,2022-05-21 14:10:00,44.6,256544.76000000056,245788.04000000068,10756.719999999885
15195,2022-05-21 14:15:00,-1499.53,255045.23000000056,245788.04000000068,9257.189999999886
15196,2022-05-21 14:20:00,-811.17,254234.06000000055,245788.04000000068,8446.019999999873
15197,2022-05-21 14:25:00,454.98,254689.04000000056,245788.04000000068,8900.999999999884
15198,2022-05-21 14:30:00,758.68,255447.72000000055,245788.04000000068,9659.679999999877
15199,2022-05-21 14:35:00,-814.57,254633.15000000055,245788.04000000068,8845.10999999987
15200,2022-05-21 14:40:00,-1325.27,253307.88000000056,245788.04000000068,7519.83999999988
15201,2022-05-21 14:45:00,1208.58,254516.46000000054,245788.04000000068,8728.419999999867
15202,2022-05-21 14:50:00,-148.46,254368.00000000055,245788.04000000068,8579.959999999875
15203,2022-05-21 14:55:00,-1186.74,253181.26000000056,245788.04000000068,7393.219999999885
15204,2022-05-21 15:00:00,-1160.23,252021.03000000055,245788.04000000068,6232.989999999874
15205,2022-05-21 15:05:00,1508.02,253529.05000000054,245788.04000000068,7741.009999999864
15206,2022-05-21 15:10:00,637.41,254166.46000000054,245788.04000000068,8378.419999999867
15207,2022-05-21 15:15:00,1846.73,256013.19000000056,245788.04000000068,10225.149999999878
15208,2022-05-21 15:20:00,62.6,256075.79000000056,245788.04000000068,10287.749999999884
15209,2022-05-21 15:25:00,1031.51,257107.30000000057,245788.04000000068,11319.259999999893
15210,2022-05-21 15:30:00,-1597.0,255510.30000000057,245788.04000000068,9722.259999999893
15211,2022-05-21 15:35:00,643.56,256153.86000000057,245788.04000000068,10365.81999999989
15212,2022-05-21 15:40:00,-977.38,255176.48000000056,245788.04000000068,9388.439999999886
15213,2022-05-21 15:45:00,448.61,255625.09000000055,245788.04000000068,9837.049999999872
15214,2022-05-21 15:50:00,744.36,256369.45000000054,245788.04000000068,10581.409999999858
15215,2022-05-21 15:55:00,374.87,256744.32000000053,245788.04000000068,10956.279999999853
15216,2022-05-21 16:00:00,953.73,257698.05000000054,245788.04000000068,11910.009999999864
15217,2022-05-21 16:05:00,206.32,257904.37000000055,245788.04000000068,12116.32999999987
15218,2022-05-21 16:10:00,336.78,258241.15000000055,245788.04000000068,12453.10999999987
15219,2022-05-21 16:15:00,-678.06,257563.09000000055,245788.04000000068,11775.049999999872
15220,2022-05-21 16:20:00,1996.92,259560.01000000056,245788.04000000068,13771.969999999885
15221,2022-05-21 16:25:00,321.38,259881.39000000057,245788.04000000068,14093.34999999989
15222,2022-05-21 16:30:00,1522.07,261403.46000000057,245788.04000000068,15615.419999999896
15223,2022-05-21 16:35:00,1419.36,262822.8200000006,245788.04000000068,17034.77999999991
15224,2022-05-21 16:40:00,1695.27,264518.0900000006,245788.04000000068,18730.04999999993
15225,2022-05-21 16:45:00,-1492.22,263025.87000000064,245788.04000000068,17237.829999999958
15226,2022-05-21 16:50:00,-1167.74,261858.13000000064,245788.04000000068,16070.089999999967
15227,2022-05-21 16:55:00,-1442.0,260416.13000000064,245788.04000000068,14628.089999999967
15228,2022-05-22 08:00:00,-616.83,259799.30000000066,260416.13000000064,-616.8299999999872
15229,2022-05-22 08:05:00,-1831.65,257967.65000000066,260416.13000000064,-2448.4799999999814
15230,2022-05-22 08:10:00,-1870.83,256096.82000000068,260416.13000000064,-4319.309999999969
15231,2022-05-22 08:15:00,153.24,256250.06000000067,260416.13000000064,-4166.069999999978
15232,2022-05-22 08:20:00,679.11,256929.17000000065,260416.13000000064,-3486.959999999992
15233,2022-05-22 08:25:00,-1674.55,255254.62000000066,260416.13000000064,-5161.50999999998
15234,2022-05-22 08:30:00,-1550.37,253704.25000000067,260416.13000000064,-6711.879999999976
15235,2022-05-22 08:35:00,-1119.43,252584.82000000068,260416.13000000064,-7831.309999999969
15236,2022-05-22 08:40:00,1715.41,254300.23000000068,260416.13000000064,-6115.899999999965
15237,2022-05-22 08:45:00,-802.16,253498.07000000068,260416.13000000064,-6918.059999999969
15238,2022-05-22 08:50:00,-1859.43,251638.64000000068,260416.13000000064,-8777.489999999962
15239,2022-05-22 08:55:00,660.53,252299.17000000068,260416.13000000064,-8116.959999999963
15240,2022-05-22 09:00:00,1958.51,254257.6800000007,260416.13000000064,-6158.449999999953
15241,2022-05-22 09:05:00,419.77,254677.45000000068,260416.13000000064,-5738.679999999964
15242,2022-05-22 09:10:00,-1759.26,252918.19000000067,260416.13000000064,-7497.939999999973
15243,2022-05-22 09:15:00,-152.2,252765.99000000066,260416.13000000064,-7650.139999999985
15244,2022-05-22 09:20:00,-838.26,251927.73000000065,260416.13000000064,-8488.399999999994
15245,2022-05-22 09:25:00,-1305.64,250622.09000000064,260416.13000000064,-9794.040000000008
15246,2022-05-22 09:30:00,-1725.63,248896.46000000063,260416.13000000064,-11519.670000000013
15247,2022-05-22 09:35:00,101.51,248997.97000000064,260416.13000000064,-11418.160000000003
15248,2022-05-22 09:40:00,-848.88,248149.09000000064,260416.13000000064,-12267.040000000008
15249,2022-05-22 09:45:00,-383.04,247766.05000000063,260416.13000000064,-12650.080000000016
15250,2022-05-22 09:50:00,1400.75,249166.80000000063,260416.13000000064,-11249.330000000016
15251,2022-05-22 09:55:00,74.07,249240.87000000064,260416.13000000064,-11175.26000000001
15252,2022-05-22 10:00:00,-1134.24,248106.63000000064,260416.13000000064,-12309.5
15253,2022-05-22 10:05:00,-1388.16,246718.47000000064,260416.13000000064,-13697.660000000003
15254,2022-05-22 10:10:00,-609.24,246109.23000000065,260416.13000000064,-14306.899999999994
15255,2022-05-22 10:15:00,-1399.38,244709.85000000065,260416.13000000064,-15706.279999999999
15256,2022-05-22 10:20:00,-1973.55,242736.30000000066,260416.13000000064,-17679.829999999987
15257,2022-05-22 10:25:00,858.11,243594.41000000064,260416.13000000064,-16821.72
15258,2022-05-22 10:30:00,-660.56,242933.85000000065,260416.13000000064,-17482.28
15259,2022-05-22 10:35:00,-1474.72,241459.13000000064,260416.13000000064,-18957.0
15260,2022-05-22 10:40:00,142.85,241601.98000000065,260416.13000000064,-18814.149999999994
15261,2022-05-22 10:45:00,1586.33,243188.31000000064,260416.13000000064,-17227.820000000007
15262,2022-05-22 10:50:00,-67.54,243120.77000000063,260416.13000000064,-17295.360000000015
15263,2022-05-22 10:55:00,-850.94,242269.83000000063,260416.13000000064,-18146.300000000017
15264,2022-05-22 11:00:00,-965.25,241304.58000000063,260416.13000000064,-19111.550000000017
15265,2022-05-22 11:05:00,100.42,241405.00000000064,260416.13000000064,-19011.130000000005
15266,2022-05-22 11:10:00,-801.38,240603.62000000064,260416.13000000064,-19812.51000000001
15267,2022-05-22 11:15:00,716.26,241319.88000000064,260416.13000000064,-19096.25
15268,2022-05-22 11:20:00,-763.89,240555.99000000063,260416.13000000064,-19860.140000000014
15269,2022-05-22 11:25:00,-155.4,240400.59000000064,260416.13000000064,-20015.540000000008
15270,2022-05-22 11:30:00,-670.26,239730.33000000063,260416.13000000064,-20685.800000000017
15271,2022-05-22 11:35:00,-1085.81,238644.52000000063,260416.13000000064,-21771.610000000015
15272,2022-05-22 11:40:00,-383.07,238261.45000000062,260416.13000000064,-22154.680000000022
15273,2022-05-22 11:45:00,1066.63,239328.08000000063,260416.13000000064,-21088.050000000017
15274,2022-05-22 11:50:00,-974.05,238354.03000000064,260416.13000000064,-22062.100000000006
15275,2022-05-22 11:55:00,643.14,238997.17000000065,260416.13000000064,-21418.959999999992
15276,2022-05-22 12:00:00,295.33,239292.50000000064,260416.13000000064,-21123.630000000005
15277,2022-05-22 12:05:00,-886.31,238406.19000000064,260416.13000000064,-22009.940000000002
15278,2022-05-22 12:10:00,-1521.82,236884.37000000064,260416.13000000064,-23531.76000000001
15279,2022-05-22 12:15:00,1934.24,238818.61000000063,260416.13000000064,-21597.52000000002
15280,2022-05-22 12:20:00,1172.88,239991.49000000063,260416.13000000064,-20424.640000000014
15281,2022-05-22 12:25:00,-628.25,239363.24000000063,260416.13000000064,-21052.890000000014
15282,2022-05-22 12:30:00,-1591.28,237771.96000000063,260416.13000000064,-22644.170000000013
15283,2022-05-22 12:35:00,977.37,238749.33000000063,260416.13000000064,-21666.800000000017
15284,2022-05-22 12:40:00,-1851.44,236897.89000000063,260416.13000000064,-23518.24000000002
15285,2022-05-22 12:45:00,1557.49,238455.38000000062,260416.13000000064,-21960.75000000003
15286,2022-05-22 12:50:00,-466.53,237988.85000000062,260416.13000000064,-22427.280000000028
15287,2022-05-22 12:55:00,1357.4,239346.2500000006,260416.13000000064,-21069.880000000034
15288,2022-05-22 13:00:00,1403.48,240749.73000000062,260416.13000000064,-19666.400000000023
15289,2022-05-22 13:05:00,-54.37,240695.36000000063,260416.13000000064,-19720.77000000002
15290,2022-05-22 13:10:00,-805.4,239889.96000000063,260416.13000000064,-20526.170000000013
15291,2022-05-22 13:15:00,1267.48,241157.44000000064,260416.13000000064,-19258.690000000002
15292,2022-05-22 13:20:00,-815.64,240341.80000000063,260416.13000000064,-20074.330000000016
15293,2022-05-22 13:25:00,1877.04,242218.84000000064,260416.13000000064,-18197.290000000008
15294,2022-05-22 13:30:00,124.73,242343.57000000065,260416.13000000064,-18072.559999999998
15295,2022-05-22 13:35:00,1916.55,244260.12000000064,260416.13000000064,-16156.01000000001
15296,2022-05-22 13:40:00,813.79,245073.91000000064,260416.13000000064,-15342.220000000001
15297,2022-05-22 13:45:00,1154.03,246227.94000000064,260416.13000000064,-14188.190000000002
15298,2022-05-22 13:50:00,1864.99,248092.93000000063,260416.13000000064,-12323.200000000012
15299,2022-05-22 13:55:00,795.21,248888.14000000063,260416.13000000064,-11527.99000000002
15300,2022-05-22 14:00:00,-972.59,247915.55000000063,260416.13000000064,-12500.580000000016
15301,2022-05-22 14:05:00,1210.41,249125.96000000063,260416.13000000064,-11290.170000000013
15302,2022-05-22 14:10:00,783.38,249909.34000000064,260416.13000000064,-10506.790000000008
15303,2022-05-22 14:15:00,-582.94,249326.40000000063,260416.13000000064,-11089.73000000001
15304,2022-05-22 14:20:00,1268.69,250595.09000000064,260416.13000000064,-9821.040000000008
15305,2022-05-22 14:25:00,-148.75,250446.34000000064,260416.13000000064,-9969.790000000008
15306,2022-05-22 14:30:00,706.59,251152.93000000063,260416.13000000064,-9263.200000000012
15307,2022-05-22 14:35:00,-1745.68,249407.25000000064,260416.13000000064,-11008.880000000005
15308,2022-05-22 14:40:00,-748.14,248659.11000000063,260416.13000000064,-11757.020000000019
15309,2022-05-22 14:45:00,1805.99,250465.10000000062,260416.13000000064,-9951.030000000028
15310,2022-05-22 14:50:00,-1144.62,249320.48000000062,260416.13000000064,-11095.650000000023
15311,2022-05-22 14:55:00,-1724.39,247596.0900000006,260416.13000000064,-12820.040000000037
15312,2022-05-22 15:00:00,-1508.96,246087.13000000062,260416.13000000064,-14329.00000000003
15313,2022-05-22 15:05:00,699.03,246786.16000000061,260416.13000000064,-13629.97000000003
15314,2022-05-22 15:10:00,1686.32,248472.48000000062,260416.13000000064,-11943.650000000023
15315,2022-05-22 15:15:00,-519.87,247952.61000000063,260416.13000000064,-12463.520000000019
15316,2022-05-22 15:20:00,-1570.24,246382.37000000064,260416.13000000064,-14033.76000000001
15317,2022-05-22 15:25:00,671.14,247053.51000000065,260416.13000000064,-13362.619999999995
15318,2022-05-22 15:30:00,-548.32,246505.19000000064,260416.13000000064,-13910.940000000002
15319,2022-05-22 15:35:00,-665.99,245839.20000000065,260416.13000000064,-14576.929999999993
15320,2022-05-22 15:40:00,-1134.98,244704.22000000064,260416.13000000064,-15711.910000000003
15321,2022-05-22 15:45:00,1903.44,246607.66000000064,260416.13000000064,-13808.470000000001
15322,2022-05-22 15:50:00,-161.98,246445.68000000063,260416.13000000064,-13970.450000000012
15323,2022-05-22 15:55:00,745.49,247191.17000000062,260416.13000000064,-13224.960000000021
15324,2022-05-22 16:00:00,1092.0,248283.17000000062,260416.13000000064,-12132.960000000021
15325,2022-05-22 16:05:00,4.73,248287.90000000063,260416.13000000064,-12128.23000000001
15326,2022-05-22 16:10:00,800.84,249088.74000000063,260416.13000000064,-11327.390000000014
15327,2022-05-22 16:15:00,765.35,249854.09000000064,260416.13000000064,-10562.040000000008
15328,2022-05-22 16:20:00,-246.58,249607.51000000065,260416.13000000064,-10808.619999999995
15329,2022-05-22 16:25:00,-769.74,248837.77000000066,260416.13000000064,-11578.359999999986
15330,2022-05-22 16:30:00,68.76,248906.53000000067,260416.13000000064,-11509.599999999977
15331,2022-05-22 16:35:00,-1050.21,247856.32000000068,260416.13000000064,-12559.809999999969
15332,2022-05-22 16:40:00,-1317.26,246539.06000000067,260416.13000000064,-13877.069999999978
15333,2022-05-22 16:45:00,-1171.45,245367.61000000066,260416.13000000064,-15048.51999999999
15334,2022-05-22 16:50:00,-811.97,244555.64000000065,260416.13000000064,-15860.48999999999
15335,2022-05-22 16:55:00,-383.46,244172.18000000066,260416.13000000064,-16243.949999999983
15336,2022-05-23 08:00:00,88.27,244260.45000000065,244172.18000000066,88.26999999998952
15337,2022-05-23 08:05:00,-742.79,243517.66000000064,244172.18000000066,-654.5200000000186
15338,2022-05-23 08:10:00,-280.25,243237.41000000064,244172.18000000066,-934.7700000000186
15339,2022-05-23 08:15:00,-977.35,242260.06000000064,244172.18000000066,-1912.1200000000244
15340,2022-05-23 08:20:00,-1290.92,240969.14000000063,244172.18000000066,-3203.0400000000373
15341,2022-05-23 08:25:00,-343.17,240625.9700000006,244172.18000000066,-3546.21000000005
15342,2022-05-23 08:30:00,719.53,241345.5000000006,244172.18000000066,-2826.680000000051
15343,2022-05-23 08:35:00,-1645.35,239700.1500000006,244172.18000000066,-4472.030000000057
15344,2022-05-23 08:40:00,-699.93,239000.2200000006,244172.18000000066,-5171.96000000005
15345,2022-05-23 08:45:00,-1952.85,237047.3700000006,244172.18000000066,-7124.810000000056
15346,2022-05-23 08:50:00,-1968.31,235079.0600000006,244172.18000000066,-9093.120000000054
15347,2022-05-23 08:55:00,-817.43,234261.63000000062,244172.18000000066,-9910.550000000047
15348,2022-05-23 09:00:00,-1987.46,232274.17000000062,244172.18000000066,-11898.010000000038
15349,2022-05-23 09:05:00,-251.42,232022.7500000006,244172.18000000066,-12149.430000000051
15350,2022-05-23 09:10:00,-1032.86,230989.89000000063,244172.18000000066,-13182.290000000037
15351,2022-05-23 09:15:00,-614.81,230375.08000000063,244172.18000000066,-13797.100000000035
15352,2022-05-23 09:20:00,182.57,230557.65000000063,244172.18000000066,-13614.530000000028
15353,2022-05-23 09:25:00,-277.59,230280.06000000064,244172.18000000066,-13892.120000000024
15354,2022-05-23 09:30:00,704.03,230984.09000000064,244172.18000000066,-13188.090000000026
15355,2022-05-23 09:35:00,1832.37,232816.46000000063,244172.18000000066,-11355.72000000003
15356,2022-05-23 09:40:00,308.73,233125.19000000064,244172.18000000066,-11046.99000000002
15357,2022-05-23 09:45:00,-1836.51,231288.68000000063,244172.18000000066,-12883.50000000003
15358,2022-05-23 09:50:00,1411.24,232699.92000000062,244172.18000000066,-11472.260000000038
15359,2022-05-23 09:55:00,-353.5,232346.42000000062,244172.18000000066,-11825.760000000038
15360,2022-05-23 10:00:00,-1431.29,230915.13000000062,244172.18000000066,-13257.050000000047
15361,2022-05-23 10:05:00,-879.55,230035.58000000063,244172.18000000066,-14136.600000000035
15362,2022-05-23 10:10:00,-1399.57,228636.01000000062,244172.18000000066,-15536.170000000042
15363,2022-05-23 10:15:00,-823.0,227813.01000000062,244172.18000000066,-16359.170000000042
15364,2022-05-23 10:20:00,-678.45,227134.5600000006,244172.18000000066,-17037.620000000054
15365,2022-05-23 10:25:00,1374.32,228508.88000000062,244172.18000000066,-15663.300000000047
15366,2022-05-23 10:30:00,-189.96,228318.92000000062,244172.18000000066,-15853.260000000038
15367,2022-05-23 10:35:00,-100.47,228218.45000000062,244172.18000000066,-15953.73000000004
15368,2022-05-23 10:40:00,-1653.12,226565.33000000063,244172.18000000066,-17606.850000000035
15369,2022-05-23 10:45:00,-1722.94,224842.39000000063,244172.18000000066,-19329.790000000037
15370,2022-05-23 10:50:00,1461.61,226304.0000000006,244172.18000000066,-17868.18000000005
15371,2022-05-23 10:55:00,-1169.94,225134.0600000006,244172.18000000066,-19038.120000000054
15372,2022-05-23 11:00:00,1991.23,227125.29000000062,244172.18000000066,-17046.890000000043
15373,2022-05-23 11:05:00,-646.15,226479.14000000063,244172.18000000066,-17693.040000000037
15374,2022-05-23 11:10:00,-733.65,225745.49000000063,244172.18000000066,-18426.69000000003
15375,2022-05-23 11:15:00,-839.1,224906.39000000063,244172.18000000066,-19265.790000000037
15376,2022-05-23 11:20:00,1173.65,226080.04000000062,244172.18000000066,-18092.140000000043
15377,2022-05-23 11:25:00,-1206.78,224873.26000000062,244172.18000000066,-19298.920000000042
15378,2022-05-23 11:30:00,-812.29,224060.9700000006,244172.18000000066,-20111.21000000005
15379,2022-05-23 11:35:00,-229.91,223831.0600000006,244172.18000000066,-20341.120000000054
15380,2022-05-23 11:40:00,340.93,224171.9900000006,244172.18000000066,-20000.19000000006
15381,2022-05-23 11:45:00,-1339.99,222832.0000000006,244172.18000000066,-21340.18000000005
15382,2022-05-23 11:50:00,-991.31,221840.6900000006,244172.18000000066,-22331.49000000005
15383,2022-05-23 11:55:00,1087.47,222928.16000000061,244172.18000000066,-21244.020000000048
15384,2022-05-23 12:00:00,537.86,223466.0200000006,244172.18000000066,-20706.16000000006
15385,2022-05-23 12:05:00,1069.36,224535.3800000006,244172.18000000066,-19636.800000000076
15386,2022-05-23 12:10:00,-196.97,224338.4100000006,244172.18000000066,-19833.770000000077
15387,2022-05-23 12:15:00,65.04,224403.4500000006,244172.18000000066,-19768.73000000007
15388,2022-05-23 12:20:00,-1834.24,222569.2100000006,244172.18000000066,-21602.97000000006
15389,2022-05-23 12:25:00,1115.47,223684.6800000006,244172.18000000066,-20487.50000000006
15390,2022-05-23 12:30:00,34.67,223719.35000000062,244172.18000000066,-20452.830000000045
15391,2022-05-23 12:35:00,456.99,224176.3400000006,244172.18000000066,-19995.840000000055
15392,2022-05-23 12:40:00,954.59,225130.9300000006,244172.18000000066,-19041.25000000006
15393,2022-05-23 12:45:00,-1001.22,224129.7100000006,244172.18000000066,-20042.47000000006
15394,2022-05-23 12:50:00,-768.14,223361.5700000006,244172.18000000066,-20810.610000000073
15395,2022-05-23 12:55:00,498.33,223859.90000000058,244172.18000000066,-20312.280000000086
15396,2022-05-23 13:00:00,146.85,224006.75000000058,244172.18000000066,-20165.43000000008
15397,2022-05-23 13:05:00,913.99,224920.74000000057,244172.18000000066,-19251.44000000009
15398,2022-05-23 13:10:00,19.27,224940.01000000056,244172.18000000066,-19232.1700000001
15399,2022-05-23 13:15:00,-827.72,224112.29000000056,244172.18000000066,-20059.8900000001
15400,2022-05-23 13:20:00,-973.46,223138.83000000057,244172.18000000066,-21033.350000000093
15401,2022-05-23 13:25:00,-326.79,222812.04000000056,244172.18000000066,-21360.1400000001
15402,2022-05-23 13:30:00,151.36,222963.40000000055,244172.18000000066,-21208.780000000115
15403,2022-05-23 13:35:00,-1249.68,221713.72000000055,244172.18000000066,-22458.46000000011
15404,2022-05-23 13:40:00,-139.52,221574.20000000056,244172.18000000066,-22597.980000000098
15405,2022-05-23 13:45:00,1162.0,222736.20000000056,244172.18000000066,-21435.980000000098
15406,2022-05-23 13:50:00,403.68,223139.88000000056,244172.18000000066,-21032.300000000105
15407,2022-05-23 13:55:00,-1510.03,221629.85000000056,244172.18000000066,-22542.330000000104
15408,2022-05-23 14:00:00,-1147.67,220482.18000000055,244172.18000000066,-23690.000000000116
15409,2022-05-23 14:05:00,1529.23,222011.41000000056,244172.18000000066,-22160.770000000106
15410,2022-05-23 14:10:00,1105.09,223116.50000000055,244172.18000000066,-21055.68000000011
15411,2022-05-23 14:15:00,547.51,223664.01000000056,244172.18000000066,-20508.1700000001
15412,2022-05-23 14:20:00,985.36,224649.37000000055,244172.18000000066,-19522.810000000114
15413,2022-05-23 14:25:00,-1992.96,222656.41000000056,244172.18000000066,-21515.770000000106
15414,2022-05-23 14:30:00,-1168.19,221488.22000000055,244172.18000000066,-22683.96000000011
15415,2022-05-23 14:35:00,1812.83,223301.05000000054,244172.18000000066,-20871.13000000012
15416,2022-05-23 14:40:00,353.51,223654.56000000055,244172.18000000066,-20517.62000000011
15417,2022-05-23 14:45:00,1515.53,225170.09000000055,244172.18000000066,-19002.090000000113
15418,2022-05-23 14:50:00,-160.41,225009.68000000055,244172.18000000066,-19162.500000000116
15419,2022-05-23 14:55:00,1774.28,226783.96000000054,244172.18000000066,-17388.220000000118
15420,2022-05-23 15:00:00,232.3,227016.26000000053,244172.18000000066,-17155.92000000013
15421,2022-05-23 15:05:00,738.71,227754.97000000053,244172.18000000066,-16417.210000000137
15422,2022-05-23 15:10:00,-696.67,227058.3000000005,244172.18000000066,-17113.88000000015
15423,2022-05-23 15:15:00,-201.89,226856.4100000005,244172.18000000066,-17315.770000000164
15424,2022-05-23 15:20:00,440.62,227297.0300000005,244172.18000000066,-16875.15000000017
15425,2022-05-23 15:25:00,1975.19,229272.2200000005,244172.18000000066,-14899.960000000166
15426,2022-05-23 15:30:00,1130.03,230402.2500000005,244172.18000000066,-13769.930000000168
15427,2022-05-23 15:35:00,-1182.5,229219.7500000005,244172.18000000066,-14952.430000000168
15428,2022-05-23 15:40:00,-1210.98,228008.77000000048,244172.18000000066,-16163.410000000178
15429,2022-05-23 15:45:00,-419.28,227589.4900000005,244172.18000000066,-16582.690000000177
15430,2022-05-23 15:50:00,-1070.56,226518.9300000005,244172.18000000066,-17653.250000000175
15431,2022-05-23 15:55:00,-1928.35,224590.58000000048,244172.18000000066,-19581.60000000018
15432,2022-05-23 16:00:00,1497.13,226087.7100000005,244172.18000000066,-18084.470000000176
15433,2022-05-23 16:05:00,1792.01,227879.7200000005,244172.18000000066,-16292.460000000166
15434,2022-05-23 16:10:00,-1708.92,226170.80000000048,244172.18000000066,-18001.38000000018
15435,2022-05-23 16:15:00,1007.83,227178.63000000047,244172.18000000066,-16993.550000000192
15436,2022-05-23 16:20:00,-298.35,226880.28000000046,244172.18000000066,-17291.900000000198
15437,2022-05-23 16:25:00,1459.78,228340.06000000046,244172.18000000066,-15832.120000000199
15438,2022-05-23 16:30:00,-464.02,227876.04000000047,244172.18000000066,-16296.140000000189
15439,2022-05-23 16:35:00,-1867.32,226008.72000000047,244172.18000000066,-18163.460000000196
15440,2022-05-23 16:40:00,1868.57,227877.29000000047,244172.18000000066,-16294.890000000189
15441,2022-05-23 16:45:00,1152.98,229030.27000000048,244172.18000000066,-15141.910000000178
15442,2022-05-23 16:50:00,-594.18,228436.0900000005,244172.18000000066,-15736.090000000171
15443,2022-05-23 16:55:00,588.72,229024.8100000005,244172.18000000066,-15147.37000000017
15444,2022-05-24 08:00:00,1616.67,230641.4800000005,229024.8100000005,1616.6700000000128
15445,2022-05-24 08:05:00,-151.82,230489.6600000005,229024.8100000005,1464.8500000000058
15446,2022-05-24 08:10:00,766.99,231256.6500000005,229024.8100000005,2231.8399999999965
15447,2022-05-24 08:15:00,1173.54,232430.1900000005,229024.8100000005,3405.3800000000047
15448,2022-05-24 08:20:00,-631.18,231799.0100000005,229024.8100000005,2774.2000000000116
15449,2022-05-24 08:25:00,1985.73,233784.74000000051,229024.8100000005,4759.930000000022
15450,2022-05-24 08:30:00,-1236.31,232548.43000000052,229024.8100000005,3523.6200000000244
15451,2022-05-24 08:35:00,-1880.16,230668.2700000005,229024.8100000005,1643.460000000021
15452,2022-05-24 08:40:00,459.41,231127.68000000052,229024.8100000005,2102.8700000000244
15453,2022-05-24 08:45:00,-310.5,230817.18000000052,229024.8100000005,1792.3700000000244
15454,2022-05-24 08:50:00,856.14,231673.32000000053,229024.8100000005,2648.5100000000384
15455,2022-05-24 08:55:00,1602.63,233275.95000000054,229024.8100000005,4251.140000000043
15456,2022-05-24 09:00:00,758.6,234034.55000000054,229024.8100000005,5009.740000000049
15457,2022-05-24 09:05:00,1984.85,236019.40000000055,229024.8100000005,6994.590000000055
15458,2022-05-24 09:10:00,514.0,236533.40000000055,229024.8100000005,7508.590000000055
15459,2022-05-24 09:15:00,0.06,236533.46000000054,229024.8100000005,7508.650000000052
15460,2022-05-24 09:20:00,-183.58,236349.88000000056,229024.8100000005,7325.070000000065
15461,2022-05-24 09:25:00,796.18,237146.06000000055,229024.8100000005,8121.250000000058
15462,2022-05-24 09:30:00,-1993.7,235152.36000000054,229024.8100000005,6127.550000000047
15463,2022-05-24 09:35:00,541.2,235693.56000000055,229024.8100000005,6668.750000000058
15464,2022-05-24 09:40:00,1194.69,236888.25000000055,229024.8100000005,7863.4400000000605
15465,2022-05-24 09:45:00,-201.42,236686.83000000054,229024.8100000005,7662.020000000048
15466,2022-05-24 09:50:00,1514.24,238201.07000000053,229024.8100000005,9176.260000000038
15467,2022-05-24 09:55:00,1556.16,239757.23000000053,229024.8100000005,10732.420000000042
15468,2022-05-24 10:00:00,-207.6,239549.63000000053,229024.8100000005,10524.820000000036
15469,2022-05-24 10:05:00,-163.72,239385.91000000053,229024.8100000005,10361.100000000035
15470,2022-05-24 10:10:00,-38.72,239347.19000000053,229024.8100000005,10322.380000000034
15471,2022-05-24 10:15:00,1049.38,240396.57000000053,229024.8100000005,11371.760000000038
15472,2022-05-24 10:20:00,894.91,241291.48000000053,229024.8100000005,12266.670000000042
15473,2022-05-24 10:25:00,1404.8,242696.28000000052,229024.8100000005,13671.47000000003
15474,2022-05-24 10:30:00,-1041.97,241654.31000000052,229024.8100000005,12629.50000000003
15475,2022-05-24 10:35:00,1867.01,243521.32000000053,229024.8100000005,14496.510000000038
15476,2022-05-24 10:40:00,-327.05,243194.27000000054,229024.8100000005,14169.46000000005
15477,2022-05-24 10:45:00,-1146.37,242047.90000000055,229024.8100000005,13023.090000000055
15478,2022-05-24 10:50:00,1245.41,243293.31000000055,229024.8100000005,14268.500000000058
15479,2022-05-24 10:55:00,1780.64,245073.95000000056,229024.8100000005,16049.140000000072
15480,2022-05-24 11:00:00,1166.8,246240.75000000055,229024.8100000005,17215.94000000006
15481,2022-05-24 11:05:00,831.73,247072.48000000056,229024.8100000005,18047.67000000007
15482,2022-05-24 11:10:00,-254.58,246817.90000000058,229024.8100000005,17793.090000000084
15483,2022-05-24 11:15:00,1175.95,247993.8500000006,229024.8100000005,18969.040000000095
15484,2022-05-24 11:20:00,1436.9,249430.75000000058,229024.8100000005,20405.94000000009
15485,2022-05-24 11:25:00,-688.64,248742.11000000057,229024.8100000005,19717.300000000076
15486,2022-05-24 11:30:00,1517.91,250260.02000000057,229024.8100000005,21235.21000000008
15487,2022-05-24 11:35:00,1057.49,251317.51000000056,229024.8100000005,22292.70000000007
15488,2022-05-24 11:40:00,1098.88,252416.39000000057,229024.8100000005,23391.580000000075
15489,2022-05-24 11:45:00,-173.88,252242.51000000056,229024.8100000005,23217.70000000007
15490,2022-05-24 11:50:00,271.89,252514.40000000058,229024.8100000005,23489.590000000084
15491,2022-05-24 11:55:00,1556.41,254070.81000000058,229024.8100000005,25046.000000000087
15492,2022-05-24 12:00:00,-1423.16,252647.65000000058,229024.8100000005,23622.840000000084
15493,2022-05-24 12:05:00,1063.62,253711.27000000057,229024.8100000005,24686.46000000008
15494,2022-05-24 12:10:00,1928.27,255639.54000000056,229024.8100000005,26614.73000000007
15495,2022-05-24 12:15:00,502.01,256141.55000000057,229024.8100000005,27116.740000000078
15496,2022-05-24 12:20:00,1105.13,257246.68000000058,229024.8100000005,28221.870000000083
15497,2022-05-24 12:25:00,-1910.15,255336.53000000058,229024.8100000005,26311.72000000009
15498,2022-05-24 12:30:00,1330.15,256666.68000000058,229024.8100000005,27641.870000000083
15499,2022-05-24 12:35:00,783.73,257450.4100000006,229024.8100000005,28425.600000000093
15500,2022-05-24 12:40:00,1765.55,259215.96000000057,229024.8100000005,30191.15000000008
15501,2022-05-24 12:45:00,614.46,259830.42000000057,229024.8100000005,30805.610000000073
15502,2022-05-24 12:50:00,-1048.86,258781.56000000058,229024.8100000005,29756.750000000087
15503,2022-05-24 12:55:00,-707.2,258074.36000000057,229024.8100000005,29049.550000000076
15504,2022-05-24 13:00:00,-986.89,257087.47000000055,229024.8100000005,28062.66000000006
15505,2022-05-24 13:05:00,1617.85,258705.32000000056,229024.8100000005,29680.510000000068
15506,2022-05-24 13:10:00,128.01,258833.33000000057,229024.8100000005,29808.520000000077
15507,2022-05-24 13:15:00,-1357.67,257475.66000000056,229024.8100000005,28450.850000000064
15508,2022-05-24 13:20:00,664.18,258139.84000000055,229024.8100000005,29115.030000000057
15509,2022-05-24 13:25:00,1443.31,259583.15000000055,229024.8100000005,30558.340000000055
15510,2022-05-24 13:30:00,1898.1,261481.25000000055,229024.8100000005,32456.44000000006
15511,2022-05-24 13:35:00,230.23,261711.48000000056,229024.8100000005,32686.67000000007
15512,2022-05-24 13:40:00,986.27,262697.7500000006,229024.8100000005,33672.94000000009
15513,2022-05-24 13:45:00,-1811.34,260886.4100000006,229024.8100000005,31861.600000000093
15514,2022-05-24 13:50:00,-28.37,260858.0400000006,229024.8100000005,31833.230000000098
15515,2022-05-24 13:55:00,1603.17,262461.2100000006,229024.8100000005,33436.40000000011
15516,2022-05-24 14:00:00,188.46,262649.6700000006,229024.8100000005,33624.86000000013
15517,2022-05-24 14:05:00,-391.91,262257.76000000065,229024.8100000005,33232.95000000016
15518,2022-05-24 14:10:00,-965.96,261291.80000000066,229024.8100000005,32266.990000000165
15519,2022-05-24 14:15:00,1884.46,263176.26000000065,229024.8100000005,34151.45000000016
15520,2022-05-24 14:20:00,944.41,264120.6700000006,229024.8100000005,35095.86000000013
15521,2022-05-24 14:25:00,1052.75,265173.4200000006,229024.8100000005,36148.61000000013
15522,2022-05-24 14:30:00,761.62,265935.0400000006,229024.8100000005,36910.23000000013
15523,2022-05-24 14:35:00,-1409.48,264525.56000000064,229024.8100000005,35500.750000000146
15524,2022-05-24 14:40:00,1751.66,266277.2200000006,229024.8100000005,37252.41000000012
15525,2022-05-24 14:45:00,1572.89,267850.1100000006,229024.8100000005,38825.300000000134
15526,2022-05-24 14:50:00,-420.6,267429.51000000065,229024.8100000005,38404.70000000016
15527,2022-05-24 14:55:00,1130.95,268560.46000000066,229024.8100000005,39535.65000000017
15528,2022-05-24 15:00:00,1171.14,269731.6000000007,229024.8100000005,40706.79000000018
15529,2022-05-24 15:05:00,1570.99,271302.59000000067,229024.8100000005,42277.78000000017
15530,2022-05-24 15:10:00,-1698.35,269604.2400000007,229024.8100000005,40579.4300000002
15531,2022-05-24 15:15:00,-1557.74,268046.5000000007,229024.8100000005,39021.690000000206
15532,2022-05-24 15:20:00,1188.37,269234.8700000007,229024.8100000005,40210.0600000002
15533,2022-05-24 15:25:00,708.57,269943.4400000007,229024.8100000005,40918.63000000021
15534,2022-05-24 15:30:00,1874.33,271817.7700000007,229024.8100000005,42792.960000000225
15535,2022-05-24 15:35:00,169.39,271987.16000000073,229024.8100000005,42962.35000000024
15536,2022-05-24 15:40:00,1433.23,273420.3900000007,229024.8100000005,44395.58000000022
15537,2022-05-24 15:45:00,611.16,274031.5500000007,229024.8100000005,45006.740000000194
15538,2022-05-24 15:50:00,913.73,274945.28000000067,229024.8100000005,45920.470000000176
15539,2022-05-24 15:55:00,-1284.0,273661.28000000067,229024.8100000005,44636.470000000176
15540,2022-05-24 16:00:00,-1652.2,272009.08000000066,229024.8100000005,42984.270000000164
15541,2022-05-24 16:05:00,-1179.56,270829.52000000066,229024.8100000005,41804.71000000017
15542,2022-05-24 16:10:00,1650.42,272479.94000000064,229024.8100000005,43455.13000000015
15543,2022-05-24 16:15:00,83.41,272563.3500000006,229024.8100000005,43538.540000000125
15544,2022-05-24 16:20:00,-307.07,272256.2800000006,229024.8100000005,43231.47000000012
15545,2022-05-24 16:25:00,-1267.33,270988.9500000006,229024.8100000005,41964.1400000001
15546,2022-05-24 16:30:00,-1121.75,269867.2000000006,229024.8100000005,40842.3900000001
15547,2022-05-24 16:35:00,-1656.32,268210.8800000006,229024.8100000005,39186.070000000094
15548,2022-05-24 16:40:00,669.78,268880.6600000006,229024.8100000005,39855.85000000012
15549,2022-05-24 16:45:00,-509.87,268370.7900000006,229024.8100000005,39345.98000000013
15550,2022-05-24 16:50:00,1178.95,269549.74000000063,229024.8100000005,40524.93000000014
15551,2022-05-24 16:55:00,-833.89,268715.8500000006,229024.8100000005,39691.040000000125
15552,2022-05-25 08:00:00,-1042.84,267673.0100000006,268715.8500000006,-1042.8400000000256
15553,2022-05-25 08:05:00,961.34,268634.3500000006,268715.8500000006,-81.5
15554,2022-05-25 08:10:00,-1535.41,267098.94000000064,268715.8500000006,-1616.9099999999744
15555,2022-05-25 08:15:00,1887.04,268985.9800000006,268715.8500000006,270.13000000000466
15556,2022-05-25 08:20:00,-1026.3,267959.68000000063,268715.8500000006,-756.1699999999837
15557,2022-05-25 08:25:00,-1206.41,266753.27000000066,268715.8500000006,-1962.579999999958
15558,2022-05-25 08:30:00,-658.23,266095.0400000007,268715.8500000006,-2620.8099999999395
15559,2022-05-25 08:35:00,1584.63,267679.6700000007,268715.8500000006,-1036.1799999999348
15560,2022-05-25 08:40:00,862.55,268542.22000000067,268715.8500000006,-173.62999999994645
15561,2022-05-25 08:45:00,-283.77,268258.45000000065,268715.8500000006,-457.3999999999651
15562,2022-05-25 08:50:00,1754.03,270012.4800000007,268715.8500000006,1296.6300000000629
15563,2022-05-25 08:55:00,609.81,270622.2900000007,268715.8500000006,1906.4400000000605
15564,2022-05-25 09:00:00,-1317.1,269305.1900000007,268715.8500000006,589.3400000000838
15565,2022-05-25 09:05:00,-555.87,268749.3200000007,268715.8500000006,33.470000000088476
15566,2022-05-25 09:10:00,-23.28,268726.0400000007,268715.8500000006,10.190000000060536
15567,2022-05-25 09:15:00,51.07,268777.1100000007,268715.8500000006,61.26000000006752
15568,2022-05-25 09:20:00,170.99,268948.1000000007,268715.8500000006,232.2500000000582
15569,2022-05-25 09:25:00,-1175.47,267772.6300000007,268715.8500000006,-943.2199999999139
15570,2022-05-25 09:30:00,-1323.87,266448.7600000007,268715.8500000006,-2267.089999999909
15571,2022-05-25 09:35:00,1174.5,267623.2600000007,268715.8500000006,-1092.5899999999092
15572,2022-05-25 09:40:00,-537.21,267086.0500000007,268715.8500000006,-1629.7999999999302
15573,2022-05-25 09:45:00,-908.97,266177.0800000007,268715.8500000006,-2538.769999999902
15574,2022-05-25 09:50:00,-191.37,265985.7100000007,268715.8500000006,-2730.1399999998976
15575,2022-05-25 09:55:00,-1822.04,264163.67000000074,268715.8500000006,-4552.179999999877
15576,2022-05-25 10:00:00,-337.89,263825.7800000007,268715.8500000006,-4890.069999999891
15577,2022-05-25 10:05:00,1699.68,265525.4600000007,268715.8500000006,-3190.3899999998976
15578,2022-05-25 10:10:00,1830.93,267356.3900000007,268715.8500000006,-1359.4599999999045
15579,2022-05-25 10:15:00,-544.95,266811.4400000007,268715.8500000006,-1904.4099999999162
15580,2022-05-25 10:20:00,961.01,267772.4500000007,268715.8500000006,-943.3999999999069
15581,2022-05-25 10:25:00,-1575.67,266196.7800000007,268715.8500000006,-2519.0699999998906
15582,2022-05-25 10:30:00,-489.72,265707.06000000075,268715.8500000006,-3008.7899999998626
15583,2022-05-25 10:35:00,-1987.35,263719.7100000008,268715.8500000006,-4996.139999999839
15584,2022-05-25 10:40:00,-895.24,262824.4700000008,268715.8500000006,-5891.37999999983
15585,2022-05-25 10:45:00,1206.56,264031.0300000008,268715.8500000006,-4684.819999999832
15586,2022-05-25 10:50:00,1858.36,265889.39000000077,268715.8500000006,-2826.4599999998463
15587,2022-05-25 10:55:00,1895.84,267785.2300000008,268715.8500000006,-930.6199999998207
15588,2022-05-25 11:00:00,779.28,268564.5100000008,268715.8500000006,-151.33999999979278
15589,2022-05-25 11:05:00,1837.82,270402.33000000083,268715.8500000006,1686.4800000002142
15590,2022-05-25 11:10:00,-670.82,269731.5100000008,268715.8500000006,1015.6600000002072
15591,2022-05-25 11:15:00,-298.3,269433.21000000084,268715.8500000006,717.3600000002189
15592,2022-05-25 11:20:00,-867.25,268565.96000000084,268715.8500000006,-149.88999999978114
15593,2022-05-25 11:25:00,-1538.78,267027.1800000008,268715.8500000006,-1688.669999999809
15594,2022-05-25 11:30:00,1841.84,268869.02000000083,268715.8500000006,153.17000000021653
15595,2022-05-25 11:35:00,-1581.34,267287.6800000008,268715.8500000006,-1428.169999999809
15596,2022-05-25 11:40:00,-847.63,266440.0500000008,268715.8500000006,-2275.7999999998137
15597,2022-05-25 11:45:00,367.51,266807.5600000008,268715.8500000006,-1908.2899999998044
15598,2022-05-25 11:50:00,437.0,267244.5600000008,268715.8500000006,-1471.2899999998044
15599,2022-05-25 11:55:00,-1909.22,265335.34000000084,268715.8500000006,-3380.5099999997765
15600,2022-05-25 12:00:00,-99.29,265236.05000000086,268715.8500000006,-3479.7999999997555
15601,2022-05-25 12:05:00,-740.42,264495.6300000009,268715.8500000006,-4220.219999999739
15602,2022-05-25 12:10:00,909.11,265404.74000000086,268715.8500000006,-3311.109999999753
15603,2022-05-25 12:15:00,-337.4,265067.34000000084,268715.8500000006,-3648.5099999997765
15604,2022-05-25 12:20:00,-683.98,264383.36000000086,268715.8500000006,-4332.489999999758
15605,2022-05-25 12:25:00,329.8,264713.16000000085,268715.8500000006,-4002.6899999997695
15606,2022-05-25 12:30:00,-1552.38,263160.78000000084,268715.8500000006,-5555.069999999774
15607,2022-05-25 12:35:00,134.57,263295.35000000085,268715.8500000006,-5420.499999999767
15608,2022-05-25 12:40:00,-1234.93,262060.42000000086,268715.8500000006,-6655.42999999976
15609,2022-05-25 12:45:00,931.32,262991.74000000086,268715.8500000006,-5724.109999999753
15610,2022-05-25 12:50:00,1125.93,264117.67000000086,268715.8500000006,-4598.17999999976
15611,2022-05-25 12:55:00,1997.18,266114.85000000085,268715.8500000006,-2600.999999999767
15612,2022-05-25 13:00:00,1169.54,267284.3900000008,268715.8500000006,-1431.4599999997881
15613,2022-05-25 13:05:00,1029.32,268313.71000000084,268715.8500000006,-402.13999999978114
15614,2022-05-25 13:10:00,158.33,268472.04000000085,268715.8500000006,-243.80999999976484
15615,2022-05-25 13:15:00,-1177.49,267294.55000000086,268715.8500000006,-1421.2999999997555
15616,2022-05-25 13:20:00,-953.09,266341.46000000084,268715.8500000006,-2374.389999999781
15617,2022-05-25 13:25:00,1221.69,267563.15000000084,268715.8500000006,-1152.6999999997788
15618,2022-05-25 13:30:00,1831.68,269394.83000000083,268715.8500000006,678.9800000002142
15619,2022-05-25 13:35:00,1851.91,271246.7400000008,268715.8500000006,2530.8900000001886
15620,2022-05-25 13:40:00,250.24,271496.9800000008,268715.8500000006,2781.1300000001793
15621,2022-05-25 13:45:00,1497.46,272994.4400000008,268715.8500000006,4278.5900000002
15622,2022-05-25 13:50:00,571.56,273566.0000000008,268715.8500000006,4850.150000000198
15623,2022-05-25 13:55:00,780.51,274346.5100000008,268715.8500000006,5630.660000000207
15624,2022-05-25 14:00:00,627.1,274973.6100000008,268715.8500000006,6257.760000000184
15625,2022-05-25 14:05:00,1739.72,276713.3300000008,268715.8500000006,7997.480000000156
15626,2022-05-25 14:10:00,-1090.47,275622.8600000008,268715.8500000006,6907.010000000184
15627,2022-05-25 14:15:00,-1956.38,273666.4800000008,268715.8500000006,4950.630000000179
15628,2022-05-25 14:20:00,-222.36,273444.1200000008,268715.8500000006,4728.270000000193
15629,2022-05-25 14:25:00,-1428.31,272015.8100000008,268715.8500000006,3299.9600000001956
15630,2022-05-25 14:30:00,1796.03,273811.84000000084,268715.8500000006,5095.9900000002235
15631,2022-05-25 14:35:00,-1193.65,272618.1900000008,268715.8500000006,3902.3400000002002
15632,2022-05-25 14:40:00,-39.64,272578.5500000008,268715.8500000006,3862.7000000001863
15633,2022-05-25 14:45:00,1936.89,274515.4400000008,268715.8500000006,5799.5900000002
15634,2022-05-25 14:50:00,-1801.98,272713.46000000084,268715.8500000006,3997.610000000219
15635,2022-05-25 14:55:00,139.85,272853.3100000008,268715.8500000006,4137.460000000196
15636,2022-05-25 15:00:00,-358.5,272494.8100000008,268715.8500000006,3778.9600000001956
15637,2022-05-25 15:05:00,1855.83,274350.6400000008,268715.8500000006,5634.790000000212
15638,2022-05-25 15:10:00,1551.91,275902.5500000008,268715.8500000006,7186.700000000186
15639,2022-05-25 15:15:00,1307.57,277210.1200000008,268715.8500000006,8494.270000000193
15640,2022-05-25 15:20:00,1736.17,278946.2900000008,268715.8500000006,10230.440000000177
15641,2022-05-25 15:25:00,-872.94,278073.3500000008,268715.8500000006,9357.500000000175
15642,2022-05-25 15:30:00,-1277.3,276796.0500000008,268715.8500000006,8080.200000000186
15643,2022-05-25 15:35:00,-569.38,276226.6700000008,268715.8500000006,7510.820000000182
15644,2022-05-25 15:40:00,-1860.18,274366.4900000008,268715.8500000006,5650.640000000189
15645,2022-05-25 15:45:00,-996.44,273370.0500000008,268715.8500000006,4654.200000000186
15646,2022-05-25 15:50:00,-1796.36,271573.6900000008,268715.8500000006,2857.8400000002002
15647,2022-05-25 15:55:00,1739.78,273313.47000000085,268715.8500000006,4597.620000000228
15648,2022-05-25 16:00:00,996.1,274309.5700000008,268715.8500000006,5593.720000000205
15649,2022-05-25 16:05:00,1205.01,275514.58000000083,268715.8500000006,6798.730000000214
15650,2022-05-25 16:10:00,-88.12,275426.46000000084,268715.8500000006,6710.610000000219
15651,2022-05-25 16:15:00,-913.98,274512.48000000085,268715.8500000006,5796.6300000002375
15652,2022-05-25 16:20:00,-725.6,273786.8800000009,268715.8500000006,5071.030000000261
15653,2022-05-25 16:25:00,-273.99,273512.8900000009,268715.8500000006,4797.04000000027
15654,2022-05-25 16:30:00,-1125.02,272387.87000000087,268715.8500000006,3672.0200000002515
15655,2022-05-25 16:35:00,-484.55,271903.3200000009,268715.8500000006,3187.470000000263
15656,2022-05-25 16:40:00,-1440.34,270462.98000000085,268715.8500000006,1747.1300000002375
15657,2022-05-25 16:45:00,-861.83,269601.15000000084,268715.8500000006,885.3000000002212
15658,2022-05-25 16:50:00,-264.76,269336.3900000008,268715.8500000006,620.5400000002119
15659,2022-05-25 16:55:00,34.6,269370.9900000008,268715.8500000006,655.1400000001886
15660,2022-05-26 08:00:00,1952.85,271323.8400000008,269370.9900000008,1952.8499999999767
15661,2022-05-26 08:05:00,1884.26,273208.1000000008,269370.9900000008,3837.109999999986
15662,2022-05-26 08:10:00,-122.58,273085.5200000008,269370.9900000008,3714.5299999999697
15663,2022-05-26 08:15:00,-94.21,272991.31000000075,269370.9900000008,3620.319999999949
15664,2022-05-26 08:20:00,-1529.19,271462.12000000075,269370.9900000008,2091.1299999999464
15665,2022-05-26 08:25:00,-1735.08,269727.04000000074,269370.9900000008,356.04999999993015
15666,2022-05-26 08:30:00,-490.45,269236.5900000007,269370.9900000008,-134.4000000000815
15667,2022-05-26 08:35:00,-1339.1,267897.49000000075,269370.9900000008,-1473.5000000000582
15668,2022-05-26 08:40:00,736.81,268634.30000000075,269370.9900000008,-736.6900000000605
15669,2022-05-26 08:45:00,1286.65,269920.95000000077,269370.9900000008,549.9599999999627
15670,2022-05-26 08:50:00,-293.89,269627.06000000075,269370.9900000008,256.0699999999488
15671,2022-05-26 08:55:00,811.63,270438.69000000076,269370.9900000008,1067.6999999999534
15672,2022-05-26 09:00:00,1647.79,272086.48000000074,269370.9900000008,2715.4899999999325
15673,2022-05-26 09:05:00,-603.7,271482.7800000007,269370.9900000008,2111.789999999921
15674,2022-05-26 09:10:00,-457.61,271025.17000000074,269370.9900000008,1654.1799999999348
15675,2022-05-26 09:15:00,131.9,271157.07000000076,269370.9900000008,1786.079999999958
15676,2022-05-26 09:20:00,-958.54,270198.5300000008,269370.9900000008,827.539999999979
15677,2022-05-26 09:25:00,395.4,270593.9300000008,269370.9900000008,1222.9400000000023
15678,2022-05-26 09:30:00,622.09,271216.02000000083,269370.9900000008,1845.030000000028
15679,2022-05-26 09:35:00,1535.02,272751.04000000085,269370.9900000008,3380.0500000000466
15680,2022-05-26 09:40:00,-660.75,272090.29000000085,269370.9900000008,2719.3000000000466
15681,2022-05-26 09:45:00,-1100.96,270989.33000000083,269370.9900000008,1618.3400000000256
15682,2022-05-26 09:50:00,1030.5,272019.83000000083,269370.9900000008,2648.8400000000256
15683,2022-05-26 09:55:00,-1053.63,270966.2000000008,269370.9900000008,1595.210000000021
15684,2022-05-26 10:00:00,1760.77,272726.97000000085,269370.9900000008,3355.9800000000396
15685,2022-05-26 10:05:00,-1153.13,271573.84000000084,269370.9900000008,2202.850000000035
15686,2022-05-26 10:10:00,666.59,272240.43000000087,269370.9900000008,2869.4400000000605
15687,2022-05-26 10:15:00,557.97,272798.40000000084,269370.9900000008,3427.4100000000326
15688,2022-05-26 10:20:00,699.47,273497.8700000008,269370.9900000008,4126.880000000005
15689,2022-05-26 10:25:00,-381.08,273116.7900000008,269370.9900000008,3745.7999999999884
15690,2022-05-26 10:30:00,608.21,273725.0000000008,269370.9900000008,4354.010000000009
15691,2022-05-26 10:35:00,403.42,274128.4200000008,269370.9900000008,4757.429999999993
15692,2022-05-26 10:40:00,1023.15,275151.5700000008,269370.9900000008,5780.580000000016
15693,2022-05-26 10:45:00,-579.19,274572.3800000008,269370.9900000008,5201.390000000014
15694,2022-05-26 10:50:00,437.78,275010.16000000085,269370.9900000008,5639.170000000042
15695,2022-05-26 10:55:00,557.25,275567.41000000085,269370.9900000008,6196.420000000042
15696,2022-05-26 11:00:00,-835.63,274731.78000000084,269370.9900000008,5360.790000000037
15697,2022-05-26 11:05:00,-397.36,274334.42000000086,269370.9900000008,4963.430000000051
15698,2022-05-26 11:10:00,848.23,275182.65000000084,269370.9900000008,5811.660000000033
15699,2022-05-26 11:15:00,-983.63,274199.02000000083,269370.9900000008,4828.030000000028
15700,2022-05-26 11:20:00,383.37,274582.3900000008,269370.9900000008,5211.400000000023
15701,2022-05-26 11:25:00,-1889.53,272692.8600000008,269370.9900000008,3321.8699999999953
15702,2022-05-26 11:30:00,-120.48,272572.3800000008,269370.9900000008,3201.390000000014
15703,2022-05-26 11:35:00,-741.64,271830.7400000008,269370.9900000008,2459.75
15704,2022-05-26 11:40:00,-50.53,271780.2100000008,269370.9900000008,2409.219999999972
15705,2022-05-26 11:45:00,-31.18,271749.0300000008,269370.9900000008,2378.039999999979
15706,2022-05-26 11:50:00,1452.41,273201.44000000076,269370.9900000008,3830.4499999999534
15707,2022-05-26 11:55:00,994.68,274196.12000000075,269370.9900000008,4825.129999999946
15708,2022-05-26 12:00:00,-272.3,273923.82000000076,269370.9900000008,4552.829999999958
15709,2022-05-26 12:05:00,1583.59,275507.4100000008,269370.9900000008,6136.419999999984
15710,2022-05-26 12:10:00,-710.81,274796.6000000008,269370.9900000008,5425.609999999986
15711,2022-05-26 12:15:00,157.48,274954.0800000008,269370.9900000008,5583.089999999967
15712,2022-05-26 12:20:00,-1329.05,273625.0300000008,269370.9900000008,4254.039999999979
15713,2022-05-26 12:25:00,-378.01,273247.0200000008,269370.9900000008,3876.0299999999697
15714,2022-05-26 12:30:00,63.56,273310.5800000008,269370.9900000008,3939.5899999999674
15715,2022-05-26 12:35:00,1655.9,274966.4800000008,269370.9900000008,5595.489999999991
15716,2022-05-26 12:40:00,-565.73,274400.7500000008,269370.9900000008,5029.760000000009
15717,2022-05-26 12:45:00,-1362.57,273038.1800000008,269370.9900000008,3667.1900000000023
15718,2022-05-26 12:50:00,1527.05,274565.2300000008,269370.9900000008,5194.239999999991
15719,2022-05-26 12:55:00,-1132.68,273432.5500000008,269370.9900000008,4061.5599999999977
15720,2022-05-26 13:00:00,292.16,273724.7100000008,269370.9900000008,4353.719999999972
15721,2022-05-26 13:05:00,546.28,274270.9900000008,269370.9900000008,4900.0
15722,2022-05-26 13:10:00,1103.46,275374.4500000008,269370.9900000008,6003.460000000021
15723,2022-05-26 13:15:00,299.63,275674.08000000083,269370.9900000008,6303.090000000026
15724,2022-05-26 13:20:00,-385.9,275288.1800000008,269370.9900000008,5917.190000000002
15725,2022-05-26 13:25:00,1731.91,277020.0900000008,269370.9900000008,7649.099999999977
15726,2022-05-26 13:30:00,-534.83,276485.26000000077,269370.9900000008,7114.26999999996
15727,2022-05-26 13:35:00,1775.55,278260.81000000075,269370.9900000008,8889.819999999949
15728,2022-05-26 13:40:00,1345.92,279606.73000000074,269370.9900000008,10235.739999999932
15729,2022-05-26 13:45:00,-1736.88,277869.85000000073,269370.9900000008,8498.859999999928
15730,2022-05-26 13:50:00,-1496.03,276373.8200000007,269370.9900000008,7002.8299999999
15731,2022-05-26 13:55:00,-130.75,276243.0700000007,269370.9900000008,6872.0799999999
15732,2022-05-26 14:00:00,-800.05,275443.0200000007,269370.9900000008,6072.0299999999115
15733,2022-05-26 14:05:00,964.59,276407.61000000074,269370.9900000008,7036.619999999937
15734,2022-05-26 14:10:00,-1274.06,275133.55000000075,269370.9900000008,5762.5599999999395
15735,2022-05-26 14:15:00,1791.69,276925.24000000075,269370.9900000008,7554.249999999942
15736,2022-05-26 14:20:00,-1227.46,275697.7800000007,269370.9900000008,6326.789999999921
15737,2022-05-26 14:25:00,-1218.7,274479.0800000007,269370.9900000008,5108.089999999909
15738,2022-05-26 14:30:00,-908.16,273570.92000000074,269370.9900000008,4199.929999999935
15739,2022-05-26 14:35:00,1908.23,275479.1500000007,269370.9900000008,6108.159999999916
15740,2022-05-26 14:40:00,-1503.37,273975.7800000007,269370.9900000008,4604.789999999921
15741,2022-05-26 14:45:00,371.23,274347.0100000007,269370.9900000008,4976.019999999902
15742,2022-05-26 14:50:00,229.49,274576.5000000007,269370.9900000008,5205.509999999893
15743,2022-05-26 14:55:00,-802.99,273773.5100000007,269370.9900000008,4402.519999999902
15744,2022-05-26 15:00:00,1970.85,275744.3600000007,269370.9900000008,6373.369999999879
15745,2022-05-26 15:05:00,-450.96,275293.40000000066,269370.9900000008,5922.409999999858
15746,2022-05-26 15:10:00,1459.02,276752.4200000007,269370.9900000008,7381.429999999877
15747,2022-05-26 15:15:00,1701.06,278453.4800000007,269370.9900000008,9082.489999999874
15748,2022-05-26 15:20:00,1573.32,280026.8000000007,269370.9900000008,10655.809999999881
15749,2022-05-26 15:25:00,-1288.07,278738.7300000007,269370.9900000008,9367.739999999874
15750,2022-05-26 15:30:00,-644.28,278094.45000000065,269370.9900000008,8723.459999999846
15751,2022-05-26 15:35:00,-59.28,278035.1700000006,269370.9900000008,8664.179999999818
15752,2022-05-26 15:40:00,1856.94,279892.1100000006,269370.9900000008,10521.11999999982
15753,2022-05-26 15:45:00,278.32,280170.43000000063,269370.9900000008,10799.439999999828
15754,2022-05-26 15:50:00,1822.55,281992.9800000006,269370.9900000008,12621.989999999816
15755,2022-05-26 15:55:00,87.14,282080.12000000064,269370.9900000008,12709.12999999983
15756,2022-05-26 16:00:00,293.44,282373.56000000064,269370.9900000008,13002.569999999832
15757,2022-05-26 16:05:00,1045.81,283419.37000000064,269370.9900000008,14048.37999999983
15758,2022-05-26 16:10:00,-995.53,282423.8400000006,269370.9900000008,13052.849999999802
15759,2022-05-26 16:15:00,836.6,283260.4400000006,269370.9900000008,13889.449999999779
15760,2022-05-26 16:20:00,723.53,283983.9700000006,269370.9900000008,14612.979999999807
15761,2022-05-26 16:25:00,-631.36,283352.6100000006,269370.9900000008,13981.61999999982
15762,2022-05-26 16:30:00,-232.46,283120.1500000006,269370.9900000008,13749.1599999998
15763,2022-05-26 16:35:00,-1790.48,281329.6700000006,269370.9900000008,11958.679999999818
15764,2022-05-26 16:40:00,294.13,281623.8000000006,269370.9900000008,12252.809999999823
15765,2022-05-26 16:45:00,-583.46,281040.3400000006,269370.9900000008,11669.349999999802
15766,2022-05-26 16:50:00,-827.96,280212.3800000006,269370.9900000008,10841.389999999781
15767,2022-05-26 16:55:00,-227.05,279985.3300000006,269370.9900000008,10614.339999999793
15768,2022-05-27 08:00:00,-170.36,279814.9700000006,279985.3300000006,-170.35999999998603
15769,2022-05-27 08:05:00,814.45,280629.4200000006,279985.3300000006,644.0900000000256
15770,2022-05-27 08:10:00,226.22,280855.6400000006,279985.3300000006,870.3099999999977
15771,2022-05-27 08:15:00,1570.41,282426.05000000057,279985.3300000006,2440.719999999972
15772,2022-05-27 08:20:00,9.19,282435.2400000006,279985.3300000006,2449.9099999999744
15773,2022-05-27 08:25:00,-887.67,281547.5700000006,279985.3300000006,1562.2399999999907
15774,2022-05-27 08:30:00,1908.99,283456.5600000006,279985.3300000006,3471.2299999999814
15775,2022-05-27 08:35:00,-1200.15,282256.41000000056,279985.3300000006,2271.079999999958
15776,2022-05-27 08:40:00,430.47,282686.8800000005,279985.3300000006,2701.54999999993
15777,2022-05-27 08:45:00,1285.43,283972.3100000005,279985.3300000006,3986.979999999923
15778,2022-05-27 08:50:00,-285.16,283687.15000000055,279985.3300000006,3701.819999999949
15779,2022-05-27 08:55:00,912.7,284599.85000000056,279985.3300000006,4614.51999999996
15780,2022-05-27 09:00:00,674.01,285273.86000000057,279985.3300000006,5288.52999999997
15781,2022-05-27 09:05:00,-1240.98,284032.8800000006,279985.3300000006,4047.5499999999884
15782,2022-05-27 09:10:00,208.6,284241.48000000056,279985.3300000006,4256.149999999965
15783,2022-05-27 09:15:00,-1853.32,282388.16000000056,279985.3300000006,2402.829999999958
15784,2022-05-27 09:20:00,-943.71,281444.45000000054,279985.3300000006,1459.1199999999371
15785,2022-05-27 09:25:00,-672.39,280772.0600000005,279985.3300000006,786.7299999999232
15786,2022-05-27 09:30:00,1015.35,281787.4100000005,279985.3300000006,1802.0799999998999
15787,2022-05-27 09:35:00,-74.04,281713.3700000005,279985.3300000006,1728.0399999999208
15788,2022-05-27 09:40:00,631.83,282345.20000000054,279985.3300000006,2359.869999999937
15789,2022-05-27 09:45:00,-1204.55,281140.65000000055,279985.3300000006,1155.3199999999488
15790,2022-05-27 09:50:00,-791.44,280349.21000000054,279985.3300000006,363.87999999994645
15791,2022-05-27 09:55:00,1203.71,281552.92000000057,279985.3300000006,1567.5899999999674
15792,2022-05-27 10:00:00,1269.25,282822.17000000057,279985.3300000006,2836.8399999999674
15793,2022-05-27 10:05:00,-685.06,282137.11000000057,279985.3300000006,2151.7799999999697
15794,2022-05-27 10:10:00,605.95,282743.0600000006,279985.3300000006,2757.7299999999814
15795,2022-05-27 10:15:00,-837.99,281905.0700000006,279985.3300000006,1919.7399999999907
15796,2022-05-27 10:20:00,567.59,282472.6600000006,279985.3300000006,2487.3300000000163
15797,2022-05-27 10:25:00,1378.07,283850.7300000006,279985.3300000006,3865.4000000000233
15798,2022-05-27 10:30:00,754.81,284605.5400000006,279985.3300000006,4620.210000000021
15799,2022-05-27 10:35:00,-409.26,284196.2800000006,279985.3300000006,4210.950000000012
15800,2022-05-27 10:40:00,1488.77,285685.0500000006,279985.3300000006,5699.72000000003
15801,2022-05-27 10:45:00,95.8,285780.8500000006,279985.3300000006,5795.520000000019
15802,2022-05-27 10:50:00,1285.81,287066.6600000006,279985.3300000006,7081.330000000016
15803,2022-05-27 10:55:00,-299.1,286767.56000000064,279985.3300000006,6782.23000000004
15804,2022-05-27 11:00:00,-1137.85,285629.71000000066,279985.3300000006,5644.380000000063
15805,2022-05-27 11:05:00,861.6,286491.31000000064,279985.3300000006,6505.98000000004
15806,2022-05-27 11:10:00,1728.07,288219.38000000064,279985.3300000006,8234.050000000047
15807,2022-05-27 11:15:00,607.05,288826.43000000063,279985.3300000006,8841.100000000035
15808,2022-05-27 11:20:00,-697.14,288129.2900000006,279985.3300000006,8143.960000000021
15809,2022-05-27 11:25:00,377.4,288506.69000000064,279985.3300000006,8521.360000000044
15810,2022-05-27 11:30:00,194.41,288701.1000000006,279985.3300000006,8715.770000000019
15811,2022-05-27 11:35:00,1947.03,290648.13000000064,279985.3300000006,10662.800000000047
15812,2022-05-27 11:40:00,-1203.29,289444.84000000067,279985.3300000006,9459.510000000068
15813,2022-05-27 11:45:00,-63.98,289380.8600000007,279985.3300000006,9395.530000000086
15814,2022-05-27 11:50:00,-1228.63,288152.2300000007,279985.3300000006,8166.9000000000815
15815,2022-05-27 11:55:00,295.22,288447.45000000065,279985.3300000006,8462.120000000054
15816,2022-05-27 12:00:00,-1934.62,286512.83000000066,279985.3300000006,6527.500000000058
15817,2022-05-27 12:05:00,1585.5,288098.33000000066,279985.3300000006,8113.000000000058
15818,2022-05-27 12:10:00,-1454.16,286644.1700000007,279985.3300000006,6658.840000000084
15819,2022-05-27 12:15:00,-1846.08,284798.09000000067,279985.3300000006,4812.7600000000675
15820,2022-05-27 12:20:00,1601.41,286399.50000000064,279985.3300000006,6414.170000000042
15821,2022-05-27 12:25:00,826.48,287225.9800000006,279985.3300000006,7240.650000000023
15822,2022-05-27 12:30:00,1486.67,288712.6500000006,279985.3300000006,8727.320000000007
15823,2022-05-27 12:35:00,-1096.71,287615.9400000006,279985.3300000006,7630.609999999986
15824,2022-05-27 12:40:00,1896.77,289512.7100000006,279985.3300000006,9527.380000000005
15825,2022-05-27 12:45:00,-285.24,289227.4700000006,279985.3300000006,9242.140000000014
15826,2022-05-27 12:50:00,-1481.03,287746.4400000006,279985.3300000006,7761.109999999986
15827,2022-05-27 12:55:00,72.46,287818.9000000006,279985.3300000006,7833.570000000007
15828,2022-05-27 13:00:00,-1950.38,285868.5200000006,279985.3300000006,5883.190000000002
15829,2022-05-27 13:05:00,1407.87,287276.3900000006,279985.3300000006,7291.059999999998
15830,2022-05-27 13:10:00,1676.89,288953.2800000006,279985.3300000006,8967.950000000012
15831,2022-05-27 13:15:00,-11.35,288941.93000000063,279985.3300000006,8956.600000000035
15832,2022-05-27 13:20:00,-585.72,288356.21000000066,279985.3300000006,8370.880000000063
15833,2022-05-27 13:25:00,530.87,288887.08000000066,279985.3300000006,8901.750000000058
15834,2022-05-27 13:30:00,1728.36,290615.44000000064,279985.3300000006,10630.110000000044
15835,2022-05-27 13:35:00,218.49,290833.93000000063,279985.3300000006,10848.600000000035
15836,2022-05-27 13:40:00,-117.69,290716.24000000063,279985.3300000006,10730.910000000033
15837,2022-05-27 13:45:00,-1131.76,289584.4800000006,279985.3300000006,9599.150000000023
15838,2022-05-27 13:50:00,-368.76,289215.7200000006,279985.3300000006,9230.390000000014
15839,2022-05-27 13:55:00,-788.9,288426.8200000006,279985.3300000006,8441.48999999999
15840,2022-05-27 14:00:00,1269.13,289695.9500000006,279985.3300000006,9710.619999999995
15841,2022-05-27 14:05:00,79.21,289775.1600000006,279985.3300000006,9789.830000000016
15842,2022-05-27 14:10:00,-1208.9,288566.2600000006,279985.3300000006,8580.929999999993
15843,2022-05-27 14:15:00,1310.65,289876.9100000006,279985.3300000006,9891.580000000016
15844,2022-05-27 14:20:00,-648.24,289228.6700000006,279985.3300000006,9243.340000000026
15845,2022-05-27 14:25:00,132.57,289361.24000000063,279985.3300000006,9375.910000000033
15846,2022-05-27 14:30:00,-1099.3,288261.94000000064,279985.3300000006,8276.610000000044
15847,2022-05-27 14:35:00,-782.58,287479.3600000006,279985.3300000006,7494.030000000028
15848,2022-05-27 14:40:00,-657.5,286821.8600000006,279985.3300000006,6836.530000000028
15849,2022-05-27 14:45:00,1896.55,288718.4100000006,279985.3300000006,8733.080000000016
15850,2022-05-27 14:50:00,281.81,289000.2200000006,279985.3300000006,9014.890000000014
15851,2022-05-27 14:55:00,646.96,289647.18000000063,279985.3300000006,9661.850000000035
15852,2022-05-27 15:00:00,-1488.18,288159.00000000064,279985.3300000006,8173.670000000042
15853,2022-05-27 15:05:00,829.53,288988.53000000067,279985.3300000006,9003.20000000007
15854,2022-05-27 15:10:00,-810.4,288178.13000000064,279985.3300000006,8192.800000000047
15855,2022-05-27 15:15:00,-1453.12,286725.01000000065,279985.3300000006,6739.680000000051
15856,2022-05-27 15:20:00,-1224.57,285500.44000000064,279985.3300000006,5515.110000000044
15857,2022-05-27 15:25:00,1503.62,287004.06000000064,279985.3300000006,7018.73000000004
15858,2022-05-27 15:30:00,-982.13,286021.93000000063,279985.3300000006,6036.600000000035
15859,2022-05-27 15:35:00,1206.15,287228.08000000066,279985.3300000006,7242.750000000058
15860,2022-05-27 15:40:00,95.64,287323.72000000067,279985.3300000006,7338.390000000072
15861,2022-05-27 15:45:00,706.88,288030.6000000007,279985.3300000006,8045.270000000077
15862,2022-05-27 15:50:00,-1917.46,286113.14000000065,279985.3300000006,6127.810000000056
15863,2022-05-27 15:55:00,1074.18,287187.32000000065,279985.3300000006,7201.990000000049
15864,2022-05-27 16:00:00,833.98,288021.3000000006,279985.3300000006,8035.97000000003
15865,2022-05-27 16:05:00,1047.22,289068.5200000006,279985.3300000006,9083.190000000002
15866,2022-05-27 16:10:00,-3.61,289064.9100000006,279985.3300000006,9079.580000000016
15867,2022-05-27 16:15:00,-214.38,288850.5300000006,279985.3300000006,8865.200000000012
15868,2022-05-27 16:20:00,1389.23,290239.7600000006,279985.3300000006,10254.429999999993
15869,2022-05-27 16:25:00,1697.06,291936.8200000006,279985.3300000006,11951.48999999999
15870,2022-05-27 16:30:00,-768.9,291167.92000000057,279985.3300000006,11182.589999999967
15871,2022-05-27 16:35:00,1816.01,292983.9300000006,279985.3300000006,12998.599999999977
15872,2022-05-27 16:40:00,-791.96,292191.97000000055,279985.3300000006,12206.639999999956
15873,2022-05-27 16:45:00,-154.85,292037.1200000006,279985.3300000006,12051.789999999979
15874,2022-05-27 16:50:00,1115.41,293152.53000000055,279985.3300000006,13167.199999999953
15875,2022-05-27 16:55:00,-1228.55,291923.98000000056,279985.3300000006,11938.649999999965
15876,2022-05-28 08:00:00,1743.63,293667.61000000057,291923.98000000056,1743.6300000000047
15877,2022-05-28 08:05:00,934.85,294602.46000000054,291923.98000000056,2678.4799999999814
15878,2022-05-28 08:10:00,948.39,295550.85000000056,291923.98000000056,3626.8699999999953
15879,2022-05-28 08:15:00,-1087.52,294463.33000000054,291923.98000000056,2539.3499999999767
15880,2022-05-28 08:20:00,-1757.5,292705.83000000054,291923.98000000056,781.8499999999767
15881,2022-05-28 08:25:00,1553.29,294259.1200000005,291923.98000000056,2335.1399999999558
15882,2022-05-28 08:30:00,-729.56,293529.5600000005,291923.98000000056,1605.579999999958
15883,2022-05-28 08:35:00,-73.29,293456.27000000054,291923.98000000056,1532.289999999979
15884,2022-05-28 08:40:00,1875.95,295332.22000000055,291923.98000000056,3408.2399999999907
15885,2022-05-28 08:45:00,291.12,295623.34000000055,291923.98000000056,3699.359999999986
15886,2022-05-28 08:50:00,-1315.96,294307.3800000005,291923.98000000056,2383.399999999965
15887,2022-05-28 08:55:00,-1179.59,293127.7900000005,291923.98000000056,1203.8099999999395
15888,2022-05-28 09:00:00,169.33,293297.1200000005,291923.98000000056,1373.1399999999558
15889,2022-05-28 09:05:00,134.56,293431.6800000005,291923.98000000056,1507.6999999999534
15890,2022-05-28 09:10:00,1754.84,295186.52000000054,291923.98000000056,3262.539999999979
15891,2022-05-28 09:15:00,414.42,295600.9400000005,291923.98000000056,3676.9599999999627
15892,2022-05-28 09:20:00,475.98,296076.9200000005,291923.98000000056,4152.939999999944
15893,2022-05-28 09:25:00,-539.24,295537.6800000005,291923.98000000056,3613.6999999999534
15894,2022-05-28 09:30:00,1451.13,296988.8100000005,291923.98000000056,5064.829999999958
15895,2022-05-28 09:35:00,1527.16,298515.9700000005,291923.98000000056,6591.9899999999325
15896,2022-05-28 09:40:00,-1182.68,297333.2900000005,291923.98000000056,5409.3099999999395
15897,2022-05-28 09:45:00,819.43,298152.7200000005,291923.98000000056,6228.7399999999325
15898,2022-05-28 09:50:00,86.1,298238.8200000005,291923.98000000056,6314.839999999909
15899,2022-05-28 09:55:00,-1232.57,297006.25000000047,291923.98000000056,5082.269999999902
15900,2022-05-28 10:00:00,193.22,297199.47000000044,291923.98000000056,5275.489999999874
15901,2022-05-28 10:05:00,837.02,298036.49000000046,291923.98000000056,6112.509999999893
15902,2022-05-28 10:10:00,680.66,298717.15000000043,291923.98000000056,6793.169999999867
15903,2022-05-28 10:15:00,1094.69,299811.84000000043,291923.98000000056,7887.85999999987
15904,2022-05-28 10:20:00,-1188.24,298623.60000000044,291923.98000000056,6699.619999999879
15905,2022-05-28 10:25:00,1444.55,300068.15000000043,291923.98000000056,8144.169999999867
15906,2022-05-28 10:30:00,-404.42,299663.73000000045,291923.98000000056,7739.749999999884
15907,2022-05-28 10:35:00,-74.61,299589.12000000046,291923.98000000056,7665.139999999898
15908,2022-05-28 10:40:00,-406.98,299182.1400000005,291923.98000000056,7258.159999999916
15909,2022-05-28 10:45:00,3.92,299186.06000000046,291923.98000000056,7262.0799999999
15910,2022-05-28 10:50:00,471.17,299657.23000000045,291923.98000000056,7733.249999999884
15911,2022-05-28 10:55:00,-205.85,299451.38000000047,291923.98000000056,7527.399999999907
15912,2022-05-28 11:00:00,-1014.1,298437.2800000005,291923.98000000056,6513.29999999993
15913,2022-05-28 11:05:00,-223.2,298214.0800000005,291923.98000000056,6290.0999999999185
15914,2022-05-28 11:10:00,196.58,298410.6600000005,291923.98000000056,6486.679999999935
15915,2022-05-28 11:15:00,938.24,299348.9000000005,291923.98000000056,7424.9199999999255
15916,2022-05-28 11:20:00,741.59,300090.4900000005,291923.98000000056,8166.509999999951
15917,2022-05-28 11:25:00,-274.99,299815.5000000005,291923.98000000056,7891.51999999996
15918,2022-05-28 11:30:00,-577.81,299237.6900000005,291923.98000000056,7313.709999999963
15919,2022-05-28 11:35:00,-1597.63,297640.0600000005,291923.98000000056,5716.079999999958
15920,2022-05-28 11:40:00,-1938.85,295701.21000000054,291923.98000000056,3777.2299999999814
15921,2022-05-28 11:45:00,-424.16,295277.05000000057,291923.98000000056,3353.070000000007
15922,2022-05-28 11:50:00,275.09,295552.1400000006,291923.98000000056,3628.1600000000326
15923,2022-05-28 11:55:00,-721.23,294830.9100000006,291923.98000000056,2906.930000000051
15924,2022-05-28 12:00:00,-1555.26,293275.6500000006,291923.98000000056,1351.670000000042
15925,2022-05-28 12:05:00,648.23,293923.8800000006,291923.98000000056,1999.9000000000233
15926,2022-05-28 12:10:00,1396.67,295320.55000000057,291923.98000000056,3396.570000000007
15927,2022-05-28 12:15:00,-853.03,294467.52000000054,291923.98000000056,2543.539999999979
15928,2022-05-28 12:20:00,657.47,295124.9900000005,291923.98000000056,3201.009999999951
15929,2022-05-28 12:25:00,1970.45,297095.4400000005,291923.98000000056,5171.459999999963
15930,2022-05-28 12:30:00,1760.04,298855.4800000005,291923.98000000056,6931.499999999942
15931,2022-05-28 12:35:00,-281.23,298574.2500000005,291923.98000000056,6650.26999999996
15932,2022-05-28 12:40:00,310.03,298884.28000000055,291923.98000000056,6960.299999999988
15933,2022-05-28 12:45:00,-727.65,298156.6300000005,291923.98000000056,6232.649999999965
15934,2022-05-28 12:50:00,-1543.03,296613.6000000005,291923.98000000056,4689.619999999937
15935,2022-05-28 12:55:00,1645.2,298258.8000000005,291923.98000000056,6334.819999999949
15936,2022-05-28 13:00:00,-1233.02,297025.7800000005,291923.98000000056,5101.79999999993
15937,2022-05-28 13:05:00,-1850.0,295175.7800000005,291923.98000000056,3251.79999999993
15938,2022-05-28 13:10:00,-1795.17,293380.6100000005,291923.98000000056,1456.6299999999464
15939,2022-05-28 13:15:00,483.01,293863.6200000005,291923.98000000056,1939.6399999999558
15940,2022-05-28 13:20:00,1027.56,294891.1800000005,291923.98000000056,2967.1999999999534
15941,2022-05-28 13:25:00,484.62,295375.8000000005,291923.98000000056,3451.819999999949
15942,2022-05-28 13:30:00,-855.26,294520.5400000005,291923.98000000056,2596.5599999999395
15943,2022-05-28 13:35:00,1191.0,295711.5400000005,291923.98000000056,3787.5599999999395
15944,2022-05-28 13:40:00,-1654.1,294057.4400000005,291923.98000000056,2133.4599999999627
15945,2022-05-28 13:45:00,-36.48,294020.96000000054,291923.98000000056,2096.9799999999814
15946,2022-05-28 13:50:00,522.93,294543.89000000054,291923.98000000056,2619.9099999999744
15947,2022-05-28 13:55:00,-1663.19,292880.70000000054,291923.98000000056,956.7199999999721
15948,2022-05-28 14:00:00,-419.59,292461.1100000005,291923.98000000056,537.1299999999464
15949,2022-05-28 14:05:00,323.68,292784.7900000005,291923.98000000056,860.8099999999395
15950,2022-05-28 14:10:00,796.12,293580.9100000005,291923.98000000056,1656.9299999999348
15951,2022-05-28 14:15:00,-25.56,293555.3500000005,291923.98000000056,1631.3699999999371
15952,2022-05-28 14:20:00,1051.84,294607.1900000005,291923.98000000056,2683.2099999999627
15953,2022-05-28 14:25:00,-1927.39,292679.8000000005,291923.98000000056,755.8199999999488
15954,2022-05-28 14:30:00,-1114.38,291565.4200000005,291923.98000000056,-358.5600000000559
15955,2022-05-28 14:35:00,-989.17,290576.2500000005,291923.98000000056,-1347.7300000000396
15956,2022-05-28 14:40:00,1874.25,292450.5000000005,291923.98000000056,526.5199999999604
15957,2022-05-28 14:45:00,-142.41,292308.09000000055,291923.98000000056,384.10999999998603
15958,2022-05-28 14:50:00,1707.28,294015.3700000006,291923.98000000056,2091.390000000014
15959,2022-05-28 14:55:00,-1084.88,292930.4900000006,291923.98000000056,1006.5100000000093
15960,2022-05-28 15:00:00,-1584.02,291346.47000000055,291923.98000000056,-577.5100000000093
15961,2022-05-28 15:05:00,-1441.28,289905.1900000005,291923.98000000056,-2018.7900000000373
15962,2022-05-28 15:10:00,1782.63,291687.82000000053,291923.98000000056,-236.1600000000326
15963,2022-05-28 15:15:00,-1852.72,289835.10000000056,291923.98000000056,-2088.8800000000047
15964,2022-05-28 15:20:00,1974.43,291809.53000000055,291923.98000000056,-114.45000000001164
15965,2022-05-28 15:25:00,-878.54,290930.9900000006,291923.98000000056,-992.9899999999907
15966,2022-05-28 15:30:00,-483.55,290447.4400000006,291923.98000000056,-1476.539999999979
15967,2022-05-28 15:35:00,-1782.09,288665.35000000056,291923.98000000056,-3258.6300000000047
15968,2022-05-28 15:40:00,-1663.64,287001.71000000054,291923.98000000056,-4922.270000000019
15969,2022-05-28 15:45:00,-284.93,286716.78000000055,291923.98000000056,-5207.200000000012
15970,2022-05-28 15:50:00,627.43,287344.21000000054,291923.98000000056,-4579.770000000019
15971,2022-05-28 15:55:00,777.12,288121.33000000054,291923.98000000056,-3802.6500000000233
15972,2022-05-28 16:00:00,1801.88,289923.21000000054,291923.98000000056,-2000.7700000000186
15973,2022-05-28 16:05:00,-1233.54,288689.67000000057,291923.98000000056,-3234.3099999999977
15974,2022-05-28 16:10:00,-1441.43,287248.2400000006,291923.98000000056,-4675.739999999991
15975,2022-05-28 16:15:00,1229.85,288478.09000000055,291923.98000000056,-3445.890000000014
15976,2022-05-28 16:20:00,-5.61,288472.48000000056,291923.98000000056,-3451.5
15977,2022-05-28 16:25:00,796.33,289268.8100000006,291923.98000000056,-2655.1699999999837
15978,2022-05-28 16:30:00,277.11,289545.92000000057,291923.98000000056,-2378.0599999999977
15979,2022-05-28 16:35:00,1098.99,290644.91000000056,291923.98000000056,-1279.070000000007
15980,2022-05-28 16:40:00,1624.83,292269.7400000006,291923.98000000056,345.7600000000093
15981,2022-05-28 16:45:00,-1328.55,290941.1900000006,291923.98000000056,-982.789999999979
15982,2022-05-28 16:50:00,926.94,291868.1300000006,291923.98000000056,-55.84999999997672
15983,2022-05-28 16:55:00,-136.92,291731.2100000006,291923.98000000056,-192.76999999996042
15984,2022-05-29 08:00:00,-602.68,291128.5300000006,291731.2100000006,-602.679999999993
15985,2022-05-29 08:05:00,-1896.1,289232.43000000063,291731.2100000006,-2498.7799999999697
15986,2022-05-29 08:10:00,-13.62,289218.81000000064,291731.2100000006,-2512.399999999965
15987,2022-05-29 08:15:00,-474.87,288743.94000000064,291731.2100000006,-2987.2699999999604
15988,2022-05-29 08:20:00,-1088.21,287655.7300000006,291731.2100000006,-4075.4799999999814
15989,2022-05-29 08:25:00,1711.93,289367.6600000006,291731.2100000006,-2363.5499999999884
15990,2022-05-29 08:30:00,-525.71,288841.9500000006,291731.2100000006,-2889.2600000000093
15991,2022-05-29 08:35:00,530.35,289372.30000000057,291731.2100000006,-2358.9100000000326
15992,2022-05-29 08:40:00,862.41,290234.71000000054,291731.2100000006,-1496.5000000000582
15993,2022-05-29 08:45:00,-631.03,289603.6800000005,291731.2100000006,-2127.530000000086
15994,2022-05-29 08:50:00,-406.89,289196.7900000005,291731.2100000006,-2534.4200000001
15995,2022-05-29 08:55:00,-264.64,288932.1500000005,291731.2100000006,-2799.060000000114
15996,2022-05-29 09:00:00,-215.88,288716.2700000005,291731.2100000006,-3014.9400000001187
15997,2022-05-29 09:05:00,-583.42,288132.8500000005,291731.2100000006,-3598.3600000001024
15998,2022-05-29 09:10:00,-1759.09,286373.7600000005,291731.2100000006,-5357.450000000128
15999,2022-05-29 09:15:00,1493.03,287866.7900000005,291731.2100000006,-3864.4200000001
16000,2022-05-29 09:20:00,886.82,288753.6100000005,291731.2100000006,-2977.600000000093
16001,2022-05-29 09:25:00,-150.05,288603.5600000005,291731.2100000006,-3127.6500000000815
16002,2022-05-29 09:30:00,-984.41,287619.15000000055,291731.2100000006,-4112.060000000056
16003,2022-05-29 09:35:00,-1412.78,286206.3700000005,291731.2100000006,-5524.840000000084
16004,2022-05-29 09:40:00,468.33,286674.70000000054,291731.2100000006,-5056.5100000000675
16005,2022-05-29 09:45:00,323.77,286998.47000000055,291731.2100000006,-4732.740000000049
16006,2022-05-29 09:50:00,570.13,287568.60000000056,291731.2100000006,-4162.610000000044
16007,2022-05-29 09:55:00,939.81,288508.41000000056,291731.2100000006,-3222.8000000000466
16008,2022-05-29 10:00:00,1006.61,289515.02000000054,291731.2100000006,-2216.1900000000605
16009,2022-05-29 10:05:00,-482.71,289032.3100000005,291731.2100000006,-2698.9000000000815
16010,2022-05-29 10:10:00,481.72,289514.0300000005,291731.2100000006,-2217.1800000001094
16011,2022-05-29 10:15:00,-209.1,289304.9300000005,291731.2100000006,-2426.280000000086
16012,2022-05-29 10:20:00,-349.83,288955.1000000005,291731.2100000006,-2776.1100000001024
16013,2022-05-29 10:25:00,1950.44,290905.5400000005,291731.2100000006,-825.6700000001001
16014,2022-05-29 10:30:00,697.44,291602.9800000005,291731.2100000006,-128.2300000000978
16015,2022-05-29 10:35:00,-828.93,290774.0500000005,291731.2100000006,-957.1600000000908
16016,2022-05-29 10:40:00,697.72,291471.7700000005,291731.2100000006,-259.44000000011874
16017,2022-05-29 10:45:00,-702.91,290768.8600000005,291731.2100000006,-962.3500000000931
16018,2022-05-29 10:50:00,934.24,291703.1000000005,291731.2100000006,-28.110000000102445
16019,2022-05-29 10:55:00,-1608.15,290094.9500000005,291731.2100000006,-1636.2600000001257
16020,2022-05-29 11:00:00,-984.58,289110.37000000046,291731.2100000006,-2620.840000000142
16021,2022-05-29 11:05:00,826.13,289936.50000000047,291731.2100000006,-1794.7100000001374
16022,2022-05-29 11:10:00,-109.4,289827.10000000044,291731.2100000006,-1904.1100000001607
16023,2022-05-29 11:15:00,1686.52,291513.62000000046,291731.2100000006,-217.59000000014203
16024,2022-05-29 11:20:00,-634.4,290879.22000000044,291731.2100000006,-851.9900000001653
16025,2022-05-29 11:25:00,-821.51,290057.7100000004,291731.2100000006,-1673.5000000001746
16026,2022-05-29 11:30:00,-588.99,289468.72000000044,291731.2100000006,-2262.4900000001653
16027,2022-05-29 11:35:00,383.31,289852.03000000044,291731.2100000006,-1879.1800000001676
16028,2022-05-29 11:40:00,541.54,290393.5700000004,291731.2100000006,-1337.6400000001886
16029,2022-05-29 11:45:00,1850.01,292243.5800000004,291731.2100000006,512.3699999998207
16030,2022-05-29 11:50:00,456.94,292700.5200000004,291731.2100000006,969.309999999823
16031,2022-05-29 11:55:00,1583.51,294284.03000000044,291731.2100000006,2552.8199999998324
16032,2022-05-29 12:00:00,-1142.52,293141.5100000004,291731.2100000006,1410.2999999998137
16033,2022-05-29 12:05:00,-263.14,292878.3700000004,291731.2100000006,1147.1599999997998
16034,2022-05-29 12:10:00,1553.37,294431.7400000004,291731.2100000006,2700.529999999795
16035,2022-05-29 12:15:00,925.6,295357.3400000004,291731.2100000006,3626.129999999772
16036,2022-05-29 12:20:00,-869.31,294488.0300000004,291731.2100000006,2756.819999999774
16037,2022-05-29 12:25:00,831.42,295319.45000000036,291731.2100000006,3588.239999999758
16038,2022-05-29 12:30:00,-1317.39,294002.06000000035,291731.2100000006,2270.849999999744
16039,2022-05-29 12:35:00,-1250.04,292752.02000000037,291731.2100000006,1020.8099999997648
16040,2022-05-29 12:40:00,-1474.52,291277.50000000035,291731.2100000006,-453.7100000002538
16041,2022-05-29 12:45:00,1492.4,292769.9000000004,291731.2100000006,1038.6899999997695
16042,2022-05-29 12:50:00,647.65,293417.5500000004,291731.2100000006,1686.3399999997928
16043,2022-05-29 12:55:00,1050.47,294468.02000000037,291731.2100000006,2736.809999999765
16044,2022-05-29 13:00:00,1129.59,295597.6100000004,291731.2100000006,3866.3999999997905
16045,2022-05-29 13:05:00,-1456.79,294140.8200000004,291731.2100000006,2409.6099999998114
16046,2022-05-29 13:10:00,1756.28,295897.10000000044,291731.2100000006,4165.889999999839
16047,2022-05-29 13:15:00,1275.12,297172.22000000044,291731.2100000006,5441.009999999835
16048,2022-05-29 13:20:00,102.52,297274.74000000046,291731.2100000006,5543.529999999853
16049,2022-05-29 13:25:00,520.82,297795.56000000046,291731.2100000006,6064.34999999986
16050,2022-05-29 13:30:00,-613.42,297182.1400000005,291731.2100000006,5450.929999999877
16051,2022-05-29 13:35:00,870.49,298052.63000000047,291731.2100000006,6321.419999999867
16052,2022-05-29 13:40:00,1490.37,299543.00000000047,291731.2100000006,7811.789999999863
16053,2022-05-29 13:45:00,1430.82,300973.8200000005,291731.2100000006,9242.60999999987
16054,2022-05-29 13:50:00,320.79,301294.61000000045,291731.2100000006,9563.399999999849
16055,2022-05-29 13:55:00,1652.02,302946.63000000047,291731.2100000006,11215.419999999867
16056,2022-05-29 14:00:00,781.07,303727.7000000005,291731.2100000006,11996.489999999874
16057,2022-05-29 14:05:00,-1122.59,302605.11000000045,291731.2100000006,10873.899999999849
16058,2022-05-29 14:10:00,-212.38,302392.73000000045,291731.2100000006,10661.519999999844
16059,2022-05-29 14:15:00,-989.4,301403.3300000004,291731.2100000006,9672.11999999982
16060,2022-05-29 14:20:00,-35.68,301367.65000000043,291731.2100000006,9636.439999999828
16061,2022-05-29 14:25:00,-955.82,300411.8300000004,291731.2100000006,8680.61999999982
16062,2022-05-29 14:30:00,1408.43,301820.2600000004,291731.2100000006,10089.049999999814
16063,2022-05-29 14:35:00,47.52,301867.78000000044,291731.2100000006,10136.569999999832
16064,2022-05-29 14:40:00,-1845.93,300021.85000000044,291731.2100000006,8290.63999999984
16065,2022-05-29 14:45:00,-1343.8,298678.05000000045,291731.2100000006,6946.839999999851
16066,2022-05-29 14:50:00,1887.0,300565.05000000045,291731.2100000006,8833.839999999851
16067,2022-05-29 14:55:00,-521.65,300043.40000000043,291731.2100000006,8312.189999999828
16068,2022-05-29 15:00:00,1794.7,301838.10000000044,291731.2100000006,10106.88999999984
16069,2022-05-29 15:05:00,1508.93,303347.03000000044,291731.2100000006,11615.819999999832
16070,2022-05-29 15:10:00,660.21,304007.24000000046,291731.2100000006,12276.029999999853
16071,2022-05-29 15:15:00,1085.67,305092.91000000044,291731.2100000006,13361.699999999837
16072,2022-05-29 15:20:00,-1634.44,303458.47000000044,291731.2100000006,11727.259999999835
16073,2022-05-29 15:25:00,1453.23,304911.7000000004,291731.2100000006,13180.489999999816
16074,2022-05-29 15:30:00,842.57,305754.2700000004,291731.2100000006,14023.059999999823
16075,2022-05-29 15:35:00,-1545.19,304209.0800000004,291731.2100000006,12477.86999999982
16076,2022-05-29 15:40:00,1907.91,306116.9900000004,291731.2100000006,14385.779999999795
16077,2022-05-29 15:45:00,-105.2,306011.7900000004,291731.2100000006,14280.579999999783
16078,2022-05-29 15:50:00,1184.87,307196.6600000004,291731.2100000006,15465.449999999779
16079,2022-05-29 15:55:00,450.84,307647.5000000004,291731.2100000006,15916.289999999804
16080,2022-05-29 16:00:00,-1933.34,305714.1600000004,291731.2100000006,13982.949999999779
16081,2022-05-29 16:05:00,1979.26,307693.4200000004,291731.2100000006,15962.209999999788
16082,2022-05-29 16:10:00,-122.6,307570.8200000004,291731.2100000006,15839.609999999811
16083,2022-05-29 16:15:00,645.71,308216.53000000044,291731.2100000006,16485.319999999832
16084,2022-05-29 16:20:00,-1851.26,306365.2700000004,291731.2100000006,14634.059999999823
16085,2022-05-29 16:25:00,849.9,307215.17000000045,291731.2100000006,15483.959999999846
16086,2022-05-29 16:30:00,-1000.83,306214.34000000043,291731.2100000006,14483.12999999983
16087,2022-05-29 16:35:00,-1165.46,305048.8800000004,291731.2100000006,13317.669999999809
16088,2022-05-29 16:40:00,757.02,305805.90000000043,291731.2100000006,14074.689999999828
16089,2022-05-29 16:45:00,962.79,306768.6900000004,291731.2100000006,15037.479999999807
16090,2022-05-29 16:50:00,-1164.16,305604.53000000044,291731.2100000006,13873.319999999832
16091,2022-05-29 16:55:00,1201.95,306806.48000000045,291731.2100000006,15075.269999999844
16092,2022-05-30 08:00:00,-928.41,305878.0700000005,306806.48000000045,-928.4099999999744
16093,2022-05-30 08:05:00,-645.35,305232.7200000005,306806.48000000045,-1573.759999999951
16094,2022-05-30 08:10:00,1398.62,306631.3400000005,306806.48000000045,-175.13999999995576
16095,2022-05-30 08:15:00,925.41,307556.75000000047,306806.48000000045,750.2700000000186
16096,2022-05-30 08:20:00,71.18,307627.93000000046,306806.48000000045,821.4500000000116
16097,2022-05-30 08:25:00,1592.13,309220.06000000046,306806.48000000045,2413.5800000000163
16098,2022-05-30 08:30:00,217.53,309437.5900000005,306806.48000000045,2631.1100000000442
16099,2022-05-30 08:35:00,-1773.0,307664.5900000005,306806.48000000045,858.1100000000442
16100,2022-05-30 08:40:00,778.42,308443.0100000005,306806.48000000045,1636.530000000028
16101,2022-05-30 08:45:00,1761.27,310204.2800000005,306806.48000000045,3397.8000000000466
16102,2022-05-30 08:50:00,116.1,310320.38000000047,306806.48000000045,3513.9000000000233
16103,2022-05-30 08:55:00,1906.81,312227.19000000047,306806.48000000045,5420.710000000021
16104,2022-05-30 09:00:00,1811.58,314038.7700000005,306806.48000000045,7232.290000000037
16105,2022-05-30 09:05:00,817.34,314856.1100000005,306806.48000000045,8049.630000000063
16106,2022-05-30 09:10:00,932.35,315788.4600000005,306806.48000000045,8981.98000000004
16107,2022-05-30 09:15:00,1628.58,317417.0400000005,306806.48000000045,10610.560000000056
16108,2022-05-30 09:20:00,55.89,317472.9300000005,306806.48000000045,10666.45000000007
16109,2022-05-30 09:25:00,-797.73,316675.20000000054,306806.48000000045,9868.720000000088
16110,2022-05-30 09:30:00,259.45,316934.65000000055,306806.48000000045,10128.1700000001
16111,2022-05-30 09:35:00,1159.44,318094.09000000055,306806.48000000045,11287.610000000102
16112,2022-05-30 09:40:00,643.92,318738.01000000053,306806.48000000045,11931.530000000086
16113,2022-05-30 09:45:00,-684.58,318053.4300000005,306806.48000000045,11246.95000000007
16114,2022-05-30 09:50:00,-34.89,318018.5400000005,306806.48000000045,11212.060000000056
16115,2022-05-30 09:55:00,193.47,318212.0100000005,306806.48000000045,11405.530000000028
16116,2022-05-30 10:00:00,211.14,318423.1500000005,306806.48000000045,11616.670000000042
16117,2022-05-30 10:05:00,100.31,318523.4600000005,306806.48000000045,11716.98000000004
16118,2022-05-30 10:10:00,1559.74,320083.2000000005,306806.48000000045,13276.72000000003
16119,2022-05-30 10:15:00,1308.74,321391.94000000047,306806.48000000045,14585.460000000021
16120,2022-05-30 10:20:00,1581.18,322973.12000000046,306806.48000000045,16166.640000000014
16121,2022-05-30 10:25:00,-610.77,322362.35000000044,306806.48000000045,15555.869999999995
16122,2022-05-30 10:30:00,-312.82,322049.53000000044,306806.48000000045,15243.049999999988
16123,2022-05-30 10:35:00,-1978.94,320070.59000000043,306806.48000000045,13264.109999999986
16124,2022-05-30 10:40:00,89.35,320159.9400000004,306806.48000000045,13353.459999999963
16125,2022-05-30 10:45:00,654.72,320814.6600000004,306806.48000000045,14008.179999999935
16126,2022-05-30 10:50:00,-606.62,320208.0400000004,306806.48000000045,13401.55999999994
16127,2022-05-30 10:55:00,-1061.46,319146.58000000037,306806.48000000045,12340.099999999919
16128,2022-05-30 11:00:00,600.23,319746.81000000035,306806.48000000045,12940.3299999999
16129,2022-05-30 11:05:00,-1225.56,318521.25000000035,306806.48000000045,11714.769999999902
16130,2022-05-30 11:10:00,-1309.33,317211.92000000033,306806.48000000045,10405.439999999886
16131,2022-05-30 11:15:00,667.25,317879.17000000033,306806.48000000045,11072.689999999886
16132,2022-05-30 11:20:00,407.15,318286.32000000036,306806.48000000045,11479.83999999991
16133,2022-05-30 11:25:00,-674.81,317611.51000000036,306806.48000000045,10805.029999999912
16134,2022-05-30 11:30:00,-50.47,317561.0400000004,306806.48000000045,10754.55999999994
16135,2022-05-30 11:35:00,-1067.6,316493.4400000004,306806.48000000045,9686.959999999963
16136,2022-05-30 11:40:00,-1258.61,315234.8300000004,306806.48000000045,8428.349999999977
16137,2022-05-30 11:45:00,-1220.94,314013.8900000004,306806.48000000045,7207.409999999974
16138,2022-05-30 11:50:00,-1806.19,312207.7000000004,306806.48000000045,5401.219999999972
16139,2022-05-30 11:55:00,9.92,312217.6200000004,306806.48000000045,5411.139999999956
16140,2022-05-30 12:00:00,858.36,313075.9800000004,306806.48000000045,6269.499999999942
16141,2022-05-30 12:05:00,1945.5,315021.4800000004,306806.48000000045,8214.999999999942
16142,2022-05-30 12:10:00,-1320.33,313701.1500000004,306806.48000000045,6894.6699999999255
16143,2022-05-30 12:15:00,-593.58,313107.57000000036,306806.48000000045,6301.089999999909
16144,2022-05-30 12:20:00,881.68,313989.25000000035,306806.48000000045,7182.769999999902
16145,2022-05-30 12:25:00,1641.83,315631.08000000037,306806.48000000045,8824.599999999919
16146,2022-05-30 12:30:00,-1683.09,313947.99000000034,306806.48000000045,7141.509999999893
16147,2022-05-30 12:35:00,-1541.0,312406.99000000034,306806.48000000045,5600.509999999893
16148,2022-05-30 12:40:00,1619.04,314026.0300000003,306806.48000000045,7219.549999999872
16149,2022-05-30 12:45:00,-1407.78,312618.2500000003,306806.48000000045,5811.769999999844
16150,2022-05-30 12:50:00,1725.18,314343.4300000003,306806.48000000045,7536.949999999837
16151,2022-05-30 12:55:00,1281.35,315624.78000000026,306806.48000000045,8818.299999999814
16152,2022-05-30 13:00:00,1890.21,317514.9900000003,306806.48000000045,10708.509999999835
16153,2022-05-30 13:05:00,1687.39,319202.3800000003,306806.48000000045,12395.899999999849
16154,2022-05-30 13:10:00,807.13,320009.5100000003,306806.48000000045,13203.029999999853
16155,2022-05-30 13:15:00,-999.9,319009.6100000003,306806.48000000045,12203.12999999983
16156,2022-05-30 13:20:00,1107.19,320116.8000000003,306806.48000000045,13310.319999999832
16157,2022-05-30 13:25:00,-1545.85,318570.9500000003,306806.48000000045,11764.469999999856
16158,2022-05-30 13:30:00,1641.75,320212.7000000003,306806.48000000045,13406.219999999856
16159,2022-05-30 13:35:00,-164.11,320048.5900000003,306806.48000000045,13242.10999999987
16160,2022-05-30 13:40:00,-830.23,319218.36000000034,306806.48000000045,12411.879999999888
16161,2022-05-30 13:45:00,1133.4,320351.76000000036,306806.48000000045,13545.279999999912
16162,2022-05-30 13:50:00,-413.46,319938.30000000034,306806.48000000045,13131.81999999989
16163,2022-05-30 13:55:00,-1217.25,318721.05000000034,306806.48000000045,11914.56999999989
16164,2022-05-30 14:00:00,375.47,319096.5200000003,306806.48000000045,12290.039999999863
16165,2022-05-30 14:05:00,-356.48,318740.0400000003,306806.48000000045,11933.559999999881
16166,2022-05-30 14:10:00,946.45,319686.49000000034,306806.48000000045,12880.009999999893
16167,2022-05-30 14:15:00,-1906.53,317779.9600000003,306806.48000000045,10973.479999999865
16168,2022-05-30 14:20:00,83.5,317863.4600000003,306806.48000000045,11056.979999999865
16169,2022-05-30 14:25:00,-492.82,317370.6400000003,306806.48000000045,10564.159999999858
16170,2022-05-30 14:30:00,-799.4,316571.2400000003,306806.48000000045,9764.759999999835
16171,2022-05-30 14:35:00,701.67,317272.91000000027,306806.48000000045,10466.429999999818
16172,2022-05-30 14:40:00,-921.97,316350.9400000003,306806.48000000045,9544.459999999846
16173,2022-05-30 14:45:00,-642.04,315708.9000000003,306806.48000000045,8902.419999999867
16174,2022-05-30 14:50:00,1521.62,317230.5200000003,306806.48000000045,10424.039999999863
16175,2022-05-30 14:55:00,-295.39,316935.1300000003,306806.48000000045,10128.649999999849
16176,2022-05-30 15:00:00,-350.63,316584.5000000003,306806.48000000045,9778.019999999844
16177,2022-05-30 15:05:00,-1625.61,314958.8900000003,306806.48000000045,8152.409999999858
16178,2022-05-30 15:10:00,-374.28,314584.6100000003,306806.48000000045,7778.12999999983
16179,2022-05-30 15:15:00,-1772.56,312812.0500000003,306806.48000000045,6005.569999999832
16180,2022-05-30 15:20:00,-1311.84,311500.21000000025,306806.48000000045,4693.729999999807
16181,2022-05-30 15:25:00,1108.45,312608.66000000027,306806.48000000045,5802.179999999818
16182,2022-05-30 15:30:00,188.71,312797.3700000003,306806.48000000045,5990.889999999839
16183,2022-05-30 15:35:00,-562.67,312234.7000000003,306806.48000000045,5428.219999999856
16184,2022-05-30 15:40:00,1669.72,313904.4200000003,306806.48000000045,7097.939999999828
16185,2022-05-30 15:45:00,1068.65,314973.0700000003,306806.48000000045,8166.589999999851
16186,2022-05-30 15:50:00,-856.99,314116.0800000003,306806.48000000045,7309.59999999986
16187,2022-05-30 15:55:00,-1238.47,312877.61000000034,306806.48000000045,6071.129999999888
16188,2022-05-30 16:00:00,-631.7,312245.9100000003,306806.48000000045,5439.429999999877
16189,2022-05-30 16:05:00,-1522.66,310723.25000000035,306806.48000000045,3916.769999999902
16190,2022-05-30 16:10:00,-89.68,310633.57000000036,306806.48000000045,3827.089999999909
16191,2022-05-30 16:15:00,-994.4,309639.17000000033,306806.48000000045,2832.689999999886
16192,2022-05-30 16:20:00,982.12,310621.2900000003,306806.48000000045,3814.8099999998813
16193,2022-05-30 16:25:00,228.46,310849.75000000035,306806.48000000045,4043.269999999902
16194,2022-05-30 16:30:00,-1194.84,309654.9100000003,306806.48000000045,2848.4299999998766
16195,2022-05-30 16:35:00,524.96,310179.87000000034,306806.48000000045,3373.3899999998976
16196,2022-05-30 16:40:00,-416.57,309763.30000000034,306806.48000000045,2956.8199999998906
16197,2022-05-30 16:45:00,331.79,310095.0900000003,306806.48000000045,3288.6099999998696
16198,2022-05-30 16:50:00,1372.85,311467.9400000003,306806.48000000045,4661.459999999846
16199,2022-05-30 16:55:00,-1492.56,309975.3800000003,306806.48000000045,3168.8999999998487
16200,2022-05-31 08:00:00,1934.7,311910.0800000003,309975.3800000003,1934.7000000000116
16201,2022-05-31 08:05:00,933.34,312843.42000000033,309975.3800000003,2868.0400000000373
16202,2022-05-31 08:10:00,-582.61,312260.81000000035,309975.3800000003,2285.430000000051
16203,2022-05-31 08:15:00,-1949.95,310310.86000000034,309975.3800000003,335.4800000000396
16204,2022-05-31 08:20:00,-1604.05,308706.81000000035,309975.3800000003,-1268.5699999999488
16205,2022-05-31 08:25:00,231.46,308938.27000000037,309975.3800000003,-1037.1099999999278
16206,2022-05-31 08:30:00,1671.51,310609.7800000004,309975.3800000003,634.4000000000815
16207,2022-05-31 08:35:00,-471.92,310137.8600000004,309975.3800000003,162.4800000000978
16208,2022-05-31 08:40:00,948.54,311086.4000000004,309975.3800000003,1111.0200000000768
16209,2022-05-31 08:45:00,1314.62,312401.02000000037,309975.3800000003,2425.640000000072
16210,2022-05-31 08:50:00,-403.21,311997.81000000035,309975.3800000003,2022.4300000000512
16211,2022-05-31 08:55:00,-1763.96,310233.8500000003,309975.3800000003,258.47000000003027
16212,2022-05-31 09:00:00,-1151.75,309082.1000000003,309975.3800000003,-893.2799999999697
16213,2022-05-31 09:05:00,-439.08,308643.0200000003,309975.3800000003,-1332.359999999986
16214,2022-05-31 09:10:00,-1853.37,306789.6500000003,309975.3800000003,-3185.7299999999814
16215,2022-05-31 09:15:00,-1512.12,305277.5300000003,309975.3800000003,-4697.849999999977
16216,2022-05-31 09:20:00,34.81,305312.3400000003,309975.3800000003,-4663.039999999979
16217,2022-05-31 09:25:00,1603.63,306915.9700000003,309975.3800000003,-3059.4099999999744
16218,2022-05-31 09:30:00,-612.54,306303.43000000034,309975.3800000003,-3671.9499999999534
16219,2022-05-31 09:35:00,26.12,306329.55000000034,309975.3800000003,-3645.829999999958
16220,2022-05-31 09:40:00,1426.07,307755.62000000034,309975.3800000003,-2219.759999999951
16221,2022-05-31 09:45:00,-1033.42,306722.20000000036,309975.3800000003,-3253.179999999935
16222,2022-05-31 09:50:00,-1720.07,305002.13000000035,309975.3800000003,-4973.249999999942
16223,2022-05-31 09:55:00,1825.25,306827.38000000035,309975.3800000003,-3147.999999999942
16224,2022-05-31 10:00:00,-113.47,306713.9100000004,309975.3800000003,-3261.469999999914
16225,2022-05-31 10:05:00,-1599.04,305114.8700000004,309975.3800000003,-4860.509999999893
16226,2022-05-31 10:10:00,776.78,305891.65000000043,309975.3800000003,-4083.729999999865
16227,2022-05-31 10:15:00,-257.44,305634.2100000004,309975.3800000003,-4341.169999999867
16228,2022-05-31 10:20:00,1982.45,307616.66000000044,309975.3800000003,-2358.7199999998556
16229,2022-05-31 10:25:00,1496.5,309113.16000000044,309975.3800000003,-862.2199999998556
16230,2022-05-31 10:30:00,1850.47,310963.6300000004,309975.3800000003,988.2500000001164
16231,2022-05-31 10:35:00,-17.3,310946.3300000004,309975.3800000003,970.9500000001281
16232,2022-05-31 10:40:00,473.83,311420.16000000044,309975.3800000003,1444.7800000001444
16233,2022-05-31 10:45:00,-249.42,311170.74000000046,309975.3800000003,1195.3600000001607
16234,2022-05-31 10:50:00,257.35,311428.09000000043,309975.3800000003,1452.7100000001374
16235,2022-05-31 10:55:00,291.47,311719.5600000004,309975.3800000003,1744.1800000001094
16236,2022-05-31 11:00:00,445.25,312164.8100000004,309975.3800000003,2189.4300000001094
16237,2022-05-31 11:05:00,1744.56,313909.3700000004,309975.3800000003,3933.990000000107
16238,2022-05-31 11:10:00,1140.46,315049.8300000004,309975.3800000003,5074.450000000128
16239,2022-05-31 11:15:00,-787.79,314262.04000000044,309975.3800000003,4286.660000000149
16240,2022-05-31 11:20:00,-138.19,314123.85000000044,309975.3800000003,4148.470000000147
16241,2022-05-31 11:25:00,-1715.44,312408.41000000044,309975.3800000003,2433.0300000001444
16242,2022-05-31 11:30:00,768.95,313177.36000000045,309975.3800000003,3201.980000000156
16243,2022-05-31 11:35:00,-1732.98,311444.38000000047,309975.3800000003,1469.0000000001746
16244,2022-05-31 11:40:00,-1292.93,310151.4500000005,309975.3800000003,176.0700000001816
16245,2022-05-31 11:45:00,-559.97,309591.4800000005,309975.3800000003,-383.89999999979045
16246,2022-05-31 11:50:00,-663.12,308928.3600000005,309975.3800000003,-1047.0199999997858
16247,2022-05-31 11:55:00,-1487.09,307441.2700000005,309975.3800000003,-2534.1099999998114
16248,2022-05-31 12:00:00,1887.0,309328.2700000005,309975.3800000003,-647.1099999998114
16249,2022-05-31 12:05:00,1138.86,310467.13000000047,309975.3800000003,491.7500000001746
16250,2022-05-31 12:10:00,-1025.11,309442.0200000005,309975.3800000003,-533.3599999998114
16251,2022-05-31 12:15:00,545.5,309987.5200000005,309975.3800000003,12.140000000188593
16252,2022-05-31 12:20:00,-162.57,309824.9500000005,309975.3800000003,-150.4299999998184
16253,2022-05-31 12:25:00,1537.56,311362.5100000005,309975.3800000003,1387.1300000001793
16254,2022-05-31 12:30:00,-422.86,310939.6500000005,309975.3800000003,964.2700000001932
16255,2022-05-31 12:35:00,-1227.17,309712.4800000005,309975.3800000003,-262.89999999979045
16256,2022-05-31 12:40:00,-1791.82,307920.6600000005,309975.3800000003,-2054.7199999997974
16257,2022-05-31 12:45:00,-4.49,307916.1700000005,309975.3800000003,-2059.209999999788
16258,2022-05-31 12:50:00,-39.79,307876.3800000005,309975.3800000003,-2098.999999999767
16259,2022-05-31 12:55:00,693.8,308570.1800000005,309975.3800000003,-1405.1999999997788
16260,2022-05-31 13:00:00,-1843.6,306726.58000000054,309975.3800000003,-3248.7999999997555
16261,2022-05-31 13:05:00,1838.41,308564.9900000005,309975.3800000003,-1410.3899999997811
16262,2022-05-31 13:10:00,-915.91,307649.08000000054,309975.3800000003,-2326.2999999997555
16263,2022-05-31 13:15:00,358.31,308007.39000000054,309975.3800000003,-1967.9899999997579
16264,2022-05-31 13:20:00,-635.99,307371.40000000055,309975.3800000003,-2603.9799999997485
16265,2022-05-31 13:25:00,1111.17,308482.57000000053,309975.3800000003,-1492.8099999997648
16266,2022-05-31 13:30:00,-88.92,308393.65000000055,309975.3800000003,-1581.7299999997485
16267,2022-05-31 13:35:00,1376.48,309770.1300000005,309975.3800000003,-205.24999999976717
16268,2022-05-31 13:40:00,-964.65,308805.4800000005,309975.3800000003,-1169.8999999997905
16269,2022-05-31 13:45:00,1133.98,309939.4600000005,309975.3800000003,-35.91999999980908
16270,2022-05-31 13:50:00,1219.73,311159.19000000047,309975.3800000003,1183.8100000001723
16271,2022-05-31 13:55:00,1272.13,312431.3200000005,309975.3800000003,2455.940000000177
16272,2022-05-31 14:00:00,-434.42,311996.9000000005,309975.3800000003,2021.5200000001932
16273,2022-05-31 14:05:00,-345.33,311651.5700000005,309975.3800000003,1676.190000000177
16274,2022-05-31 14:10:00,-392.29,311259.2800000005,309975.3800000003,1283.900000000198
16275,2022-05-31 14:15:00,-1912.28,309347.00000000047,309975.3800000003,-628.37999999983
16276,2022-05-31 14:20:00,5.79,309352.79000000044,309975.3800000003,-622.589999999851
16277,2022-05-31 14:25:00,1173.02,310525.81000000046,309975.3800000003,550.4300000001676
16278,2022-05-31 14:30:00,-1779.66,308746.1500000005,309975.3800000003,-1229.2299999998068
16279,2022-05-31 14:35:00,1099.67,309845.8200000005,309975.3800000003,-129.55999999982305
16280,2022-05-31 14:40:00,-1702.21,308143.61000000045,309975.3800000003,-1831.769999999844
16281,2022-05-31 14:45:00,842.94,308986.55000000045,309975.3800000003,-988.8299999998417
16282,2022-05-31 14:50:00,-272.26,308714.29000000044,309975.3800000003,-1261.089999999851
16283,2022-05-31 14:55:00,486.42,309200.7100000004,309975.3800000003,-774.6699999998673
16284,2022-05-31 15:00:00,-340.3,308860.41000000044,309975.3800000003,-1114.9699999998556
16285,2022-05-31 15:05:00,1873.58,310733.99000000046,309975.3800000003,758.6100000001607
16286,2022-05-31 15:10:00,-1818.64,308915.35000000044,309975.3800000003,-1060.0299999998533
16287,2022-05-31 15:15:00,-264.02,308651.3300000004,309975.3800000003,-1324.049999999872
16288,2022-05-31 15:20:00,303.37,308954.7000000004,309975.3800000003,-1020.6799999998766
16289,2022-05-31 15:25:00,704.33,309659.03000000044,309975.3800000003,-316.3499999998603
16290,2022-05-31 15:30:00,-1515.46,308143.5700000004,309975.3800000003,-1831.8099999998813
16291,2022-05-31 15:35:00,1450.59,309594.16000000044,309975.3800000003,-381.21999999985565
16292,2022-05-31 15:40:00,931.73,310525.8900000004,309975.3800000003,550.5100000001257
16293,2022-05-31 15:45:00,1548.56,312074.4500000004,309975.3800000003,2099.0700000001234
16294,2022-05-31 15:50:00,-1890.81,310183.6400000004,309975.3800000003,208.26000000012573
16295,2022-05-31 15:55:00,1050.17,311233.8100000004,309975.3800000003,1258.4300000001094
16296,2022-05-31 16:00:00,-1490.11,309743.7000000004,309975.3800000003,-231.6799999998766
16297,2022-05-31 16:05:00,149.16,309892.8600000004,309975.3800000003,-82.51999999990221
16298,2022-05-31 16:10:00,-1318.73,308574.1300000004,309975.3800000003,-1401.2499999998836
16299,2022-05-31 16:15:00,-181.62,308392.5100000004,309975.3800000003,-1582.869999999879
16300,2022-05-31 16:20:00,632.55,309025.0600000004,309975.3800000003,-950.3199999998906
16301,2022-05-31 16:25:00,238.64,309263.7000000004,309975.3800000003,-711.6799999998766
16302,2022-05-31 16:30:00,7.27,309270.97000000044,309975.3800000003,-704.409999999858
16303,2022-05-31 16:35:00,1040.57,310311.54000000044,309975.3800000003,336.160000000149
16304,2022-05-31 16:40:00,286.82,310598.36000000045,309975.3800000003,622.980000000156
16305,2022-05-31 16:45:00,-870.25,309728.11000000045,309975.3800000003,-247.269999999844
16306,2022-05-31 16:50:00,-1933.55,307794.56000000046,309975.3800000003,-2180.8199999998324
16307,2022-05-31 16:55:00,-1674.27,306120.29000000044,309975.3800000003,-3855.089999999851
16308,2022-06-01 08:00:00,-182.69,305937.60000000044,306120.29000000044,-182.69000000000233
16309,2022-06-01 08:05:00,-622.82,305314.78000000044,306120.29000000044,-805.5100000000093
16310,2022-06-01 08:10:00,-185.06,305129.72000000044,306120.29000000044,-990.570000000007
16311,2022-06-01 08:15:00,762.0,305891.72000000044,306120.29000000044,-228.57000000000698
16312,2022-06-01 08:20:00,375.21,306266.93000000046,306120.29000000044,146.64000000001397
16313,2022-06-01 08:25:00,1219.71,307486.6400000005,306120.29000000044,1366.350000000035
16314,2022-06-01 08:30:00,249.12,307735.7600000005,306120.29000000044,1615.4700000000303
16315,2022-06-01 08:35:00,1364.79,309100.55000000045,306120.29000000044,2980.2600000000093
16316,2022-06-01 08:40:00,852.63,309953.18000000046,306120.29000000044,3832.890000000014
16317,2022-06-01 08:45:00,479.67,310432.85000000044,306120.29000000044,4312.559999999998
16318,2022-06-01 08:50:00,1643.1,312075.9500000004,306120.29000000044,5955.659999999974
16319,2022-06-01 08:55:00,-1975.11,310100.84000000043,306120.29000000044,3980.5499999999884
16320,2022-06-01 09:00:00,-1628.96,308471.8800000004,306120.29000000044,2351.5899999999674
16321,2022-06-01 09:05:00,-1637.22,306834.66000000044,306120.29000000044,714.3699999999953
16322,2022-06-01 09:10:00,1028.8,307863.4600000004,306120.29000000044,1743.1699999999837
16323,2022-06-01 09:15:00,1050.18,308913.6400000004,306120.29000000044,2793.3499999999767
16324,2022-06-01 09:20:00,1943.15,310856.79000000044,306120.29000000044,4736.5
16325,2022-06-01 09:25:00,1045.04,311901.8300000004,306120.29000000044,5781.539999999979
16326,2022-06-01 09:30:00,1159.46,313061.29000000044,306120.29000000044,6941.0
16327,2022-06-01 09:35:00,-1249.97,311811.3200000005,306120.29000000044,5691.030000000028
16328,2022-06-01 09:40:00,300.51,312111.8300000005,306120.29000000044,5991.540000000037
16329,2022-06-01 09:45:00,1219.44,313331.2700000005,306120.29000000044,7210.98000000004
16330,2022-06-01 09:50:00,-1271.53,312059.74000000046,306120.29000000044,5939.450000000012
16331,2022-06-01 09:55:00,141.09,312200.8300000005,306120.29000000044,6080.540000000037
16332,2022-06-01 10:00:00,-1442.41,310758.4200000005,306120.29000000044,4638.130000000063
16333,2022-06-01 10:05:00,1604.33,312362.7500000005,306120.29000000044,6242.460000000079
16334,2022-06-01 10:10:00,-262.41,312100.34000000055,306120.29000000044,5980.050000000105
16335,2022-06-01 10:15:00,1542.34,313642.6800000006,306120.29000000044,7522.39000000013
16336,2022-06-01 10:20:00,1066.63,314709.3100000006,306120.29000000044,8589.020000000135
16337,2022-06-01 10:25:00,1464.68,316173.9900000006,306120.29000000044,10053.700000000128
16338,2022-06-01 10:30:00,-871.94,315302.05000000057,306120.29000000044,9181.760000000126
16339,2022-06-01 10:35:00,-1017.06,314284.9900000006,306120.29000000044,8164.700000000128
16340,2022-06-01 10:40:00,1937.46,316222.4500000006,306120.29000000044,10102.160000000149
16341,2022-06-01 10:45:00,974.26,317196.7100000006,306120.29000000044,11076.420000000158
16342,2022-06-01 10:50:00,734.14,317930.8500000006,306120.29000000044,11810.560000000172
16343,2022-06-01 10:55:00,817.53,318748.38000000064,306120.29000000044,12628.0900000002
16344,2022-06-01 11:00:00,207.04,318955.4200000006,306120.29000000044,12835.13000000018
16345,2022-06-01 11:05:00,1965.18,320920.6000000006,306120.29000000044,14800.310000000172
16346,2022-06-01 11:10:00,1652.9,322573.50000000064,306120.29000000044,16453.210000000196
16347,2022-06-01 11:15:00,998.0,323571.50000000064,306120.29000000044,17451.210000000196
16348,2022-06-01 11:20:00,-911.25,322660.25000000064,306120.29000000044,16539.960000000196
16349,2022-06-01 11:25:00,45.69,322705.94000000064,306120.29000000044,16585.650000000198
16350,2022-06-01 11:30:00,-1132.84,321573.1000000006,306120.29000000044,15452.810000000172
16351,2022-06-01 11:35:00,-1267.05,320306.0500000006,306120.29000000044,14185.760000000184
16352,2022-06-01 11:40:00,-1027.06,319278.99000000063,306120.29000000044,13158.700000000186
16353,2022-06-01 11:45:00,-381.38,318897.6100000006,306120.29000000044,12777.320000000182
16354,2022-06-01 11:50:00,810.77,319708.38000000064,306120.29000000044,13588.0900000002
16355,2022-06-01 11:55:00,153.73,319862.1100000006,306120.29000000044,13741.820000000182
16356,2022-06-01 12:00:00,162.13,320024.24000000063,306120.29000000044,13903.950000000186
16357,2022-06-01 12:05:00,-216.73,319807.51000000065,306120.29000000044,13687.220000000205
16358,2022-06-01 12:10:00,-1002.28,318805.2300000006,306120.29000000044,12684.940000000177
16359,2022-06-01 12:15:00,-1092.91,317712.32000000065,306120.29000000044,11592.030000000203
16360,2022-06-01 12:20:00,-299.33,317412.99000000063,306120.29000000044,11292.700000000186
16361,2022-06-01 12:25:00,-721.99,316691.00000000064,306120.29000000044,10570.710000000196
16362,2022-06-01 12:30:00,1827.57,318518.57000000065,306120.29000000044,12398.280000000203
16363,2022-06-01 12:35:00,619.92,319138.49000000063,306120.29000000044,13018.200000000186
16364,2022-06-01 12:40:00,940.53,320079.02000000066,306120.29000000044,13958.730000000214
16365,2022-06-01 12:45:00,-1024.51,319054.51000000065,306120.29000000044,12934.220000000205
16366,2022-06-01 12:50:00,312.62,319367.13000000064,306120.29000000044,13246.8400000002
16367,2022-06-01 12:55:00,1607.46,320974.59000000067,306120.29000000044,14854.300000000221
16368,2022-06-01 13:00:00,-250.13,320724.46000000066,306120.29000000044,14604.170000000217
16369,2022-06-01 13:05:00,-1293.87,319430.59000000067,306120.29000000044,13310.300000000221
16370,2022-06-01 13:10:00,-1768.2,317662.39000000065,306120.29000000044,11542.10000000021
16371,2022-06-01 13:15:00,-1530.28,316132.1100000006,306120.29000000044,10011.820000000182
16372,2022-06-01 13:20:00,-941.42,315190.69000000064,306120.29000000044,9070.400000000198
16373,2022-06-01 13:25:00,-1772.48,313418.21000000066,306120.29000000044,7297.9200000002165
16374,2022-06-01 13:30:00,1596.7,315014.9100000007,306120.29000000044,8894.620000000228
16375,2022-06-01 13:35:00,-770.0,314244.9100000007,306120.29000000044,8124.620000000228
16376,2022-06-01 13:40:00,-1989.97,312254.9400000007,306120.29000000044,6134.650000000256
16377,2022-06-01 13:45:00,-656.64,311598.3000000007,306120.29000000044,5478.010000000242
16378,2022-06-01 13:50:00,-1185.96,310412.34000000067,306120.29000000044,4292.050000000221
16379,2022-06-01 13:55:00,44.64,310456.9800000007,306120.29000000044,4336.690000000235
16380,2022-06-01 14:00:00,1853.33,312310.3100000007,306120.29000000044,6190.0200000002515
16381,2022-06-01 14:05:00,1110.59,313420.9000000007,306120.29000000044,7300.610000000277
16382,2022-06-01 14:10:00,-1077.23,312343.67000000074,306120.29000000044,6223.380000000296
16383,2022-06-01 14:15:00,1924.95,314268.62000000075,306120.29000000044,8148.330000000307
16384,2022-06-01 14:20:00,357.97,314626.5900000007,306120.29000000044,8506.30000000028
16385,2022-06-01 14:25:00,-989.79,313636.80000000075,306120.29000000044,7516.5100000003
16386,2022-06-01 14:30:00,-764.67,312872.13000000076,306120.29000000044,6751.840000000317
16387,2022-06-01 14:35:00,-1935.85,310936.2800000008,306120.29000000044,4815.99000000034
16388,2022-06-01 14:40:00,1778.32,312714.6000000008,306120.29000000044,6594.310000000347
16389,2022-06-01 14:45:00,-394.53,312320.07000000076,306120.29000000044,6199.780000000319
16390,2022-06-01 14:50:00,1326.83,313646.9000000008,306120.29000000044,7526.610000000335
16391,2022-06-01 14:55:00,-1803.92,311842.9800000008,306120.29000000044,5722.690000000352
16392,2022-06-01 15:00:00,-298.97,311544.0100000008,306120.29000000044,5423.7200000003795
16393,2022-06-01 15:05:00,1624.47,313168.4800000008,306120.29000000044,7048.190000000352
16394,2022-06-01 15:10:00,1658.03,314826.5100000008,306120.29000000044,8706.22000000038
16395,2022-06-01 15:15:00,-1132.51,313694.0000000008,306120.29000000044,7573.71000000037
16396,2022-06-01 15:20:00,-1504.3,312189.7000000008,306120.29000000044,6069.410000000382
16397,2022-06-01 15:25:00,-951.22,311238.48000000085,306120.29000000044,5118.19000000041
16398,2022-06-01 15:30:00,-1600.24,309638.24000000086,306120.29000000044,3517.950000000419
16399,2022-06-01 15:35:00,584.74,310222.98000000085,306120.29000000044,4102.69000000041
16400,2022-06-01 15:40:00,1109.17,311332.15000000084,306120.29000000044,5211.8600000003935
16401,2022-06-01 15:45:00,1779.81,313111.96000000084,306120.29000000044,6991.670000000391
16402,2022-06-01 15:50:00,1772.2,314884.16000000085,306120.29000000044,8763.870000000403
16403,2022-06-01 15:55:00,-1427.53,313456.6300000008,306120.29000000044,7336.340000000375
16404,2022-06-01 16:00:00,-820.75,312635.8800000008,306120.29000000044,6515.590000000375
16405,2022-06-01 16:05:00,-1627.23,311008.65000000084,306120.29000000044,4888.3600000003935
16406,2022-06-01 16:10:00,1833.38,312842.03000000084,306120.29000000044,6721.740000000398
16407,2022-06-01 16:15:00,808.61,313650.6400000008,306120.29000000044,7530.350000000384
16408,2022-06-01 16:20:00,315.82,313966.46000000084,306120.29000000044,7846.170000000391
16409,2022-06-01 16:25:00,10.75,313977.21000000084,306120.29000000044,7856.920000000391
16410,2022-06-01 16:30:00,-1888.94,312088.27000000083,306120.29000000044,5967.980000000389
16411,2022-06-01 16:35:00,1875.39,313963.66000000085,306120.29000000044,7843.370000000403
16412,2022-06-01 16:40:00,1737.72,315701.3800000008,306120.29000000044,9581.090000000375
16413,2022-06-01 16:45:00,1465.39,317166.77000000083,306120.29000000044,11046.480000000389
16414,2022-06-01 16:50:00,-1368.2,315798.5700000008,306120.29000000044,9678.280000000377
16415,2022-06-01 16:55:00,153.18,315951.7500000008,306120.29000000044,9831.46000000037
16416,2022-06-02 08:00:00,-1955.82,313995.9300000008,315951.7500000008,-1955.820000000007
16417,2022-06-02 08:05:00,1506.89,315502.8200000008,315951.7500000008,-448.929999999993
16418,2022-06-02 08:10:00,1353.37,316856.1900000008,315951.7500000008,904.4400000000023
16419,2022-06-02 08:15:00,1412.11,318268.3000000008,315951.7500000008,2316.5499999999884
16420,2022-06-02 08:20:00,-1184.02,317084.2800000008,315951.7500000008,1132.5299999999697
16421,2022-06-02 08:25:00,1818.41,318902.69000000076,315951.7500000008,2950.939999999944
16422,2022-06-02 08:30:00,1910.18,320812.87000000075,315951.7500000008,4861.119999999937
16423,2022-06-02 08:35:00,14.2,320827.07000000076,315951.7500000008,4875.319999999949
16424,2022-06-02 08:40:00,-1739.79,319087.2800000008,315951.7500000008,3135.5299999999697
16425,2022-06-02 08:45:00,1349.66,320436.94000000076,315951.7500000008,4485.189999999944
16426,2022-06-02 08:50:00,-1297.64,319139.30000000075,315951.7500000008,3187.54999999993
16427,2022-06-02 08:55:00,-1129.75,318009.55000000075,315951.7500000008,2057.79999999993
16428,2022-06-02 09:00:00,-130.96,317878.5900000007,315951.7500000008,1926.8399999999092
16429,2022-06-02 09:05:00,-1728.71,316149.8800000007,315951.7500000008,198.12999999988824
16430,2022-06-02 09:10:00,-1127.09,315022.7900000007,315951.7500000008,-928.9600000001374
16431,2022-06-02 09:15:00,501.41,315524.20000000065,315951.7500000008,-427.550000000163
16432,2022-06-02 09:20:00,1967.42,317491.62000000064,315951.7500000008,1539.8699999998207
16433,2022-06-02 09:25:00,1762.55,319254.1700000006,315951.7500000008,3302.419999999809
16434,2022-06-02 09:30:00,798.95,320053.12000000064,315951.7500000008,4101.369999999821
16435,2022-06-02 09:35:00,-370.92,319682.20000000065,315951.7500000008,3730.449999999837
16436,2022-06-02 09:40:00,572.48,320254.68000000063,315951.7500000008,4302.929999999818
16437,2022-06-02 09:45:00,546.34,320801.02000000066,315951.7500000008,4849.269999999844
16438,2022-06-02 09:50:00,283.76,321084.78000000067,315951.7500000008,5133.029999999853
16439,2022-06-02 09:55:00,-766.77,320318.01000000065,315951.7500000008,4366.259999999835
16440,2022-06-02 10:00:00,-1056.64,319261.37000000064,315951.7500000008,3309.6199999998207
16441,2022-06-02 10:05:00,-1935.52,317325.8500000006,315951.7500000008,1374.099999999802
16442,2022-06-02 10:10:00,1508.05,318833.9000000006,315951.7500000008,2882.1499999997905
16443,2022-06-02 10:15:00,1080.84,319914.74000000063,315951.7500000008,3962.989999999816
16444,2022-06-02 10:20:00,627.06,320541.8000000006,315951.7500000008,4590.049999999814
16445,2022-06-02 10:25:00,-1136.97,319404.83000000066,315951.7500000008,3453.0799999998417
16446,2022-06-02 10:30:00,-1726.3,317678.53000000067,315951.7500000008,1726.7799999998533
16447,2022-06-02 10:35:00,1269.42,318947.95000000065,315951.7500000008,2996.199999999837
16448,2022-06-02 10:40:00,1704.97,320652.9200000006,315951.7500000008,4701.169999999809
16449,2022-06-02 10:45:00,343.26,320996.18000000063,315951.7500000008,5044.429999999818
16450,2022-06-02 10:50:00,-1.22,320994.96000000066,315951.7500000008,5043.209999999846
16451,2022-06-02 10:55:00,-1275.48,319719.4800000007,315951.7500000008,3767.729999999865
16452,2022-06-02 11:00:00,-1103.63,318615.8500000007,315951.7500000008,2664.0999999998603
16453,2022-06-02 11:05:00,-1989.27,316626.58000000066,315951.7500000008,674.8299999998417
16454,2022-06-02 11:10:00,-1904.8,314721.78000000067,315951.7500000008,-1229.9700000001467
16455,2022-06-02 11:15:00,-956.86,313764.9200000007,315951.7500000008,-2186.8300000001327
16456,2022-06-02 11:20:00,-488.91,313276.0100000007,315951.7500000008,-2675.740000000107
16457,2022-06-02 11:25:00,1652.06,314928.0700000007,315951.7500000008,-1023.6800000001094
16458,2022-06-02 11:30:00,-859.68,314068.3900000007,315951.7500000008,-1883.3600000001024
16459,2022-06-02 11:35:00,1507.09,315575.48000000074,315951.7500000008,-376.27000000007683
16460,2022-06-02 11:40:00,-905.4,314670.0800000007,315951.7500000008,-1281.6700000001001
16461,2022-06-02 11:45:00,1526.53,316196.61000000074,315951.7500000008,244.85999999992782
16462,2022-06-02 11:50:00,-50.11,316146.50000000076,315951.7500000008,194.7499999999418
16463,2022-06-02 11:55:00,1564.09,317710.5900000008,315951.7500000008,1758.8399999999674
16464,2022-06-02 12:00:00,719.73,318430.32000000076,315951.7500000008,2478.569999999949
16465,2022-06-02 12:05:00,-209.9,318220.42000000074,315951.7500000008,2268.6699999999255
16466,2022-06-02 12:10:00,-1107.42,317113.00000000076,315951.7500000008,1161.2499999999418
16467,2022-06-02 12:15:00,1211.94,318324.94000000076,315951.7500000008,2373.189999999944
16468,2022-06-02 12:20:00,1450.62,319775.56000000075,315951.7500000008,3823.8099999999395
16469,2022-06-02 12:25:00,-1523.56,318252.00000000076,315951.7500000008,2300.249999999942
16470,2022-06-02 12:30:00,1357.86,319609.86000000074,315951.7500000008,3658.109999999928
16471,2022-06-02 12:35:00,-1914.3,317695.56000000075,315951.7500000008,1743.8099999999395
16472,2022-06-02 12:40:00,-781.76,316913.80000000075,315951.7500000008,962.0499999999302
16473,2022-06-02 12:45:00,-1221.64,315692.16000000073,315951.7500000008,-259.5900000000838
16474,2022-06-02 12:50:00,-1162.68,314529.48000000074,315951.7500000008,-1422.2700000000768
16475,2022-06-02 12:55:00,562.1,315091.5800000007,315951.7500000008,-860.1700000001001
16476,2022-06-02 13:00:00,1191.16,316282.7400000007,315951.7500000008,330.98999999987427
16477,2022-06-02 13:05:00,-553.91,315728.8300000007,315951.7500000008,-222.92000000010012
16478,2022-06-02 13:10:00,1134.98,316863.8100000007,315951.7500000008,912.0599999998813
16479,2022-06-02 13:15:00,-1666.79,315197.0200000007,315951.7500000008,-754.7300000000978
16480,2022-06-02 13:20:00,1244.81,316441.8300000007,315951.7500000008,490.0799999998999
16481,2022-06-02 13:25:00,-1706.23,314735.60000000073,315951.7500000008,-1216.1500000000815
16482,2022-06-02 13:30:00,558.14,315293.74000000075,315951.7500000008,-658.0100000000675
16483,2022-06-02 13:35:00,-309.3,314984.44000000076,315951.7500000008,-967.3100000000559
16484,2022-06-02 13:40:00,1598.18,316582.62000000075,315951.7500000008,630.8699999999371
16485,2022-06-02 13:45:00,547.65,317130.2700000008,315951.7500000008,1178.5199999999604
16486,2022-06-02 13:50:00,951.22,318081.49000000075,315951.7500000008,2129.7399999999325
16487,2022-06-02 13:55:00,823.75,318905.24000000075,315951.7500000008,2953.4899999999325
16488,2022-06-02 14:00:00,1074.77,319980.01000000077,315951.7500000008,4028.259999999951
16489,2022-06-02 14:05:00,482.64,320462.6500000008,315951.7500000008,4510.899999999965
16490,2022-06-02 14:10:00,-1039.78,319422.87000000075,315951.7500000008,3471.119999999937
16491,2022-06-02 14:15:00,1628.09,321050.9600000008,315951.7500000008,5099.209999999963
16492,2022-06-02 14:20:00,835.4,321886.3600000008,315951.7500000008,5934.609999999986
16493,2022-06-02 14:25:00,-397.51,321488.8500000008,315951.7500000008,5537.099999999977
16494,2022-06-02 14:30:00,1322.72,322811.57000000076,315951.7500000008,6859.819999999949
16495,2022-06-02 14:35:00,1365.46,324177.0300000008,315951.7500000008,8225.27999999997
16496,2022-06-02 14:40:00,-403.97,323773.0600000008,315951.7500000008,7821.309999999998
16497,2022-06-02 14:45:00,-1725.05,322048.0100000008,315951.7500000008,6096.260000000009
16498,2022-06-02 14:50:00,1113.59,323161.60000000085,315951.7500000008,7209.850000000035
16499,2022-06-02 14:55:00,-1492.56,321669.04000000085,315951.7500000008,5717.290000000037
16500,2022-06-02 15:00:00,876.05,322545.09000000084,315951.7500000008,6593.340000000026
16501,2022-06-02 15:05:00,-15.8,322529.29000000085,315951.7500000008,6577.540000000037
16502,2022-06-02 15:10:00,-1708.53,320820.7600000008,315951.7500000008,4869.010000000009
16503,2022-06-02 15:15:00,-1566.87,319253.8900000008,315951.7500000008,3302.140000000014
16504,2022-06-02 15:20:00,-1222.65,318031.2400000008,315951.7500000008,2079.4899999999907
16505,2022-06-02 15:25:00,-1528.01,316503.2300000008,315951.7500000008,551.4799999999814
16506,2022-06-02 15:30:00,1908.54,318411.7700000008,315951.7500000008,2460.0199999999604
16507,2022-06-02 15:35:00,-953.74,317458.0300000008,315951.7500000008,1506.2799999999697
16508,2022-06-02 15:40:00,-374.96,317083.07000000076,315951.7500000008,1131.3199999999488
16509,2022-06-02 15:45:00,-365.61,316717.4600000008,315951.7500000008,765.7099999999627
16510,2022-06-02 15:50:00,-24.89,316692.57000000076,315951.7500000008,740.8199999999488
16511,2022-06-02 15:55:00,-306.03,316386.54000000074,315951.7500000008,434.78999999992084
16512,2022-06-02 16:00:00,1015.71,317402.25000000076,315951.7500000008,1450.4999999999418
16513,2022-06-02 16:05:00,-1425.83,315976.42000000074,315951.7500000008,24.669999999925494
16514,2022-06-02 16:10:00,1661.85,317638.2700000007,315951.7500000008,1686.5199999999022
16515,2022-06-02 16:15:00,-1549.77,316088.5000000007,315951.7500000008,136.74999999988358
16516,2022-06-02 16:20:00,1323.79,317412.2900000007,315951.7500000008,1460.5399999998626
16517,2022-06-02 16:25:00,-1347.59,316064.70000000065,315951.7500000008,112.94999999983702
16518,2022-06-02 16:30:00,841.27,316905.97000000067,315951.7500000008,954.2199999998556
16519,2022-06-02 16:35:00,-819.27,316086.70000000065,315951.7500000008,134.94999999983702
16520,2022-06-02 16:40:00,1896.75,317983.45000000065,315951.7500000008,2031.699999999837
16521,2022-06-02 16:45:00,-1381.04,316602.4100000007,315951.7500000008,650.659999999858
16522,2022-06-02 16:50:00,-55.67,316546.7400000007,315951.7500000008,594.9899999998743
16523,2022-06-02 16:55:00,-606.88,315939.8600000007,315951.7500000008,-11.890000000130385
16524,2022-06-03 08:00:00,-1973.23,313966.6300000007,315939.8600000007,-1973.2299999999814
16525,2022-06-03 08:05:00,-226.13,313740.5000000007,315939.8600000007,-2199.359999999986
16526,2022-06-03 08:10:00,-1599.85,312140.6500000007,315939.8600000007,-3799.2099999999627
16527,2022-06-03 08:15:00,-895.35,311245.30000000075,315939.8600000007,-4694.5599999999395
16528,2022-06-03 08:20:00,-1584.27,309661.0300000007,315939.8600000007,-6278.829999999958
16529,2022-06-03 08:25:00,1270.99,310932.0200000007,315939.8600000007,-5007.839999999967
16530,2022-06-03 08:30:00,1925.43,312857.4500000007,315939.8600000007,-3082.4099999999744
16531,2022-06-03 08:35:00,-989.48,311867.9700000007,315939.8600000007,-4071.8899999999558
16532,2022-06-03 08:40:00,-1918.76,309949.2100000007,315939.8600000007,-5990.649999999965
16533,2022-06-03 08:45:00,-1722.64,308226.5700000007,315939.8600000007,-7713.289999999979
16534,2022-06-03 08:50:00,973.72,309200.2900000007,315939.8600000007,-6739.570000000007
16535,2022-06-03 08:55:00,-1283.22,307917.0700000007,315939.8600000007,-8022.789999999979
16536,2022-06-03 09:00:00,1438.14,309355.2100000007,315939.8600000007,-6584.649999999965
16537,2022-06-03 09:05:00,-1307.41,308047.80000000075,315939.8600000007,-7892.0599999999395
16538,2022-06-03 09:10:00,44.06,308091.86000000074,315939.8600000007,-7847.999999999942
16539,2022-06-03 09:15:00,-1922.25,306169.61000000074,315939.8600000007,-9770.249999999942
16540,2022-06-03 09:20:00,-1567.14,304602.4700000007,315939.8600000007,-11337.389999999956
16541,2022-06-03 09:25:00,-445.36,304157.11000000074,315939.8600000007,-11782.749999999942
16542,2022-06-03 09:30:00,-607.71,303549.4000000007,315939.8600000007,-12390.459999999963
16543,2022-06-03 09:35:00,775.87,304325.2700000007,315939.8600000007,-11614.589999999967
16544,2022-06-03 09:40:00,-247.4,304077.8700000007,315939.8600000007,-11861.98999999999
16545,2022-06-03 09:45:00,-1239.78,302838.09000000067,315939.8600000007,-13101.770000000019
16546,2022-06-03 09:50:00,-1025.34,301812.75000000064,315939.8600000007,-14127.110000000044
16547,2022-06-03 09:55:00,-31.06,301781.69000000064,315939.8600000007,-14158.170000000042
16548,2022-06-03 10:00:00,1253.97,303035.6600000006,315939.8600000007,-12904.20000000007
16549,2022-06-03 10:05:00,876.65,303912.31000000064,315939.8600000007,-12027.550000000047
16550,2022-06-03 10:10:00,1521.85,305434.1600000006,315939.8600000007,-10505.70000000007
16551,2022-06-03 10:15:00,1284.56,306718.7200000006,315939.8600000007,-9221.140000000072
16552,2022-06-03 10:20:00,-196.4,306522.3200000006,315939.8600000007,-9417.540000000095
16553,2022-06-03 10:25:00,-505.23,306017.0900000006,315939.8600000007,-9922.770000000077
16554,2022-06-03 10:30:00,1374.74,307391.8300000006,315939.8600000007,-8548.030000000086
16555,2022-06-03 10:35:00,-62.71,307329.1200000006,315939.8600000007,-8610.740000000107
16556,2022-06-03 10:40:00,1496.31,308825.4300000006,315939.8600000007,-7114.430000000109
16557,2022-06-03 10:45:00,709.32,309534.7500000006,315939.8600000007,-6405.110000000102
16558,2022-06-03 10:50:00,683.82,310218.5700000006,315939.8600000007,-5721.2900000000955
16559,2022-06-03 10:55:00,-1763.53,308455.04000000056,315939.8600000007,-7484.820000000123
16560,2022-06-03 11:00:00,1135.76,309590.80000000057,315939.8600000007,-6349.060000000114
16561,2022-06-03 11:05:00,1710.91,311301.71000000054,315939.8600000007,-4638.15000000014
16562,2022-06-03 11:10:00,1174.61,312476.32000000053,315939.8600000007,-3463.5400000001537
16563,2022-06-03 11:15:00,-1139.2,311337.1200000005,315939.8600000007,-4602.740000000165
16564,2022-06-03 11:20:00,52.69,311389.8100000005,315939.8600000007,-4550.050000000163
16565,2022-06-03 11:25:00,-785.31,310604.5000000005,315939.8600000007,-5335.360000000161
16566,2022-06-03 11:30:00,-845.59,309758.9100000005,315939.8600000007,-6180.950000000186
16567,2022-06-03 11:35:00,1067.91,310826.8200000005,315939.8600000007,-5113.040000000212
16568,2022-06-03 11:40:00,-987.88,309838.94000000047,315939.8600000007,-6100.9200000002165
16569,2022-06-03 11:45:00,1630.69,311469.63000000047,315939.8600000007,-4470.230000000214
16570,2022-06-03 11:50:00,-164.89,311304.74000000046,315939.8600000007,-4635.120000000228
16571,2022-06-03 11:55:00,-140.06,311164.68000000046,315939.8600000007,-4775.180000000226
16572,2022-06-03 12:00:00,-855.5,310309.18000000046,315939.8600000007,-5630.680000000226
16573,2022-06-03 12:05:00,-571.98,309737.2000000005,315939.8600000007,-6202.660000000207
16574,2022-06-03 12:10:00,-1186.81,308550.3900000005,315939.8600000007,-7389.470000000205
16575,2022-06-03 12:15:00,-221.56,308328.8300000005,315939.8600000007,-7611.030000000203
16576,2022-06-03 12:20:00,-1273.65,307055.18000000046,315939.8600000007,-8884.680000000226
16577,2022-06-03 12:25:00,1919.41,308974.59000000043,315939.8600000007,-6965.2700000002515
16578,2022-06-03 12:30:00,1499.7,310474.29000000044,315939.8600000007,-5465.57000000024
16579,2022-06-03 12:35:00,1019.99,311494.28000000044,315939.8600000007,-4445.580000000249
16580,2022-06-03 12:40:00,-978.82,310515.4600000004,315939.8600000007,-5424.400000000256
16581,2022-06-03 12:45:00,1509.25,312024.7100000004,315939.8600000007,-3915.150000000256
16582,2022-06-03 12:50:00,952.48,312977.1900000004,315939.8600000007,-2962.6700000002747
16583,2022-06-03 12:55:00,-1593.11,311384.0800000004,315939.8600000007,-4555.780000000261
16584,2022-06-03 13:00:00,1607.39,312991.47000000044,315939.8600000007,-2948.390000000247
16585,2022-06-03 13:05:00,-157.9,312833.5700000004,315939.8600000007,-3106.29000000027
16586,2022-06-03 13:10:00,356.35,313189.9200000004,315939.8600000007,-2749.9400000002934
16587,2022-06-03 13:15:00,-1498.68,311691.2400000004,315939.8600000007,-4248.620000000286
16588,2022-06-03 13:20:00,-545.69,311145.5500000004,315939.8600000007,-4794.310000000289
16589,2022-06-03 13:25:00,809.74,311955.2900000004,315939.8600000007,-3984.570000000298
16590,2022-06-03 13:30:00,-664.01,311291.2800000004,315939.8600000007,-4648.580000000307
16591,2022-06-03 13:35:00,532.58,311823.8600000004,315939.8600000007,-4116.000000000291
16592,2022-06-03 13:40:00,1593.52,313417.3800000004,315939.8600000007,-2522.4800000002724
16593,2022-06-03 13:45:00,-1431.28,311986.1000000004,315939.8600000007,-3953.7600000003004
16594,2022-06-03 13:50:00,1857.48,313843.58000000037,315939.8600000007,-2096.280000000319
16595,2022-06-03 13:55:00,1950.62,315794.20000000036,315939.8600000007,-145.66000000032363
16596,2022-06-03 14:00:00,-1478.98,314315.2200000004,315939.8600000007,-1624.640000000305
16597,2022-06-03 14:05:00,-1213.4,313101.82000000036,315939.8600000007,-2838.0400000003283
16598,2022-06-03 14:10:00,509.62,313611.44000000035,315939.8600000007,-2328.420000000333
16599,2022-06-03 14:15:00,1064.2,314675.64000000036,315939.8600000007,-1264.2200000003213
16600,2022-06-03 14:20:00,482.82,315158.46000000037,315939.8600000007,-781.4000000003143
16601,2022-06-03 14:25:00,1093.79,316252.25000000035,315939.8600000007,312.3899999996647
16602,2022-06-03 14:30:00,790.69,317042.94000000035,315939.8600000007,1103.079999999667
16603,2022-06-03 14:35:00,-667.93,316375.01000000036,315939.8600000007,435.14999999967404
16604,2022-06-03 14:40:00,-637.29,315737.7200000004,315939.8600000007,-202.140000000305
16605,2022-06-03 14:45:00,-1811.58,313926.14000000036,315939.8600000007,-2013.7200000003213
16606,2022-06-03 14:50:00,1423.85,315349.99000000034,315939.8600000007,-589.8700000003446
16607,2022-06-03 14:55:00,598.24,315948.23000000033,315939.8600000007,8.369999999646097
16608,2022-06-03 15:00:00,1599.32,317547.55000000034,315939.8600000007,1607.689999999653
16609,2022-06-03 15:05:00,512.43,318059.98000000033,315939.8600000007,2120.119999999646
16610,2022-06-03 15:10:00,-1585.51,316474.4700000003,315939.8600000007,534.6099999996368
16611,2022-06-03 15:15:00,1456.15,317930.62000000034,315939.8600000007,1990.75999999966
16612,2022-06-03 15:20:00,416.18,318346.80000000034,315939.8600000007,2406.939999999653
16613,2022-06-03 15:25:00,704.19,319050.99000000034,315939.8600000007,3111.1299999996554
16614,2022-06-03 15:30:00,1989.95,321040.94000000035,315939.8600000007,5101.079999999667
16615,2022-06-03 15:35:00,-1410.48,319630.46000000037,315939.8600000007,3690.5999999996857
16616,2022-06-03 15:40:00,-1992.07,317638.39000000036,315939.8600000007,1698.5299999996787
16617,2022-06-03 15:45:00,330.28,317968.6700000004,315939.8600000007,2028.8099999997066
16618,2022-06-03 15:50:00,-1563.46,316405.21000000037,315939.8600000007,465.3499999996857
16619,2022-06-03 15:55:00,-335.34,316069.87000000034,315939.8600000007,130.00999999966007
16620,2022-06-03 16:00:00,1328.55,317398.42000000033,315939.8600000007,1458.5599999996484
16621,2022-06-03 16:05:00,-330.07,317068.3500000003,315939.8600000007,1128.4899999996414
16622,2022-06-03 16:10:00,817.85,317886.2000000003,315939.8600000007,1946.3399999996182
16623,2022-06-03 16:15:00,222.28,318108.48000000033,315939.8600000007,2168.619999999646
16624,2022-06-03 16:20:00,16.27,318124.75000000035,315939.8600000007,2184.8899999996647
16625,2022-06-03 16:25:00,1723.64,319848.39000000036,315939.8600000007,3908.5299999996787
16626,2022-06-03 16:30:00,-1732.86,318115.5300000004,315939.8600000007,2175.6699999996927
16627,2022-06-03 16:35:00,-30.3,318085.2300000004,315939.8600000007,2145.3699999997043
16628,2022-06-03 16:40:00,1598.5,319683.7300000004,315939.8600000007,3743.8699999997043
16629,2022-06-03 16:45:00,1721.8,321405.5300000004,315939.8600000007,5465.669999999693
16630,2022-06-03 16:50:00,1090.45,322495.9800000004,315939.8600000007,6556.119999999704
16631,2022-06-03 16:55:00,58.24,322554.2200000004,315939.8600000007,6614.359999999695
16632,2022-06-04 08:00:00,-401.59,322152.63000000035,322554.2200000004,-401.5900000000256
16633,2022-06-04 08:05:00,-664.47,321488.1600000004,322554.2200000004,-1066.0599999999977
16634,2022-06-04 08:10:00,-488.78,320999.38000000035,322554.2200000004,-1554.8400000000256
16635,2022-06-04 08:15:00,-940.06,320059.32000000036,322554.2200000004,-2494.9000000000233
16636,2022-06-04 08:20:00,1295.79,321355.11000000034,322554.2200000004,-1199.1100000000442
16637,2022-06-04 08:25:00,462.33,321817.44000000035,322554.2200000004,-736.7800000000279
16638,2022-06-04 08:30:00,-581.96,321235.48000000033,322554.2200000004,-1318.740000000049
16639,2022-06-04 08:35:00,-938.41,320297.07000000036,322554.2200000004,-2257.1500000000233
16640,2022-06-04 08:40:00,-238.82,320058.25000000035,322554.2200000004,-2495.9700000000303
16641,2022-06-04 08:45:00,-1325.38,318732.87000000034,322554.2200000004,-3821.350000000035
16642,2022-06-04 08:50:00,-833.24,317899.63000000035,322554.2200000004,-4654.590000000026
16643,2022-06-04 08:55:00,1340.51,319240.14000000036,322554.2200000004,-3314.0800000000163
16644,2022-06-04 09:00:00,994.84,320234.9800000004,322554.2200000004,-2319.2399999999907
16645,2022-06-04 09:05:00,-862.63,319372.3500000004,322554.2200000004,-3181.8699999999953
16646,2022-06-04 09:10:00,367.85,319740.20000000036,322554.2200000004,-2814.0200000000186
16647,2022-06-04 09:15:00,-261.7,319478.50000000035,322554.2200000004,-3075.7200000000303
16648,2022-06-04 09:20:00,1076.23,320554.73000000033,322554.2200000004,-1999.490000000049
16649,2022-06-04 09:25:00,1716.46,322271.19000000035,322554.2200000004,-283.03000000002794
16650,2022-06-04 09:30:00,-1969.93,320301.26000000036,322554.2200000004,-2252.960000000021
16651,2022-06-04 09:35:00,-1993.06,318308.20000000036,322554.2200000004,-4246.020000000019
16652,2022-06-04 09:40:00,1855.08,320163.2800000004,322554.2200000004,-2390.9400000000023
16653,2022-06-04 09:45:00,-1157.1,319006.1800000004,322554.2200000004,-3548.039999999979
16654,2022-06-04 09:50:00,-207.28,318798.9000000004,322554.2200000004,-3755.320000000007
16655,2022-06-04 09:55:00,-625.22,318173.6800000004,322554.2200000004,-4380.539999999979
16656,2022-06-04 10:00:00,626.05,318799.7300000004,322554.2200000004,-3754.4899999999907
16657,2022-06-04 10:05:00,-1153.67,317646.0600000004,322554.2200000004,-4908.159999999974
16658,2022-06-04 10:10:00,-168.15,317477.9100000004,322554.2200000004,-5076.309999999998
16659,2022-06-04 10:15:00,233.8,317711.71000000037,322554.2200000004,-4842.510000000009
16660,2022-06-04 10:20:00,517.11,318228.82000000036,322554.2200000004,-4325.400000000023
16661,2022-06-04 10:25:00,969.12,319197.94000000035,322554.2200000004,-3356.280000000028
16662,2022-06-04 10:30:00,1377.93,320575.87000000034,322554.2200000004,-1978.350000000035
16663,2022-06-04 10:35:00,-1083.88,319491.99000000034,322554.2200000004,-3062.2300000000396
16664,2022-06-04 10:40:00,1580.32,321072.31000000035,322554.2200000004,-1481.9100000000326
16665,2022-06-04 10:45:00,-1077.82,319994.49000000034,322554.2200000004,-2559.7300000000396
16666,2022-06-04 10:50:00,16.29,320010.7800000003,322554.2200000004,-2543.4400000000605
16667,2022-06-04 10:55:00,-1172.79,318837.99000000034,322554.2200000004,-3716.2300000000396
16668,2022-06-04 11:00:00,1209.89,320047.88000000035,322554.2200000004,-2506.3400000000256
16669,2022-06-04 11:05:00,-707.88,319340.00000000035,322554.2200000004,-3214.2200000000303
16670,2022-06-04 11:10:00,-426.45,318913.55000000034,322554.2200000004,-3640.670000000042
16671,2022-06-04 11:15:00,-1772.74,317140.81000000035,322554.2200000004,-5413.410000000033
16672,2022-06-04 11:20:00,1325.87,318466.68000000034,322554.2200000004,-4087.5400000000373
16673,2022-06-04 11:25:00,-1246.63,317220.05000000034,322554.2200000004,-5334.170000000042
16674,2022-06-04 11:30:00,-672.88,316547.17000000033,322554.2200000004,-6007.050000000047
16675,2022-06-04 11:35:00,759.15,317306.32000000036,322554.2200000004,-5247.900000000023
16676,2022-06-04 11:40:00,800.78,318107.1000000004,322554.2200000004,-4447.119999999995
16677,2022-06-04 11:45:00,857.09,318964.1900000004,322554.2200000004,-3590.0299999999697
16678,2022-06-04 11:50:00,919.56,319883.7500000004,322554.2200000004,-2670.469999999972
16679,2022-06-04 11:55:00,-1683.5,318200.2500000004,322554.2200000004,-4353.969999999972
16680,2022-06-04 12:00:00,-641.37,317558.8800000004,322554.2200000004,-4995.339999999967
16681,2022-06-04 12:05:00,1290.49,318849.3700000004,322554.2200000004,-3704.8499999999767
16682,2022-06-04 12:10:00,1004.76,319854.1300000004,322554.2200000004,-2700.0899999999674
16683,2022-06-04 12:15:00,815.54,320669.6700000004,322554.2200000004,-1884.5499999999884
16684,2022-06-04 12:20:00,-1269.07,319400.6000000004,322554.2200000004,-3153.6199999999953
16685,2022-06-04 12:25:00,-134.83,319265.77000000037,322554.2200000004,-3288.4500000000116
16686,2022-06-04 12:30:00,-1984.65,317281.12000000034,322554.2200000004,-5273.100000000035
16687,2022-06-04 12:35:00,-800.98,316480.14000000036,322554.2200000004,-6074.080000000016
16688,2022-06-04 12:40:00,-1383.64,315096.50000000035,322554.2200000004,-7457.72000000003
16689,2022-06-04 12:45:00,-1689.61,313406.89000000036,322554.2200000004,-9147.330000000016
16690,2022-06-04 12:50:00,-144.55,313262.3400000004,322554.2200000004,-9291.880000000005
16691,2022-06-04 12:55:00,-523.48,312738.8600000004,322554.2200000004,-9815.359999999986
16692,2022-06-04 13:00:00,264.67,313003.5300000004,322554.2200000004,-9550.690000000002
16693,2022-06-04 13:05:00,502.29,313505.82000000036,322554.2200000004,-9048.400000000023
16694,2022-06-04 13:10:00,-1970.04,311535.7800000004,322554.2200000004,-11018.440000000002
16695,2022-06-04 13:15:00,1078.94,312614.7200000004,322554.2200000004,-9939.5
16696,2022-06-04 13:20:00,-1434.59,311180.13000000035,322554.2200000004,-11374.090000000026
16697,2022-06-04 13:25:00,788.22,311968.3500000003,322554.2200000004,-10585.870000000054
16698,2022-06-04 13:30:00,156.97,312125.3200000003,322554.2200000004,-10428.900000000081
16699,2022-06-04 13:35:00,547.62,312672.9400000003,322554.2200000004,-9881.280000000086
16700,2022-06-04 13:40:00,-203.52,312469.4200000003,322554.2200000004,-10084.800000000105
16701,2022-06-04 13:45:00,860.08,313329.5000000003,322554.2200000004,-9224.720000000088
16702,2022-06-04 13:50:00,368.16,313697.66000000027,322554.2200000004,-8856.560000000114
16703,2022-06-04 13:55:00,1180.75,314878.41000000027,322554.2200000004,-7675.810000000114
16704,2022-06-04 14:00:00,1396.27,316274.6800000003,322554.2200000004,-6279.5400000000955
16705,2022-06-04 14:05:00,369.31,316643.9900000003,322554.2200000004,-5910.230000000098
16706,2022-06-04 14:10:00,-78.36,316565.6300000003,322554.2200000004,-5988.590000000084
16707,2022-06-04 14:15:00,-294.75,316270.8800000003,322554.2200000004,-6283.340000000084
16708,2022-06-04 14:20:00,-578.22,315692.6600000003,322554.2200000004,-6861.560000000056
16709,2022-06-04 14:25:00,-390.26,315302.4000000003,322554.2200000004,-7251.820000000065
16710,2022-06-04 14:30:00,1644.49,316946.8900000003,322554.2200000004,-5607.3300000000745
16711,2022-06-04 14:35:00,-1195.95,315750.9400000003,322554.2200000004,-6803.280000000086
16712,2022-06-04 14:40:00,1531.08,317282.0200000003,322554.2200000004,-5272.20000000007
16713,2022-06-04 14:45:00,1396.01,318678.0300000003,322554.2200000004,-3876.1900000000605
16714,2022-06-04 14:50:00,-243.48,318434.55000000034,322554.2200000004,-4119.670000000042
16715,2022-06-04 14:55:00,168.84,318603.39000000036,322554.2200000004,-3950.8300000000163
16716,2022-06-04 15:00:00,339.12,318942.51000000036,322554.2200000004,-3611.710000000021
16717,2022-06-04 15:05:00,1576.9,320519.4100000004,322554.2200000004,-2034.8099999999977
16718,2022-06-04 15:10:00,-1887.11,318632.3000000004,322554.2200000004,-3921.9199999999837
16719,2022-06-04 15:15:00,765.15,319397.4500000004,322554.2200000004,-3156.7699999999604
16720,2022-06-04 15:20:00,-23.93,319373.5200000004,322554.2200000004,-3180.6999999999534
16721,2022-06-04 15:25:00,893.37,320266.8900000004,322554.2200000004,-2287.329999999958
16722,2022-06-04 15:30:00,301.86,320568.7500000004,322554.2200000004,-1985.469999999972
16723,2022-06-04 15:35:00,-1112.39,319456.3600000004,322554.2200000004,-3097.859999999986
16724,2022-06-04 15:40:00,1718.01,321174.3700000004,322554.2200000004,-1379.8499999999767
16725,2022-06-04 15:45:00,-969.57,320204.8000000004,322554.2200000004,-2349.4199999999837
16726,2022-06-04 15:50:00,-1529.1,318675.7000000004,322554.2200000004,-3878.5199999999604
16727,2022-06-04 15:55:00,-1208.96,317466.7400000004,322554.2200000004,-5087.479999999981
16728,2022-06-04 16:00:00,670.6,318137.3400000004,322554.2200000004,-4416.880000000005
16729,2022-06-04 16:05:00,-1238.58,316898.76000000036,322554.2200000004,-5655.460000000021
16730,2022-06-04 16:10:00,897.28,317796.0400000004,322554.2200000004,-4758.179999999993
16731,2022-06-04 16:15:00,-57.35,317738.6900000004,322554.2200000004,-4815.52999999997
16732,2022-06-04 16:20:00,746.53,318485.22000000044,322554.2200000004,-4068.999999999942
16733,2022-06-04 16:25:00,-493.39,317991.8300000004,322554.2200000004,-4562.389999999956
16734,2022-06-04 16:30:00,-798.91,317192.92000000045,322554.2200000004,-5361.29999999993
16735,2022-06-04 16:35:00,-1935.49,315257.43000000046,322554.2200000004,-7296.789999999921
16736,2022-06-04 16:40:00,-1485.66,313771.7700000005,322554.2200000004,-8782.449999999895
16737,2022-06-04 16:45:00,1238.26,315010.0300000005,322554.2200000004,-7544.189999999886
16738,2022-06-04 16:50:00,523.19,315533.2200000005,322554.2200000004,-7020.999999999884
16739,2022-06-04 16:55:00,1986.18,317519.4000000005,322554.2200000004,-5034.819999999891
16740,2022-06-05 08:00:00,-158.62,317360.7800000005,317519.4000000005,-158.61999999999534
16741,2022-06-05 08:05:00,-1172.1,316188.6800000005,317519.4000000005,-1330.719999999972
16742,2022-06-05 08:10:00,-336.68,315852.0000000005,317519.4000000005,-1667.399999999965
16743,2022-06-05 08:15:00,-1041.7,314810.3000000005,317519.4000000005,-2709.0999999999767
16744,2022-06-05 08:20:00,894.92,315705.2200000005,317519.4000000005,-1814.179999999993
16745,2022-06-05 08:25:00,1856.84,317562.0600000005,317519.4000000005,42.660000000032596
16746,2022-06-05 08:30:00,551.4,318113.46000000054,317519.4000000005,594.0600000000559
16747,2022-06-05 08:35:00,145.8,318259.26000000053,317519.4000000005,739.8600000000442
16748,2022-06-05 08:40:00,1808.74,320068.0000000005,317519.4000000005,2548.600000000035
16749,2022-06-05 08:45:00,-1373.01,318694.9900000005,317519.4000000005,1175.5900000000256
16750,2022-06-05 08:50:00,-1819.28,316875.7100000005,317519.4000000005,-643.6900000000023
16751,2022-06-05 08:55:00,-1226.42,315649.2900000005,317519.4000000005,-1870.109999999986
16752,2022-06-05 09:00:00,664.01,316313.3000000005,317519.4000000005,-1206.0999999999767
16753,2022-06-05 09:05:00,-1395.39,314917.9100000005,317519.4000000005,-2601.4899999999907
16754,2022-06-05 09:10:00,1174.74,316092.6500000005,317519.4000000005,-1426.75
16755,2022-06-05 09:15:00,-1304.46,314788.19000000047,317519.4000000005,-2731.210000000021
16756,2022-06-05 09:20:00,834.27,315622.4600000005,317519.4000000005,-1896.9400000000023
16757,2022-06-05 09:25:00,736.92,316359.38000000047,317519.4000000005,-1160.0200000000186
16758,2022-06-05 09:30:00,559.02,316918.4000000005,317519.4000000005,-601.0
16759,2022-06-05 09:35:00,-1937.61,314980.7900000005,317519.4000000005,-2538.609999999986
16760,2022-06-05 09:40:00,1197.5,316178.2900000005,317519.4000000005,-1341.109999999986
16761,2022-06-05 09:45:00,1710.6,317888.8900000005,317519.4000000005,369.4899999999907
16762,2022-06-05 09:50:00,-1799.07,316089.8200000005,317519.4000000005,-1429.5800000000163
16763,2022-06-05 09:55:00,-741.52,315348.30000000045,317519.4000000005,-2171.100000000035
16764,2022-06-05 10:00:00,-1464.22,313884.0800000005,317519.4000000005,-3635.320000000007
16765,2022-06-05 10:05:00,-1202.03,312682.05000000045,317519.4000000005,-4837.350000000035
16766,2022-06-05 10:10:00,1696.3,314378.35000000044,317519.4000000005,-3141.0500000000466
16767,2022-06-05 10:15:00,-1021.17,313357.18000000046,317519.4000000005,-4162.22000000003
16768,2022-06-05 10:20:00,185.87,313543.05000000045,317519.4000000005,-3976.350000000035
16769,2022-06-05 10:25:00,-921.56,312621.49000000046,317519.4000000005,-4897.910000000033
16770,2022-06-05 10:30:00,966.51,313588.00000000047,317519.4000000005,-3931.4000000000233
16771,2022-06-05 10:35:00,-349.03,313238.97000000044,317519.4000000005,-4280.430000000051
16772,2022-06-05 10:40:00,-1785.86,311453.11000000045,317519.4000000005,-6066.290000000037
16773,2022-06-05 10:45:00,-771.37,310681.74000000046,317519.4000000005,-6837.660000000033
16774,2022-06-05 10:50:00,-1463.03,309218.7100000004,317519.4000000005,-8300.69000000006
16775,2022-06-05 10:55:00,-745.13,308473.5800000004,317519.4000000005,-9045.820000000065
16776,2022-06-05 11:00:00,986.47,309460.0500000004,317519.4000000005,-8059.350000000093
16777,2022-06-05 11:05:00,-1044.24,308415.8100000004,317519.4000000005,-9103.590000000084
16778,2022-06-05 11:10:00,-1476.17,306939.6400000004,317519.4000000005,-10579.760000000068
16779,2022-06-05 11:15:00,-9.08,306930.5600000004,317519.4000000005,-10588.840000000084
16780,2022-06-05 11:20:00,1139.32,308069.8800000004,317519.4000000005,-9449.520000000077
16781,2022-06-05 11:25:00,-834.92,307234.9600000004,317519.4000000005,-10284.44000000006
16782,2022-06-05 11:30:00,763.32,307998.28000000044,317519.4000000005,-9521.120000000054
16783,2022-06-05 11:35:00,1190.65,309188.93000000046,317519.4000000005,-8330.47000000003
16784,2022-06-05 11:40:00,-1871.07,307317.86000000045,317519.4000000005,-10201.540000000037
16785,2022-06-05 11:45:00,-1547.8,305770.06000000046,317519.4000000005,-11749.340000000026
16786,2022-06-05 11:50:00,-1793.64,303976.42000000045,317519.4000000005,-13542.98000000004
16787,2022-06-05 11:55:00,-1585.81,302390.61000000045,317519.4000000005,-15128.790000000037
16788,2022-06-05 12:00:00,-1955.18,300435.43000000046,317519.4000000005,-17083.97000000003
16789,2022-06-05 12:05:00,-920.33,299515.10000000044,317519.4000000005,-18004.300000000047
16790,2022-06-05 12:10:00,-932.28,298582.8200000004,317519.4000000005,-18936.580000000075
16791,2022-06-05 12:15:00,1618.17,300200.9900000004,317519.4000000005,-17318.41000000009
16792,2022-06-05 12:20:00,-606.49,299594.5000000004,317519.4000000005,-17924.90000000008
16793,2022-06-05 12:25:00,809.58,300404.0800000004,317519.4000000005,-17115.320000000065
16794,2022-06-05 12:30:00,509.18,300913.2600000004,317519.4000000005,-16606.140000000072
16795,2022-06-05 12:35:00,766.1,301679.3600000004,317519.4000000005,-15840.040000000095
16796,2022-06-05 12:40:00,-628.45,301050.9100000004,317519.4000000005,-16468.490000000107
16797,2022-06-05 12:45:00,1302.15,302353.0600000004,317519.4000000005,-15166.340000000084
16798,2022-06-05 12:50:00,-1259.83,301093.2300000004,317519.4000000005,-16426.1700000001
16799,2022-06-05 12:55:00,1093.91,302187.14000000036,317519.4000000005,-15332.260000000126
16800,2022-06-05 13:00:00,1232.73,303419.87000000034,317519.4000000005,-14099.530000000144
16801,2022-06-05 13:05:00,7.64,303427.51000000036,317519.4000000005,-14091.89000000013
16802,2022-06-05 13:10:00,1052.64,304480.1500000004,317519.4000000005,-13039.250000000116
16803,2022-06-05 13:15:00,596.76,305076.9100000004,317519.4000000005,-12442.490000000107
16804,2022-06-05 13:20:00,635.71,305712.6200000004,317519.4000000005,-11806.780000000086
16805,2022-06-05 13:25:00,-1468.29,304244.3300000004,317519.4000000005,-13275.070000000065
16806,2022-06-05 13:30:00,721.76,304966.09000000043,317519.4000000005,-12553.310000000056
16807,2022-06-05 13:35:00,-222.0,304744.09000000043,317519.4000000005,-12775.310000000056
16808,2022-06-05 13:40:00,-1511.55,303232.54000000044,317519.4000000005,-14286.860000000044
16809,2022-06-05 13:45:00,648.66,303881.2000000004,317519.4000000005,-13638.20000000007
16810,2022-06-05 13:50:00,545.1,304426.3000000004,317519.4000000005,-13093.100000000093
16811,2022-06-05 13:55:00,-1121.87,303304.4300000004,317519.4000000005,-14214.970000000088
16812,2022-06-05 14:00:00,1359.26,304663.6900000004,317519.4000000005,-12855.71000000008
16813,2022-06-05 14:05:00,839.7,305503.3900000004,317519.4000000005,-12016.010000000068
16814,2022-06-05 14:10:00,1373.5,306876.8900000004,317519.4000000005,-10642.510000000068
16815,2022-06-05 14:15:00,616.83,307493.72000000044,317519.4000000005,-10025.680000000051
16816,2022-06-05 14:20:00,-208.93,307284.79000000044,317519.4000000005,-10234.610000000044
16817,2022-06-05 14:25:00,-1890.35,305394.44000000047,317519.4000000005,-12124.960000000021
16818,2022-06-05 14:30:00,903.78,306298.2200000005,317519.4000000005,-11221.179999999993
16819,2022-06-05 14:35:00,-1455.41,304842.8100000005,317519.4000000005,-12676.589999999967
16820,2022-06-05 14:40:00,-1684.07,303158.7400000005,317519.4000000005,-14360.659999999974
16821,2022-06-05 14:45:00,-90.82,303067.9200000005,317519.4000000005,-14451.479999999981
16822,2022-06-05 14:50:00,1538.98,304606.9000000005,317519.4000000005,-12912.5
16823,2022-06-05 14:55:00,1271.39,305878.2900000005,317519.4000000005,-11641.109999999986
16824,2022-06-05 15:00:00,-106.66,305771.6300000005,317519.4000000005,-11747.76999999996
16825,2022-06-05 15:05:00,1540.61,307312.2400000005,317519.4000000005,-10207.159999999974
16826,2022-06-05 15:10:00,1805.34,309117.58000000054,317519.4000000005,-8401.819999999949
16827,2022-06-05 15:15:00,-1227.42,307890.16000000056,317519.4000000005,-9629.239999999932
16828,2022-06-05 15:20:00,1354.44,309244.60000000056,317519.4000000005,-8274.79999999993
16829,2022-06-05 15:25:00,-1901.58,307343.02000000054,317519.4000000005,-10176.379999999946
16830,2022-06-05 15:30:00,-1915.38,305427.64000000054,317519.4000000005,-12091.759999999951
16831,2022-06-05 15:35:00,-89.38,305338.26000000053,317519.4000000005,-12181.139999999956
16832,2022-06-05 15:40:00,-1029.55,304308.71000000054,317519.4000000005,-13210.689999999944
16833,2022-06-05 15:45:00,-1572.76,302735.95000000054,317519.4000000005,-14783.449999999953
16834,2022-06-05 15:50:00,1043.03,303778.98000000056,317519.4000000005,-13740.419999999925
16835,2022-06-05 15:55:00,-653.83,303125.15000000055,317519.4000000005,-14394.249999999942
16836,2022-06-05 16:00:00,-97.35,303027.80000000057,317519.4000000005,-14491.599999999919
16837,2022-06-05 16:05:00,-1728.9,301298.90000000055,317519.4000000005,-16220.499999999942
16838,2022-06-05 16:10:00,-605.73,300693.17000000057,317519.4000000005,-16826.229999999923
16839,2022-06-05 16:15:00,1710.56,302403.73000000056,317519.4000000005,-15115.669999999925
16840,2022-06-05 16:20:00,791.34,303195.0700000006,317519.4000000005,-14324.3299999999
16841,2022-06-05 16:25:00,-579.42,302615.6500000006,317519.4000000005,-14903.749999999884
16842,2022-06-05 16:30:00,-848.51,301767.1400000006,317519.4000000005,-15752.259999999893
16843,2022-06-05 16:35:00,-1691.87,300075.2700000006,317519.4000000005,-17444.12999999989
16844,2022-06-05 16:40:00,326.61,300401.8800000006,317519.4000000005,-17117.519999999902
16845,2022-06-05 16:45:00,-1742.57,298659.3100000006,317519.4000000005,-18860.08999999991
16846,2022-06-05 16:50:00,-571.59,298087.72000000055,317519.4000000005,-19431.679999999935
16847,2022-06-05 16:55:00,26.47,298114.1900000005,317519.4000000005,-19405.209999999963
16848,2022-06-06 08:00:00,-601.42,297512.77000000054,298114.1900000005,-601.4199999999837
16849,2022-06-06 08:05:00,918.55,298431.32000000053,298114.1900000005,317.13000000000466
16850,2022-06-06 08:10:00,-1086.68,297344.64000000054,298114.1900000005,-769.5499999999884
16851,2022-06-06 08:15:00,-1683.8,295660.84000000055,298114.1900000005,-2453.3499999999767
16852,2022-06-06 08:20:00,911.38,296572.22000000055,298114.1900000005,-1541.969999999972
16853,2022-06-06 08:25:00,-1682.97,294889.2500000006,298114.1900000005,-3224.939999999944
16854,2022-06-06 08:30:00,-1004.04,293885.2100000006,298114.1900000005,-4228.979999999923
16855,2022-06-06 08:35:00,1129.32,295014.5300000006,298114.1900000005,-3099.659999999916
16856,2022-06-06 08:40:00,838.25,295852.7800000006,298114.1900000005,-2261.409999999916
16857,2022-06-06 08:45:00,1971.34,297824.12000000064,298114.1900000005,-290.06999999989057
16858,2022-06-06 08:50:00,688.83,298512.95000000065,298114.1900000005,398.76000000012573
16859,2022-06-06 08:55:00,-1837.16,296675.7900000007,298114.1900000005,-1438.3999999998487
16860,2022-06-06 09:00:00,-1698.1,294977.6900000007,298114.1900000005,-3136.4999999998254
16861,2022-06-06 09:05:00,1908.79,296886.4800000007,298114.1900000005,-1227.7099999998463
16862,2022-06-06 09:10:00,-180.03,296706.45000000065,298114.1900000005,-1407.7399999998743
16863,2022-06-06 09:15:00,902.45,297608.90000000066,298114.1900000005,-505.28999999986263
16864,2022-06-06 09:20:00,-1643.72,295965.1800000007,298114.1900000005,-2149.0099999998347
16865,2022-06-06 09:25:00,-1615.52,294349.6600000007,298114.1900000005,-3764.5299999998533
16866,2022-06-06 09:30:00,272.27,294621.9300000007,298114.1900000005,-3492.2599999998347
16867,2022-06-06 09:35:00,-390.94,294230.9900000007,298114.1900000005,-3883.199999999837
16868,2022-06-06 09:40:00,-74.48,294156.5100000007,298114.1900000005,-3957.6799999998184
16869,2022-06-06 09:45:00,-1509.98,292646.5300000007,298114.1900000005,-5467.6599999998
16870,2022-06-06 09:50:00,-1982.03,290664.5000000007,298114.1900000005,-7449.689999999828
16871,2022-06-06 09:55:00,-220.02,290444.4800000007,298114.1900000005,-7669.709999999846
16872,2022-06-06 10:00:00,-695.01,289749.47000000067,298114.1900000005,-8364.719999999856
16873,2022-06-06 10:05:00,862.26,290611.7300000007,298114.1900000005,-7502.459999999846
16874,2022-06-06 10:10:00,493.84,291105.5700000007,298114.1900000005,-7008.619999999821
16875,2022-06-06 10:15:00,265.08,291370.6500000007,298114.1900000005,-6743.539999999804
16876,2022-06-06 10:20:00,1140.41,292511.0600000007,298114.1900000005,-5603.12999999983
16877,2022-06-06 10:25:00,-550.38,291960.6800000007,298114.1900000005,-6153.509999999835
16878,2022-06-06 10:30:00,-339.05,291621.6300000007,298114.1900000005,-6492.559999999823
16879,2022-06-06 10:35:00,-1005.37,290616.2600000007,298114.1900000005,-7497.929999999818
16880,2022-06-06 10:40:00,-1994.04,288622.2200000007,298114.1900000005,-9491.969999999797
16881,2022-06-06 10:45:00,-1496.79,287125.43000000075,298114.1900000005,-10988.759999999776
16882,2022-06-06 10:50:00,-1192.99,285932.44000000076,298114.1900000005,-12181.749999999767
16883,2022-06-06 10:55:00,855.78,286788.2200000008,298114.1900000005,-11325.96999999974
16884,2022-06-06 11:00:00,-692.61,286095.6100000008,298114.1900000005,-12018.579999999725
16885,2022-06-06 11:05:00,918.19,287013.8000000008,298114.1900000005,-11100.389999999723
16886,2022-06-06 11:10:00,1123.81,288137.6100000008,298114.1900000005,-9976.579999999725
16887,2022-06-06 11:15:00,-1146.06,286991.5500000008,298114.1900000005,-11122.639999999723
16888,2022-06-06 11:20:00,195.53,287187.08000000083,298114.1900000005,-10927.109999999695
16889,2022-06-06 11:25:00,1455.59,288642.67000000086,298114.1900000005,-9471.51999999967
16890,2022-06-06 11:30:00,1171.0,289813.67000000086,298114.1900000005,-8300.51999999967
16891,2022-06-06 11:35:00,521.38,290335.05000000086,298114.1900000005,-7779.139999999665
16892,2022-06-06 11:40:00,-775.76,289559.29000000085,298114.1900000005,-8554.899999999674
16893,2022-06-06 11:45:00,-521.6,289037.6900000009,298114.1900000005,-9076.49999999965
16894,2022-06-06 11:50:00,1582.55,290620.24000000086,298114.1900000005,-7493.949999999662
16895,2022-06-06 11:55:00,0.55,290620.79000000085,298114.1900000005,-7493.399999999674
16896,2022-06-06 12:00:00,-379.33,290241.46000000084,298114.1900000005,-7872.72999999969
16897,2022-06-06 12:05:00,1393.8,291635.2600000008,298114.1900000005,-6478.929999999702
16898,2022-06-06 12:10:00,-478.85,291156.41000000085,298114.1900000005,-6957.779999999679
16899,2022-06-06 12:15:00,452.64,291609.05000000086,298114.1900000005,-6505.139999999665
16900,2022-06-06 12:20:00,-186.39,291422.66000000085,298114.1900000005,-6691.529999999679
16901,2022-06-06 12:25:00,-105.84,291316.8200000008,298114.1900000005,-6797.369999999704
16902,2022-06-06 12:30:00,-889.41,290427.41000000085,298114.1900000005,-7686.779999999679
16903,2022-06-06 12:35:00,882.87,291310.28000000084,298114.1900000005,-6803.909999999683
16904,2022-06-06 12:40:00,-141.67,291168.61000000086,298114.1900000005,-6945.579999999667
16905,2022-06-06 12:45:00,281.65,291450.2600000009,298114.1900000005,-6663.929999999644
16906,2022-06-06 12:50:00,1755.52,293205.7800000009,298114.1900000005,-4908.409999999625
16907,2022-06-06 12:55:00,684.56,293890.3400000009,298114.1900000005,-4223.8499999996275
16908,2022-06-06 13:00:00,720.04,294610.3800000009,298114.1900000005,-3503.8099999996484
16909,2022-06-06 13:05:00,-1561.57,293048.81000000087,298114.1900000005,-5065.379999999655
16910,2022-06-06 13:10:00,-1620.68,291428.1300000009,298114.1900000005,-6686.059999999648
16911,2022-06-06 13:15:00,1114.23,292542.36000000086,298114.1900000005,-5571.829999999667
16912,2022-06-06 13:20:00,1152.82,293695.18000000087,298114.1900000005,-4419.00999999966
16913,2022-06-06 13:25:00,-258.72,293436.4600000009,298114.1900000005,-4677.729999999632
16914,2022-06-06 13:30:00,248.32,293684.7800000009,298114.1900000005,-4429.409999999625
16915,2022-06-06 13:35:00,-889.3,292795.4800000009,298114.1900000005,-5318.7099999996135
16916,2022-06-06 13:40:00,1349.69,294145.1700000009,298114.1900000005,-3969.019999999611
16917,2022-06-06 13:45:00,11.86,294157.0300000009,298114.1900000005,-3957.159999999625
16918,2022-06-06 13:50:00,-496.92,293660.1100000009,298114.1900000005,-4454.079999999609
16919,2022-06-06 13:55:00,-286.7,293373.4100000009,298114.1900000005,-4740.7799999996205
16920,2022-06-06 14:00:00,800.95,294174.3600000009,298114.1900000005,-3939.829999999609
16921,2022-06-06 14:05:00,-1506.31,292668.0500000009,298114.1900000005,-5446.1399999996065
16922,2022-06-06 14:10:00,-358.32,292309.7300000009,298114.1900000005,-5804.4599999996135
16923,2022-06-06 14:15:00,-921.59,291388.1400000009,298114.1900000005,-6726.049999999639
16924,2022-06-06 14:20:00,-759.7,290628.4400000009,298114.1900000005,-7485.749999999651
16925,2022-06-06 14:25:00,-978.27,289650.17000000086,298114.1900000005,-8464.01999999967
16926,2022-06-06 14:30:00,1512.67,291162.84000000084,298114.1900000005,-6951.349999999686
16927,2022-06-06 14:35:00,-789.2,290373.6400000008,298114.1900000005,-7740.549999999697
16928,2022-06-06 14:40:00,-1825.9,288547.7400000008,298114.1900000005,-9566.44999999972
16929,2022-06-06 14:45:00,764.03,289311.77000000083,298114.1900000005,-8802.419999999693
16930,2022-06-06 14:50:00,-1387.04,287924.73000000085,298114.1900000005,-10189.459999999672
16931,2022-06-06 14:55:00,-911.47,287013.2600000009,298114.1900000005,-11100.929999999644
16932,2022-06-06 15:00:00,-460.04,286553.2200000009,298114.1900000005,-11560.969999999623
16933,2022-06-06 15:05:00,340.64,286893.8600000009,298114.1900000005,-11220.329999999609
16934,2022-06-06 15:10:00,-82.64,286811.2200000009,298114.1900000005,-11302.969999999623
16935,2022-06-06 15:15:00,-976.93,285834.2900000009,298114.1900000005,-12279.899999999616
16936,2022-06-06 15:20:00,-1273.5,284560.7900000009,298114.1900000005,-13553.399999999616
16937,2022-06-06 15:25:00,254.54,284815.3300000009,298114.1900000005,-13298.859999999637
16938,2022-06-06 15:30:00,-876.9,283938.43000000087,298114.1900000005,-14175.75999999966
16939,2022-06-06 15:35:00,997.37,284935.80000000086,298114.1900000005,-13178.389999999665
16940,2022-06-06 15:40:00,-1050.1,283885.7000000009,298114.1900000005,-14228.489999999641
16941,2022-06-06 15:45:00,-1704.41,282181.2900000009,298114.1900000005,-15932.899999999616
16942,2022-06-06 15:50:00,-305.24,281876.0500000009,298114.1900000005,-16238.139999999607
16943,2022-06-06 15:55:00,101.97,281978.0200000009,298114.1900000005,-16136.169999999634
16944,2022-06-06 16:00:00,852.73,282830.7500000009,298114.1900000005,-15283.439999999653
16945,2022-06-06 16:05:00,1726.29,284557.04000000085,298114.1900000005,-13557.149999999674
16946,2022-06-06 16:10:00,1507.02,286064.06000000087,298114.1900000005,-12050.129999999655
16947,2022-06-06 16:15:00,182.76,286246.8200000009,298114.1900000005,-11867.369999999646
16948,2022-06-06 16:20:00,-737.17,285509.6500000009,298114.1900000005,-12604.53999999963
16949,2022-06-06 16:25:00,-1558.98,283950.6700000009,298114.1900000005,-14163.519999999611
16950,2022-06-06 16:30:00,304.23,284254.9000000009,298114.1900000005,-13859.28999999963
16951,2022-06-06 16:35:00,-1579.02,282675.8800000009,298114.1900000005,-15438.309999999648
16952,2022-06-06 16:40:00,-69.17,282606.7100000009,298114.1900000005,-15507.479999999632
16953,2022-06-06 16:45:00,-1382.65,281224.06000000087,298114.1900000005,-16890.129999999655
16954,2022-06-06 16:50:00,1077.45,282301.5100000009,298114.1900000005,-15812.679999999644
16955,2022-06-06 16:55:00,1440.2,283741.7100000009,298114.1900000005,-14372.479999999632
16956,2022-06-07 08:00:00,-1130.44,282611.2700000009,283741.7100000009,-1130.4400000000023
16957,2022-06-07 08:05:00,-582.86,282028.4100000009,283741.7100000009,-1713.2999999999884
16958,2022-06-07 08:10:00,-1300.02,280728.3900000009,283741.7100000009,-3013.320000000007
16959,2022-06-07 08:15:00,1534.64,282263.0300000009,283741.7100000009,-1478.679999999993
16960,2022-06-07 08:20:00,-744.48,281518.5500000009,283741.7100000009,-2223.1599999999744
16961,2022-06-07 08:25:00,10.52,281529.07000000094,283741.7100000009,-2212.6399999999558
16962,2022-06-07 08:30:00,-774.91,280754.16000000096,283741.7100000009,-2987.54999999993
16963,2022-06-07 08:35:00,-473.32,280280.84000000096,283741.7100000009,-3460.869999999937
16964,2022-06-07 08:40:00,-1334.59,278946.25000000093,283741.7100000009,-4795.459999999963
16965,2022-06-07 08:45:00,1318.77,280265.02000000095,283741.7100000009,-3476.689999999944
16966,2022-06-07 08:50:00,1934.91,282199.9300000009,283741.7100000009,-1541.7799999999697
16967,2022-06-07 08:55:00,-1057.18,281142.75000000093,283741.7100000009,-2598.9599999999627
16968,2022-06-07 09:00:00,1651.57,282794.32000000094,283741.7100000009,-947.3899999999558
16969,2022-06-07 09:05:00,395.68,283190.00000000093,283741.7100000009,-551.7099999999627
16970,2022-06-07 09:10:00,-813.25,282376.75000000093,283741.7100000009,-1364.9599999999627
16971,2022-06-07 09:15:00,1401.55,283778.3000000009,283741.7100000009,36.59000000002561
16972,2022-06-07 09:20:00,1556.22,285334.5200000009,283741.7100000009,1592.8099999999977
16973,2022-06-07 09:25:00,1784.66,287119.18000000087,283741.7100000009,3377.469999999972
16974,2022-06-07 09:30:00,-1482.55,285636.6300000009,283741.7100000009,1894.9199999999837
16975,2022-06-07 09:35:00,986.67,286623.30000000086,283741.7100000009,2881.5899999999674
16976,2022-06-07 09:40:00,-547.09,286076.21000000084,283741.7100000009,2334.499999999942
16977,2022-06-07 09:45:00,-1245.3,284830.91000000085,283741.7100000009,1089.1999999999534
16978,2022-06-07 09:50:00,-928.38,283902.53000000084,283741.7100000009,160.81999999994878
16979,2022-06-07 09:55:00,459.43,284361.96000000084,283741.7100000009,620.2499999999418
16980,2022-06-07 10:00:00,-309.66,284052.30000000086,283741.7100000009,310.5899999999674
16981,2022-06-07 10:05:00,-1934.79,282117.5100000009,283741.7100000009,-1624.2000000000116
16982,2022-06-07 10:10:00,-835.37,281282.1400000009,283741.7100000009,-2459.570000000007
16983,2022-06-07 10:15:00,1249.59,282531.7300000009,283741.7100000009,-1209.9799999999814
16984,2022-06-07 10:20:00,-1640.33,280891.4000000009,283741.7100000009,-2850.3099999999977
16985,2022-06-07 10:25:00,1814.08,282705.4800000009,283741.7100000009,-1036.2299999999814
16986,2022-06-07 10:30:00,1817.51,284522.9900000009,283741.7100000009,781.2800000000279
16987,2022-06-07 10:35:00,-1439.19,283083.8000000009,283741.7100000009,-657.9099999999744
16988,2022-06-07 10:40:00,-270.11,282813.69000000093,283741.7100000009,-928.0199999999604
16989,2022-06-07 10:45:00,-1356.37,281457.32000000094,283741.7100000009,-2284.3899999999558
16990,2022-06-07 10:50:00,1444.79,282902.1100000009,283741.7100000009,-839.5999999999767
16991,2022-06-07 10:55:00,1703.43,284605.5400000009,283741.7100000009,863.8300000000163
16992,2022-06-07 11:00:00,1855.43,286460.9700000009,283741.7100000009,2719.2600000000093
16993,2022-06-07 11:05:00,-1543.75,284917.2200000009,283741.7100000009,1175.5100000000093
16994,2022-06-07 11:10:00,1605.25,286522.4700000009,283741.7100000009,2780.7600000000093
16995,2022-06-07 11:15:00,-387.99,286134.4800000009,283741.7100000009,2392.7700000000186
16996,2022-06-07 11:20:00,-448.72,285685.76000000094,283741.7100000009,1944.0500000000466
16997,2022-06-07 11:25:00,728.58,286414.34000000096,283741.7100000009,2672.630000000063
16998,2022-06-07 11:30:00,1861.13,288275.47000000096,283741.7100000009,4533.7600000000675
16999,2022-06-07 11:35:00,-1784.04,286491.430000001,283741.7100000009,2749.7200000000885
17000,2022-06-07 11:40:00,997.59,287489.020000001,283741.7100000009,3747.310000000114
17001,2022-06-07 11:45:00,-563.91,286925.11000000103,283741.7100000009,3183.4000000001397
17002,2022-06-07 11:50:00,1326.62,288251.73000000103,283741.7100000009,4510.020000000135
17003,2022-06-07 11:55:00,-171.24,288080.49000000104,283741.7100000009,4338.780000000144
17004,2022-06-07 12:00:00,-690.71,287389.780000001,283741.7100000009,3648.0700000001234
17005,2022-06-07 12:05:00,-950.2,286439.580000001,283741.7100000009,2697.8700000001118
17006,2022-06-07 12:10:00,-432.13,286007.450000001,283741.7100000009,2265.740000000107
17007,2022-06-07 12:15:00,-870.4,285137.050000001,283741.7100000009,1395.3400000000838
17008,2022-06-07 12:20:00,-1815.12,283321.930000001,283741.7100000009,-419.7799999999115
17009,2022-06-07 12:25:00,-1349.98,281971.950000001,283741.7100000009,-1769.759999999893
17010,2022-06-07 12:30:00,-142.86,281829.090000001,283741.7100000009,-1912.619999999879
17011,2022-06-07 12:35:00,-1197.66,280631.43000000104,283741.7100000009,-3110.2799999998533
17012,2022-06-07 12:40:00,1534.55,282165.98000000103,283741.7100000009,-1575.729999999865
17013,2022-06-07 12:45:00,390.14,282556.12000000104,283741.7100000009,-1185.589999999851
17014,2022-06-07 12:50:00,406.67,282962.790000001,283741.7100000009,-778.9199999998673
17015,2022-06-07 12:55:00,1302.51,284265.30000000104,283741.7100000009,523.590000000142
17016,2022-06-07 13:00:00,-1204.02,283061.280000001,283741.7100000009,-680.4299999998766
17017,2022-06-07 13:05:00,-13.97,283047.31000000105,283741.7100000009,-694.3999999998487
17018,2022-06-07 13:10:00,-1124.66,281922.6500000011,283741.7100000009,-1819.059999999823
17019,2022-06-07 13:15:00,-8.46,281914.19000000105,283741.7100000009,-1827.519999999844
17020,2022-06-07 13:20:00,-678.85,281235.3400000011,283741.7100000009,-2506.3699999998207
17021,2022-06-07 13:25:00,22.14,281257.4800000011,283741.7100000009,-2484.2299999998068
17022,2022-06-07 13:30:00,-983.81,280273.6700000011,283741.7100000009,-3468.0399999998044
17023,2022-06-07 13:35:00,-789.29,279484.3800000011,283741.7100000009,-4257.3299999997835
17024,2022-06-07 13:40:00,1729.76,281214.1400000011,283741.7100000009,-2527.569999999774
17025,2022-06-07 13:45:00,-148.97,281065.17000000115,283741.7100000009,-2676.539999999746
17026,2022-06-07 13:50:00,-1306.59,279758.5800000011,283741.7100000009,-3983.129999999772
17027,2022-06-07 13:55:00,37.3,279795.8800000011,283741.7100000009,-3945.8299999997835
17028,2022-06-07 14:00:00,451.05,280246.9300000011,283741.7100000009,-3494.779999999795
17029,2022-06-07 14:05:00,149.15,280396.0800000011,283741.7100000009,-3345.629999999772
17030,2022-06-07 14:10:00,-1193.34,279202.7400000011,283741.7100000009,-4538.969999999797
17031,2022-06-07 14:15:00,-766.34,278436.4000000011,283741.7100000009,-5305.309999999823
17032,2022-06-07 14:20:00,-584.69,277851.71000000107,283741.7100000009,-5889.999999999825
17033,2022-06-07 14:25:00,315.48,278167.19000000105,283741.7100000009,-5574.519999999844
17034,2022-06-07 14:30:00,-1141.77,277025.42000000103,283741.7100000009,-6716.289999999863
17035,2022-06-07 14:35:00,736.26,277761.68000000104,283741.7100000009,-5980.029999999853
17036,2022-06-07 14:40:00,-665.79,277095.89000000106,283741.7100000009,-6645.819999999832
17037,2022-06-07 14:45:00,407.18,277503.07000000105,283741.7100000009,-6238.639999999839
17038,2022-06-07 14:50:00,5.21,277508.2800000011,283741.7100000009,-6233.429999999818
17039,2022-06-07 14:55:00,456.72,277965.00000000105,283741.7100000009,-5776.709999999846
17040,2022-06-07 15:00:00,1175.93,279140.93000000104,283741.7100000009,-4600.779999999853
17041,2022-06-07 15:05:00,-988.35,278152.58000000106,283741.7100000009,-5589.12999999983
17042,2022-06-07 15:10:00,-1038.9,277113.68000000104,283741.7100000009,-6628.029999999853
17043,2022-06-07 15:15:00,-1776.82,275336.86000000103,283741.7100000009,-8404.84999999986
17044,2022-06-07 15:20:00,1302.04,276638.900000001,283741.7100000009,-7102.809999999881
17045,2022-06-07 15:25:00,293.07,276931.970000001,283741.7100000009,-6809.739999999874
17046,2022-06-07 15:30:00,-1131.65,275800.320000001,283741.7100000009,-7941.389999999898
17047,2022-06-07 15:35:00,-194.95,275605.370000001,283741.7100000009,-8136.339999999909
17048,2022-06-07 15:40:00,98.23,275703.60000000097,283741.7100000009,-8038.109999999928
17049,2022-06-07 15:45:00,1443.41,277147.01000000094,283741.7100000009,-6594.699999999953
17050,2022-06-07 15:50:00,767.96,277914.97000000096,283741.7100000009,-5826.7399999999325
17051,2022-06-07 15:55:00,535.46,278450.430000001,283741.7100000009,-5291.2799999999115
17052,2022-06-07 16:00:00,-553.65,277896.78000000096,283741.7100000009,-5844.929999999935
17053,2022-06-07 16:05:00,682.96,278579.740000001,283741.7100000009,-5161.969999999914
17054,2022-06-07 16:10:00,-1054.67,277525.070000001,283741.7100000009,-6216.639999999898
17055,2022-06-07 16:15:00,126.4,277651.470000001,283741.7100000009,-6090.239999999874
17056,2022-06-07 16:20:00,1015.48,278666.950000001,283741.7100000009,-5074.759999999893
17057,2022-06-07 16:25:00,1664.49,280331.440000001,283741.7100000009,-3410.269999999902
17058,2022-06-07 16:30:00,275.82,280607.260000001,283741.7100000009,-3134.449999999895
17059,2022-06-07 16:35:00,-1342.06,279265.200000001,283741.7100000009,-4476.509999999893
17060,2022-06-07 16:40:00,92.37,279357.570000001,283741.7100000009,-4384.139999999898
17061,2022-06-07 16:45:00,1100.41,280457.980000001,283741.7100000009,-3283.729999999923
17062,2022-06-07 16:50:00,91.0,280548.980000001,283741.7100000009,-3192.729999999923
17063,2022-06-07 16:55:00,-1129.46,279419.52000000095,283741.7100000009,-4322.189999999944
17064,2022-06-08 08:00:00,-231.58,279187.94000000093,279419.52000000095,-231.5800000000163
17065,2022-06-08 08:05:00,630.8,279818.7400000009,279419.52000000095,399.21999999997206
17066,2022-06-08 08:10:00,-1723.96,278094.7800000009,279419.52000000095,-1324.740000000049
17067,2022-06-08 08:15:00,564.22,278659.0000000009,279419.52000000095,-760.5200000000768
17068,2022-06-08 08:20:00,1398.41,280057.41000000085,279419.52000000095,637.8899999998976
17069,2022-06-08 08:25:00,152.2,280209.61000000086,279419.52000000095,790.0899999999092
17070,2022-06-08 08:30:00,-734.56,279475.05000000086,279419.52000000095,55.529999999911524
17071,2022-06-08 08:35:00,928.2,280403.2500000009,279419.52000000095,983.7299999999232
17072,2022-06-08 08:40:00,-857.15,279546.10000000085,279419.52000000095,126.57999999989988
17073,2022-06-08 08:45:00,59.89,279605.99000000086,279419.52000000095,186.46999999991385
17074,2022-06-08 08:50:00,-1925.52,277680.47000000085,279419.52000000095,-1739.0500000001048
17075,2022-06-08 08:55:00,-1341.45,276339.02000000083,279419.52000000095,-3080.5000000001164
17076,2022-06-08 09:00:00,1200.64,277539.66000000085,279419.52000000095,-1879.8600000001024
17077,2022-06-08 09:05:00,987.15,278526.81000000087,279419.52000000095,-892.7100000000792
17078,2022-06-08 09:10:00,1555.11,280081.92000000086,279419.52000000095,662.3999999999069
17079,2022-06-08 09:15:00,-1564.12,278517.80000000086,279419.52000000095,-901.7200000000885
17080,2022-06-08 09:20:00,1537.52,280055.3200000009,279419.52000000095,635.7999999999302
17081,2022-06-08 09:25:00,-941.66,279113.6600000009,279419.52000000095,-305.86000000004424
17082,2022-06-08 09:30:00,932.02,280045.6800000009,279419.52000000095,626.1599999999744
17083,2022-06-08 09:35:00,-1181.78,278863.9000000009,279419.52000000095,-555.6200000000536
17084,2022-06-08 09:40:00,1021.42,279885.3200000009,279419.52000000095,465.79999999993015
17085,2022-06-08 09:45:00,341.7,280227.0200000009,279419.52000000095,807.4999999999418
17086,2022-06-08 09:50:00,140.0,280367.0200000009,279419.52000000095,947.4999999999418
17087,2022-06-08 09:55:00,548.23,280915.2500000009,279419.52000000095,1495.7299999999232
17088,2022-06-08 10:00:00,90.6,281005.85000000085,279419.52000000095,1586.3299999998999
17089,2022-06-08 10:05:00,188.02,281193.87000000087,279419.52000000095,1774.3499999999185
17090,2022-06-08 10:10:00,-426.97,280766.9000000009,279419.52000000095,1347.3799999999464
17091,2022-06-08 10:15:00,-1491.59,279275.31000000087,279419.52000000095,-144.21000000007916
17092,2022-06-08 10:20:00,413.34,279688.6500000009,279419.52000000095,269.12999999994645
17093,2022-06-08 10:25:00,1646.6,281335.2500000009,279419.52000000095,1915.7299999999232
17094,2022-06-08 10:30:00,-1033.12,280302.1300000009,279419.52000000095,882.6099999999278
17095,2022-06-08 10:35:00,-78.63,280223.5000000009,279419.52000000095,803.9799999999232
17096,2022-06-08 10:40:00,1515.52,281739.0200000009,279419.52000000095,2319.499999999942
17097,2022-06-08 10:45:00,-1961.48,279777.5400000009,279419.52000000095,358.0199999999604
17098,2022-06-08 10:50:00,-649.86,279127.6800000009,279419.52000000095,-291.8400000000256
17099,2022-06-08 10:55:00,1744.0,280871.6800000009,279419.52000000095,1452.1599999999744
17100,2022-06-08 11:00:00,844.32,281716.00000000093,279419.52000000095,2296.4799999999814
17101,2022-06-08 11:05:00,-1606.35,280109.65000000095,279419.52000000095,690.1300000000047
17102,2022-06-08 11:10:00,-242.9,279866.75000000093,279419.52000000095,447.2299999999814
17103,2022-06-08 11:15:00,-1699.72,278167.03000000096,279419.52000000095,-1252.4899999999907
17104,2022-06-08 11:20:00,-317.12,277849.91000000096,279419.52000000095,-1569.609999999986
17105,2022-06-08 11:25:00,-1903.18,275946.730000001,279419.52000000095,-3472.789999999979
17106,2022-06-08 11:30:00,1087.57,277034.300000001,279419.52000000095,-2385.219999999972
17107,2022-06-08 11:35:00,-1218.57,275815.730000001,279419.52000000095,-3603.789999999979
17108,2022-06-08 11:40:00,320.13,276135.860000001,279419.52000000095,-3283.6599999999744
17109,2022-06-08 11:45:00,477.36,276613.22000000096,279419.52000000095,-2806.2999999999884
17110,2022-06-08 11:50:00,-370.87,276242.35000000097,279419.52000000095,-3177.1699999999837
17111,2022-06-08 11:55:00,-1119.84,275122.51000000094,279419.52000000095,-4297.010000000009
17112,2022-06-08 12:00:00,-359.93,274762.58000000095,279419.52000000095,-4656.940000000002
17113,2022-06-08 12:05:00,1255.33,276017.91000000096,279419.52000000095,-3401.609999999986
17114,2022-06-08 12:10:00,1836.95,277854.860000001,279419.52000000095,-1564.6599999999744
17115,2022-06-08 12:15:00,-559.23,277295.630000001,279419.52000000095,-2123.8899999999558
17116,2022-06-08 12:20:00,-1677.45,275618.180000001,279419.52000000095,-3801.3399999999674
17117,2022-06-08 12:25:00,-1750.13,273868.050000001,279419.52000000095,-5551.469999999972
17118,2022-06-08 12:30:00,-1487.41,272380.640000001,279419.52000000095,-7038.879999999946
17119,2022-06-08 12:35:00,-1326.27,271054.370000001,279419.52000000095,-8365.149999999965
17120,2022-06-08 12:40:00,1849.85,272904.22000000096,279419.52000000095,-6515.299999999988
17121,2022-06-08 12:45:00,286.03,273190.250000001,279419.52000000095,-6229.26999999996
17122,2022-06-08 12:50:00,1848.31,275038.560000001,279419.52000000095,-4380.959999999963
17123,2022-06-08 12:55:00,431.09,275469.650000001,279419.52000000095,-3949.869999999937
17124,2022-06-08 13:00:00,1364.06,276833.710000001,279419.52000000095,-2585.8099999999395
17125,2022-06-08 13:05:00,-1905.29,274928.42000000103,279419.52000000095,-4491.0999999999185
17126,2022-06-08 13:10:00,226.76,275155.18000000104,279419.52000000095,-4264.339999999909
17127,2022-06-08 13:15:00,-1345.94,273809.24000000104,279419.52000000095,-5610.2799999999115
17128,2022-06-08 13:20:00,-1495.15,272314.090000001,279419.52000000095,-7105.429999999935
17129,2022-06-08 13:25:00,170.95,272485.040000001,279419.52000000095,-6934.479999999923
17130,2022-06-08 13:30:00,315.1,272800.140000001,279419.52000000095,-6619.379999999946
17131,2022-06-08 13:35:00,1941.68,274741.820000001,279419.52000000095,-4677.699999999953
17132,2022-06-08 13:40:00,-1085.53,273656.29000000097,279419.52000000095,-5763.229999999981
17133,2022-06-08 13:45:00,-1513.35,272142.940000001,279419.52000000095,-7276.579999999958
17134,2022-06-08 13:50:00,-713.5,271429.440000001,279419.52000000095,-7990.079999999958
17135,2022-06-08 13:55:00,707.97,272137.41000000096,279419.52000000095,-7282.109999999986
17136,2022-06-08 14:00:00,-1422.63,270714.78000000096,279419.52000000095,-8704.73999999999
17137,2022-06-08 14:05:00,1070.01,271784.79000000097,279419.52000000095,-7634.729999999981
17138,2022-06-08 14:10:00,560.26,272345.050000001,279419.52000000095,-7074.469999999972
17139,2022-06-08 14:15:00,276.74,272621.79000000097,279419.52000000095,-6797.729999999981
17140,2022-06-08 14:20:00,416.56,273038.35000000097,279419.52000000095,-6381.169999999984
17141,2022-06-08 14:25:00,734.63,273772.980000001,279419.52000000095,-5646.539999999979
17142,2022-06-08 14:30:00,-883.94,272889.04000000097,279419.52000000095,-6530.479999999981
17143,2022-06-08 14:35:00,206.89,273095.930000001,279419.52000000095,-6323.589999999967
17144,2022-06-08 14:40:00,-1095.03,272000.90000000095,279419.52000000095,-7418.619999999995
17145,2022-06-08 14:45:00,-1191.73,270809.170000001,279419.52000000095,-8610.349999999977
17146,2022-06-08 14:50:00,-1872.4,268936.77000000095,279419.52000000095,-10482.75
17147,2022-06-08 14:55:00,-1090.89,267845.88000000094,279419.52000000095,-11573.640000000014
17148,2022-06-08 15:00:00,-450.1,267395.78000000096,279419.52000000095,-12023.73999999999
17149,2022-06-08 15:05:00,-1039.34,266356.44000000093,279419.52000000095,-13063.080000000016
17150,2022-06-08 15:10:00,445.72,266802.1600000009,279419.52000000095,-12617.360000000044
17151,2022-06-08 15:15:00,-775.32,266026.8400000009,279419.52000000095,-13392.680000000051
17152,2022-06-08 15:20:00,386.28,266413.1200000009,279419.52000000095,-13006.400000000023
17153,2022-06-08 15:25:00,1225.1,267638.2200000009,279419.52000000095,-11781.300000000047
17154,2022-06-08 15:30:00,-706.83,266931.3900000009,279419.52000000095,-12488.130000000063
17155,2022-06-08 15:35:00,-1526.24,265405.1500000009,279419.52000000095,-14014.370000000054
17156,2022-06-08 15:40:00,1853.65,267258.8000000009,279419.52000000095,-12160.72000000003
17157,2022-06-08 15:45:00,-574.14,266684.6600000009,279419.52000000095,-12734.860000000044
17158,2022-06-08 15:50:00,1365.05,268049.7100000009,279419.52000000095,-11369.810000000056
17159,2022-06-08 15:55:00,985.22,269034.93000000087,279419.52000000095,-10384.590000000084
17160,2022-06-08 16:00:00,-1013.99,268020.9400000009,279419.52000000095,-11398.580000000075
17161,2022-06-08 16:05:00,-1152.2,266868.74000000086,279419.52000000095,-12550.780000000086
17162,2022-06-08 16:10:00,1674.09,268542.8300000009,279419.52000000095,-10876.69000000006
17163,2022-06-08 16:15:00,1112.52,269655.3500000009,279419.52000000095,-9764.170000000042
17164,2022-06-08 16:20:00,-1995.5,267659.8500000009,279419.52000000095,-11759.670000000042
17165,2022-06-08 16:25:00,-221.29,267438.5600000009,279419.52000000095,-11980.960000000021
17166,2022-06-08 16:30:00,776.98,268215.5400000009,279419.52000000095,-11203.98000000004
17167,2022-06-08 16:35:00,740.24,268955.7800000009,279419.52000000095,-10463.740000000049
17168,2022-06-08 16:40:00,1202.75,270158.5300000009,279419.52000000095,-9260.990000000049
17169,2022-06-08 16:45:00,1238.72,271397.2500000009,279419.52000000095,-8022.270000000077
17170,2022-06-08 16:50:00,742.47,272139.72000000085,279419.52000000095,-7279.800000000105
17171,2022-06-08 16:55:00,-1653.19,270486.53000000084,279419.52000000095,-8932.990000000107
17172,2022-06-09 08:00:00,-548.24,269938.29000000085,270486.53000000084,-548.2399999999907
17173,2022-06-09 08:05:00,-1589.19,268349.10000000085,270486.53000000084,-2137.429999999993
17174,2022-06-09 08:10:00,317.58,268666.68000000087,270486.53000000084,-1819.8499999999767
17175,2022-06-09 08:15:00,-56.66,268610.0200000009,270486.53000000084,-1876.509999999951
17176,2022-06-09 08:20:00,474.24,269084.2600000009,270486.53000000084,-1402.2699999999604
17177,2022-06-09 08:25:00,1515.91,270600.17000000086,270486.53000000084,113.64000000001397
17178,2022-06-09 08:30:00,-1049.27,269550.90000000084,270486.53000000084,-935.6300000000047
17179,2022-06-09 08:35:00,313.66,269864.5600000008,270486.53000000084,-621.9700000000303
17180,2022-06-09 08:40:00,-1922.56,267942.0000000008,270486.53000000084,-2544.530000000028
17181,2022-06-09 08:45:00,-1900.84,266041.1600000008,270486.53000000084,-4445.370000000054
17182,2022-06-09 08:50:00,90.01,266131.1700000008,270486.53000000084,-4355.360000000044
17183,2022-06-09 08:55:00,-905.07,265226.1000000008,270486.53000000084,-5260.430000000051
17184,2022-06-09 09:00:00,1988.68,267214.7800000008,270486.53000000084,-3271.750000000058
17185,2022-06-09 09:05:00,354.22,267569.00000000076,270486.53000000084,-2917.530000000086
17186,2022-06-09 09:10:00,133.78,267702.7800000008,270486.53000000084,-2783.750000000058
17187,2022-06-09 09:15:00,830.97,268533.75000000076,270486.53000000084,-1952.7800000000861
17188,2022-06-09 09:20:00,435.43,268969.18000000075,270486.53000000084,-1517.3500000000931
17189,2022-06-09 09:25:00,324.3,269293.48000000074,270486.53000000084,-1193.0500000001048
17190,2022-06-09 09:30:00,1885.87,271179.35000000073,270486.53000000084,692.8199999998906
17191,2022-06-09 09:35:00,230.78,271410.13000000076,270486.53000000084,923.5999999999185
17192,2022-06-09 09:40:00,-159.2,271250.93000000075,270486.53000000084,764.3999999999069
17193,2022-06-09 09:45:00,1397.53,272648.4600000008,270486.53000000084,2161.929999999935
17194,2022-06-09 09:50:00,1600.06,274248.5200000008,270486.53000000084,3761.9899999999325
17195,2022-06-09 09:55:00,28.93,274277.45000000077,270486.53000000084,3790.9199999999255
17196,2022-06-09 10:00:00,-256.86,274020.5900000008,270486.53000000084,3534.0599999999395
17197,2022-06-09 10:05:00,1410.29,275430.88000000076,270486.53000000084,4944.3499999999185
17198,2022-06-09 10:10:00,1847.31,277278.19000000076,270486.53000000084,6791.659999999916
17199,2022-06-09 10:15:00,-1501.88,275776.31000000075,270486.53000000084,5289.7799999999115
17200,2022-06-09 10:20:00,-234.66,275541.6500000008,270486.53000000084,5055.119999999937
17201,2022-06-09 10:25:00,1236.16,276777.81000000075,270486.53000000084,6291.2799999999115
17202,2022-06-09 10:30:00,13.59,276791.4000000008,270486.53000000084,6304.869999999937
17203,2022-06-09 10:35:00,376.58,277167.9800000008,270486.53000000084,6681.449999999953
17204,2022-06-09 10:40:00,1061.73,278229.7100000008,270486.53000000084,7743.179999999935
17205,2022-06-09 10:45:00,-259.21,277970.50000000076,270486.53000000084,7483.969999999914
17206,2022-06-09 10:50:00,-539.49,277431.01000000077,270486.53000000084,6944.479999999923
17207,2022-06-09 10:55:00,1051.38,278482.39000000077,270486.53000000084,7995.859999999928
17208,2022-06-09 11:00:00,411.51,278893.9000000008,270486.53000000084,8407.369999999937
17209,2022-06-09 11:05:00,422.08,279315.9800000008,270486.53000000084,8829.449999999953
17210,2022-06-09 11:10:00,-195.96,279120.0200000008,270486.53000000084,8633.489999999932
17211,2022-06-09 11:15:00,-116.82,279003.20000000077,270486.53000000084,8516.669999999925
17212,2022-06-09 11:20:00,1837.1,280840.30000000075,270486.53000000084,10353.769999999902
17213,2022-06-09 11:25:00,-317.74,280522.56000000075,270486.53000000084,10036.029999999912
17214,2022-06-09 11:30:00,286.4,280808.9600000008,270486.53000000084,10322.429999999935
17215,2022-06-09 11:35:00,571.87,281380.8300000008,270486.53000000084,10894.29999999993
17216,2022-06-09 11:40:00,145.42,281526.25000000076,270486.53000000084,11039.719999999914
17217,2022-06-09 11:45:00,-67.66,281458.5900000008,270486.53000000084,10972.05999999994
17218,2022-06-09 11:50:00,-1371.0,280087.5900000008,270486.53000000084,9601.05999999994
17219,2022-06-09 11:55:00,1510.49,281598.0800000008,270486.53000000084,11111.54999999993
17220,2022-06-09 12:00:00,-719.24,280878.8400000008,270486.53000000084,10392.30999999994
17221,2022-06-09 12:05:00,-637.61,280241.2300000008,270486.53000000084,9754.699999999953
17222,2022-06-09 12:10:00,-106.13,280135.1000000008,270486.53000000084,9648.569999999949
17223,2022-06-09 12:15:00,1403.21,281538.3100000008,270486.53000000084,11051.77999999997
17224,2022-06-09 12:20:00,-1123.19,280415.1200000008,270486.53000000084,9928.589999999967
17225,2022-06-09 12:25:00,-178.6,280236.52000000083,270486.53000000084,9749.98999999999
17226,2022-06-09 12:30:00,410.78,280647.30000000086,270486.53000000084,10160.770000000019
17227,2022-06-09 12:35:00,-109.83,280537.47000000085,270486.53000000084,10050.940000000002
17228,2022-06-09 12:40:00,1556.93,282094.40000000084,270486.53000000084,11607.869999999995
17229,2022-06-09 12:45:00,-172.67,281921.73000000085,270486.53000000084,11435.200000000012
17230,2022-06-09 12:50:00,432.45,282354.18000000087,270486.53000000084,11867.650000000023
17231,2022-06-09 12:55:00,-715.59,281638.59000000084,270486.53000000084,11152.059999999998
17232,2022-06-09 13:00:00,1150.45,282789.04000000085,270486.53000000084,12302.51000000001
17233,2022-06-09 13:05:00,-758.28,282030.7600000008,270486.53000000084,11544.229999999981
17234,2022-06-09 13:10:00,1456.33,283487.09000000084,270486.53000000084,13000.559999999998
17235,2022-06-09 13:15:00,-1897.39,281589.7000000008,270486.53000000084,11103.169999999984
17236,2022-06-09 13:20:00,309.92,281899.6200000008,270486.53000000084,11413.089999999967
17237,2022-06-09 13:25:00,-370.96,281528.6600000008,270486.53000000084,11042.129999999946
17238,2022-06-09 13:30:00,1889.98,283418.64000000077,270486.53000000084,12932.109999999928
17239,2022-06-09 13:35:00,964.81,284383.45000000077,270486.53000000084,13896.919999999925
17240,2022-06-09 13:40:00,1625.09,286008.5400000008,270486.53000000084,15522.009999999951
17241,2022-06-09 13:45:00,1763.71,287772.2500000008,270486.53000000084,17285.719999999972
17242,2022-06-09 13:50:00,1919.69,289691.9400000008,270486.53000000084,19205.409999999974
17243,2022-06-09 13:55:00,469.45,290161.3900000008,270486.53000000084,19674.859999999986
17244,2022-06-09 14:00:00,-1907.19,288254.2000000008,270486.53000000084,17767.669999999984
17245,2022-06-09 14:05:00,154.8,288409.0000000008,270486.53000000084,17922.469999999972
17246,2022-06-09 14:10:00,1746.04,290155.0400000008,270486.53000000084,19668.50999999995
17247,2022-06-09 14:15:00,554.78,290709.8200000008,270486.53000000084,20223.28999999998
17248,2022-06-09 14:20:00,449.84,291159.66000000085,270486.53000000084,20673.130000000005
17249,2022-06-09 14:25:00,488.56,291648.22000000085,270486.53000000084,21161.690000000002
17250,2022-06-09 14:30:00,592.2,292240.42000000086,270486.53000000084,21753.890000000014
17251,2022-06-09 14:35:00,-90.97,292149.4500000009,270486.53000000084,21662.920000000042
17252,2022-06-09 14:40:00,-1377.42,290772.0300000009,270486.53000000084,20285.50000000006
17253,2022-06-09 14:45:00,306.53,291078.5600000009,270486.53000000084,20592.030000000086
17254,2022-06-09 14:50:00,-573.48,290505.08000000095,270486.53000000084,20018.550000000105
17255,2022-06-09 14:55:00,-738.14,289766.94000000093,270486.53000000084,19280.41000000009
17256,2022-06-09 15:00:00,-1670.76,288096.1800000009,270486.53000000084,17609.65000000008
17257,2022-06-09 15:05:00,-493.96,287602.2200000009,270486.53000000084,17115.69000000006
17258,2022-06-09 15:10:00,-1376.74,286225.4800000009,270486.53000000084,15738.95000000007
17259,2022-06-09 15:15:00,1063.74,287289.2200000009,270486.53000000084,16802.69000000006
17260,2022-06-09 15:20:00,-1642.7,285646.5200000009,270486.53000000084,15159.990000000049
17261,2022-06-09 15:25:00,1353.92,287000.4400000009,270486.53000000084,16513.910000000033
17262,2022-06-09 15:30:00,1338.4,288338.8400000009,270486.53000000084,17852.310000000056
17263,2022-06-09 15:35:00,1197.7,289536.5400000009,270486.53000000084,19050.010000000068
17264,2022-06-09 15:40:00,-1912.81,287623.7300000009,270486.53000000084,17137.20000000007
17265,2022-06-09 15:45:00,1572.63,289196.3600000009,270486.53000000084,18709.830000000075
17266,2022-06-09 15:50:00,1955.67,291152.0300000009,270486.53000000084,20665.50000000006
17267,2022-06-09 15:55:00,334.71,291486.7400000009,270486.53000000084,21000.21000000008
17268,2022-06-09 16:00:00,-1951.36,289535.38000000094,270486.53000000084,19048.850000000093
17269,2022-06-09 16:05:00,1739.77,291275.15000000095,270486.53000000084,20788.62000000011
17270,2022-06-09 16:10:00,-577.12,290698.03000000096,270486.53000000084,20211.500000000116
17271,2022-06-09 16:15:00,817.01,291515.04000000097,270486.53000000084,21028.510000000126
17272,2022-06-09 16:20:00,793.25,292308.29000000097,270486.53000000084,21821.760000000126
17273,2022-06-09 16:25:00,-1829.79,290478.500000001,270486.53000000084,19991.970000000147
17274,2022-06-09 16:30:00,-1992.17,288486.330000001,270486.53000000084,17999.800000000163
17275,2022-06-09 16:35:00,-9.3,288477.030000001,270486.53000000084,17990.500000000175
17276,2022-06-09 16:40:00,1569.74,290046.770000001,270486.53000000084,19560.240000000165
17277,2022-06-09 16:45:00,187.07,290233.840000001,270486.53000000084,19747.310000000172
17278,2022-06-09 16:50:00,1909.97,292143.810000001,270486.53000000084,21657.280000000144
17279,2022-06-09 16:55:00,-319.26,291824.550000001,270486.53000000084,21338.020000000135
17280,2022-06-10 08:00:00,893.1,292717.65000000095,291824.550000001,893.0999999999767
17281,2022-06-10 08:05:00,1062.79,293780.44000000093,291824.550000001,1955.8899999999558
17282,2022-06-10 08:10:00,-1968.49,291811.95000000094,291824.550000001,-12.600000000034925
17283,2022-06-10 08:15:00,-1775.11,290036.84000000096,291824.550000001,-1787.710000000021
17284,2022-06-10 08:20:00,780.6,290817.44000000093,291824.550000001,-1007.1100000000442
17285,2022-06-10 08:25:00,565.15,291382.59000000096,291824.550000001,-441.96000000002095
17286,2022-06-10 08:30:00,1191.59,292574.180000001,291824.550000001,749.6300000000047
17287,2022-06-10 08:35:00,-1117.53,291456.65000000095,291824.550000001,-367.9000000000233
17288,2022-06-10 08:40:00,1302.05,292758.70000000094,291824.550000001,934.1499999999651
17289,2022-06-10 08:45:00,-1687.01,291071.69000000093,291824.550000001,-752.8600000000442
17290,2022-06-10 08:50:00,-994.18,290077.51000000094,291824.550000001,-1747.0400000000373
17291,2022-06-10 08:55:00,-1433.07,288644.44000000093,291824.550000001,-3180.1100000000442
17292,2022-06-10 09:00:00,436.52,289080.96000000095,291824.550000001,-2743.5900000000256
17293,2022-06-10 09:05:00,541.38,289622.34000000096,291824.550000001,-2202.210000000021
17294,2022-06-10 09:10:00,884.75,290507.09000000096,291824.550000001,-1317.460000000021
17295,2022-06-10 09:15:00,-1208.12,289298.97000000096,291824.550000001,-2525.5800000000163
17296,2022-06-10 09:20:00,-1296.94,288002.03000000096,291824.550000001,-3822.5200000000186
17297,2022-06-10 09:25:00,376.93,288378.96000000095,291824.550000001,-3445.5900000000256
17298,2022-06-10 09:30:00,-1878.87,286500.09000000096,291824.550000001,-5324.460000000021
17299,2022-06-10 09:35:00,1051.79,287551.88000000094,291824.550000001,-4272.670000000042
17300,2022-06-10 09:40:00,815.56,288367.44000000093,291824.550000001,-3457.1100000000442
17301,2022-06-10 09:45:00,1341.85,289709.2900000009,291824.550000001,-2115.2600000000675
17302,2022-06-10 09:50:00,1619.31,291328.6000000009,291824.550000001,-495.95000000006985
17303,2022-06-10 09:55:00,115.83,291444.4300000009,291824.550000001,-380.12000000005355
17304,2022-06-10 10:00:00,465.09,291909.52000000095,291824.550000001,84.96999999997206
17305,2022-06-10 10:05:00,-650.6,291258.920000001,291824.550000001,-565.6300000000047
17306,2022-06-10 10:10:00,-1864.95,289393.97000000096,291824.550000001,-2430.5800000000163
17307,2022-06-10 10:15:00,-439.15,288954.82000000094,291824.550000001,-2869.7300000000396
17308,2022-06-10 10:20:00,-1619.42,287335.40000000095,291824.550000001,-4489.150000000023
17309,2022-06-10 10:25:00,827.53,288162.930000001,291824.550000001,-3661.6199999999953
17310,2022-06-10 10:30:00,1344.28,289507.210000001,291824.550000001,-2317.3399999999674
17311,2022-06-10 10:35:00,-196.95,289310.260000001,291824.550000001,-2514.289999999979
17312,2022-06-10 10:40:00,-75.53,289234.730000001,291824.550000001,-2589.820000000007
17313,2022-06-10 10:45:00,-1376.97,287857.760000001,291824.550000001,-3966.789999999979
17314,2022-06-10 10:50:00,338.6,288196.360000001,291824.550000001,-3628.1900000000023
17315,2022-06-10 10:55:00,-310.63,287885.730000001,291824.550000001,-3938.820000000007
17316,2022-06-10 11:00:00,-1043.86,286841.870000001,291824.550000001,-4982.679999999993
17317,2022-06-10 11:05:00,-725.07,286116.800000001,291824.550000001,-5707.75
17318,2022-06-10 11:10:00,-688.99,285427.810000001,291824.550000001,-6396.739999999991
17319,2022-06-10 11:15:00,1468.38,286896.190000001,291824.550000001,-4928.359999999986
17320,2022-06-10 11:20:00,1983.26,288879.450000001,291824.550000001,-2945.0999999999767
17321,2022-06-10 11:25:00,310.51,289189.960000001,291824.550000001,-2634.5899999999674
17322,2022-06-10 11:30:00,-1268.78,287921.180000001,291824.550000001,-3903.3699999999953
17323,2022-06-10 11:35:00,1717.44,289638.620000001,291824.550000001,-2185.929999999993
17324,2022-06-10 11:40:00,1354.4,290993.020000001,291824.550000001,-831.5299999999697
17325,2022-06-10 11:45:00,1756.6,292749.620000001,291824.550000001,925.070000000007
17326,2022-06-10 11:50:00,-1834.43,290915.190000001,291824.550000001,-909.359999999986
17327,2022-06-10 11:55:00,-1449.24,289465.950000001,291824.550000001,-2358.5999999999767
17328,2022-06-10 12:00:00,-1416.15,288049.800000001,291824.550000001,-3774.75
17329,2022-06-10 12:05:00,-257.93,287791.870000001,291824.550000001,-4032.679999999993
17330,2022-06-10 12:10:00,353.66,288145.53000000096,291824.550000001,-3679.0200000000186
17331,2022-06-10 12:15:00,-68.45,288077.08000000095,291824.550000001,-3747.4700000000303
17332,2022-06-10 12:20:00,1729.91,289806.9900000009,291824.550000001,-2017.5600000000559
17333,2022-06-10 12:25:00,-608.24,289198.75000000093,291824.550000001,-2625.8000000000466
17334,2022-06-10 12:30:00,1141.04,290339.7900000009,291824.550000001,-1484.7600000000675
17335,2022-06-10 12:35:00,-84.32,290255.4700000009,291824.550000001,-1569.0800000000745
17336,2022-06-10 12:40:00,1770.52,292025.9900000009,291824.550000001,201.43999999994412
17337,2022-06-10 12:45:00,855.82,292881.8100000009,291824.550000001,1057.259999999951
17338,2022-06-10 12:50:00,-1421.63,291460.1800000009,291824.550000001,-364.37000000005355
17339,2022-06-10 12:55:00,407.08,291867.26000000094,291824.550000001,42.70999999996275
17340,2022-06-10 13:00:00,-547.55,291319.71000000095,291824.550000001,-504.8400000000256
17341,2022-06-10 13:05:00,57.65,291377.360000001,291824.550000001,-447.1900000000023
17342,2022-06-10 13:10:00,-1094.94,290282.420000001,291824.550000001,-1542.1300000000047
17343,2022-06-10 13:15:00,731.57,291013.990000001,291824.550000001,-810.5599999999977
17344,2022-06-10 13:20:00,1199.16,292213.15000000095,291824.550000001,388.5999999999767
17345,2022-06-10 13:25:00,1255.6,293468.75000000093,291824.550000001,1644.1999999999534
17346,2022-06-10 13:30:00,-486.87,292981.88000000094,291824.550000001,1157.329999999958
17347,2022-06-10 13:35:00,1498.13,294480.01000000094,291824.550000001,2655.4599999999627
17348,2022-06-10 13:40:00,-464.41,294015.60000000097,291824.550000001,2191.0499999999884
17349,2022-06-10 13:45:00,1431.79,295447.39000000095,291824.550000001,3622.8399999999674
17350,2022-06-10 13:50:00,-1848.21,293599.1800000009,291824.550000001,1774.6299999999464
17351,2022-06-10 13:55:00,1071.73,294670.9100000009,291824.550000001,2846.359999999928
17352,2022-06-10 14:00:00,1214.48,295885.3900000009,291824.550000001,4060.839999999909
17353,2022-06-10 14:05:00,34.84,295920.2300000009,291824.550000001,4095.679999999935
17354,2022-06-10 14:10:00,-1729.46,294190.7700000009,291824.550000001,2366.219999999914
17355,2022-06-10 14:15:00,-1186.83,293003.9400000009,291824.550000001,1179.3899999998976
17356,2022-06-10 14:20:00,-1056.37,291947.5700000009,291824.550000001,123.01999999990221
17357,2022-06-10 14:25:00,757.04,292704.61000000086,291824.550000001,880.0599999998813
17358,2022-06-10 14:30:00,-1062.43,291642.18000000087,291824.550000001,-182.37000000011176
17359,2022-06-10 14:35:00,130.79,291772.97000000085,291824.550000001,-51.58000000013271
17360,2022-06-10 14:40:00,-1736.12,290036.85000000085,291824.550000001,-1787.700000000128
17361,2022-06-10 14:45:00,1229.47,291266.3200000008,291824.550000001,-558.230000000156
17362,2022-06-10 14:50:00,131.91,291398.2300000008,291824.550000001,-426.3200000001816
17363,2022-06-10 14:55:00,-879.66,290518.5700000008,291824.550000001,-1305.980000000156
17364,2022-06-10 15:00:00,1458.73,291977.3000000008,291824.550000001,152.74999999982538
17365,2022-06-10 15:05:00,21.64,291998.9400000008,291824.550000001,174.38999999983935
17366,2022-06-10 15:10:00,-1094.27,290904.6700000008,291824.550000001,-919.8800000001793
17367,2022-06-10 15:15:00,212.7,291117.3700000008,291824.550000001,-707.1800000001676
17368,2022-06-10 15:20:00,225.74,291343.1100000008,291824.550000001,-481.44000000017695
17369,2022-06-10 15:25:00,-1864.92,289478.1900000008,291824.550000001,-2346.3600000001607
17370,2022-06-10 15:30:00,-920.94,288557.2500000008,291824.550000001,-3267.300000000163
17371,2022-06-10 15:35:00,-382.88,288174.3700000008,291824.550000001,-3650.1800000001676
17372,2022-06-10 15:40:00,1690.19,289864.5600000008,291824.550000001,-1959.9900000001653
17373,2022-06-10 15:45:00,947.0,290811.5600000008,291824.550000001,-1012.9900000001653
17374,2022-06-10 15:50:00,138.87,290950.4300000008,291824.550000001,-874.12000000017
17375,2022-06-10 15:55:00,-853.28,290097.1500000008,291824.550000001,-1727.400000000198
17376,2022-06-10 16:00:00,-1835.29,288261.8600000008,291824.550000001,-3562.690000000177
17377,2022-06-10 16:05:00,350.75,288612.6100000008,291824.550000001,-3211.940000000177
17378,2022-06-10 16:10:00,-1744.42,286868.1900000008,291824.550000001,-4956.360000000161
17379,2022-06-10 16:15:00,-1074.47,285793.72000000085,291824.550000001,-6030.830000000133
17380,2022-06-10 16:20:00,1924.14,287717.86000000086,291824.550000001,-4106.690000000119
17381,2022-06-10 16:25:00,947.35,288665.21000000084,291824.550000001,-3159.340000000142
17382,2022-06-10 16:30:00,1678.74,290343.9500000008,291824.550000001,-1480.6000000001513
17383,2022-06-10 16:35:00,-792.08,289551.8700000008,291824.550000001,-2272.6800000001676
17384,2022-06-10 16:40:00,-1557.72,287994.15000000084,291824.550000001,-3830.4000000001397
17385,2022-06-10 16:45:00,741.78,288735.93000000087,291824.550000001,-3088.6200000001118
17386,2022-06-10 16:50:00,-498.38,288237.55000000086,291824.550000001,-3587.0000000001164
17387,2022-06-10 16:55:00,503.62,288741.17000000086,291824.550000001,-3083.380000000121
17388,2022-06-11 08:00:00,-1321.83,287419.34000000084,288741.17000000086,-1321.8300000000163
17389,2022-06-11 08:05:00,-1286.71,286132.6300000008,288741.17000000086,-2608.5400000000373
17390,2022-06-11 08:10:00,1320.2,287452.83000000083,288741.17000000086,-1288.3400000000256
17391,2022-06-11 08:15:00,-1926.07,285526.7600000008,288741.17000000086,-3214.4100000000326
17392,2022-06-11 08:20:00,600.5,286127.2600000008,288741.17000000086,-2613.9100000000326
17393,2022-06-11 08:25:00,1923.35,288050.6100000008,288741.17000000086,-690.5600000000559
17394,2022-06-11 08:30:00,793.03,288843.6400000008,288741.17000000086,102.46999999997206
17395,2022-06-11 08:35:00,562.08,289405.72000000085,288741.17000000086,664.5499999999884
17396,2022-06-11 08:40:00,-1467.17,287938.55000000086,288741.17000000086,-802.6199999999953
17397,2022-06-11 08:45:00,524.19,288462.74000000086,288741.17000000086,-278.429999999993
17398,2022-06-11 08:50:00,-1277.39,287185.35000000085,288741.17000000086,-1555.820000000007
17399,2022-06-11 08:55:00,-1501.61,285683.74000000086,288741.17000000086,-3057.429999999993
17400,2022-06-11 09:00:00,1588.85,287272.59000000084,288741.17000000086,-1468.5800000000163
17401,2022-06-11 09:05:00,-976.1,286296.49000000086,288741.17000000086,-2444.679999999993
17402,2022-06-11 09:10:00,891.49,287187.98000000085,288741.17000000086,-1553.1900000000023
17403,2022-06-11 09:15:00,1742.08,288930.06000000087,288741.17000000086,188.89000000001397
17404,2022-06-11 09:20:00,863.63,289793.6900000009,288741.17000000086,1052.5200000000186
17405,2022-06-11 09:25:00,-1599.09,288194.60000000085,288741.17000000086,-546.570000000007
17406,2022-06-11 09:30:00,-1177.61,287016.99000000086,288741.17000000086,-1724.179999999993
17407,2022-06-11 09:35:00,-814.9,286202.09000000084,288741.17000000086,-2539.0800000000163
17408,2022-06-11 09:40:00,702.39,286904.48000000085,288741.17000000086,-1836.6900000000023
17409,2022-06-11 09:45:00,-266.36,286638.12000000087,288741.17000000086,-2103.0499999999884
17410,2022-06-11 09:50:00,-756.69,285881.43000000087,288741.17000000086,-2859.7399999999907
17411,2022-06-11 09:55:00,555.87,286437.30000000086,288741.17000000086,-2303.8699999999953
17412,2022-06-11 10:00:00,1659.31,288096.61000000086,288741.17000000086,-644.5599999999977
17413,2022-06-11 10:05:00,67.55,288164.16000000085,288741.17000000086,-577.0100000000093
17414,2022-06-11 10:10:00,624.81,288788.97000000085,288741.17000000086,47.79999999998836
17415,2022-06-11 10:15:00,-115.08,288673.8900000008,288741.17000000086,-67.28000000002794
17416,2022-06-11 10:20:00,-264.76,288409.1300000008,288741.17000000086,-332.04000000003725
17417,2022-06-11 10:25:00,971.81,289380.9400000008,288741.17000000086,639.7699999999604
17418,2022-06-11 10:30:00,132.22,289513.1600000008,288741.17000000086,771.9899999999325
17419,2022-06-11 10:35:00,-119.16,289394.0000000008,288741.17000000086,652.8299999999581
17420,2022-06-11 10:40:00,226.8,289620.8000000008,288741.17000000086,879.6299999999464
17421,2022-06-11 10:45:00,1592.81,291213.6100000008,288741.17000000086,2472.439999999944
17422,2022-06-11 10:50:00,87.61,291301.2200000008,288741.17000000086,2560.04999999993
17423,2022-06-11 10:55:00,6.5,291307.7200000008,288741.17000000086,2566.54999999993
17424,2022-06-11 11:00:00,833.92,292141.64000000077,288741.17000000086,3400.469999999914
17425,2022-06-11 11:05:00,-1519.54,290622.1000000008,288741.17000000086,1880.9299999999348
17426,2022-06-11 11:10:00,-88.3,290533.8000000008,288741.17000000086,1792.6299999999464
17427,2022-06-11 11:15:00,768.97,291302.7700000008,288741.17000000086,2561.5999999999185
17428,2022-06-11 11:20:00,-1912.19,289390.5800000008,288741.17000000086,649.4099999999162
17429,2022-06-11 11:25:00,1905.11,291295.69000000076,288741.17000000086,2554.519999999902
17430,2022-06-11 11:30:00,1398.46,292694.1500000008,288741.17000000086,3952.979999999923
17431,2022-06-11 11:35:00,-1365.7,291328.45000000077,288741.17000000086,2587.2799999999115
17432,2022-06-11 11:40:00,1833.24,293161.69000000076,288741.17000000086,4420.519999999902
17433,2022-06-11 11:45:00,850.25,294011.94000000076,288741.17000000086,5270.769999999902
17434,2022-06-11 11:50:00,-611.01,293400.93000000075,288741.17000000086,4659.759999999893
17435,2022-06-11 11:55:00,1014.12,294415.05000000075,288741.17000000086,5673.879999999888
17436,2022-06-11 12:00:00,-1737.39,292677.66000000073,288741.17000000086,3936.4899999998743
17437,2022-06-11 12:05:00,137.84,292815.50000000076,288741.17000000086,4074.3299999999
17438,2022-06-11 12:10:00,1053.72,293869.2200000007,288741.17000000086,5128.049999999872
17439,2022-06-11 12:15:00,-1062.35,292806.87000000075,288741.17000000086,4065.699999999895
17440,2022-06-11 12:20:00,16.12,292822.99000000075,288741.17000000086,4081.8199999998906
17441,2022-06-11 12:25:00,-928.03,291894.9600000007,288741.17000000086,3153.7899999998626
17442,2022-06-11 12:30:00,1762.89,293657.85000000073,288741.17000000086,4916.679999999877
17443,2022-06-11 12:35:00,1158.12,294815.9700000007,288741.17000000086,6074.799999999872
17444,2022-06-11 12:40:00,703.07,295519.04000000074,288741.17000000086,6777.869999999879
17445,2022-06-11 12:45:00,-1051.18,294467.86000000074,288741.17000000086,5726.689999999886
17446,2022-06-11 12:50:00,1027.46,295495.32000000076,288741.17000000086,6754.149999999907
17447,2022-06-11 12:55:00,1753.53,297248.8500000008,288741.17000000086,8507.679999999935
17448,2022-06-11 13:00:00,-1107.3,296141.5500000008,288741.17000000086,7400.379999999946
17449,2022-06-11 13:05:00,1964.4,298105.9500000008,288741.17000000086,9364.77999999997
17450,2022-06-11 13:10:00,-1049.49,297056.46000000084,288741.17000000086,8315.289999999979
17451,2022-06-11 13:15:00,-1400.64,295655.8200000008,288741.17000000086,6914.649999999965
17452,2022-06-11 13:20:00,995.95,296651.77000000083,288741.17000000086,7910.599999999977
17453,2022-06-11 13:25:00,-647.17,296004.60000000085,288741.17000000086,7263.429999999993
17454,2022-06-11 13:30:00,-616.65,295387.9500000008,288741.17000000086,6646.77999999997
17455,2022-06-11 13:35:00,459.36,295847.3100000008,288741.17000000086,7106.139999999956
17456,2022-06-11 13:40:00,-341.75,295505.5600000008,288741.17000000086,6764.389999999956
17457,2022-06-11 13:45:00,-167.47,295338.09000000084,288741.17000000086,6596.919999999984
17458,2022-06-11 13:50:00,480.71,295818.80000000086,288741.17000000086,7077.630000000005
17459,2022-06-11 13:55:00,470.89,296289.6900000009,288741.17000000086,7548.520000000019
17460,2022-06-11 14:00:00,648.8,296938.49000000086,288741.17000000086,8197.320000000007
17461,2022-06-11 14:05:00,-465.17,296473.3200000009,288741.17000000086,7732.150000000023
17462,2022-06-11 14:10:00,-903.95,295569.37000000087,288741.17000000086,6828.200000000012
17463,2022-06-11 14:15:00,-1168.65,294400.72000000085,288741.17000000086,5659.549999999988
17464,2022-06-11 14:20:00,1142.81,295543.53000000084,288741.17000000086,6802.359999999986
17465,2022-06-11 14:25:00,-1738.62,293804.91000000085,288741.17000000086,5063.739999999991
17466,2022-06-11 14:30:00,71.64,293876.55000000086,288741.17000000086,5135.380000000005
17467,2022-06-11 14:35:00,-1381.54,292495.0100000009,288741.17000000086,3753.8400000000256
17468,2022-06-11 14:40:00,581.79,293076.80000000086,288741.17000000086,4335.630000000005
17469,2022-06-11 14:45:00,382.22,293459.02000000083,288741.17000000086,4717.849999999977
17470,2022-06-11 14:50:00,-274.14,293184.8800000008,288741.17000000086,4443.709999999963
17471,2022-06-11 14:55:00,1484.07,294668.9500000008,288741.17000000086,5927.77999999997
17472,2022-06-11 15:00:00,-250.55,294418.40000000084,288741.17000000086,5677.229999999981
17473,2022-06-11 15:05:00,821.92,295240.3200000008,288741.17000000086,6499.149999999965
17474,2022-06-11 15:10:00,501.25,295741.5700000008,288741.17000000086,7000.399999999965
17475,2022-06-11 15:15:00,1276.25,297017.8200000008,288741.17000000086,8276.649999999965
17476,2022-06-11 15:20:00,-1879.78,295138.0400000008,288741.17000000086,6396.869999999937
17477,2022-06-11 15:25:00,-1648.49,293489.5500000008,288741.17000000086,4748.379999999946
17478,2022-06-11 15:30:00,842.73,294332.2800000008,288741.17000000086,5591.109999999928
17479,2022-06-11 15:35:00,1132.74,295465.0200000008,288741.17000000086,6723.8499999999185
17480,2022-06-11 15:40:00,1587.01,297052.0300000008,288741.17000000086,8310.859999999928
17481,2022-06-11 15:45:00,-663.92,296388.1100000008,288741.17000000086,7646.939999999944
17482,2022-06-11 15:50:00,-1630.73,294757.3800000008,288741.17000000086,6016.209999999963
17483,2022-06-11 15:55:00,-115.38,294642.0000000008,288741.17000000086,5900.829999999958
17484,2022-06-11 16:00:00,-287.55,294354.4500000008,288741.17000000086,5613.27999999997
17485,2022-06-11 16:05:00,1071.22,295425.6700000008,288741.17000000086,6684.499999999942
17486,2022-06-11 16:10:00,1127.65,296553.3200000008,288741.17000000086,7812.149999999965
17487,2022-06-11 16:15:00,-461.22,296092.10000000085,288741.17000000086,7350.929999999993
17488,2022-06-11 16:20:00,1503.87,297595.97000000085,288741.17000000086,8854.799999999988
17489,2022-06-11 16:25:00,-936.95,296659.02000000083,288741.17000000086,7917.849999999977
17490,2022-06-11 16:30:00,-695.42,295963.60000000085,288741.17000000086,7222.429999999993
17491,2022-06-11 16:35:00,48.5,296012.10000000085,288741.17000000086,7270.929999999993
17492,2022-06-11 16:40:00,1346.96,297359.06000000087,288741.17000000086,8617.890000000014
17493,2022-06-11 16:45:00,-778.87,296580.1900000009,288741.17000000086,7839.020000000019
17494,2022-06-11 16:50:00,-1128.67,295451.5200000009,288741.17000000086,6710.350000000035
17495,2022-06-11 16:55:00,-444.05,295007.4700000009,288741.17000000086,6266.300000000047
17496,2022-06-12 08:00:00,-602.08,294405.3900000009,295007.4700000009,-602.0800000000163
17497,2022-06-12 08:05:00,307.39,294712.7800000009,295007.4700000009,-294.6900000000023
17498,2022-06-12 08:10:00,35.69,294748.4700000009,295007.4700000009,-259.0
17499,2022-06-12 08:15:00,209.18,294957.6500000009,295007.4700000009,-49.820000000006985
17500,2022-06-12 08:20:00,-754.57,294203.0800000009,295007.4700000009,-804.390000000014
17501,2022-06-12 08:25:00,-1529.0,292674.0800000009,295007.4700000009,-2333.390000000014
17502,2022-06-12 08:30:00,-1529.65,291144.43000000087,295007.4700000009,-3863.0400000000373
17503,2022-06-12 08:35:00,-64.89,291079.54000000085,295007.4700000009,-3927.930000000051
17504,2022-06-12 08:40:00,398.85,291478.3900000008,295007.4700000009,-3529.0800000000745
17505,2022-06-12 08:45:00,-134.89,291343.5000000008,295007.4700000009,-3663.9700000000885
17506,2022-06-12 08:50:00,-483.88,290859.6200000008,295007.4700000009,-4147.850000000093
17507,2022-06-12 08:55:00,418.87,291278.4900000008,295007.4700000009,-3728.980000000098
17508,2022-06-12 09:00:00,1849.53,293128.02000000083,295007.4700000009,-1879.4500000000698
17509,2022-06-12 09:05:00,1730.11,294858.1300000008,295007.4700000009,-149.34000000008382
17510,2022-06-12 09:10:00,-847.59,294010.5400000008,295007.4700000009,-996.9300000001094
17511,2022-06-12 09:15:00,1612.59,295623.1300000008,295007.4700000009,615.6599999999162
17512,2022-06-12 09:20:00,-239.01,295384.1200000008,295007.4700000009,376.64999999990687
17513,2022-06-12 09:25:00,-1476.54,293907.58000000083,295007.4700000009,-1099.8900000000722
17514,2022-06-12 09:30:00,898.28,294805.86000000086,295007.4700000009,-201.61000000004424
17515,2022-06-12 09:35:00,1869.24,296675.10000000085,295007.4700000009,1667.6299999999464
17516,2022-06-12 09:40:00,1835.91,298511.0100000008,295007.4700000009,3503.539999999921
17517,2022-06-12 09:45:00,699.31,299210.3200000008,295007.4700000009,4202.8499999999185
17518,2022-06-12 09:50:00,1052.69,300263.0100000008,295007.4700000009,5255.539999999921
17519,2022-06-12 09:55:00,-1898.49,298364.52000000083,295007.4700000009,3357.04999999993
17520,2022-06-12 10:00:00,-835.79,297528.73000000085,295007.4700000009,2521.259999999951
17521,2022-06-12 10:05:00,104.61,297633.34000000084,295007.4700000009,2625.869999999937
17522,2022-06-12 10:10:00,30.1,297663.4400000008,295007.4700000009,2655.969999999914
17523,2022-06-12 10:15:00,446.32,298109.7600000008,295007.4700000009,3102.289999999921
17524,2022-06-12 10:20:00,1029.0,299138.7600000008,295007.4700000009,4131.289999999921
17525,2022-06-12 10:25:00,1029.13,300167.8900000008,295007.4700000009,5160.4199999999255
17526,2022-06-12 10:30:00,1767.3,301935.1900000008,295007.4700000009,6927.719999999914
17527,2022-06-12 10:35:00,-285.69,301649.5000000008,295007.4700000009,6642.0299999999115
17528,2022-06-12 10:40:00,1286.18,302935.6800000008,295007.4700000009,7928.2099999999045
17529,2022-06-12 10:45:00,-222.7,302712.9800000008,295007.4700000009,7705.509999999893
17530,2022-06-12 10:50:00,-19.24,302693.7400000008,295007.4700000009,7686.269999999902
17531,2022-06-12 10:55:00,1769.62,304463.3600000008,295007.4700000009,9455.889999999898
17532,2022-06-12 11:00:00,137.7,304601.0600000008,295007.4700000009,9593.58999999991
17533,2022-06-12 11:05:00,763.74,305364.8000000008,295007.4700000009,10357.3299999999
17534,2022-06-12 11:10:00,954.6,306319.4000000008,295007.4700000009,11311.929999999877
17535,2022-06-12 11:15:00,-1871.71,304447.69000000076,295007.4700000009,9440.219999999856
17536,2022-06-12 11:20:00,-1589.32,302858.37000000075,295007.4700000009,7850.899999999849
17537,2022-06-12 11:25:00,1152.68,304011.05000000075,295007.4700000009,9003.579999999842
17538,2022-06-12 11:30:00,694.83,304705.88000000076,295007.4700000009,9698.409999999858
17539,2022-06-12 11:35:00,1485.79,306191.67000000074,295007.4700000009,11184.199999999837
17540,2022-06-12 11:40:00,1891.82,308083.49000000075,295007.4700000009,13076.019999999844
17541,2022-06-12 11:45:00,-1894.57,306188.92000000074,295007.4700000009,11181.449999999837
17542,2022-06-12 11:50:00,162.77,306351.69000000076,295007.4700000009,11344.219999999856
17543,2022-06-12 11:55:00,822.06,307173.75000000076,295007.4700000009,12166.279999999853
17544,2022-06-12 12:00:00,-602.9,306570.85000000073,295007.4700000009,11563.37999999983
17545,2022-06-12 12:05:00,1383.78,307954.63000000076,295007.4700000009,12947.159999999858
17546,2022-06-12 12:10:00,963.82,308918.45000000077,295007.4700000009,13910.979999999865
17547,2022-06-12 12:15:00,1851.45,310769.9000000008,295007.4700000009,15762.429999999877
17548,2022-06-12 12:20:00,1114.7,311884.6000000008,295007.4700000009,16877.12999999989
17549,2022-06-12 12:25:00,-1574.48,310310.1200000008,295007.4700000009,15302.649999999907
17550,2022-06-12 12:30:00,1139.15,311449.27000000083,295007.4700000009,16441.79999999993
17551,2022-06-12 12:35:00,468.77,311918.04000000085,295007.4700000009,16910.56999999995
17552,2022-06-12 12:40:00,1301.37,313219.41000000085,295007.4700000009,18211.939999999944
17553,2022-06-12 12:45:00,646.12,313865.53000000084,295007.4700000009,18858.05999999994
17554,2022-06-12 12:50:00,1681.85,315547.3800000008,295007.4700000009,20539.909999999916
17555,2022-06-12 12:55:00,1313.37,316860.7500000008,295007.4700000009,21853.27999999991
17556,2022-06-12 13:00:00,1509.86,318370.6100000008,295007.4700000009,23363.139999999898
17557,2022-06-12 13:05:00,-1398.08,316972.5300000008,295007.4700000009,21965.05999999988
17558,2022-06-12 13:10:00,-361.6,316610.9300000008,295007.4700000009,21603.459999999905
17559,2022-06-12 13:15:00,974.75,317585.6800000008,295007.4700000009,22578.209999999905
17560,2022-06-12 13:20:00,-918.4,316667.2800000008,295007.4700000009,21659.80999999988
17561,2022-06-12 13:25:00,392.17,317059.45000000077,295007.4700000009,22051.979999999865
17562,2022-06-12 13:30:00,1487.84,318547.2900000008,295007.4700000009,23539.81999999989
17563,2022-06-12 13:35:00,-877.45,317669.8400000008,295007.4700000009,22662.36999999988
17564,2022-06-12 13:40:00,212.53,317882.3700000008,295007.4700000009,22874.899999999907
17565,2022-06-12 13:45:00,-86.71,317795.6600000008,295007.4700000009,22788.189999999886
17566,2022-06-12 13:50:00,-1708.8,316086.8600000008,295007.4700000009,21079.389999999898
17567,2022-06-12 13:55:00,901.22,316988.0800000008,295007.4700000009,21980.60999999987
17568,2022-06-12 14:00:00,833.38,317821.4600000008,295007.4700000009,22813.989999999874
17569,2022-06-12 14:05:00,-1745.48,316075.9800000008,295007.4700000009,21068.509999999893
17570,2022-06-12 14:10:00,1562.12,317638.1000000008,295007.4700000009,22630.62999999989
17571,2022-06-12 14:15:00,-1832.5,315805.6000000008,295007.4700000009,20798.12999999989
17572,2022-06-12 14:20:00,234.1,316039.70000000077,295007.4700000009,21032.229999999865
17573,2022-06-12 14:25:00,1823.96,317863.6600000008,295007.4700000009,22856.189999999886
17574,2022-06-12 14:30:00,-1606.3,316257.3600000008,295007.4700000009,21249.889999999898
17575,2022-06-12 14:35:00,1045.76,317303.1200000008,295007.4700000009,22295.649999999907
17576,2022-06-12 14:40:00,1792.02,319095.1400000008,295007.4700000009,24087.669999999925
17577,2022-06-12 14:45:00,-1675.72,317419.42000000086,295007.4700000009,22411.949999999953
17578,2022-06-12 14:50:00,374.4,317793.8200000009,295007.4700000009,22786.349999999977
17579,2022-06-12 14:55:00,-1001.02,316792.80000000086,295007.4700000009,21785.329999999958
17580,2022-06-12 15:00:00,1728.27,318521.0700000009,295007.4700000009,23513.599999999977
17581,2022-06-12 15:05:00,1022.93,319544.0000000009,295007.4700000009,24536.52999999997
17582,2022-06-12 15:10:00,-1822.78,317721.22000000085,295007.4700000009,22713.74999999994
17583,2022-06-12 15:15:00,299.55,318020.77000000083,295007.4700000009,23013.29999999993
17584,2022-06-12 15:20:00,-865.51,317155.2600000008,295007.4700000009,22147.78999999992
17585,2022-06-12 15:25:00,-943.01,316212.2500000008,295007.4700000009,21204.77999999991
17586,2022-06-12 15:30:00,441.26,316653.5100000008,295007.4700000009,21646.03999999992
17587,2022-06-12 15:35:00,-1826.97,314826.54000000085,295007.4700000009,19819.06999999995
17588,2022-06-12 15:40:00,-483.83,314342.71000000084,295007.4700000009,19335.239999999932
17589,2022-06-12 15:45:00,98.22,314440.9300000008,295007.4700000009,19433.459999999905
17590,2022-06-12 15:50:00,542.05,314982.9800000008,295007.4700000009,19975.509999999893
17591,2022-06-12 15:55:00,348.15,315331.1300000008,295007.4700000009,20323.659999999916
17592,2022-06-12 16:00:00,1169.33,316500.46000000084,295007.4700000009,21492.989999999932
17593,2022-06-12 16:05:00,0.9,316501.36000000086,295007.4700000009,21493.889999999956
17594,2022-06-12 16:10:00,895.03,317396.3900000009,295007.4700000009,22388.919999999984
17595,2022-06-12 16:15:00,116.51,317512.9000000009,295007.4700000009,22505.429999999993
17596,2022-06-12 16:20:00,-401.06,317111.8400000009,295007.4700000009,22104.369999999995
17597,2022-06-12 16:25:00,-1407.11,315704.7300000009,295007.4700000009,20697.26000000001
17598,2022-06-12 16:30:00,714.72,316419.4500000009,295007.4700000009,21411.97999999998
17599,2022-06-12 16:35:00,-1134.33,315285.12000000087,295007.4700000009,20277.649999999965
17600,2022-06-12 16:40:00,-845.85,314439.2700000009,295007.4700000009,19431.79999999999
17601,2022-06-12 16:45:00,-1387.51,313051.7600000009,295007.4700000009,18044.28999999998
17602,2022-06-12 16:50:00,1775.12,314826.8800000009,295007.4700000009,19819.409999999974
17603,2022-06-12 16:55:00,408.61,315235.49000000086,295007.4700000009,20228.01999999996
17604,2022-06-13 08:00:00,-1051.13,314184.36000000086,315235.49000000086,-1051.1300000000047
17605,2022-06-13 08:05:00,1218.15,315402.5100000009,315235.49000000086,167.02000000001863
17606,2022-06-13 08:10:00,351.56,315754.0700000009,315235.49000000086,518.5800000000163
17607,2022-06-13 08:15:00,-923.89,314830.18000000087,315235.49000000086,-405.3099999999977
17608,2022-06-13 08:20:00,-342.93,314487.2500000009,315235.49000000086,-748.2399999999907
17609,2022-06-13 08:25:00,-1380.98,313106.2700000009,315235.49000000086,-2129.219999999972
17610,2022-06-13 08:30:00,-368.39,312737.8800000009,315235.49000000086,-2497.609999999986
17611,2022-06-13 08:35:00,-237.71,312500.17000000086,315235.49000000086,-2735.320000000007
17612,2022-06-13 08:40:00,56.62,312556.79000000085,315235.49000000086,-2678.7000000000116
17613,2022-06-13 08:45:00,113.98,312670.77000000083,315235.49000000086,-2564.7200000000303
17614,2022-06-13 08:50:00,-738.71,311932.0600000008,315235.49000000086,-3303.430000000051
17615,2022-06-13 08:55:00,1846.77,313778.83000000083,315235.49000000086,-1456.6600000000326
17616,2022-06-13 09:00:00,723.13,314501.96000000084,315235.49000000086,-733.5300000000279
17617,2022-06-13 09:05:00,372.74,314874.7000000008,315235.49000000086,-360.79000000003725
17618,2022-06-13 09:10:00,1665.63,316540.33000000083,315235.49000000086,1304.8399999999674
17619,2022-06-13 09:15:00,-1434.0,315106.33000000083,315235.49000000086,-129.1600000000326
17620,2022-06-13 09:20:00,1789.67,316896.0000000008,315235.49000000086,1660.509999999951
17621,2022-06-13 09:25:00,1097.21,317993.21000000084,315235.49000000086,2757.719999999972
17622,2022-06-13 09:30:00,-1167.14,316826.0700000008,315235.49000000086,1590.579999999958
17623,2022-06-13 09:35:00,653.17,317479.2400000008,315235.49000000086,2243.749999999942
17624,2022-06-13 09:40:00,1356.3,318835.5400000008,315235.49000000086,3600.04999999993
17625,2022-06-13 09:45:00,-856.72,317978.8200000008,315235.49000000086,2743.329999999958
17626,2022-06-13 09:50:00,195.03,318173.85000000085,315235.49000000086,2938.359999999986
17627,2022-06-13 09:55:00,1870.68,320044.53000000084,315235.49000000086,4809.039999999979
17628,2022-06-13 10:00:00,179.54,320224.0700000008,315235.49000000086,4988.579999999958
17629,2022-06-13 10:05:00,-55.83,320168.2400000008,315235.49000000086,4932.749999999942
17630,2022-06-13 10:10:00,-1677.69,318490.5500000008,315235.49000000086,3255.0599999999395
17631,2022-06-13 10:15:00,1909.63,320400.1800000008,315235.49000000086,5164.689999999944
17632,2022-06-13 10:20:00,-557.52,319842.6600000008,315235.49000000086,4607.1699999999255
17633,2022-06-13 10:25:00,719.18,320561.8400000008,315235.49000000086,5326.3499999999185
17634,2022-06-13 10:30:00,749.07,321310.9100000008,315235.49000000086,6075.4199999999255
17635,2022-06-13 10:35:00,-1222.3,320088.6100000008,315235.49000000086,4853.119999999937
17636,2022-06-13 10:40:00,-373.2,319715.4100000008,315235.49000000086,4479.9199999999255
17637,2022-06-13 10:45:00,1455.09,321170.5000000008,315235.49000000086,5935.009999999951
17638,2022-06-13 10:50:00,741.95,321912.4500000008,315235.49000000086,6676.959999999963
17639,2022-06-13 10:55:00,-1501.37,320411.08000000083,315235.49000000086,5175.589999999967
17640,2022-06-13 11:00:00,722.06,321133.1400000008,315235.49000000086,5897.649999999965
17641,2022-06-13 11:05:00,863.14,321996.28000000084,315235.49000000086,6760.789999999979
17642,2022-06-13 11:10:00,861.71,322857.99000000086,315235.49000000086,7622.5
17643,2022-06-13 11:15:00,-609.84,322248.15000000084,315235.49000000086,7012.659999999974
17644,2022-06-13 11:20:00,371.13,322619.28000000084,315235.49000000086,7383.789999999979
17645,2022-06-13 11:25:00,-597.79,322021.49000000086,315235.49000000086,6786.0
17646,2022-06-13 11:30:00,-1599.82,320421.67000000086,315235.49000000086,5186.179999999993
17647,2022-06-13 11:35:00,1602.77,322024.4400000009,315235.49000000086,6788.950000000012
17648,2022-06-13 11:40:00,-914.48,321109.9600000009,315235.49000000086,5874.47000000003
17649,2022-06-13 11:45:00,756.16,321866.12000000087,315235.49000000086,6630.630000000005
17650,2022-06-13 11:50:00,-1195.63,320670.49000000086,315235.49000000086,5435.0
17651,2022-06-13 11:55:00,1723.11,322393.60000000085,315235.49000000086,7158.109999999986
17652,2022-06-13 12:00:00,851.58,323245.18000000087,315235.49000000086,8009.690000000002
17653,2022-06-13 12:05:00,-1885.88,321359.30000000086,315235.49000000086,6123.809999999998
17654,2022-06-13 12:10:00,860.77,322220.0700000009,315235.49000000086,6984.580000000016
17655,2022-06-13 12:15:00,613.96,322834.0300000009,315235.49000000086,7598.540000000037
17656,2022-06-13 12:20:00,1255.18,324089.2100000009,315235.49000000086,8853.72000000003
17657,2022-06-13 12:25:00,780.79,324870.0000000009,315235.49000000086,9634.51000000001
17658,2022-06-13 12:30:00,1956.27,326826.2700000009,315235.49000000086,11590.780000000028
17659,2022-06-13 12:35:00,1891.31,328717.5800000009,315235.49000000086,13482.090000000026
17660,2022-06-13 12:40:00,-223.39,328494.1900000009,315235.49000000086,13258.700000000012
17661,2022-06-13 12:45:00,-1011.77,327482.42000000086,315235.49000000086,12246.929999999993
17662,2022-06-13 12:50:00,-1760.03,325722.3900000008,315235.49000000086,10486.899999999965
17663,2022-06-13 12:55:00,912.06,326634.4500000008,315235.49000000086,11398.959999999963
17664,2022-06-13 13:00:00,1399.28,328033.73000000085,315235.49000000086,12798.23999999999
17665,2022-06-13 13:05:00,297.94,328331.67000000086,315235.49000000086,13096.179999999993
17666,2022-06-13 13:10:00,204.8,328536.47000000085,315235.49000000086,13300.979999999981
17667,2022-06-13 13:15:00,1000.96,329537.43000000087,315235.49000000086,14301.940000000002
17668,2022-06-13 13:20:00,-1291.87,328245.56000000087,315235.49000000086,13010.070000000007
17669,2022-06-13 13:25:00,-1125.52,327120.04000000085,315235.49000000086,11884.549999999988
17670,2022-06-13 13:30:00,-1091.37,326028.67000000086,315235.49000000086,10793.179999999993
17671,2022-06-13 13:35:00,982.71,327011.3800000009,315235.49000000086,11775.890000000014
17672,2022-06-13 13:40:00,826.95,327838.3300000009,315235.49000000086,12602.840000000026
17673,2022-06-13 13:45:00,1459.68,329298.0100000009,315235.49000000086,14062.520000000019
17674,2022-06-13 13:50:00,115.42,329413.43000000087,315235.49000000086,14177.940000000002
17675,2022-06-13 13:55:00,625.41,330038.84000000084,315235.49000000086,14803.349999999977
17676,2022-06-13 14:00:00,1042.95,331081.79000000085,315235.49000000086,15846.299999999988
17677,2022-06-13 14:05:00,-1974.59,329107.2000000008,315235.49000000086,13871.709999999963
17678,2022-06-13 14:10:00,9.26,329116.46000000084,315235.49000000086,13880.969999999972
17679,2022-06-13 14:15:00,1656.13,330772.59000000084,315235.49000000086,15537.099999999977
17680,2022-06-13 14:20:00,1805.43,332578.02000000083,315235.49000000086,17342.52999999997
17681,2022-06-13 14:25:00,-1152.62,331425.40000000084,315235.49000000086,16189.909999999974
17682,2022-06-13 14:30:00,-1372.31,330053.09000000084,315235.49000000086,14817.599999999977
17683,2022-06-13 14:35:00,115.59,330168.68000000087,315235.49000000086,14933.190000000002
17684,2022-06-13 14:40:00,1890.8,332059.48000000085,315235.49000000086,16823.98999999999
17685,2022-06-13 14:45:00,552.1,332611.58000000083,315235.49000000086,17376.089999999967
17686,2022-06-13 14:50:00,-177.33,332434.2500000008,315235.49000000086,17198.75999999995
17687,2022-06-13 14:55:00,1239.39,333673.6400000008,315235.49000000086,18438.149999999965
17688,2022-06-13 15:00:00,327.18,334000.8200000008,315235.49000000086,18765.329999999958
17689,2022-06-13 15:05:00,718.98,334719.8000000008,315235.49000000086,19484.30999999994
17690,2022-06-13 15:10:00,49.41,334769.2100000008,315235.49000000086,19533.719999999914
17691,2022-06-13 15:15:00,-1728.5,333040.7100000008,315235.49000000086,17805.219999999914
17692,2022-06-13 15:20:00,122.02,333162.7300000008,315235.49000000086,17927.239999999932
17693,2022-06-13 15:25:00,-1576.36,331586.3700000008,315235.49000000086,16350.879999999946
17694,2022-06-13 15:30:00,1511.79,333098.1600000008,315235.49000000086,17862.669999999925
17695,2022-06-13 15:35:00,653.42,333751.5800000008,315235.49000000086,18516.08999999991
17696,2022-06-13 15:40:00,-567.53,333184.05000000075,315235.49000000086,17948.55999999988
17697,2022-06-13 15:45:00,1708.46,334892.51000000077,315235.49000000086,19657.019999999902
17698,2022-06-13 15:50:00,1427.35,336319.86000000074,315235.49000000086,21084.36999999988
17699,2022-06-13 15:55:00,934.36,337254.2200000007,315235.49000000086,22018.729999999865
17700,2022-06-13 16:00:00,1423.09,338677.31000000075,315235.49000000086,23441.81999999989
17701,2022-06-13 16:05:00,-1855.95,336821.36000000074,315235.49000000086,21585.86999999988
17702,2022-06-13 16:10:00,1281.65,338103.01000000077,315235.49000000086,22867.519999999902
17703,2022-06-13 16:15:00,-514.24,337588.7700000008,315235.49000000086,22353.27999999991
17704,2022-06-13 16:20:00,1187.02,338775.7900000008,315235.49000000086,23540.29999999993
17705,2022-06-13 16:25:00,386.42,339162.2100000008,315235.49000000086,23926.719999999914
17706,2022-06-13 16:30:00,402.62,339564.8300000008,315235.49000000086,24329.33999999991
17707,2022-06-13 16:35:00,1791.65,341356.4800000008,315235.49000000086,26120.989999999932
17708,2022-06-13 16:40:00,328.85,341685.3300000008,315235.49000000086,26449.83999999991
17709,2022-06-13 16:45:00,-198.05,341487.2800000008,315235.49000000086,26251.78999999992
17710,2022-06-13 16:50:00,-293.15,341194.13000000076,315235.49000000086,25958.639999999898
17711,2022-06-13 16:55:00,1329.51,342523.64000000077,315235.49000000086,27288.149999999907
17712,2022-06-14 08:00:00,1079.23,343602.87000000075,342523.64000000077,1079.2299999999814
17713,2022-06-14 08:05:00,1695.98,345298.85000000073,342523.64000000077,2775.2099999999627
17714,2022-06-14 08:10:00,1982.85,347281.7000000007,342523.64000000077,4758.0599999999395
17715,2022-06-14 08:15:00,1801.18,349082.8800000007,342523.64000000077,6559.2399999999325
17716,2022-06-14 08:20:00,-407.29,348675.5900000007,342523.64000000077,6151.949999999953
17717,2022-06-14 08:25:00,-83.5,348592.0900000007,342523.64000000077,6068.449999999953
17718,2022-06-14 08:30:00,1959.4,350551.49000000075,342523.64000000077,8027.849999999977
17719,2022-06-14 08:35:00,-1016.68,349534.81000000075,342523.64000000077,7011.169999999984
17720,2022-06-14 08:40:00,1563.2,351098.01000000077,342523.64000000077,8574.369999999995
17721,2022-06-14 08:45:00,-27.27,351070.74000000075,342523.64000000077,8547.099999999977
17722,2022-06-14 08:50:00,-1407.2,349663.54000000074,342523.64000000077,7139.899999999965
17723,2022-06-14 08:55:00,1855.77,351519.31000000075,342523.64000000077,8995.669999999984
17724,2022-06-14 09:00:00,-535.27,350984.04000000074,342523.64000000077,8460.399999999965
17725,2022-06-14 09:05:00,-690.78,350293.2600000007,342523.64000000077,7769.619999999937
17726,2022-06-14 09:10:00,-1299.49,348993.7700000007,342523.64000000077,6470.129999999946
17727,2022-06-14 09:15:00,395.1,349388.8700000007,342523.64000000077,6865.229999999923
17728,2022-06-14 09:20:00,1263.66,350652.53000000067,342523.64000000077,8128.889999999898
17729,2022-06-14 09:25:00,-1224.31,349428.22000000067,342523.64000000077,6904.5799999999
17730,2022-06-14 09:30:00,-654.0,348774.22000000067,342523.64000000077,6250.5799999999
17731,2022-06-14 09:35:00,-81.51,348692.71000000066,342523.64000000077,6169.069999999891
17732,2022-06-14 09:40:00,1085.63,349778.34000000067,342523.64000000077,7254.699999999895
17733,2022-06-14 09:45:00,979.47,350757.81000000064,342523.64000000077,8234.169999999867
17734,2022-06-14 09:50:00,48.06,350805.87000000064,342523.64000000077,8282.229999999865
17735,2022-06-14 09:55:00,200.66,351006.5300000006,342523.64000000077,8482.88999999984
17736,2022-06-14 10:00:00,-1452.03,349554.5000000006,342523.64000000077,7030.859999999811
17737,2022-06-14 10:05:00,400.25,349954.7500000006,342523.64000000077,7431.109999999811
17738,2022-06-14 10:10:00,-452.76,349501.9900000006,342523.64000000077,6978.349999999802
17739,2022-06-14 10:15:00,110.76,349612.7500000006,342523.64000000077,7089.109999999811
17740,2022-06-14 10:20:00,351.49,349964.2400000006,342523.64000000077,7440.599999999802
17741,2022-06-14 10:25:00,-723.8,349240.4400000006,342523.64000000077,6716.799999999814
17742,2022-06-14 10:30:00,775.73,350016.17000000057,342523.64000000077,7492.529999999795
17743,2022-06-14 10:35:00,-1878.41,348137.7600000006,342523.64000000077,5614.119999999821
17744,2022-06-14 10:40:00,416.84,348554.6000000006,342523.64000000077,6030.959999999846
17745,2022-06-14 10:45:00,-608.77,347945.8300000006,342523.64000000077,5422.189999999828
17746,2022-06-14 10:50:00,1160.12,349105.9500000006,342523.64000000077,6582.309999999823
17747,2022-06-14 10:55:00,853.07,349959.0200000006,342523.64000000077,7435.37999999983
17748,2022-06-14 11:00:00,-665.76,349293.2600000006,342523.64000000077,6769.619999999821
17749,2022-06-14 11:05:00,504.63,349797.8900000006,342523.64000000077,7274.249999999825
17750,2022-06-14 11:10:00,1837.14,351635.0300000006,342523.64000000077,9111.38999999984
17751,2022-06-14 11:15:00,1167.12,352802.1500000006,342523.64000000077,10278.509999999835
17752,2022-06-14 11:20:00,-788.5,352013.6500000006,342523.64000000077,9490.009999999835
17753,2022-06-14 11:25:00,-1471.63,350542.0200000006,342523.64000000077,8018.37999999983
17754,2022-06-14 11:30:00,1415.59,351957.6100000006,342523.64000000077,9433.969999999856
17755,2022-06-14 11:35:00,-1234.52,350723.0900000006,342523.64000000077,8199.449999999837
17756,2022-06-14 11:40:00,1765.05,352488.1400000006,342523.64000000077,9964.499999999825
17757,2022-06-14 11:45:00,1561.61,354049.7500000006,342523.64000000077,11526.109999999811
17758,2022-06-14 11:50:00,1298.19,355347.9400000006,342523.64000000077,12824.299999999814
17759,2022-06-14 11:55:00,772.14,356120.0800000006,342523.64000000077,13596.439999999828
17760,2022-06-14 12:00:00,572.3,356692.3800000006,342523.64000000077,14168.739999999816
17761,2022-06-14 12:05:00,-851.69,355840.6900000006,342523.64000000077,13317.049999999814
17762,2022-06-14 12:10:00,-613.38,355227.3100000006,342523.64000000077,12703.669999999809
17763,2022-06-14 12:15:00,-588.64,354638.67000000057,342523.64000000077,12115.029999999795
17764,2022-06-14 12:20:00,436.05,355074.72000000055,342523.64000000077,12551.079999999783
17765,2022-06-14 12:25:00,485.92,355560.64000000054,342523.64000000077,13036.999999999767
17766,2022-06-14 12:30:00,-1425.01,354135.6300000005,342523.64000000077,11611.989999999758
17767,2022-06-14 12:35:00,-1728.25,352407.3800000005,342523.64000000077,9883.739999999758
17768,2022-06-14 12:40:00,-1099.04,351308.34000000055,342523.64000000077,8784.699999999779
17769,2022-06-14 12:45:00,-1557.61,349750.73000000056,342523.64000000077,7227.089999999793
17770,2022-06-14 12:50:00,419.44,350170.17000000057,342523.64000000077,7646.529999999795
17771,2022-06-14 12:55:00,586.54,350756.71000000054,342523.64000000077,8233.069999999774
17772,2022-06-14 13:00:00,1136.23,351892.9400000005,342523.64000000077,9369.299999999756
17773,2022-06-14 13:05:00,-642.11,351250.83000000054,342523.64000000077,8727.18999999977
17774,2022-06-14 13:10:00,-71.72,351179.11000000057,342523.64000000077,8655.469999999797
17775,2022-06-14 13:15:00,-1097.18,350081.9300000006,342523.64000000077,7558.289999999804
17776,2022-06-14 13:20:00,161.8,350243.73000000056,342523.64000000077,7720.089999999793
17777,2022-06-14 13:25:00,-8.82,350234.91000000056,342523.64000000077,7711.269999999786
17778,2022-06-14 13:30:00,1913.98,352148.89000000054,342523.64000000077,9625.249999999767
17779,2022-06-14 13:35:00,1677.25,353826.14000000054,342523.64000000077,11302.499999999767
17780,2022-06-14 13:40:00,1090.85,354916.9900000005,342523.64000000077,12393.349999999744
17781,2022-06-14 13:45:00,1417.63,356334.6200000005,342523.64000000077,13810.979999999749
17782,2022-06-14 13:50:00,612.69,356947.3100000005,342523.64000000077,14423.66999999975
17783,2022-06-14 13:55:00,-294.11,356653.20000000054,342523.64000000077,14129.559999999765
17784,2022-06-14 14:00:00,525.54,357178.7400000005,342523.64000000077,14655.099999999744
17785,2022-06-14 14:05:00,-1023.81,356154.9300000005,342523.64000000077,13631.289999999746
17786,2022-06-14 14:10:00,654.14,356809.07000000053,342523.64000000077,14285.42999999976
17787,2022-06-14 14:15:00,1625.77,358434.84000000055,342523.64000000077,15911.199999999779
17788,2022-06-14 14:20:00,1280.56,359715.40000000055,342523.64000000077,17191.759999999776
17789,2022-06-14 14:25:00,152.53,359867.9300000006,342523.64000000077,17344.289999999804
17790,2022-06-14 14:30:00,691.14,360559.0700000006,342523.64000000077,18035.42999999982
17791,2022-06-14 14:35:00,9.62,360568.6900000006,342523.64000000077,18045.049999999814
17792,2022-06-14 14:40:00,-1746.59,358822.10000000056,342523.64000000077,16298.459999999788
17793,2022-06-14 14:45:00,1183.17,360005.27000000054,342523.64000000077,17481.629999999772
17794,2022-06-14 14:50:00,-741.37,359263.90000000055,342523.64000000077,16740.259999999776
17795,2022-06-14 14:55:00,-527.41,358736.4900000006,342523.64000000077,16212.849999999802
17796,2022-06-14 15:00:00,1985.64,360722.1300000006,342523.64000000077,18198.489999999816
17797,2022-06-14 15:05:00,-82.71,360639.42000000057,342523.64000000077,18115.779999999795
17798,2022-06-14 15:10:00,-529.2,360110.22000000055,342523.64000000077,17586.579999999783
17799,2022-06-14 15:15:00,-1842.84,358267.3800000005,342523.64000000077,15743.739999999758
17800,2022-06-14 15:20:00,-193.47,358073.91000000056,342523.64000000077,15550.269999999786
17801,2022-06-14 15:25:00,-806.88,357267.03000000055,342523.64000000077,14743.389999999781
17802,2022-06-14 15:30:00,712.79,357979.82000000053,342523.64000000077,15456.17999999976
17803,2022-06-14 15:35:00,1491.33,359471.15000000055,342523.64000000077,16947.509999999776
17804,2022-06-14 15:40:00,1359.17,360830.32000000053,342523.64000000077,18306.67999999976
17805,2022-06-14 15:45:00,-494.64,360335.6800000005,342523.64000000077,17812.039999999746
17806,2022-06-14 15:50:00,-1830.25,358505.4300000005,342523.64000000077,15981.789999999746
17807,2022-06-14 15:55:00,-1103.56,357401.8700000005,342523.64000000077,14878.229999999749
17808,2022-06-14 16:00:00,1894.87,359296.7400000005,342523.64000000077,16773.099999999744
17809,2022-06-14 16:05:00,-1285.08,358011.6600000005,342523.64000000077,15488.019999999728
17810,2022-06-14 16:10:00,-1122.08,356889.5800000005,342523.64000000077,14365.939999999711
17811,2022-06-14 16:15:00,-1561.83,355327.75000000047,342523.64000000077,12804.109999999695
17812,2022-06-14 16:20:00,-1415.01,353912.74000000046,342523.64000000077,11389.099999999686
17813,2022-06-14 16:25:00,-1285.23,352627.5100000005,342523.64000000077,10103.869999999704
17814,2022-06-14 16:30:00,-464.73,352162.7800000005,342523.64000000077,9639.139999999723
17815,2022-06-14 16:35:00,-760.31,351402.4700000005,342523.64000000077,8878.829999999725
17816,2022-06-14 16:40:00,-1239.04,350163.4300000005,342523.64000000077,7639.789999999746
17817,2022-06-14 16:45:00,-289.29,349874.14000000054,342523.64000000077,7350.499999999767
17818,2022-06-14 16:50:00,1409.69,351283.83000000054,342523.64000000077,8760.18999999977
17819,2022-06-14 16:55:00,-1673.17,349610.66000000056,342523.64000000077,7087.019999999786
17820,2022-06-15 08:00:00,555.9,350166.5600000006,349610.66000000056,555.9000000000233
17821,2022-06-15 08:05:00,-282.38,349884.1800000006,349610.66000000056,273.5200000000186
17822,2022-06-15 08:10:00,949.36,350833.54000000056,349610.66000000056,1222.8800000000047
17823,2022-06-15 08:15:00,-1350.46,349483.08000000054,349610.66000000056,-127.5800000000163
17824,2022-06-15 08:20:00,1582.41,351065.4900000005,349610.66000000056,1454.829999999958
17825,2022-06-15 08:25:00,-1260.97,349804.52000000054,349610.66000000056,193.85999999998603
17826,2022-06-15 08:30:00,-1302.34,348502.1800000005,349610.66000000056,-1108.4800000000396
17827,2022-06-15 08:35:00,-1066.16,347436.02000000054,349610.66000000056,-2174.640000000014
17828,2022-06-15 08:40:00,-956.51,346479.51000000053,349610.66000000056,-3131.1500000000233
17829,2022-06-15 08:45:00,19.09,346498.60000000056,349610.66000000056,-3112.0599999999977
17830,2022-06-15 08:50:00,27.54,346526.14000000054,349610.66000000056,-3084.5200000000186
17831,2022-06-15 08:55:00,-632.57,345893.57000000053,349610.66000000056,-3717.0900000000256
17832,2022-06-15 09:00:00,-1517.17,344376.40000000055,349610.66000000056,-5234.260000000009
17833,2022-06-15 09:05:00,-1809.9,342566.5000000005,349610.66000000056,-7044.160000000033
17834,2022-06-15 09:10:00,1977.16,344543.6600000005,349610.66000000056,-5067.000000000058
17835,2022-06-15 09:15:00,-330.31,344213.3500000005,349610.66000000056,-5397.310000000056
17836,2022-06-15 09:20:00,230.05,344443.4000000005,349610.66000000056,-5167.2600000000675
17837,2022-06-15 09:25:00,-1791.25,342652.1500000005,349610.66000000056,-6958.5100000000675
17838,2022-06-15 09:30:00,997.78,343649.9300000005,349610.66000000056,-5960.73000000004
17839,2022-06-15 09:35:00,-1941.66,341708.27000000054,349610.66000000056,-7902.390000000014
17840,2022-06-15 09:40:00,-615.77,341092.5000000005,349610.66000000056,-8518.160000000033
17841,2022-06-15 09:45:00,-740.17,340352.33000000054,349610.66000000056,-9258.330000000016
17842,2022-06-15 09:50:00,1830.58,342182.91000000056,349610.66000000056,-7427.75
17843,2022-06-15 09:55:00,1415.76,343598.67000000057,349610.66000000056,-6011.989999999991
17844,2022-06-15 10:00:00,852.47,344451.14000000054,349610.66000000056,-5159.520000000019
17845,2022-06-15 10:05:00,-825.8,343625.34000000055,349610.66000000056,-5985.320000000007
17846,2022-06-15 10:10:00,-609.38,343015.96000000054,349610.66000000056,-6594.700000000012
17847,2022-06-15 10:15:00,-74.68,342941.28000000055,349610.66000000056,-6669.380000000005
17848,2022-06-15 10:20:00,-1246.19,341695.09000000055,349610.66000000056,-7915.570000000007
17849,2022-06-15 10:25:00,-990.48,340704.61000000057,349610.66000000056,-8906.049999999988
17850,2022-06-15 10:30:00,1678.11,342382.72000000055,349610.66000000056,-7227.940000000002
17851,2022-06-15 10:35:00,-1459.99,340922.73000000056,349610.66000000056,-8687.929999999993
17852,2022-06-15 10:40:00,1307.15,342229.8800000006,349610.66000000056,-7380.77999999997
17853,2022-06-15 10:45:00,909.98,343139.86000000057,349610.66000000056,-6470.799999999988
17854,2022-06-15 10:50:00,1463.28,344603.1400000006,349610.66000000056,-5007.51999999996
17855,2022-06-15 10:55:00,-483.05,344120.0900000006,349610.66000000056,-5490.569999999949
17856,2022-06-15 11:00:00,120.94,344241.0300000006,349610.66000000056,-5369.629999999946
17857,2022-06-15 11:05:00,-820.75,343420.2800000006,349610.66000000056,-6190.379999999946
17858,2022-06-15 11:10:00,-1864.0,341556.2800000006,349610.66000000056,-8054.379999999946
17859,2022-06-15 11:15:00,678.87,342235.1500000006,349610.66000000056,-7375.509999999951
17860,2022-06-15 11:20:00,-215.02,342020.1300000006,349610.66000000056,-7590.52999999997
17861,2022-06-15 11:25:00,1229.2,343249.3300000006,349610.66000000056,-6361.329999999958
17862,2022-06-15 11:30:00,-832.21,342417.1200000006,349610.66000000056,-7193.539999999979
17863,2022-06-15 11:35:00,960.42,343377.54000000056,349610.66000000056,-6233.119999999995
17864,2022-06-15 11:40:00,-1902.27,341475.27000000054,349610.66000000056,-8135.390000000014
17865,2022-06-15 11:45:00,-1499.86,339975.41000000056,349610.66000000056,-9635.25
17866,2022-06-15 11:50:00,121.92,340097.33000000054,349610.66000000056,-9513.330000000016
17867,2022-06-15 11:55:00,-1208.97,338888.36000000057,349610.66000000056,-10722.299999999988
17868,2022-06-15 12:00:00,-1856.0,337032.36000000057,349610.66000000056,-12578.299999999988
17869,2022-06-15 12:05:00,1814.0,338846.36000000057,349610.66000000056,-10764.299999999988
17870,2022-06-15 12:10:00,1896.66,340743.02000000054,349610.66000000056,-8867.640000000014
17871,2022-06-15 12:15:00,742.26,341485.28000000055,349610.66000000056,-8125.380000000005
17872,2022-06-15 12:20:00,1453.03,342938.3100000006,349610.66000000056,-6672.349999999977
17873,2022-06-15 12:25:00,1881.05,344819.36000000057,349610.66000000056,-4791.299999999988
17874,2022-06-15 12:30:00,-768.47,344050.8900000006,349610.66000000056,-5559.76999999996
17875,2022-06-15 12:35:00,-1138.62,342912.2700000006,349610.66000000056,-6698.389999999956
17876,2022-06-15 12:40:00,-674.68,342237.5900000006,349610.66000000056,-7373.069999999949
17877,2022-06-15 12:45:00,74.33,342311.9200000006,349610.66000000056,-7298.7399999999325
17878,2022-06-15 12:50:00,-891.95,341419.9700000006,349610.66000000056,-8190.689999999944
17879,2022-06-15 12:55:00,1448.31,342868.2800000006,349610.66000000056,-6742.379999999946
17880,2022-06-15 13:00:00,108.5,342976.7800000006,349610.66000000056,-6633.879999999946
17881,2022-06-15 13:05:00,695.67,343672.4500000006,349610.66000000056,-5938.209999999963
17882,2022-06-15 13:10:00,-1178.34,342494.11000000057,349610.66000000056,-7116.549999999988
17883,2022-06-15 13:15:00,1641.37,344135.48000000056,349610.66000000056,-5475.179999999993
17884,2022-06-15 13:20:00,-1470.81,342664.67000000057,349610.66000000056,-6945.989999999991
17885,2022-06-15 13:25:00,-1448.77,341215.90000000055,349610.66000000056,-8394.76000000001
17886,2022-06-15 13:30:00,756.65,341972.55000000057,349610.66000000056,-7638.109999999986
17887,2022-06-15 13:35:00,-1939.99,340032.5600000006,349610.66000000056,-9578.099999999977
17888,2022-06-15 13:40:00,-1604.81,338427.7500000006,349610.66000000056,-11182.909999999974
17889,2022-06-15 13:45:00,-1456.15,336971.60000000056,349610.66000000056,-12639.059999999998
17890,2022-06-15 13:50:00,1106.87,338078.47000000055,349610.66000000056,-11532.190000000002
17891,2022-06-15 13:55:00,247.13,338325.60000000056,349610.66000000056,-11285.059999999998
17892,2022-06-15 14:00:00,-1920.43,336405.17000000057,349610.66000000056,-13205.48999999999
17893,2022-06-15 14:05:00,460.6,336865.77000000054,349610.66000000056,-12744.890000000014
17894,2022-06-15 14:10:00,1553.36,338419.1300000005,349610.66000000056,-11191.530000000028
17895,2022-06-15 14:15:00,-1785.54,336633.59000000055,349610.66000000056,-12977.070000000007
17896,2022-06-15 14:20:00,1160.65,337794.2400000006,349610.66000000056,-11816.419999999984
17897,2022-06-15 14:25:00,989.93,338784.17000000057,349610.66000000056,-10826.48999999999
17898,2022-06-15 14:30:00,-1688.4,337095.77000000054,349610.66000000056,-12514.890000000014
17899,2022-06-15 14:35:00,1701.18,338796.95000000054,349610.66000000056,-10813.710000000021
17900,2022-06-15 14:40:00,715.66,339512.6100000005,349610.66000000056,-10098.050000000047
17901,2022-06-15 14:45:00,1073.29,340585.9000000005,349610.66000000056,-9024.760000000068
17902,2022-06-15 14:50:00,-1407.33,339178.5700000005,349610.66000000056,-10432.090000000084
17903,2022-06-15 14:55:00,-337.73,338840.8400000005,349610.66000000056,-10769.820000000065
17904,2022-06-15 15:00:00,558.29,339399.13000000047,349610.66000000056,-10211.530000000086
17905,2022-06-15 15:05:00,-1064.23,338334.9000000005,349610.66000000056,-11275.760000000068
17906,2022-06-15 15:10:00,-341.5,337993.4000000005,349610.66000000056,-11617.260000000068
17907,2022-06-15 15:15:00,-572.83,337420.5700000005,349610.66000000056,-12190.090000000084
17908,2022-06-15 15:20:00,560.3,337980.87000000046,349610.66000000056,-11629.790000000095
17909,2022-06-15 15:25:00,-1159.73,336821.1400000005,349610.66000000056,-12789.520000000077
17910,2022-06-15 15:30:00,-347.86,336473.2800000005,349610.66000000056,-13137.380000000063
17911,2022-06-15 15:35:00,496.68,336969.9600000005,349610.66000000056,-12640.70000000007
17912,2022-06-15 15:40:00,704.08,337674.0400000005,349610.66000000056,-11936.620000000054
17913,2022-06-15 15:45:00,779.54,338453.5800000005,349610.66000000056,-11157.080000000075
17914,2022-06-15 15:50:00,908.33,339361.9100000005,349610.66000000056,-10248.750000000058
17915,2022-06-15 15:55:00,-150.9,339211.0100000005,349610.66000000056,-10399.650000000081
17916,2022-06-15 16:00:00,-768.83,338442.18000000046,349610.66000000056,-11168.480000000098
17917,2022-06-15 16:05:00,-1540.72,336901.4600000005,349610.66000000056,-12709.20000000007
17918,2022-06-15 16:10:00,1835.3,338736.7600000005,349610.66000000056,-10873.900000000081
17919,2022-06-15 16:15:00,1921.05,340657.81000000046,349610.66000000056,-8952.850000000093
17920,2022-06-15 16:20:00,416.02,341073.8300000005,349610.66000000056,-8536.830000000075
17921,2022-06-15 16:25:00,1631.91,342705.74000000046,349610.66000000056,-6904.9200000001
17922,2022-06-15 16:30:00,28.04,342733.78000000044,349610.66000000056,-6876.880000000121
17923,2022-06-15 16:35:00,-1036.78,341697.0000000004,349610.66000000056,-7913.660000000149
17924,2022-06-15 16:40:00,817.8,342514.8000000004,349610.66000000056,-7095.860000000161
17925,2022-06-15 16:45:00,-334.69,342180.1100000004,349610.66000000056,-7430.550000000163
17926,2022-06-15 16:50:00,653.74,342833.8500000004,349610.66000000056,-6776.810000000172
17927,2022-06-15 16:55:00,-518.92,342314.9300000004,349610.66000000056,-7295.730000000156
17928,2022-06-16 08:00:00,-879.66,341435.2700000004,342314.9300000004,-879.6599999999744
17929,2022-06-16 08:05:00,-1612.76,339822.5100000004,342314.9300000004,-2492.4199999999837
17930,2022-06-16 08:10:00,599.9,340422.41000000044,342314.9300000004,-1892.5199999999604
17931,2022-06-16 08:15:00,446.91,340869.3200000004,342314.9300000004,-1445.609999999986
17932,2022-06-16 08:20:00,-336.34,340532.9800000004,342314.9300000004,-1781.9500000000116
17933,2022-06-16 08:25:00,1829.01,342361.9900000004,342314.9300000004,47.05999999999767
17934,2022-06-16 08:30:00,264.37,342626.3600000004,342314.9300000004,311.429999999993
17935,2022-06-16 08:35:00,1999.34,344625.7000000004,342314.9300000004,2310.7700000000186
17936,2022-06-16 08:40:00,-1536.42,343089.28000000044,342314.9300000004,774.3500000000349
17937,2022-06-16 08:45:00,-1570.58,341518.7000000004,342314.9300000004,-796.2299999999814
17938,2022-06-16 08:50:00,-69.29,341449.41000000044,342314.9300000004,-865.5199999999604
17939,2022-06-16 08:55:00,-1268.98,340180.43000000046,342314.9300000004,-2134.499999999942
17940,2022-06-16 09:00:00,-48.7,340131.73000000045,342314.9300000004,-2183.1999999999534
17941,2022-06-16 09:05:00,-827.18,339304.55000000045,342314.9300000004,-3010.3799999999464
17942,2022-06-16 09:10:00,739.82,340044.37000000046,342314.9300000004,-2270.5599999999395
17943,2022-06-16 09:15:00,-820.13,339224.24000000046,342314.9300000004,-3090.689999999944
17944,2022-06-16 09:20:00,-1071.54,338152.7000000005,342314.9300000004,-4162.229999999923
17945,2022-06-16 09:25:00,851.71,339004.4100000005,342314.9300000004,-3310.519999999902
17946,2022-06-16 09:30:00,133.84,339138.2500000005,342314.9300000004,-3176.6799999998766
17947,2022-06-16 09:35:00,-1280.25,337858.0000000005,342314.9300000004,-4456.929999999877
17948,2022-06-16 09:40:00,1230.4,339088.40000000055,342314.9300000004,-3226.5299999998533
17949,2022-06-16 09:45:00,-866.78,338221.6200000005,342314.9300000004,-4093.3099999998813
17950,2022-06-16 09:50:00,516.59,338738.21000000054,342314.9300000004,-3576.7199999998556
17951,2022-06-16 09:55:00,1623.97,340362.1800000005,342314.9300000004,-1952.7499999998836
17952,2022-06-16 10:00:00,925.96,341288.14000000054,342314.9300000004,-1026.7899999998626
17953,2022-06-16 10:05:00,-1229.85,340058.29000000056,342314.9300000004,-2256.6399999998393
17954,2022-06-16 10:10:00,1948.4,342006.6900000006,342314.9300000004,-308.23999999981606
17955,2022-06-16 10:15:00,1287.77,343294.4600000006,342314.9300000004,979.5300000002026
17956,2022-06-16 10:20:00,902.88,344197.3400000006,342314.9300000004,1882.4100000002072
17957,2022-06-16 10:25:00,-646.71,343550.6300000006,342314.9300000004,1235.7000000001863
17958,2022-06-16 10:30:00,1023.67,344574.30000000057,342314.9300000004,2259.37000000017
17959,2022-06-16 10:35:00,1457.87,346032.17000000057,342314.9300000004,3717.2400000001653
17960,2022-06-16 10:40:00,673.95,346706.1200000006,342314.9300000004,4391.190000000177
17961,2022-06-16 10:45:00,-375.24,346330.8800000006,342314.9300000004,4015.9500000001863
17962,2022-06-16 10:50:00,-34.54,346296.3400000006,342314.9300000004,3981.410000000207
17963,2022-06-16 10:55:00,598.94,346895.2800000006,342314.9300000004,4580.35000000021
17964,2022-06-16 11:00:00,-1420.25,345475.0300000006,342314.9300000004,3160.1000000002095
17965,2022-06-16 11:05:00,1452.17,346927.2000000006,342314.9300000004,4612.270000000193
17966,2022-06-16 11:10:00,-362.27,346564.9300000006,342314.9300000004,4250.000000000175
17967,2022-06-16 11:15:00,478.93,347043.86000000057,342314.9300000004,4728.930000000168
17968,2022-06-16 11:20:00,287.15,347331.0100000006,342314.9300000004,5016.080000000191
17969,2022-06-16 11:25:00,755.28,348086.2900000006,342314.9300000004,5771.360000000219
17970,2022-06-16 11:30:00,841.86,348928.1500000006,342314.9300000004,6613.220000000205
17971,2022-06-16 11:35:00,796.24,349724.3900000006,342314.9300000004,7409.460000000196
17972,2022-06-16 11:40:00,-1463.69,348260.7000000006,342314.9300000004,5945.770000000193
17973,2022-06-16 11:45:00,1138.16,349398.86000000057,342314.9300000004,7083.930000000168
17974,2022-06-16 11:50:00,778.13,350176.9900000006,342314.9300000004,7862.060000000172
17975,2022-06-16 11:55:00,1256.74,351433.73000000056,342314.9300000004,9118.800000000163
17976,2022-06-16 12:00:00,1044.07,352477.80000000057,342314.9300000004,10162.87000000017
17977,2022-06-16 12:05:00,259.23,352737.03000000055,342314.9300000004,10422.100000000151
17978,2022-06-16 12:10:00,19.98,352757.01000000053,342314.9300000004,10442.080000000133
17979,2022-06-16 12:15:00,1153.71,353910.72000000055,342314.9300000004,11595.790000000154
17980,2022-06-16 12:20:00,1459.0,355369.72000000055,342314.9300000004,13054.790000000154
17981,2022-06-16 12:25:00,-1320.9,354048.82000000053,342314.9300000004,11733.89000000013
17982,2022-06-16 12:30:00,-1596.12,352452.70000000054,342314.9300000004,10137.770000000135
17983,2022-06-16 12:35:00,-1461.55,350991.15000000055,342314.9300000004,8676.220000000147
17984,2022-06-16 12:40:00,1745.5,352736.65000000055,342314.9300000004,10421.720000000147
17985,2022-06-16 12:45:00,190.31,352926.96000000054,342314.9300000004,10612.030000000144
17986,2022-06-16 12:50:00,696.27,353623.23000000056,342314.9300000004,11308.300000000163
17987,2022-06-16 12:55:00,1945.38,355568.61000000057,342314.9300000004,13253.680000000168
17988,2022-06-16 13:00:00,-1314.18,354254.4300000006,342314.9300000004,11939.500000000175
17989,2022-06-16 13:05:00,-1443.98,352810.4500000006,342314.9300000004,10495.520000000193
17990,2022-06-16 13:10:00,-537.63,352272.8200000006,342314.9300000004,9957.890000000189
17991,2022-06-16 13:15:00,21.56,352294.3800000006,342314.9300000004,9979.450000000186
17992,2022-06-16 13:20:00,1339.31,353633.6900000006,342314.9300000004,11318.760000000184
17993,2022-06-16 13:25:00,497.93,354131.6200000006,342314.9300000004,11816.690000000177
17994,2022-06-16 13:30:00,727.45,354859.0700000006,342314.9300000004,12544.140000000189
17995,2022-06-16 13:35:00,-974.04,353885.0300000006,342314.9300000004,11570.10000000021
17996,2022-06-16 13:40:00,1514.69,355399.7200000006,342314.9300000004,13084.790000000212
17997,2022-06-16 13:45:00,1150.1,356549.8200000006,342314.9300000004,14234.890000000189
17998,2022-06-16 13:50:00,-273.45,356276.3700000006,342314.9300000004,13961.440000000177
17999,2022-06-16 13:55:00,-696.39,355579.98000000056,342314.9300000004,13265.050000000163
18000,2022-06-16 14:00:00,-375.42,355204.5600000006,342314.9300000004,12889.63000000018
18001,2022-06-16 14:05:00,655.48,355860.04000000056,342314.9300000004,13545.11000000016
18002,2022-06-16 14:10:00,-1110.29,354749.7500000006,342314.9300000004,12434.820000000182
18003,2022-06-16 14:15:00,-364.97,354384.7800000006,342314.9300000004,12069.85000000021
18004,2022-06-16 14:20:00,-832.09,353552.6900000006,342314.9300000004,11237.760000000184
18005,2022-06-16 14:25:00,1746.82,355299.5100000006,342314.9300000004,12984.580000000191
18006,2022-06-16 14:30:00,-910.1,354389.4100000006,342314.9300000004,12074.480000000214
18007,2022-06-16 14:35:00,-992.69,353396.7200000006,342314.9300000004,11081.790000000212
18008,2022-06-16 14:40:00,939.86,354336.5800000006,342314.9300000004,12021.650000000198
18009,2022-06-16 14:45:00,1793.9,356130.4800000006,342314.9300000004,13815.550000000221
18010,2022-06-16 14:50:00,-1751.36,354379.12000000064,342314.9300000004,12064.190000000235
18011,2022-06-16 14:55:00,-129.16,354249.96000000066,342314.9300000004,11935.03000000026
18012,2022-06-16 15:00:00,1433.92,355683.88000000064,342314.9300000004,13368.950000000244
18013,2022-06-16 15:05:00,-1490.07,354193.81000000064,342314.9300000004,11878.880000000237
18014,2022-06-16 15:10:00,-1914.8,352279.01000000065,342314.9300000004,9964.08000000025
18015,2022-06-16 15:15:00,1724.34,354003.3500000007,342314.9300000004,11688.420000000275
18016,2022-06-16 15:20:00,-1.37,354001.9800000007,342314.9300000004,11687.05000000028
18017,2022-06-16 15:25:00,1667.33,355669.3100000007,342314.9300000004,13354.380000000296
18018,2022-06-16 15:30:00,1105.57,356774.8800000007,342314.9300000004,14459.950000000303
18019,2022-06-16 15:35:00,1921.32,358696.2000000007,342314.9300000004,16381.27000000031
18020,2022-06-16 15:40:00,1422.01,360118.2100000007,342314.9300000004,17803.28000000032
18021,2022-06-16 15:45:00,426.75,360544.9600000007,342314.9300000004,18230.03000000032
18022,2022-06-16 15:50:00,-1421.77,359123.1900000007,342314.9300000004,16808.2600000003
18023,2022-06-16 15:55:00,207.36,359330.5500000007,342314.9300000004,17015.620000000286
18024,2022-06-16 16:00:00,-1280.16,358050.3900000007,342314.9300000004,15735.460000000312
18025,2022-06-16 16:05:00,-20.67,358029.7200000007,342314.9300000004,15714.790000000328
18026,2022-06-16 16:10:00,-1656.22,356373.50000000076,342314.9300000004,14058.570000000356
18027,2022-06-16 16:15:00,-1961.44,354412.06000000075,342314.9300000004,12097.130000000354
18028,2022-06-16 16:20:00,-1833.86,352578.20000000077,342314.9300000004,10263.270000000368
18029,2022-06-16 16:25:00,-41.24,352536.9600000008,342314.9300000004,10222.030000000377
18030,2022-06-16 16:30:00,-44.49,352492.4700000008,342314.9300000004,10177.540000000386
18031,2022-06-16 16:35:00,-1737.45,350755.0200000008,342314.9300000004,8440.090000000375
18032,2022-06-16 16:40:00,1577.47,352332.49000000075,342314.9300000004,10017.560000000347
18033,2022-06-16 16:45:00,-1358.9,350973.5900000007,342314.9300000004,8658.660000000324
18034,2022-06-16 16:50:00,952.77,351926.36000000074,342314.9300000004,9611.430000000342
18035,2022-06-16 16:55:00,1215.01,353141.37000000075,342314.9300000004,10826.440000000352
18036,2022-06-17 08:00:00,-984.36,352157.01000000077,353141.37000000075,-984.359999999986
18037,2022-06-17 08:05:00,-861.15,351295.86000000074,353141.37000000075,-1845.5100000000093
18038,2022-06-17 08:10:00,-1860.16,349435.70000000077,353141.37000000075,-3705.6699999999837
18039,2022-06-17 08:15:00,197.46,349633.1600000008,353141.37000000075,-3508.2099999999627
18040,2022-06-17 08:20:00,-616.68,349016.4800000008,353141.37000000075,-4124.889999999956
18041,2022-06-17 08:25:00,-1606.98,347409.5000000008,353141.37000000075,-5731.869999999937
18042,2022-06-17 08:30:00,889.89,348299.3900000008,353141.37000000075,-4841.979999999923
18043,2022-06-17 08:35:00,541.13,348840.52000000083,353141.37000000075,-4300.8499999999185
18044,2022-06-17 08:40:00,1456.96,350297.48000000085,353141.37000000075,-2843.8899999998976
18045,2022-06-17 08:45:00,-1415.67,348881.81000000087,353141.37000000075,-4259.559999999881
18046,2022-06-17 08:50:00,-749.53,348132.28000000084,353141.37000000075,-5009.089999999909
18047,2022-06-17 08:55:00,126.6,348258.8800000008,353141.37000000075,-4882.4899999999325
18048,2022-06-17 09:00:00,-1908.24,346350.6400000008,353141.37000000075,-6790.729999999923
18049,2022-06-17 09:05:00,1076.64,347427.28000000084,353141.37000000075,-5714.089999999909
18050,2022-06-17 09:10:00,-429.36,346997.92000000086,353141.37000000075,-6143.449999999895
18051,2022-06-17 09:15:00,681.03,347678.9500000009,353141.37000000075,-5462.419999999867
18052,2022-06-17 09:20:00,-611.27,347067.68000000087,353141.37000000075,-6073.689999999886
18053,2022-06-17 09:25:00,943.61,348011.29000000085,353141.37000000075,-5130.0799999999
18054,2022-06-17 09:30:00,-766.27,347245.02000000083,353141.37000000075,-5896.3499999999185
18055,2022-06-17 09:35:00,1302.89,348547.91000000085,353141.37000000075,-4593.4599999999045
18056,2022-06-17 09:40:00,1335.99,349883.90000000084,353141.37000000075,-3257.469999999914
18057,2022-06-17 09:45:00,-69.0,349814.90000000084,353141.37000000075,-3326.469999999914
18058,2022-06-17 09:50:00,382.08,350196.98000000085,353141.37000000075,-2944.3899999998976
18059,2022-06-17 09:55:00,-1837.16,348359.8200000009,353141.37000000075,-4781.549999999872
18060,2022-06-17 10:00:00,-1672.51,346687.31000000087,353141.37000000075,-6454.059999999881
18061,2022-06-17 10:05:00,-1031.67,345655.6400000009,353141.37000000075,-7485.729999999865
18062,2022-06-17 10:10:00,504.6,346160.24000000086,353141.37000000075,-6981.129999999888
18063,2022-06-17 10:15:00,951.22,347111.46000000084,353141.37000000075,-6029.909999999916
18064,2022-06-17 10:20:00,1115.99,348227.4500000008,353141.37000000075,-4913.9199999999255
18065,2022-06-17 10:25:00,-906.82,347320.6300000008,353141.37000000075,-5820.7399999999325
18066,2022-06-17 10:30:00,930.25,348250.8800000008,353141.37000000075,-4890.4899999999325
18067,2022-06-17 10:35:00,670.26,348921.1400000008,353141.37000000075,-4220.229999999923
18068,2022-06-17 10:40:00,1180.79,350101.9300000008,353141.37000000075,-3039.439999999944
18069,2022-06-17 10:45:00,-1125.74,348976.1900000008,353141.37000000075,-4165.179999999935
18070,2022-06-17 10:50:00,-1686.6,347289.59000000084,353141.37000000075,-5851.7799999999115
18071,2022-06-17 10:55:00,1536.02,348825.61000000086,353141.37000000075,-4315.759999999893
18072,2022-06-17 11:00:00,-1585.14,347240.47000000085,353141.37000000075,-5900.899999999907
18073,2022-06-17 11:05:00,1199.12,348439.59000000084,353141.37000000075,-4701.7799999999115
18074,2022-06-17 11:10:00,-348.04,348091.55000000086,353141.37000000075,-5049.819999999891
18075,2022-06-17 11:15:00,-794.48,347297.0700000009,353141.37000000075,-5844.299999999872
18076,2022-06-17 11:20:00,-529.95,346767.12000000087,353141.37000000075,-6374.249999999884
18077,2022-06-17 11:25:00,-1289.91,345477.2100000009,353141.37000000075,-7664.159999999858
18078,2022-06-17 11:30:00,786.43,346263.6400000009,353141.37000000075,-6877.729999999865
18079,2022-06-17 11:35:00,-408.63,345855.0100000009,353141.37000000075,-7286.35999999987
18080,2022-06-17 11:40:00,1682.76,347537.7700000009,353141.37000000075,-5603.59999999986
18081,2022-06-17 11:45:00,1554.36,349092.1300000009,353141.37000000075,-4049.2399999998743
18082,2022-06-17 11:50:00,143.25,349235.3800000009,353141.37000000075,-3905.9899999998743
18083,2022-06-17 11:55:00,975.33,350210.7100000009,353141.37000000075,-2930.659999999858
18084,2022-06-17 12:00:00,950.91,351161.62000000087,353141.37000000075,-1979.7499999998836
18085,2022-06-17 12:05:00,-1594.81,349566.81000000087,353141.37000000075,-3574.5599999998813
18086,2022-06-17 12:10:00,-207.47,349359.3400000009,353141.37000000075,-3782.0299999998533
18087,2022-06-17 12:15:00,1803.75,351163.0900000009,353141.37000000075,-1978.2799999998533
18088,2022-06-17 12:20:00,661.16,351824.2500000009,353141.37000000075,-1317.119999999879
18089,2022-06-17 12:25:00,1313.45,353137.7000000009,353141.37000000075,-3.6699999998672865
18090,2022-06-17 12:30:00,535.85,353673.55000000086,353141.37000000075,532.1800000001094
18091,2022-06-17 12:35:00,1699.89,355373.4400000009,353141.37000000075,2232.0700000001234
18092,2022-06-17 12:40:00,-1529.44,353844.0000000009,353141.37000000075,702.6300000001211
18093,2022-06-17 12:45:00,1607.39,355451.3900000009,353141.37000000075,2310.020000000135
18094,2022-06-17 12:50:00,-555.09,354896.30000000086,353141.37000000075,1754.9300000001094
18095,2022-06-17 12:55:00,1109.95,356006.2500000009,353141.37000000075,2864.880000000121
18096,2022-06-17 13:00:00,1481.32,357487.5700000009,353141.37000000075,4346.200000000128
18097,2022-06-17 13:05:00,-1347.94,356139.6300000009,353141.37000000075,2998.2600000001257
18098,2022-06-17 13:10:00,1349.42,357489.05000000086,353141.37000000075,4347.680000000109
18099,2022-06-17 13:15:00,1726.37,359215.42000000086,353141.37000000075,6074.050000000105
18100,2022-06-17 13:20:00,-1692.15,357523.27000000083,353141.37000000075,4381.9000000000815
18101,2022-06-17 13:25:00,-1403.13,356120.1400000008,353141.37000000075,2978.770000000077
18102,2022-06-17 13:30:00,1391.86,357512.0000000008,353141.37000000075,4370.630000000063
18103,2022-06-17 13:35:00,81.76,357593.7600000008,353141.37000000075,4452.390000000072
18104,2022-06-17 13:40:00,-190.92,357402.84000000084,353141.37000000075,4261.4700000000885
18105,2022-06-17 13:45:00,717.05,358119.8900000008,353141.37000000075,4978.520000000077
18106,2022-06-17 13:50:00,838.73,358958.6200000008,353141.37000000075,5817.250000000058
18107,2022-06-17 13:55:00,-370.31,358588.3100000008,353141.37000000075,5446.9400000000605
18108,2022-06-17 14:00:00,324.59,358912.90000000084,353141.37000000075,5771.530000000086
18109,2022-06-17 14:05:00,-463.8,358449.10000000085,353141.37000000075,5307.730000000098
18110,2022-06-17 14:10:00,-1129.28,357319.8200000008,353141.37000000075,4178.45000000007
18111,2022-06-17 14:15:00,821.43,358141.2500000008,353141.37000000075,4999.880000000063
18112,2022-06-17 14:20:00,-1363.65,356777.6000000008,353141.37000000075,3636.2300000000396
18113,2022-06-17 14:25:00,434.8,357212.4000000008,353141.37000000075,4071.030000000028
18114,2022-06-17 14:30:00,-1812.62,355399.7800000008,353141.37000000075,2258.4100000000326
18115,2022-06-17 14:35:00,1836.25,357236.0300000008,353141.37000000075,4094.6600000000326
18116,2022-06-17 14:40:00,-1423.59,355812.44000000076,353141.37000000075,2671.070000000007
18117,2022-06-17 14:45:00,-225.12,355587.32000000076,353141.37000000075,2445.9500000000116
18118,2022-06-17 14:50:00,592.83,356180.1500000008,353141.37000000075,3038.780000000028
18119,2022-06-17 14:55:00,1539.6,357719.75000000076,353141.37000000075,4578.380000000005
18120,2022-06-17 15:00:00,-1932.99,355786.76000000077,353141.37000000075,2645.390000000014
18121,2022-06-17 15:05:00,1787.63,357574.39000000077,353141.37000000075,4433.020000000019
18122,2022-06-17 15:10:00,-1232.37,356342.0200000008,353141.37000000075,3200.6500000000233
18123,2022-06-17 15:15:00,1355.15,357697.1700000008,353141.37000000075,4555.800000000047
18124,2022-06-17 15:20:00,-1271.79,356425.3800000008,353141.37000000075,3284.0100000000675
18125,2022-06-17 15:25:00,504.28,356929.66000000085,353141.37000000075,3788.2900000000955
18126,2022-06-17 15:30:00,777.5,357707.16000000085,353141.37000000075,4565.7900000000955
18127,2022-06-17 15:35:00,-55.01,357652.15000000084,353141.37000000075,4510.780000000086
18128,2022-06-17 15:40:00,707.54,358359.6900000008,353141.37000000075,5218.320000000065
18129,2022-06-17 15:45:00,-980.09,357379.6000000008,353141.37000000075,4238.23000000004
18130,2022-06-17 15:50:00,1318.0,358697.6000000008,353141.37000000075,5556.23000000004
18131,2022-06-17 15:55:00,-601.2,358096.4000000008,353141.37000000075,4955.030000000028
18132,2022-06-17 16:00:00,-290.96,357805.44000000076,353141.37000000075,4664.070000000007
18133,2022-06-17 16:05:00,1557.92,359363.36000000074,353141.37000000075,6221.989999999991
18134,2022-06-17 16:10:00,1536.08,360899.44000000076,353141.37000000075,7758.070000000007
18135,2022-06-17 16:15:00,-1827.98,359071.4600000008,353141.37000000075,5930.090000000026
18136,2022-06-17 16:20:00,-1517.45,357554.01000000077,353141.37000000075,4412.640000000014
18137,2022-06-17 16:25:00,1312.24,358866.25000000076,353141.37000000075,5724.880000000005
18138,2022-06-17 16:30:00,1296.12,360162.37000000075,353141.37000000075,7021.0
18139,2022-06-17 16:35:00,-925.91,359236.4600000008,353141.37000000075,6095.090000000026
18140,2022-06-17 16:40:00,147.01,359383.4700000008,353141.37000000075,6242.100000000035
18141,2022-06-17 16:45:00,1586.33,360969.8000000008,353141.37000000075,7828.430000000051
18142,2022-06-17 16:50:00,-1779.61,359190.1900000008,353141.37000000075,6048.820000000065
18143,2022-06-17 16:55:00,391.48,359581.6700000008,353141.37000000075,6440.300000000047
18144,2022-06-18 08:00:00,1217.02,360798.6900000008,359581.6700000008,1217.0200000000186
18145,2022-06-18 08:05:00,-60.75,360737.9400000008,359581.6700000008,1156.2700000000186
18146,2022-06-18 08:10:00,-1003.45,359734.4900000008,359581.6700000008,152.82000000000698
18147,2022-06-18 08:15:00,-1728.61,358005.8800000008,359581.6700000008,-1575.789999999979
18148,2022-06-18 08:20:00,-1081.01,356924.8700000008,359581.6700000008,-2656.7999999999884
18149,2022-06-18 08:25:00,-1975.54,354949.33000000083,359581.6700000008,-4632.339999999967
18150,2022-06-18 08:30:00,-423.55,354525.78000000084,359581.6700000008,-5055.889999999956
18151,2022-06-18 08:35:00,-1449.05,353076.73000000085,359581.6700000008,-6504.939999999944
18152,2022-06-18 08:40:00,1932.23,355008.96000000084,359581.6700000008,-4572.709999999963
18153,2022-06-18 08:45:00,-1728.45,353280.5100000008,359581.6700000008,-6301.159999999974
18154,2022-06-18 08:50:00,653.26,353933.77000000083,359581.6700000008,-5647.899999999965
18155,2022-06-18 08:55:00,820.79,354754.5600000008,359581.6700000008,-4827.109999999986
18156,2022-06-18 09:00:00,-689.41,354065.15000000084,359581.6700000008,-5516.51999999996
18157,2022-06-18 09:05:00,-1991.35,352073.80000000086,359581.6700000008,-7507.869999999937
18158,2022-06-18 09:10:00,1352.04,353425.84000000084,359581.6700000008,-6155.829999999958
18159,2022-06-18 09:15:00,-205.71,353220.1300000008,359581.6700000008,-6361.539999999979
18160,2022-06-18 09:20:00,-321.51,352898.6200000008,359581.6700000008,-6683.049999999988
18161,2022-06-18 09:25:00,-1621.1,351277.52000000083,359581.6700000008,-8304.149999999965
18162,2022-06-18 09:30:00,647.97,351925.4900000008,359581.6700000008,-7656.179999999993
18163,2022-06-18 09:35:00,389.07,352314.5600000008,359581.6700000008,-7267.109999999986
18164,2022-06-18 09:40:00,-1312.21,351002.3500000008,359581.6700000008,-8579.320000000007
18165,2022-06-18 09:45:00,-1820.86,349181.4900000008,359581.6700000008,-10400.179999999993
18166,2022-06-18 09:50:00,1843.76,351025.2500000008,359581.6700000008,-8556.419999999984
18167,2022-06-18 09:55:00,-1868.8,349156.4500000008,359581.6700000008,-10425.219999999972
18168,2022-06-18 10:00:00,-1239.82,347916.6300000008,359581.6700000008,-11665.039999999979
18169,2022-06-18 10:05:00,1328.77,349245.40000000084,359581.6700000008,-10336.26999999996
18170,2022-06-18 10:10:00,-962.32,348283.08000000083,359581.6700000008,-11298.589999999967
18171,2022-06-18 10:15:00,131.68,348414.7600000008,359581.6700000008,-11166.909999999974
18172,2022-06-18 10:20:00,-918.99,347495.77000000083,359581.6700000008,-12085.899999999965
18173,2022-06-18 10:25:00,-448.24,347047.53000000084,359581.6700000008,-12534.139999999956
18174,2022-06-18 10:30:00,-229.65,346817.8800000008,359581.6700000008,-12763.789999999979
18175,2022-06-18 10:35:00,1956.85,348774.7300000008,359581.6700000008,-10806.940000000002
18176,2022-06-18 10:40:00,367.77,349142.5000000008,359581.6700000008,-10439.169999999984
18177,2022-06-18 10:45:00,-858.39,348284.1100000008,359581.6700000008,-11297.559999999998
18178,2022-06-18 10:50:00,-1463.84,346820.2700000008,359581.6700000008,-12761.400000000023
18179,2022-06-18 10:55:00,-894.32,345925.95000000077,359581.6700000008,-13655.72000000003
18180,2022-06-18 11:00:00,120.97,346046.92000000074,359581.6700000008,-13534.750000000058
18181,2022-06-18 11:05:00,810.53,346857.45000000077,359581.6700000008,-12724.22000000003
18182,2022-06-18 11:10:00,-446.58,346410.87000000075,359581.6700000008,-13170.800000000047
18183,2022-06-18 11:15:00,-805.33,345605.54000000074,359581.6700000008,-13976.130000000063
18184,2022-06-18 11:20:00,-1747.93,343857.61000000074,359581.6700000008,-15724.060000000056
18185,2022-06-18 11:25:00,-1944.94,341912.67000000074,359581.6700000008,-17669.00000000006
18186,2022-06-18 11:30:00,665.75,342578.42000000074,359581.6700000008,-17003.25000000006
18187,2022-06-18 11:35:00,1358.65,343937.07000000076,359581.6700000008,-15644.600000000035
18188,2022-06-18 11:40:00,1653.59,345590.6600000008,359581.6700000008,-13991.01000000001
18189,2022-06-18 11:45:00,628.68,346219.3400000008,359581.6700000008,-13362.330000000016
18190,2022-06-18 11:50:00,37.22,346256.56000000075,359581.6700000008,-13325.110000000044
18191,2022-06-18 11:55:00,-310.03,345946.5300000007,359581.6700000008,-13635.140000000072
18192,2022-06-18 12:00:00,-1146.69,344799.8400000007,359581.6700000008,-14781.830000000075
18193,2022-06-18 12:05:00,436.46,345236.30000000075,359581.6700000008,-14345.370000000054
18194,2022-06-18 12:10:00,1741.09,346977.39000000077,359581.6700000008,-12604.280000000028
18195,2022-06-18 12:15:00,-1663.55,345313.8400000008,359581.6700000008,-14267.830000000016
18196,2022-06-18 12:20:00,-313.36,345000.4800000008,359581.6700000008,-14581.190000000002
18197,2022-06-18 12:25:00,47.78,345048.2600000008,359581.6700000008,-14533.409999999974
18198,2022-06-18 12:30:00,1848.01,346896.27000000083,359581.6700000008,-12685.399999999965
18199,2022-06-18 12:35:00,192.62,347088.8900000008,359581.6700000008,-12492.77999999997
18200,2022-06-18 12:40:00,1128.19,348217.08000000083,359581.6700000008,-11364.589999999967
18201,2022-06-18 12:45:00,1381.18,349598.2600000008,359581.6700000008,-9983.409999999974
18202,2022-06-18 12:50:00,1998.67,351596.9300000008,359581.6700000008,-7984.739999999991
18203,2022-06-18 12:55:00,-871.93,350725.0000000008,359581.6700000008,-8856.669999999984
18204,2022-06-18 13:00:00,37.18,350762.1800000008,359581.6700000008,-8819.48999999999
18205,2022-06-18 13:05:00,1060.44,351822.6200000008,359581.6700000008,-7759.049999999988
18206,2022-06-18 13:10:00,-1166.73,350655.8900000008,359581.6700000008,-8925.77999999997
18207,2022-06-18 13:15:00,-613.19,350042.7000000008,359581.6700000008,-9538.969999999972
18208,2022-06-18 13:20:00,1041.91,351084.6100000008,359581.6700000008,-8497.059999999998
18209,2022-06-18 13:25:00,-652.08,350432.5300000008,359581.6700000008,-9149.140000000014
18210,2022-06-18 13:30:00,632.65,351065.1800000008,359581.6700000008,-8516.48999999999
18211,2022-06-18 13:35:00,455.27,351520.4500000008,359581.6700000008,-8061.219999999972
18212,2022-06-18 13:40:00,-321.06,351199.3900000008,359581.6700000008,-8382.27999999997
18213,2022-06-18 13:45:00,-1123.03,350076.3600000008,359581.6700000008,-9505.309999999998
18214,2022-06-18 13:50:00,-1554.24,348522.1200000008,359581.6700000008,-11059.549999999988
18215,2022-06-18 13:55:00,1636.69,350158.8100000008,359581.6700000008,-9422.859999999986
18216,2022-06-18 14:00:00,104.03,350262.84000000084,359581.6700000008,-9318.829999999958
18217,2022-06-18 14:05:00,298.99,350561.83000000083,359581.6700000008,-9019.839999999967
18218,2022-06-18 14:10:00,-726.25,349835.58000000083,359581.6700000008,-9746.089999999967
18219,2022-06-18 14:15:00,-1726.63,348108.9500000008,359581.6700000008,-11472.719999999972
18220,2022-06-18 14:20:00,1759.71,349868.66000000085,359581.6700000008,-9713.009999999951
18221,2022-06-18 14:25:00,-554.03,349314.6300000008,359581.6700000008,-10267.039999999979
18222,2022-06-18 14:30:00,1842.82,351157.4500000008,359581.6700000008,-8424.219999999972
18223,2022-06-18 14:35:00,-953.68,350203.77000000083,359581.6700000008,-9377.899999999965
18224,2022-06-18 14:40:00,1809.57,352013.34000000084,359581.6700000008,-7568.329999999958
18225,2022-06-18 14:45:00,816.97,352830.3100000008,359581.6700000008,-6751.359999999986
18226,2022-06-18 14:50:00,1641.23,354471.5400000008,359581.6700000008,-5110.130000000005
18227,2022-06-18 14:55:00,1293.87,355765.4100000008,359581.6700000008,-3816.2600000000093
18228,2022-06-18 15:00:00,-662.75,355102.6600000008,359581.6700000008,-4479.010000000009
18229,2022-06-18 15:05:00,352.98,355455.64000000077,359581.6700000008,-4126.030000000028
18230,2022-06-18 15:10:00,-824.77,354630.87000000075,359581.6700000008,-4950.800000000047
18231,2022-06-18 15:15:00,1256.5,355887.37000000075,359581.6700000008,-3694.3000000000466
18232,2022-06-18 15:20:00,887.01,356774.38000000076,359581.6700000008,-2807.2900000000373
18233,2022-06-18 15:25:00,-1412.67,355361.7100000008,359581.6700000008,-4219.960000000021
18234,2022-06-18 15:30:00,1706.24,357067.95000000077,359581.6700000008,-2513.7200000000303
18235,2022-06-18 15:35:00,-1719.38,355348.57000000076,359581.6700000008,-4233.100000000035
18236,2022-06-18 15:40:00,941.96,356290.5300000008,359581.6700000008,-3291.140000000014
18237,2022-06-18 15:45:00,626.0,356916.5300000008,359581.6700000008,-2665.140000000014
18238,2022-06-18 15:50:00,227.38,357143.9100000008,359581.6700000008,-2437.7600000000093
18239,2022-06-18 15:55:00,1458.89,358602.8000000008,359581.6700000008,-978.8699999999953
18240,2022-06-18 16:00:00,1160.66,359763.4600000008,359581.6700000008,181.78999999997905
18241,2022-06-18 16:05:00,390.49,360153.95000000077,359581.6700000008,572.2799999999697
18242,2022-06-18 16:10:00,-1791.6,358362.3500000008,359581.6700000008,-1219.320000000007
18243,2022-06-18 16:15:00,942.62,359304.9700000008,359581.6700000008,-276.70000000001164
18244,2022-06-18 16:20:00,-399.37,358905.6000000008,359581.6700000008,-676.070000000007
18245,2022-06-18 16:25:00,-648.73,358256.8700000008,359581.6700000008,-1324.7999999999884
18246,2022-06-18 16:30:00,1340.58,359597.4500000008,359581.6700000008,15.78000000002794
18247,2022-06-18 16:35:00,0.16,359597.6100000008,359581.6700000008,15.940000000002328
18248,2022-06-18 16:40:00,1978.2,361575.8100000008,359581.6700000008,1994.140000000014
18249,2022-06-18 16:45:00,52.16,361627.9700000008,359581.6700000008,2046.2999999999884
18250,2022-06-18 16:50:00,1271.99,362899.9600000008,359581.6700000008,3318.289999999979
18251,2022-06-18 16:55:00,-1970.13,360929.8300000008,359581.6700000008,1348.1599999999744
18252,2022-06-19 08:00:00,-1893.69,359036.14000000077,360929.8300000008,-1893.6900000000023
18253,2022-06-19 08:05:00,-957.37,358078.7700000008,360929.8300000008,-2851.0599999999977
18254,2022-06-19 08:10:00,897.26,358976.0300000008,360929.8300000008,-1953.7999999999884
18255,2022-06-19 08:15:00,925.92,359901.95000000077,360929.8300000008,-1027.8800000000047
18256,2022-06-19 08:20:00,479.45,360381.4000000008,360929.8300000008,-548.429999999993
18257,2022-06-19 08:25:00,-1521.35,358860.0500000008,360929.8300000008,-2069.7799999999697
18258,2022-06-19 08:30:00,915.69,359775.7400000008,360929.8300000008,-1154.0899999999674
18259,2022-06-19 08:35:00,1288.52,361064.2600000008,360929.8300000008,134.43000000005122
18260,2022-06-19 08:40:00,605.83,361670.09000000084,360929.8300000008,740.2600000000675
18261,2022-06-19 08:45:00,-1289.23,360380.86000000086,360929.8300000008,-548.9699999999139
18262,2022-06-19 08:50:00,-1388.16,358992.7000000009,360929.8300000008,-1937.1299999998882
18263,2022-06-19 08:55:00,-551.26,358441.4400000009,360929.8300000008,-2488.3899999998976
18264,2022-06-19 09:00:00,-1987.7,356453.74000000086,360929.8300000008,-4476.089999999909
18265,2022-06-19 09:05:00,1762.41,358216.15000000084,360929.8300000008,-2713.679999999935
18266,2022-06-19 09:10:00,-1930.36,356285.79000000085,360929.8300000008,-4644.039999999921
18267,2022-06-19 09:15:00,1951.11,358236.90000000084,360929.8300000008,-2692.929999999935
18268,2022-06-19 09:20:00,1613.79,359850.6900000008,360929.8300000008,-1079.1399999999558
18269,2022-06-19 09:25:00,-1072.72,358777.97000000085,360929.8300000008,-2151.859999999928
18270,2022-06-19 09:30:00,1547.58,360325.55000000086,360929.8300000008,-604.2799999999115
18271,2022-06-19 09:35:00,1695.58,362021.1300000009,360929.8300000008,1091.3000000001048
18272,2022-06-19 09:40:00,-1494.7,360526.43000000087,360929.8300000008,-403.39999999990687
18273,2022-06-19 09:45:00,1256.71,361783.1400000009,360929.8300000008,853.3100000001141
18274,2022-06-19 09:50:00,116.89,361900.0300000009,360929.8300000008,970.2000000001281
18275,2022-06-19 09:55:00,1925.88,363825.9100000009,360929.8300000008,2896.0800000001327
18276,2022-06-19 10:00:00,-1983.68,361842.2300000009,360929.8300000008,912.4000000001397
18277,2022-06-19 10:05:00,-1342.74,360499.4900000009,360929.8300000008,-430.339999999851
18278,2022-06-19 10:10:00,-832.82,359666.6700000009,360929.8300000008,-1263.159999999858
18279,2022-06-19 10:15:00,885.41,360552.0800000009,360929.8300000008,-377.7499999998836
18280,2022-06-19 10:20:00,-1655.84,358896.24000000086,360929.8300000008,-2033.5899999999092
18281,2022-06-19 10:25:00,-1854.22,357042.0200000009,360929.8300000008,-3887.8099999998813
18282,2022-06-19 10:30:00,1078.7,358120.7200000009,360929.8300000008,-2809.1099999998696
18283,2022-06-19 10:35:00,-392.93,357727.7900000009,360929.8300000008,-3202.0399999998626
18284,2022-06-19 10:40:00,-104.09,357623.7000000009,360929.8300000008,-3306.1299999998882
18285,2022-06-19 10:45:00,1700.21,359323.9100000009,360929.8300000008,-1605.9199999998673
18286,2022-06-19 10:50:00,1539.03,360862.94000000093,360929.8300000008,-66.88999999983935
18287,2022-06-19 10:55:00,-360.73,360502.21000000095,360929.8300000008,-427.6199999998207
18288,2022-06-19 11:00:00,1275.6,361777.8100000009,360929.8300000008,847.980000000156
18289,2022-06-19 11:05:00,565.35,362343.1600000009,360929.8300000008,1413.3300000001327
18290,2022-06-19 11:10:00,-476.02,361867.1400000009,360929.8300000008,937.3100000001141
18291,2022-06-19 11:15:00,-1912.0,359955.1400000009,360929.8300000008,-974.6899999998859
18292,2022-06-19 11:20:00,-1194.09,358761.05000000086,360929.8300000008,-2168.7799999999115
18293,2022-06-19 11:25:00,-1312.74,357448.31000000087,360929.8300000008,-3481.519999999902
18294,2022-06-19 11:30:00,-554.75,356893.56000000087,360929.8300000008,-4036.269999999902
18295,2022-06-19 11:35:00,169.65,357063.2100000009,360929.8300000008,-3866.619999999879
18296,2022-06-19 11:40:00,1530.34,358593.5500000009,360929.8300000008,-2336.2799999998533
18297,2022-06-19 11:45:00,1437.88,360031.4300000009,360929.8300000008,-898.3999999998487
18298,2022-06-19 11:50:00,130.78,360162.21000000095,360929.8300000008,-767.6199999998207
18299,2022-06-19 11:55:00,1758.68,361920.89000000095,360929.8300000008,991.0600000001723
18300,2022-06-19 12:00:00,-591.53,361329.3600000009,360929.8300000008,399.53000000014435
18301,2022-06-19 12:05:00,1782.13,363111.4900000009,360929.8300000008,2181.660000000149
18302,2022-06-19 12:10:00,83.2,363194.69000000093,360929.8300000008,2264.8600000001607
18303,2022-06-19 12:15:00,1534.11,364728.8000000009,360929.8300000008,3798.9700000001467
18304,2022-06-19 12:20:00,-814.1,363914.70000000094,360929.8300000008,2984.87000000017
18305,2022-06-19 12:25:00,-194.19,363720.51000000094,360929.8300000008,2790.6800000001676
18306,2022-06-19 12:30:00,-905.61,362814.90000000095,360929.8300000008,1885.0700000001816
18307,2022-06-19 12:35:00,-1434.95,361379.95000000094,360929.8300000008,450.12000000016997
18308,2022-06-19 12:40:00,-1653.29,359726.66000000096,360929.8300000008,-1203.169999999809
18309,2022-06-19 12:45:00,-390.56,359336.10000000097,360929.8300000008,-1593.7299999998068
18310,2022-06-19 12:50:00,1962.41,361298.51000000094,360929.8300000008,368.68000000016764
18311,2022-06-19 12:55:00,817.96,362116.47000000096,360929.8300000008,1186.6400000001886
18312,2022-06-19 13:00:00,882.34,362998.810000001,360929.8300000008,2068.980000000214
18313,2022-06-19 13:05:00,1251.12,364249.930000001,360929.8300000008,3320.1000000002095
18314,2022-06-19 13:10:00,181.75,364431.680000001,360929.8300000008,3501.8500000002095
18315,2022-06-19 13:15:00,1573.39,366005.070000001,360929.8300000008,5075.2400000002235
18316,2022-06-19 13:20:00,-853.79,365151.280000001,360929.8300000008,4221.4500000002445
18317,2022-06-19 13:25:00,1755.04,366906.320000001,360929.8300000008,5976.4900000002235
18318,2022-06-19 13:30:00,-1363.44,365542.880000001,360929.8300000008,4613.050000000221
18319,2022-06-19 13:35:00,1781.55,367324.430000001,360929.8300000008,6394.60000000021
18320,2022-06-19 13:40:00,1480.28,368804.710000001,360929.8300000008,7874.8800000002375
18321,2022-06-19 13:45:00,-550.18,368254.530000001,360929.8300000008,7324.7000000002445
18322,2022-06-19 13:50:00,-491.68,367762.850000001,360929.8300000008,6833.0200000002515
18323,2022-06-19 13:55:00,189.2,367952.05000000104,360929.8300000008,7022.220000000263
18324,2022-06-19 14:00:00,-1529.96,366422.090000001,360929.8300000008,5492.260000000242
18325,2022-06-19 14:05:00,-315.63,366106.460000001,360929.8300000008,5176.6300000002375
18326,2022-06-19 14:10:00,79.56,366186.020000001,360929.8300000008,5256.190000000235
18327,2022-06-19 14:15:00,-1962.98,364223.040000001,360929.8300000008,3293.210000000254
18328,2022-06-19 14:20:00,1992.35,366215.390000001,360929.8300000008,5285.5600000002305
18329,2022-06-19 14:25:00,1118.49,367333.880000001,360929.8300000008,6404.050000000221
18330,2022-06-19 14:30:00,1496.94,368830.820000001,360929.8300000008,7900.9900000002235
18331,2022-06-19 14:35:00,-1118.06,367712.760000001,360929.8300000008,6782.930000000226
18332,2022-06-19 14:40:00,1602.52,369315.280000001,360929.8300000008,8385.450000000244
18333,2022-06-19 14:45:00,-1837.14,367478.140000001,360929.8300000008,6548.3100000002305
18334,2022-06-19 14:50:00,-1536.37,365941.770000001,360929.8300000008,5011.940000000235
18335,2022-06-19 14:55:00,-1951.91,363989.86000000103,360929.8300000008,3060.0300000002608
18336,2022-06-19 15:00:00,1913.43,365903.290000001,360929.8300000008,4973.460000000254
18337,2022-06-19 15:05:00,-882.39,365020.900000001,360929.8300000008,4091.07000000024
18338,2022-06-19 15:10:00,-1296.34,363724.560000001,360929.8300000008,2794.730000000214
18339,2022-06-19 15:15:00,1631.51,365356.070000001,360929.8300000008,4426.2400000002235
18340,2022-06-19 15:20:00,583.09,365939.160000001,360929.8300000008,5009.330000000249
18341,2022-06-19 15:25:00,1254.55,367193.710000001,360929.8300000008,6263.8800000002375
18342,2022-06-19 15:30:00,-1804.86,365388.850000001,360929.8300000008,4459.0200000002515
18343,2022-06-19 15:35:00,859.58,366248.43000000104,360929.8300000008,5318.600000000268
18344,2022-06-19 15:40:00,670.19,366918.62000000104,360929.8300000008,5988.79000000027
18345,2022-06-19 15:45:00,190.36,367108.98000000103,360929.8300000008,6179.150000000256
18346,2022-06-19 15:50:00,-2.08,367106.900000001,360929.8300000008,6177.07000000024
18347,2022-06-19 15:55:00,-1326.24,365780.660000001,360929.8300000008,4850.830000000249
18348,2022-06-19 16:00:00,1060.18,366840.840000001,360929.8300000008,5911.010000000242
18349,2022-06-19 16:05:00,1983.95,368824.790000001,360929.8300000008,7894.960000000254
18350,2022-06-19 16:10:00,986.27,369811.06000000105,360929.8300000008,8881.230000000272
18351,2022-06-19 16:15:00,657.52,370468.58000000106,360929.8300000008,9538.750000000291
18352,2022-06-19 16:20:00,-343.33,370125.25000000105,360929.8300000008,9195.420000000275
18353,2022-06-19 16:25:00,1998.02,372123.27000000107,360929.8300000008,11193.440000000293
18354,2022-06-19 16:30:00,-994.89,371128.38000000105,360929.8300000008,10198.55000000028
18355,2022-06-19 16:35:00,1234.49,372362.87000000104,360929.8300000008,11433.04000000027
18356,2022-06-19 16:40:00,66.31,372429.18000000104,360929.8300000008,11499.350000000268
18357,2022-06-19 16:45:00,745.5,373174.68000000104,360929.8300000008,12244.850000000268
18358,2022-06-19 16:50:00,-791.38,372383.30000000104,360929.8300000008,11453.470000000263
18359,2022-06-19 16:55:00,-1825.82,370557.48000000103,360929.8300000008,9627.650000000256
18360,2022-06-20 08:00:00,1382.05,371939.530000001,370557.48000000103,1382.0499999999884
18361,2022-06-20 08:05:00,-1331.0,370608.530000001,370557.48000000103,51.04999999998836
18362,2022-06-20 08:10:00,-58.56,370549.970000001,370557.48000000103,-7.510000000009313
18363,2022-06-20 08:15:00,-1028.01,369521.960000001,370557.48000000103,-1035.5200000000186
18364,2022-06-20 08:20:00,-988.48,368533.48000000103,370557.48000000103,-2024.0
18365,2022-06-20 08:25:00,-1131.92,367401.56000000105,370557.48000000103,-3155.9199999999837
18366,2022-06-20 08:30:00,300.84,367702.4000000011,370557.48000000103,-2855.079999999958
18367,2022-06-20 08:35:00,-33.35,367669.0500000011,370557.48000000103,-2888.429999999935
18368,2022-06-20 08:40:00,78.72,367747.77000000107,370557.48000000103,-2809.7099999999627
18369,2022-06-20 08:45:00,1011.55,368759.32000000105,370557.48000000103,-1798.1599999999744
18370,2022-06-20 08:50:00,633.44,369392.76000000106,370557.48000000103,-1164.719999999972
18371,2022-06-20 08:55:00,-1928.2,367464.56000000105,370557.48000000103,-3092.9199999999837
18372,2022-06-20 09:00:00,-1409.15,366055.410000001,370557.48000000103,-4502.070000000007
18373,2022-06-20 09:05:00,-103.17,365952.24000000104,370557.48000000103,-4605.239999999991
18374,2022-06-20 09:10:00,677.42,366629.660000001,370557.48000000103,-3927.820000000007
18375,2022-06-20 09:15:00,582.3,367211.960000001,370557.48000000103,-3345.5200000000186
18376,2022-06-20 09:20:00,1954.22,369166.180000001,370557.48000000103,-1391.3000000000466
18377,2022-06-20 09:25:00,-669.7,368496.480000001,370557.48000000103,-2061.000000000058
18378,2022-06-20 09:30:00,-1663.65,366832.83000000095,370557.48000000103,-3724.6500000000815
18379,2022-06-20 09:35:00,957.02,367789.85000000097,370557.48000000103,-2767.630000000063
18380,2022-06-20 09:40:00,970.34,368760.190000001,370557.48000000103,-1797.2900000000373
18381,2022-06-20 09:45:00,423.47,369183.66000000096,370557.48000000103,-1373.8200000000652
18382,2022-06-20 09:50:00,-52.94,369130.72000000096,370557.48000000103,-1426.7600000000675
18383,2022-06-20 09:55:00,-1810.55,367320.170000001,370557.48000000103,-3237.310000000056
18384,2022-06-20 10:00:00,1918.86,369239.03000000096,370557.48000000103,-1318.4500000000698
18385,2022-06-20 10:05:00,1472.14,370711.170000001,370557.48000000103,153.68999999994412
18386,2022-06-20 10:10:00,1524.2,372235.370000001,370557.48000000103,1677.8899999999558
18387,2022-06-20 10:15:00,-538.26,371697.110000001,370557.48000000103,1139.6299999999464
18388,2022-06-20 10:20:00,1419.51,373116.620000001,370557.48000000103,2559.1399999999558
18389,2022-06-20 10:25:00,-189.17,372927.450000001,370557.48000000103,2369.969999999972
18390,2022-06-20 10:30:00,-1414.04,371513.410000001,370557.48000000103,955.929999999993
18391,2022-06-20 10:35:00,1308.0,372821.410000001,370557.48000000103,2263.929999999993
18392,2022-06-20 10:40:00,-1460.19,371361.220000001,370557.48000000103,803.7399999999907
18393,2022-06-20 10:45:00,1890.3,373251.520000001,370557.48000000103,2694.039999999979
18394,2022-06-20 10:50:00,200.46,373451.98000000103,370557.48000000103,2894.5
18395,2022-06-20 10:55:00,853.88,374305.86000000103,370557.48000000103,3748.3800000000047
18396,2022-06-20 11:00:00,-1987.73,372318.13000000105,370557.48000000103,1760.6500000000233
18397,2022-06-20 11:05:00,1360.53,373678.6600000011,370557.48000000103,3121.180000000051
18398,2022-06-20 11:10:00,-1711.63,371967.0300000011,370557.48000000103,1409.5500000000466
18399,2022-06-20 11:15:00,1045.36,373012.39000000106,370557.48000000103,2454.9100000000326
18400,2022-06-20 11:20:00,1789.14,374801.5300000011,370557.48000000103,4244.050000000047
18401,2022-06-20 11:25:00,603.91,375405.44000000105,370557.48000000103,4847.960000000021
18402,2022-06-20 11:30:00,207.74,375613.18000000104,370557.48000000103,5055.700000000012
18403,2022-06-20 11:35:00,-1024.66,374588.52000000107,370557.48000000103,4031.0400000000373
18404,2022-06-20 11:40:00,-1042.99,373545.5300000011,370557.48000000103,2988.0500000000466
18405,2022-06-20 11:45:00,1120.46,374665.9900000011,370557.48000000103,4108.5100000000675
18406,2022-06-20 11:50:00,1915.62,376581.6100000011,370557.48000000103,6024.130000000063
18407,2022-06-20 11:55:00,-7.55,376574.0600000011,370557.48000000103,6016.5800000000745
18408,2022-06-20 12:00:00,473.0,377047.0600000011,370557.48000000103,6489.5800000000745
18409,2022-06-20 12:05:00,-1681.44,375365.6200000011,370557.48000000103,4808.140000000072
18410,2022-06-20 12:10:00,-1609.29,373756.3300000011,370557.48000000103,3198.850000000093
18411,2022-06-20 12:15:00,1735.98,375492.3100000011,370557.48000000103,4934.8300000000745
18412,2022-06-20 12:20:00,-903.32,374588.9900000011,370557.48000000103,4031.5100000000675
18413,2022-06-20 12:25:00,-231.78,374357.21000000107,370557.48000000103,3799.7300000000396
18414,2022-06-20 12:30:00,-1550.17,372807.0400000011,370557.48000000103,2249.560000000056
18415,2022-06-20 12:35:00,-662.52,372144.52000000107,370557.48000000103,1587.0400000000373
18416,2022-06-20 12:40:00,1319.0,373463.52000000107,370557.48000000103,2906.0400000000373
18417,2022-06-20 12:45:00,1154.52,374618.0400000011,370557.48000000103,4060.560000000056
18418,2022-06-20 12:50:00,-1796.13,372821.9100000011,370557.48000000103,2264.430000000051
18419,2022-06-20 12:55:00,1605.66,374427.57000000105,370557.48000000103,3870.0900000000256
18420,2022-06-20 13:00:00,73.11,374500.68000000104,370557.48000000103,3943.2000000000116
18421,2022-06-20 13:05:00,733.9,375234.58000000106,370557.48000000103,4677.100000000035
18422,2022-06-20 13:10:00,649.78,375884.3600000011,370557.48000000103,5326.880000000063
18423,2022-06-20 13:15:00,-946.57,374937.7900000011,370557.48000000103,4380.310000000056
18424,2022-06-20 13:20:00,-1400.53,373537.26000000106,370557.48000000103,2979.780000000028
18425,2022-06-20 13:25:00,-913.0,372624.26000000106,370557.48000000103,2066.780000000028
18426,2022-06-20 13:30:00,1360.84,373985.1000000011,370557.48000000103,3427.6200000000536
18427,2022-06-20 13:35:00,-917.39,373067.71000000107,370557.48000000103,2510.2300000000396
18428,2022-06-20 13:40:00,-1267.83,371799.88000000105,370557.48000000103,1242.4000000000233
18429,2022-06-20 13:45:00,1090.02,372889.9000000011,370557.48000000103,2332.420000000042
18430,2022-06-20 13:50:00,1104.21,373994.1100000011,370557.48000000103,3436.630000000063
18431,2022-06-20 13:55:00,-184.24,373809.8700000011,370557.48000000103,3252.390000000072
18432,2022-06-20 14:00:00,84.87,373894.7400000011,370557.48000000103,3337.2600000000675
18433,2022-06-20 14:05:00,-309.62,373585.1200000011,370557.48000000103,3027.640000000072
18434,2022-06-20 14:10:00,-625.0,372960.1200000011,370557.48000000103,2402.640000000072
18435,2022-06-20 14:15:00,1024.19,373984.3100000011,370557.48000000103,3426.8300000000745
18436,2022-06-20 14:20:00,-1660.36,372323.9500000011,370557.48000000103,1766.4700000000885
18437,2022-06-20 14:25:00,1433.6,373757.5500000011,370557.48000000103,3200.070000000065
18438,2022-06-20 14:30:00,-1028.89,372728.6600000011,370557.48000000103,2171.180000000051
18439,2022-06-20 14:35:00,825.44,373554.1000000011,370557.48000000103,2996.6200000000536
18440,2022-06-20 14:40:00,1915.3,375469.4000000011,370557.48000000103,4911.920000000042
18441,2022-06-20 14:45:00,770.74,376240.14000000106,370557.48000000103,5682.660000000033
18442,2022-06-20 14:50:00,1508.39,377748.5300000011,370557.48000000103,7191.050000000047
18443,2022-06-20 14:55:00,-682.43,377066.1000000011,370557.48000000103,6508.620000000054
18444,2022-06-20 15:00:00,-492.22,376573.8800000011,370557.48000000103,6016.4000000000815
18445,2022-06-20 15:05:00,-1826.59,374747.2900000011,370557.48000000103,4189.810000000056
18446,2022-06-20 15:10:00,-256.33,374490.96000000107,370557.48000000103,3933.4800000000396
18447,2022-06-20 15:15:00,701.07,375192.0300000011,370557.48000000103,4634.550000000047
18448,2022-06-20 15:20:00,643.35,375835.38000000105,370557.48000000103,5277.900000000023
18449,2022-06-20 15:25:00,630.59,376465.9700000011,370557.48000000103,5908.490000000049
18450,2022-06-20 15:30:00,-1119.11,375346.8600000011,370557.48000000103,4789.380000000063
18451,2022-06-20 15:35:00,431.74,375778.6000000011,370557.48000000103,5221.120000000054
18452,2022-06-20 15:40:00,1756.26,377534.8600000011,370557.48000000103,6977.380000000063
18453,2022-06-20 15:45:00,623.59,378158.4500000011,370557.48000000103,7600.9700000000885
18454,2022-06-20 15:50:00,-1327.23,376831.22000000114,370557.48000000103,6273.740000000107
18455,2022-06-20 15:55:00,836.6,377667.8200000011,370557.48000000103,7110.340000000084
18456,2022-06-20 16:00:00,-375.27,377292.5500000011,370557.48000000103,6735.070000000065
18457,2022-06-20 16:05:00,1525.97,378818.52000000107,370557.48000000103,8261.040000000037
18458,2022-06-20 16:10:00,1485.3,380303.82000000105,370557.48000000103,9746.340000000026
18459,2022-06-20 16:15:00,803.52,381107.3400000011,370557.48000000103,10549.860000000044
18460,2022-06-20 16:20:00,-1407.75,379699.5900000011,370557.48000000103,9142.110000000044
18461,2022-06-20 16:25:00,-400.22,379299.3700000011,370557.48000000103,8741.890000000072
18462,2022-06-20 16:30:00,1327.23,380626.6000000011,370557.48000000103,10069.120000000054
18463,2022-06-20 16:35:00,-122.78,380503.82000000105,370557.48000000103,9946.340000000026
18464,2022-06-20 16:40:00,-1100.28,379403.540000001,370557.48000000103,8846.059999999998
18465,2022-06-20 16:45:00,97.97,379501.510000001,370557.48000000103,8944.02999999997
18466,2022-06-20 16:50:00,821.56,380323.070000001,370557.48000000103,9765.589999999967
18467,2022-06-20 16:55:00,-1549.41,378773.660000001,370557.48000000103,8216.179999999993
18468,2022-06-21 08:00:00,1731.57,380505.23000000103,378773.660000001,1731.570000000007
18469,2022-06-21 08:05:00,1386.66,381891.890000001,378773.660000001,3118.2299999999814
18470,2022-06-21 08:10:00,-1206.93,380684.960000001,378773.660000001,1911.2999999999884
18471,2022-06-21 08:15:00,1605.16,382290.120000001,378773.660000001,3516.4599999999627
18472,2022-06-21 08:20:00,163.22,382453.34000000096,378773.660000001,3679.679999999935
18473,2022-06-21 08:25:00,-1387.12,381066.22000000096,378773.660000001,2292.5599999999395
18474,2022-06-21 08:30:00,1521.84,382588.060000001,378773.660000001,3814.399999999965
18475,2022-06-21 08:35:00,-968.2,381619.860000001,378773.660000001,2846.1999999999534
18476,2022-06-21 08:40:00,-1188.48,380431.380000001,378773.660000001,1657.719999999972
18477,2022-06-21 08:45:00,292.23,380723.610000001,378773.660000001,1949.9499999999534
18478,2022-06-21 08:50:00,1816.8,382540.41000000096,378773.660000001,3766.749999999942
18479,2022-06-21 08:55:00,1765.54,384305.95000000094,378773.660000001,5532.289999999921
18480,2022-06-21 09:00:00,311.39,384617.34000000096,378773.660000001,5843.679999999935
18481,2022-06-21 09:05:00,-1327.84,383289.50000000093,378773.660000001,4515.839999999909
18482,2022-06-21 09:10:00,633.64,383923.14000000095,378773.660000001,5149.479999999923
18483,2022-06-21 09:15:00,-1231.31,382691.83000000095,378773.660000001,3918.1699999999255
18484,2022-06-21 09:20:00,-1313.41,381378.420000001,378773.660000001,2604.759999999951
18485,2022-06-21 09:25:00,-1184.28,380194.14000000095,378773.660000001,1420.4799999999232
18486,2022-06-21 09:30:00,1607.68,381801.82000000094,378773.660000001,3028.159999999916
18487,2022-06-21 09:35:00,490.21,382292.03000000096,378773.660000001,3518.369999999937
18488,2022-06-21 09:40:00,-1860.57,380431.46000000095,378773.660000001,1657.7999999999302
18489,2022-06-21 09:45:00,-704.07,379727.39000000095,378773.660000001,953.7299999999232
18490,2022-06-21 09:50:00,-1750.85,377976.54000000097,378773.660000001,-797.1200000000536
18491,2022-06-21 09:55:00,1924.68,379901.22000000096,378773.660000001,1127.5599999999395
18492,2022-06-21 10:00:00,1398.88,381300.10000000097,378773.660000001,2526.439999999944
18493,2022-06-21 10:05:00,1597.69,382897.79000000097,378773.660000001,4124.129999999946
18494,2022-06-21 10:10:00,-244.37,382653.420000001,378773.660000001,3879.759999999951
18495,2022-06-21 10:15:00,-1152.55,381500.870000001,378773.660000001,2727.2099999999627
18496,2022-06-21 10:20:00,827.48,382328.35000000097,378773.660000001,3554.689999999944
18497,2022-06-21 10:25:00,-1443.91,380884.440000001,378773.660000001,2110.7799999999697
18498,2022-06-21 10:30:00,-1386.83,379497.610000001,378773.660000001,723.9499999999534
18499,2022-06-21 10:35:00,1433.47,380931.08000000095,378773.660000001,2157.4199999999255
18500,2022-06-21 10:40:00,274.32,381205.40000000095,378773.660000001,2431.7399999999325
18501,2022-06-21 10:45:00,937.32,382142.72000000096,378773.660000001,3369.0599999999395
18502,2022-06-21 10:50:00,-1929.93,380212.79000000097,378773.660000001,1439.1299999999464
18503,2022-06-21 10:55:00,1895.19,382107.980000001,378773.660000001,3334.319999999949
18504,2022-06-21 11:00:00,-1850.8,380257.180000001,378773.660000001,1483.5199999999604
18505,2022-06-21 11:05:00,549.45,380806.630000001,378773.660000001,2032.969999999972
18506,2022-06-21 11:10:00,1327.88,382134.510000001,378773.660000001,3360.8499999999767
18507,2022-06-21 11:15:00,-1149.3,380985.210000001,378773.660000001,2211.5499999999884
18508,2022-06-21 11:20:00,-543.46,380441.750000001,378773.660000001,1668.0899999999674
18509,2022-06-21 11:25:00,895.79,381337.54000000097,378773.660000001,2563.8799999999464
18510,2022-06-21 11:30:00,1708.87,383046.41000000096,378773.660000001,4272.749999999942
18511,2022-06-21 11:35:00,1122.14,384168.550000001,378773.660000001,5394.889999999956
18512,2022-06-21 11:40:00,-502.94,383665.610000001,378773.660000001,4891.949999999953
18513,2022-06-21 11:45:00,346.73,384012.34000000096,378773.660000001,5238.679999999935
18514,2022-06-21 11:50:00,-1496.56,382515.78000000096,378773.660000001,3742.119999999937
18515,2022-06-21 11:55:00,1563.81,384079.59000000096,378773.660000001,5305.929999999935
18516,2022-06-21 12:00:00,-1555.43,382524.16000000096,378773.660000001,3750.499999999942
18517,2022-06-21 12:05:00,-316.49,382207.670000001,378773.660000001,3434.009999999951
18518,2022-06-21 12:10:00,-1817.83,380389.84000000096,378773.660000001,1616.1799999999348
18519,2022-06-21 12:15:00,1104.93,381494.77000000095,378773.660000001,2721.109999999928
18520,2022-06-21 12:20:00,1096.95,382591.72000000096,378773.660000001,3818.0599999999395
18521,2022-06-21 12:25:00,1130.6,383722.32000000094,378773.660000001,4948.659999999916
18522,2022-06-21 12:30:00,-1699.62,382022.70000000094,378773.660000001,3249.039999999921
18523,2022-06-21 12:35:00,-950.01,381072.69000000093,378773.660000001,2299.0299999999115
18524,2022-06-21 12:40:00,748.45,381821.14000000095,378773.660000001,3047.479999999923
18525,2022-06-21 12:45:00,792.39,382613.53000000096,378773.660000001,3839.869999999937
18526,2022-06-21 12:50:00,595.85,383209.38000000094,378773.660000001,4435.719999999914
18527,2022-06-21 12:55:00,-1477.87,381731.51000000094,378773.660000001,2957.8499999999185
18528,2022-06-21 13:00:00,1313.46,383044.97000000096,378773.660000001,4271.3099999999395
18529,2022-06-21 13:05:00,-1051.88,381993.09000000096,378773.660000001,3219.429999999935
18530,2022-06-21 13:10:00,-1672.79,380320.300000001,378773.660000001,1546.6399999999558
18531,2022-06-21 13:15:00,-1284.35,379035.950000001,378773.660000001,262.28999999997905
18532,2022-06-21 13:20:00,-940.17,378095.780000001,378773.660000001,-677.8800000000047
18533,2022-06-21 13:25:00,1595.73,379691.510000001,378773.660000001,917.8499999999767
18534,2022-06-21 13:30:00,17.93,379709.440000001,378773.660000001,935.7799999999697
18535,2022-06-21 13:35:00,897.04,380606.480000001,378773.660000001,1832.8199999999488
18536,2022-06-21 13:40:00,-1976.71,378629.77000000095,378773.660000001,-143.89000000007218
18537,2022-06-21 13:45:00,-1807.41,376822.360000001,378773.660000001,-1951.3000000000466
18538,2022-06-21 13:50:00,-1423.41,375398.950000001,378773.660000001,-3374.710000000021
18539,2022-06-21 13:55:00,-533.52,374865.430000001,378773.660000001,-3908.2300000000396
18540,2022-06-21 14:00:00,444.62,375310.050000001,378773.660000001,-3463.6100000000442
18541,2022-06-21 14:05:00,1174.82,376484.870000001,378773.660000001,-2288.7900000000373
18542,2022-06-21 14:10:00,-546.8,375938.070000001,378773.660000001,-2835.5900000000256
18543,2022-06-21 14:15:00,-527.98,375410.090000001,378773.660000001,-3363.570000000007
18544,2022-06-21 14:20:00,1402.08,376812.17000000103,378773.660000001,-1961.4899999999907
18545,2022-06-21 14:25:00,1283.16,378095.330000001,378773.660000001,-678.3300000000163
18546,2022-06-21 14:30:00,-1317.42,376777.910000001,378773.660000001,-1995.75
18547,2022-06-21 14:35:00,-573.39,376204.520000001,378773.660000001,-2569.140000000014
18548,2022-06-21 14:40:00,-1400.8,374803.720000001,378773.660000001,-3969.9400000000023
18549,2022-06-21 14:45:00,249.59,375053.31000000105,378773.660000001,-3720.3499999999767
18550,2022-06-21 14:50:00,-1849.44,373203.87000000104,378773.660000001,-5569.789999999979
18551,2022-06-21 14:55:00,-1596.18,371607.69000000105,378773.660000001,-7165.969999999972
18552,2022-06-21 15:00:00,-633.27,370974.42000000103,378773.660000001,-7799.239999999991
18553,2022-06-21 15:05:00,-425.9,370548.520000001,378773.660000001,-8225.140000000014
18554,2022-06-21 15:10:00,-272.58,370275.940000001,378773.660000001,-8497.72000000003
18555,2022-06-21 15:15:00,1214.31,371490.250000001,378773.660000001,-7283.410000000033
18556,2022-06-21 15:20:00,-913.68,370576.570000001,378773.660000001,-8197.090000000026
18557,2022-06-21 15:25:00,-1857.83,368718.740000001,378773.660000001,-10054.920000000042
18558,2022-06-21 15:30:00,-131.69,368587.050000001,378773.660000001,-10186.610000000044
18559,2022-06-21 15:35:00,1117.93,369704.980000001,378773.660000001,-9068.680000000051
18560,2022-06-21 15:40:00,-1206.16,368498.820000001,378773.660000001,-10274.840000000026
18561,2022-06-21 15:45:00,-1198.52,367300.300000001,378773.660000001,-11473.360000000044
18562,2022-06-21 15:50:00,-1788.38,365511.920000001,378773.660000001,-13261.740000000049
18563,2022-06-21 15:55:00,1640.89,367152.810000001,378773.660000001,-11620.850000000035
18564,2022-06-21 16:00:00,-1344.76,365808.050000001,378773.660000001,-12965.610000000044
18565,2022-06-21 16:05:00,1308.01,367116.060000001,378773.660000001,-11657.600000000035
18566,2022-06-21 16:10:00,374.97,367491.03000000096,378773.660000001,-11282.630000000063
18567,2022-06-21 16:15:00,-1607.98,365883.050000001,378773.660000001,-12890.610000000044
18568,2022-06-21 16:20:00,-808.16,365074.890000001,378773.660000001,-13698.770000000019
18569,2022-06-21 16:25:00,224.69,365299.580000001,378773.660000001,-13474.080000000016
18570,2022-06-21 16:30:00,-1019.97,364279.61000000103,378773.660000001,-14494.049999999988
18571,2022-06-21 16:35:00,-667.59,363612.020000001,378773.660000001,-15161.640000000014
18572,2022-06-21 16:40:00,178.67,363790.690000001,378773.660000001,-14982.97000000003
18573,2022-06-21 16:45:00,89.07,363879.760000001,378773.660000001,-14893.900000000023
18574,2022-06-21 16:50:00,848.89,364728.650000001,378773.660000001,-14045.01000000001
18575,2022-06-21 16:55:00,1011.33,365739.98000000103,378773.660000001,-13033.679999999993
18576,2022-06-22 08:00:00,-1417.83,364322.150000001,365739.98000000103,-1417.8300000000163
18577,2022-06-22 08:05:00,1578.9,365901.05000000104,365739.98000000103,161.07000000000698
18578,2022-06-22 08:10:00,-1392.65,364508.400000001,365739.98000000103,-1231.5800000000163
18579,2022-06-22 08:15:00,1745.46,366253.86000000103,365739.98000000103,513.8800000000047
18580,2022-06-22 08:20:00,1643.58,367897.44000000105,365739.98000000103,2157.460000000021
18581,2022-06-22 08:25:00,1453.44,369350.88000000105,365739.98000000103,3610.9000000000233
18582,2022-06-22 08:30:00,1479.57,370830.45000000106,365739.98000000103,5090.47000000003
18583,2022-06-22 08:35:00,271.31,371101.76000000106,365739.98000000103,5361.780000000028
18584,2022-06-22 08:40:00,-986.04,370115.7200000011,365739.98000000103,4375.740000000049
18585,2022-06-22 08:45:00,802.08,370917.8000000011,365739.98000000103,5177.820000000065
18586,2022-06-22 08:50:00,589.56,371507.3600000011,365739.98000000103,5767.380000000063
18587,2022-06-22 08:55:00,-1060.02,370447.3400000011,365739.98000000103,4707.360000000044
18588,2022-06-22 09:00:00,1500.98,371948.32000000105,365739.98000000103,6208.340000000026
18589,2022-06-22 09:05:00,-161.82,371786.50000000105,365739.98000000103,6046.520000000019
18590,2022-06-22 09:10:00,693.84,372480.3400000011,365739.98000000103,6740.360000000044
18591,2022-06-22 09:15:00,643.08,373123.4200000011,365739.98000000103,7383.4400000000605
18592,2022-06-22 09:20:00,-1991.8,371131.6200000011,365739.98000000103,5391.640000000072
18593,2022-06-22 09:25:00,-1505.77,369625.8500000011,365739.98000000103,3885.8700000000536
18594,2022-06-22 09:30:00,-1065.22,368560.6300000011,365739.98000000103,2820.6500000000815
18595,2022-06-22 09:35:00,1056.94,369617.5700000011,365739.98000000103,3877.590000000084
18596,2022-06-22 09:40:00,-1086.8,368530.7700000011,365739.98000000103,2790.7900000000955
18597,2022-06-22 09:45:00,-1418.82,367111.9500000011,365739.98000000103,1371.9700000000885
18598,2022-06-22 09:50:00,-1537.07,365574.8800000011,365739.98000000103,-165.0999999999185
18599,2022-06-22 09:55:00,-692.9,364881.9800000011,365739.98000000103,-857.9999999999418
18600,2022-06-22 10:00:00,-1496.84,363385.14000000106,365739.98000000103,-2354.8399999999674
18601,2022-06-22 10:05:00,-1803.5,361581.64000000106,365739.98000000103,-4158.339999999967
18602,2022-06-22 10:10:00,-1772.83,359808.81000000105,365739.98000000103,-5931.169999999984
18603,2022-06-22 10:15:00,1142.54,360951.350000001,365739.98000000103,-4788.630000000005
18604,2022-06-22 10:20:00,604.64,361555.99000000104,365739.98000000103,-4183.989999999991
18605,2022-06-22 10:25:00,-626.04,360929.95000000106,365739.98000000103,-4810.02999999997
18606,2022-06-22 10:30:00,-1156.46,359773.49000000104,365739.98000000103,-5966.489999999991
18607,2022-06-22 10:35:00,1165.99,360939.48000000103,365739.98000000103,-4800.5
18608,2022-06-22 10:40:00,1924.74,362864.220000001,365739.98000000103,-2875.7600000000093
18609,2022-06-22 10:45:00,-466.04,362398.18000000104,365739.98000000103,-3341.7999999999884
18610,2022-06-22 10:50:00,1623.91,364022.090000001,365739.98000000103,-1717.890000000014
18611,2022-06-22 10:55:00,1948.61,365970.700000001,365739.98000000103,230.71999999997206
18612,2022-06-22 11:00:00,1228.79,367199.490000001,365739.98000000103,1459.509999999951
18613,2022-06-22 11:05:00,1986.61,369186.10000000097,365739.98000000103,3446.119999999937
18614,2022-06-22 11:10:00,-1653.22,367532.880000001,365739.98000000103,1792.899999999965
18615,2022-06-22 11:15:00,-1630.82,365902.060000001,365739.98000000103,162.0799999999581
18616,2022-06-22 11:20:00,-45.83,365856.230000001,365739.98000000103,116.24999999994179
18617,2022-06-22 11:25:00,-58.84,365797.39000000095,365739.98000000103,57.40999999991618
18618,2022-06-22 11:30:00,133.88,365931.27000000095,365739.98000000103,191.28999999992084
18619,2022-06-22 11:35:00,864.3,366795.57000000094,365739.98000000103,1055.5899999999092
18620,2022-06-22 11:40:00,-1182.94,365612.63000000094,365739.98000000103,-127.35000000009313
18621,2022-06-22 11:45:00,-325.95,365286.6800000009,365739.98000000103,-453.3000000001048
18622,2022-06-22 11:50:00,63.2,365349.88000000094,365739.98000000103,-390.10000000009313
18623,2022-06-22 11:55:00,-1724.47,363625.41000000096,365739.98000000103,-2114.570000000065
18624,2022-06-22 12:00:00,-1076.89,362548.52000000095,365739.98000000103,-3191.460000000079
18625,2022-06-22 12:05:00,1165.19,363713.71000000095,365739.98000000103,-2026.2700000000768
18626,2022-06-22 12:10:00,-1370.87,362342.84000000096,365739.98000000103,-3397.140000000072
18627,2022-06-22 12:15:00,-1462.31,360880.53000000096,365739.98000000103,-4859.45000000007
18628,2022-06-22 12:20:00,1327.74,362208.27000000095,365739.98000000103,-3531.710000000079
18629,2022-06-22 12:25:00,-884.27,361324.00000000093,365739.98000000103,-4415.980000000098
18630,2022-06-22 12:30:00,-1049.65,360274.3500000009,365739.98000000103,-5465.630000000121
18631,2022-06-22 12:35:00,-182.05,360092.3000000009,365739.98000000103,-5647.680000000109
18632,2022-06-22 12:40:00,-411.77,359680.5300000009,365739.98000000103,-6059.450000000128
18633,2022-06-22 12:45:00,1387.31,361067.8400000009,365739.98000000103,-4672.14000000013
18634,2022-06-22 12:50:00,859.76,361927.6000000009,365739.98000000103,-3812.380000000121
18635,2022-06-22 12:55:00,1617.56,363545.1600000009,365739.98000000103,-2194.8200000001234
18636,2022-06-22 13:00:00,1876.57,365421.7300000009,365739.98000000103,-318.2500000001164
18637,2022-06-22 13:05:00,-640.15,364781.5800000009,365739.98000000103,-958.4000000001397
18638,2022-06-22 13:10:00,394.62,365176.2000000009,365739.98000000103,-563.7800000001444
18639,2022-06-22 13:15:00,1886.96,367063.1600000009,365739.98000000103,1323.1799999998766
18640,2022-06-22 13:20:00,1923.93,368987.0900000009,365739.98000000103,3247.1099999998696
18641,2022-06-22 13:25:00,-403.96,368583.1300000009,365739.98000000103,2843.1499999998487
18642,2022-06-22 13:30:00,501.53,369084.6600000009,365739.98000000103,3344.6799999998766
18643,2022-06-22 13:35:00,-1101.5,367983.1600000009,365739.98000000103,2243.1799999998766
18644,2022-06-22 13:40:00,-173.94,367809.2200000009,365739.98000000103,2069.2399999998743
18645,2022-06-22 13:45:00,-1343.67,366465.5500000009,365739.98000000103,725.5699999998906
18646,2022-06-22 13:50:00,-623.06,365842.4900000009,365739.98000000103,102.5099999998929
18647,2022-06-22 13:55:00,1168.89,367011.38000000094,365739.98000000103,1271.3999999999069
18648,2022-06-22 14:00:00,-1421.42,365589.96000000095,365739.98000000103,-150.02000000007683
18649,2022-06-22 14:05:00,-1891.06,363698.90000000095,365739.98000000103,-2041.0800000000745
18650,2022-06-22 14:10:00,-111.03,363587.8700000009,365739.98000000103,-2152.1100000001024
18651,2022-06-22 14:15:00,-884.32,362703.5500000009,365739.98000000103,-3036.4300000001094
18652,2022-06-22 14:20:00,-813.5,361890.0500000009,365739.98000000103,-3849.9300000001094
18653,2022-06-22 14:25:00,1472.05,363362.1000000009,365739.98000000103,-2377.880000000121
18654,2022-06-22 14:30:00,1894.83,365256.9300000009,365739.98000000103,-483.0500000001048
18655,2022-06-22 14:35:00,1840.7,367097.63000000094,365739.98000000103,1357.6499999999069
18656,2022-06-22 14:40:00,-1185.74,365911.89000000095,365739.98000000103,171.90999999991618
18657,2022-06-22 14:45:00,-1668.19,364243.70000000094,365739.98000000103,-1496.2800000000861
18658,2022-06-22 14:50:00,1018.75,365262.45000000094,365739.98000000103,-477.53000000008615
18659,2022-06-22 14:55:00,-214.89,365047.5600000009,365739.98000000103,-692.4200000001001
18660,2022-06-22 15:00:00,-963.87,364083.69000000093,365739.98000000103,-1656.2900000000955
18661,2022-06-22 15:05:00,-643.94,363439.75000000093,365739.98000000103,-2300.230000000098
18662,2022-06-22 15:10:00,-1302.18,362137.57000000094,365739.98000000103,-3602.410000000091
18663,2022-06-22 15:15:00,1701.46,363839.03000000096,365739.98000000103,-1900.9500000000698
18664,2022-06-22 15:20:00,-479.52,363359.51000000094,365739.98000000103,-2380.4700000000885
18665,2022-06-22 15:25:00,-226.05,363133.46000000095,365739.98000000103,-2606.520000000077
18666,2022-06-22 15:30:00,1326.63,364460.09000000096,365739.98000000103,-1279.8900000000722
18667,2022-06-22 15:35:00,1497.27,365957.360000001,365739.98000000103,217.37999999994645
18668,2022-06-22 15:40:00,1527.16,367484.52000000095,365739.98000000103,1744.5399999999208
18669,2022-06-22 15:45:00,952.6,368437.1200000009,365739.98000000103,2697.1399999998976
18670,2022-06-22 15:50:00,-1772.51,366664.6100000009,365739.98000000103,924.6299999998882
18671,2022-06-22 15:55:00,1304.99,367969.6000000009,365739.98000000103,2229.619999999879
18672,2022-06-22 16:00:00,-1509.09,366460.5100000009,365739.98000000103,720.5299999998533
18673,2022-06-22 16:05:00,889.7,367350.2100000009,365739.98000000103,1610.229999999865
18674,2022-06-22 16:10:00,-738.69,366611.5200000009,365739.98000000103,871.5399999998626
18675,2022-06-22 16:15:00,411.98,367023.5000000009,365739.98000000103,1283.519999999844
18676,2022-06-22 16:20:00,-887.65,366135.85000000085,365739.98000000103,395.8699999998207
18677,2022-06-22 16:25:00,1464.14,367599.99000000086,365739.98000000103,1860.0099999998347
18678,2022-06-22 16:30:00,1883.41,369483.40000000084,365739.98000000103,3743.419999999809
18679,2022-06-22 16:35:00,-1331.44,368151.96000000084,365739.98000000103,2411.9799999998068
18680,2022-06-22 16:40:00,-1749.02,366402.9400000008,365739.98000000103,662.9599999997881
18681,2022-06-22 16:45:00,-1817.3,364585.6400000008,365739.98000000103,-1154.3400000002002
18682,2022-06-22 16:50:00,-946.15,363639.4900000008,365739.98000000103,-2100.4900000002235
18683,2022-06-22 16:55:00,1116.68,364756.1700000008,365739.98000000103,-983.8100000002305
18684,2022-06-23 08:00:00,-1760.11,362996.0600000008,364756.1700000008,-1760.109999999986
18685,2022-06-23 08:05:00,439.52,363435.58000000083,364756.1700000008,-1320.5899999999674
18686,2022-06-23 08:10:00,-1946.23,361489.35000000085,364756.1700000008,-3266.819999999949
18687,2022-06-23 08:15:00,769.29,362258.6400000008,364756.1700000008,-2497.5299999999697
18688,2022-06-23 08:20:00,1975.14,364233.78000000084,364756.1700000008,-522.3899999999558
18689,2022-06-23 08:25:00,-992.31,363241.47000000085,364756.1700000008,-1514.6999999999534
18690,2022-06-23 08:30:00,1702.66,364944.1300000008,364756.1700000008,187.96000000002095
18691,2022-06-23 08:35:00,-991.12,363953.0100000008,364756.1700000008,-803.1599999999744
18692,2022-06-23 08:40:00,-1614.72,362338.29000000085,364756.1700000008,-2417.8799999999464
18693,2022-06-23 08:45:00,1587.32,363925.61000000086,364756.1700000008,-830.5599999999395
18694,2022-06-23 08:50:00,-458.25,363467.36000000086,364756.1700000008,-1288.8099999999395
18695,2022-06-23 08:55:00,-672.48,362794.8800000009,364756.1700000008,-1961.2899999999208
18696,2022-06-23 09:00:00,1313.75,364108.6300000009,364756.1700000008,-647.5399999999208
18697,2022-06-23 09:05:00,-841.65,363266.98000000085,364756.1700000008,-1489.1899999999441
18698,2022-06-23 09:10:00,-1456.35,361810.6300000009,364756.1700000008,-2945.539999999921
18699,2022-06-23 09:15:00,201.61,362012.24000000086,364756.1700000008,-2743.929999999935
18700,2022-06-23 09:20:00,1519.92,363532.16000000085,364756.1700000008,-1224.009999999951
18701,2022-06-23 09:25:00,1367.76,364899.92000000086,364756.1700000008,143.7500000000582
18702,2022-06-23 09:30:00,1326.0,366225.92000000086,364756.1700000008,1469.7500000000582
18703,2022-06-23 09:35:00,-1673.4,364552.52000000083,364756.1700000008,-203.64999999996508
18704,2022-06-23 09:40:00,-1531.26,363021.2600000008,364756.1700000008,-1734.9099999999744
18705,2022-06-23 09:45:00,-224.09,362797.1700000008,364756.1700000008,-1959.0
18706,2022-06-23 09:50:00,736.78,363533.9500000008,364756.1700000008,-1222.219999999972
18707,2022-06-23 09:55:00,-697.08,362836.8700000008,364756.1700000008,-1919.2999999999884
18708,2022-06-23 10:00:00,-579.76,362257.1100000008,364756.1700000008,-2499.0599999999977
18709,2022-06-23 10:05:00,-1810.71,360446.4000000008,364756.1700000008,-4309.770000000019
18710,2022-06-23 10:10:00,-1505.8,358940.6000000008,364756.1700000008,-5815.570000000007
18711,2022-06-23 10:15:00,-664.13,358276.4700000008,364756.1700000008,-6479.700000000012
18712,2022-06-23 10:20:00,-1357.44,356919.0300000008,364756.1700000008,-7837.140000000014
18713,2022-06-23 10:25:00,1282.1,358201.13000000076,364756.1700000008,-6555.040000000037
18714,2022-06-23 10:30:00,726.75,358927.88000000076,364756.1700000008,-5828.290000000037
18715,2022-06-23 10:35:00,1281.8,360209.68000000075,364756.1700000008,-4546.490000000049
18716,2022-06-23 10:40:00,11.34,360221.0200000008,364756.1700000008,-4535.150000000023
18717,2022-06-23 10:45:00,-26.24,360194.7800000008,364756.1700000008,-4561.390000000014
18718,2022-06-23 10:50:00,687.53,360882.3100000008,364756.1700000008,-3873.859999999986
18719,2022-06-23 10:55:00,1079.84,361962.15000000084,364756.1700000008,-2794.0199999999604
18720,2022-06-23 11:00:00,-1990.06,359972.09000000084,364756.1700000008,-4784.079999999958
18721,2022-06-23 11:05:00,1694.97,361667.0600000008,364756.1700000008,-3089.109999999986
18722,2022-06-23 11:10:00,1096.37,362763.4300000008,364756.1700000008,-1992.7399999999907
18723,2022-06-23 11:15:00,716.11,363479.5400000008,364756.1700000008,-1276.6300000000047
18724,2022-06-23 11:20:00,209.47,363689.01000000077,364756.1700000008,-1067.1600000000326
18725,2022-06-23 11:25:00,945.52,364634.5300000008,364756.1700000008,-121.64000000001397
18726,2022-06-23 11:30:00,-165.35,364469.1800000008,364756.1700000008,-286.9899999999907
18727,2022-06-23 11:35:00,-1334.03,363135.1500000008,364756.1700000008,-1621.0200000000186
18728,2022-06-23 11:40:00,-1450.01,361685.14000000077,364756.1700000008,-3071.030000000028
18729,2022-06-23 11:45:00,-1167.78,360517.36000000074,364756.1700000008,-4238.810000000056
18730,2022-06-23 11:50:00,-1895.0,358622.36000000074,364756.1700000008,-6133.810000000056
18731,2022-06-23 11:55:00,1107.61,359729.9700000007,364756.1700000008,-5026.20000000007
18732,2022-06-23 12:00:00,198.31,359928.2800000007,364756.1700000008,-4827.890000000072
18733,2022-06-23 12:05:00,-1493.98,358434.30000000075,364756.1700000008,-6321.870000000054
18734,2022-06-23 12:10:00,1783.04,360217.3400000007,364756.1700000008,-4538.8300000000745
18735,2022-06-23 12:15:00,1158.16,361375.5000000007,364756.1700000008,-3380.6700000001
18736,2022-06-23 12:20:00,-1322.36,360053.1400000007,364756.1700000008,-4703.030000000086
18737,2022-06-23 12:25:00,-721.2,359331.9400000007,364756.1700000008,-5424.230000000098
18738,2022-06-23 12:30:00,1454.83,360786.7700000007,364756.1700000008,-3969.4000000000815
18739,2022-06-23 12:35:00,1229.53,362016.30000000075,364756.1700000008,-2739.8700000000536
18740,2022-06-23 12:40:00,-1195.08,360821.2200000007,364756.1700000008,-3934.95000000007
18741,2022-06-23 12:45:00,-119.59,360701.6300000007,364756.1700000008,-4054.5400000000955
18742,2022-06-23 12:50:00,-866.11,359835.5200000007,364756.1700000008,-4920.6500000000815
18743,2022-06-23 12:55:00,-1857.48,357978.04000000074,364756.1700000008,-6778.130000000063
18744,2022-06-23 13:00:00,-1553.67,356424.37000000075,364756.1700000008,-8331.800000000047
18745,2022-06-23 13:05:00,-895.61,355528.76000000077,364756.1700000008,-9227.410000000033
18746,2022-06-23 13:10:00,-1172.81,354355.95000000077,364756.1700000008,-10400.22000000003
18747,2022-06-23 13:15:00,1002.22,355358.17000000074,364756.1700000008,-9398.000000000058
18748,2022-06-23 13:20:00,-484.24,354873.93000000075,364756.1700000008,-9882.240000000049
18749,2022-06-23 13:25:00,-796.32,354077.61000000074,364756.1700000008,-10678.560000000056
18750,2022-06-23 13:30:00,-1307.74,352769.87000000075,364756.1700000008,-11986.300000000047
18751,2022-06-23 13:35:00,295.68,353065.55000000075,364756.1700000008,-11690.620000000054
18752,2022-06-23 13:40:00,-1045.99,352019.56000000075,364756.1700000008,-12736.610000000044
18753,2022-06-23 13:45:00,1367.7,353387.26000000077,364756.1700000008,-11368.910000000033
18754,2022-06-23 13:50:00,1425.77,354813.0300000008,364756.1700000008,-9943.140000000014
18755,2022-06-23 13:55:00,-1682.11,353130.9200000008,364756.1700000008,-11625.25
18756,2022-06-23 14:00:00,146.57,353277.4900000008,364756.1700000008,-11478.679999999993
18757,2022-06-23 14:05:00,1236.5,354513.9900000008,364756.1700000008,-10242.179999999993
18758,2022-06-23 14:10:00,-1264.42,353249.5700000008,364756.1700000008,-11506.599999999977
18759,2022-06-23 14:15:00,-548.84,352700.7300000008,364756.1700000008,-12055.440000000002
18760,2022-06-23 14:20:00,1727.38,354428.1100000008,364756.1700000008,-10328.059999999998
18761,2022-06-23 14:25:00,1895.42,356323.5300000008,364756.1700000008,-8432.640000000014
18762,2022-06-23 14:30:00,793.27,357116.8000000008,364756.1700000008,-7639.369999999995
18763,2022-06-23 14:35:00,1889.32,359006.1200000008,364756.1700000008,-5750.049999999988
18764,2022-06-23 14:40:00,-96.38,358909.7400000008,364756.1700000008,-5846.429999999993
18765,2022-06-23 14:45:00,298.58,359208.3200000008,364756.1700000008,-5547.849999999977
18766,2022-06-23 14:50:00,-758.66,358449.66000000085,364756.1700000008,-6306.509999999951
18767,2022-06-23 14:55:00,-1831.51,356618.15000000084,364756.1700000008,-8138.01999999996
18768,2022-06-23 15:00:00,1384.94,358003.09000000084,364756.1700000008,-6753.079999999958
18769,2022-06-23 15:05:00,1942.23,359945.3200000008,364756.1700000008,-4810.849999999977
18770,2022-06-23 15:10:00,1549.43,361494.7500000008,364756.1700000008,-3261.4199999999837
18771,2022-06-23 15:15:00,-759.02,360735.7300000008,364756.1700000008,-4020.4400000000023
18772,2022-06-23 15:20:00,-75.34,360660.39000000077,364756.1700000008,-4095.780000000028
18773,2022-06-23 15:25:00,-730.68,359929.7100000008,364756.1700000008,-4826.460000000021
18774,2022-06-23 15:30:00,-1006.27,358923.44000000076,364756.1700000008,-5832.73000000004
18775,2022-06-23 15:35:00,-1836.66,357086.7800000008,364756.1700000008,-7669.390000000014
18776,2022-06-23 15:40:00,-1274.74,355812.0400000008,364756.1700000008,-8944.130000000005
18777,2022-06-23 15:45:00,81.13,355893.1700000008,364756.1700000008,-8863.0
18778,2022-06-23 15:50:00,-1295.31,354597.8600000008,364756.1700000008,-10158.309999999998
18779,2022-06-23 15:55:00,590.09,355187.9500000008,364756.1700000008,-9568.219999999972
18780,2022-06-23 16:00:00,1267.76,356455.71000000084,364756.1700000008,-8300.459999999963
18781,2022-06-23 16:05:00,1986.35,358442.0600000008,364756.1700000008,-6314.109999999986
18782,2022-06-23 16:10:00,610.67,359052.7300000008,364756.1700000008,-5703.440000000002
18783,2022-06-23 16:15:00,1186.14,360238.8700000008,364756.1700000008,-4517.299999999988
18784,2022-06-23 16:20:00,-619.56,359619.3100000008,364756.1700000008,-5136.859999999986
18785,2022-06-23 16:25:00,-1867.6,357751.71000000084,364756.1700000008,-7004.459999999963
18786,2022-06-23 16:30:00,-1788.95,355962.7600000008,364756.1700000008,-8793.409999999974
18787,2022-06-23 16:35:00,-1320.19,354642.5700000008,364756.1700000008,-10113.599999999977
18788,2022-06-23 16:40:00,25.08,354667.65000000084,364756.1700000008,-10088.51999999996
18789,2022-06-23 16:45:00,-1169.89,353497.7600000008,364756.1700000008,-11258.409999999974
18790,2022-06-23 16:50:00,100.08,353597.84000000084,364756.1700000008,-11158.329999999958
18791,2022-06-23 16:55:00,732.1,354329.9400000008,364756.1700000008,-10426.229999999981
18792,2022-06-24 08:00:00,-943.09,353386.8500000008,354329.9400000008,-943.0900000000256
18793,2022-06-24 08:05:00,824.65,354211.5000000008,354329.9400000008,-118.44000000000233
18794,2022-06-24 08:10:00,-286.7,353924.8000000008,354329.9400000008,-405.14000000001397
18795,2022-06-24 08:15:00,1474.06,355398.8600000008,354329.9400000008,1068.9199999999837
18796,2022-06-24 08:20:00,1858.3,357257.1600000008,354329.9400000008,2927.219999999972
18797,2022-06-24 08:25:00,1340.32,358597.4800000008,354329.9400000008,4267.539999999979
18798,2022-06-24 08:30:00,394.61,358992.0900000008,354329.9400000008,4662.149999999965
18799,2022-06-24 08:35:00,-997.25,357994.8400000008,354329.9400000008,3664.899999999965
18800,2022-06-24 08:40:00,-831.56,357163.2800000008,354329.9400000008,2833.3399999999674
18801,2022-06-24 08:45:00,-1547.18,355616.1000000008,354329.9400000008,1286.1599999999744
18802,2022-06-24 08:50:00,-1890.31,353725.7900000008,354329.9400000008,-604.1500000000233
18803,2022-06-24 08:55:00,-370.88,353354.9100000008,354329.9400000008,-975.0300000000279
18804,2022-06-24 09:00:00,61.87,353416.7800000008,354329.9400000008,-913.1600000000326
18805,2022-06-24 09:05:00,92.97,353509.75000000076,354329.9400000008,-820.1900000000605
18806,2022-06-24 09:10:00,1339.18,354848.93000000075,354329.9400000008,518.9899999999325
18807,2022-06-24 09:15:00,-1188.89,353660.04000000074,354329.9400000008,-669.9000000000815
18808,2022-06-24 09:20:00,-1290.08,352369.9600000007,354329.9400000008,-1959.9800000000978
18809,2022-06-24 09:25:00,521.29,352891.2500000007,354329.9400000008,-1438.6900000001187
18810,2022-06-24 09:30:00,-1161.1,351730.1500000007,354329.9400000008,-2599.7900000000955
18811,2022-06-24 09:35:00,1931.66,353661.8100000007,354329.9400000008,-668.1300000001211
18812,2022-06-24 09:40:00,-1867.53,351794.28000000067,354329.9400000008,-2535.660000000149
18813,2022-06-24 09:45:00,1516.36,353310.64000000065,354329.9400000008,-1019.300000000163
18814,2022-06-24 09:50:00,1589.54,354900.18000000063,354329.9400000008,570.2399999998161
18815,2022-06-24 09:55:00,607.9,355508.08000000066,354329.9400000008,1178.1399999998393
18816,2022-06-24 10:00:00,-1655.81,353852.27000000066,354329.9400000008,-477.6700000001583
18817,2022-06-24 10:05:00,1245.39,355097.6600000007,354329.9400000008,767.7199999998556
18818,2022-06-24 10:10:00,1479.21,356576.8700000007,354329.9400000008,2246.9299999998766
18819,2022-06-24 10:15:00,1388.87,357965.7400000007,354329.9400000008,3635.799999999872
18820,2022-06-24 10:20:00,-515.93,357449.8100000007,354329.9400000008,3119.869999999879
18821,2022-06-24 10:25:00,-712.03,356737.78000000067,354329.9400000008,2407.839999999851
18822,2022-06-24 10:30:00,-218.88,356518.90000000066,354329.9400000008,2188.9599999998463
18823,2022-06-24 10:35:00,-1228.59,355290.31000000064,354329.9400000008,960.3699999998207
18824,2022-06-24 10:40:00,-1701.56,353588.75000000064,354329.9400000008,-741.190000000177
18825,2022-06-24 10:45:00,-70.73,353518.02000000066,354329.9400000008,-811.9200000001583
18826,2022-06-24 10:50:00,-1855.85,351662.1700000007,354329.9400000008,-2667.770000000135
18827,2022-06-24 10:55:00,-83.09,351579.08000000066,354329.9400000008,-2750.8600000001607
18828,2022-06-24 11:00:00,1405.51,352984.59000000067,354329.9400000008,-1345.3500000001513
18829,2022-06-24 11:05:00,531.47,353516.06000000064,354329.9400000008,-813.8800000001793
18830,2022-06-24 11:10:00,-1899.66,351616.40000000066,354329.9400000008,-2713.5400000001537
18831,2022-06-24 11:15:00,-1196.52,350419.88000000064,354329.9400000008,-3910.0600000001723
18832,2022-06-24 11:20:00,-1891.99,348527.89000000065,354329.9400000008,-5802.050000000163
18833,2022-06-24 11:25:00,-1878.7,346649.19000000064,354329.9400000008,-7680.750000000175
18834,2022-06-24 11:30:00,-92.97,346556.22000000067,354329.9400000008,-7773.720000000147
18835,2022-06-24 11:35:00,816.98,347373.20000000065,354329.9400000008,-6956.740000000165
18836,2022-06-24 11:40:00,-95.22,347277.9800000007,354329.9400000008,-7051.960000000137
18837,2022-06-24 11:45:00,610.88,347888.8600000007,354329.9400000008,-6441.080000000133
18838,2022-06-24 11:50:00,1501.63,349390.4900000007,354329.9400000008,-4939.450000000128
18839,2022-06-24 11:55:00,1232.15,350622.6400000007,354329.9400000008,-3707.300000000105
18840,2022-06-24 12:00:00,-443.94,350178.7000000007,354329.9400000008,-4151.240000000107
18841,2022-06-24 12:05:00,-1729.13,348449.5700000007,354329.9400000008,-5880.370000000112
18842,2022-06-24 12:10:00,-949.44,347500.1300000007,354329.9400000008,-6829.810000000114
18843,2022-06-24 12:15:00,-744.87,346755.2600000007,354329.9400000008,-7574.680000000109
18844,2022-06-24 12:20:00,-800.51,345954.7500000007,354329.9400000008,-8375.190000000119
18845,2022-06-24 12:25:00,-747.18,345207.5700000007,354329.9400000008,-9122.370000000112
18846,2022-06-24 12:30:00,661.81,345869.3800000007,354329.9400000008,-8460.560000000114
18847,2022-06-24 12:35:00,1877.47,347746.8500000007,354329.9400000008,-6583.090000000142
18848,2022-06-24 12:40:00,-52.39,347694.46000000066,354329.9400000008,-6635.480000000156
18849,2022-06-24 12:45:00,-479.54,347214.9200000007,354329.9400000008,-7115.020000000135
18850,2022-06-24 12:50:00,1172.39,348387.3100000007,354329.9400000008,-5942.630000000121
18851,2022-06-24 12:55:00,1585.17,349972.4800000007,354329.9400000008,-4357.460000000137
18852,2022-06-24 13:00:00,1428.66,351401.14000000065,354329.9400000008,-2928.800000000163
18853,2022-06-24 13:05:00,-1923.2,349477.94000000064,354329.9400000008,-4852.000000000175
18854,2022-06-24 13:10:00,-1800.31,347677.63000000064,354329.9400000008,-6652.310000000172
18855,2022-06-24 13:15:00,1110.92,348788.5500000006,354329.9400000008,-5541.390000000189
18856,2022-06-24 13:20:00,371.57,349160.12000000064,354329.9400000008,-5169.820000000182
18857,2022-06-24 13:25:00,358.08,349518.20000000065,354329.9400000008,-4811.740000000165
18858,2022-06-24 13:30:00,1844.37,351362.57000000065,354329.9400000008,-2967.37000000017
18859,2022-06-24 13:35:00,1199.85,352562.4200000006,354329.9400000008,-1767.5200000001932
18860,2022-06-24 13:40:00,-539.36,352023.06000000064,354329.9400000008,-2306.8800000001793
18861,2022-06-24 13:45:00,-1285.99,350737.07000000065,354329.9400000008,-3592.87000000017
18862,2022-06-24 13:50:00,1714.12,352451.19000000064,354329.9400000008,-1878.7500000001746
18863,2022-06-24 13:55:00,-1208.79,351242.40000000066,354329.9400000008,-3087.5400000001537
18864,2022-06-24 14:00:00,1706.55,352948.95000000065,354329.9400000008,-1380.9900000001653
18865,2022-06-24 14:05:00,1325.92,354274.87000000064,354329.9400000008,-55.07000000018161
18866,2022-06-24 14:10:00,1361.72,355636.5900000006,354329.9400000008,1306.6499999997905
18867,2022-06-24 14:15:00,473.69,356110.2800000006,354329.9400000008,1780.3399999997928
18868,2022-06-24 14:20:00,-1082.75,355027.5300000006,354329.9400000008,697.5899999997928
18869,2022-06-24 14:25:00,-411.37,354616.1600000006,354329.9400000008,286.21999999979744
18870,2022-06-24 14:30:00,1597.75,356213.9100000006,354329.9400000008,1883.9699999997974
18871,2022-06-24 14:35:00,-1261.05,354952.8600000006,354329.9400000008,622.9199999998091
18872,2022-06-24 14:40:00,1349.27,356302.13000000064,354329.9400000008,1972.1899999998277
18873,2022-06-24 14:45:00,427.86,356729.99000000063,354329.9400000008,2400.0499999998137
18874,2022-06-24 14:50:00,437.02,357167.01000000065,354329.9400000008,2837.0699999998324
18875,2022-06-24 14:55:00,887.1,358054.1100000006,354329.9400000008,3724.169999999809
18876,2022-06-24 15:00:00,1104.31,359158.4200000006,354329.9400000008,4828.479999999807
18877,2022-06-24 15:05:00,-1162.4,357996.0200000006,354329.9400000008,3666.0799999997835
18878,2022-06-24 15:10:00,1374.24,359370.2600000006,354329.9400000008,5040.319999999774
18879,2022-06-24 15:15:00,1171.73,360541.9900000006,354329.9400000008,6212.0499999997555
18880,2022-06-24 15:20:00,618.12,361160.11000000057,354329.9400000008,6830.169999999751
18881,2022-06-24 15:25:00,-1484.47,359675.6400000006,354329.9400000008,5345.699999999779
18882,2022-06-24 15:30:00,404.48,360080.1200000006,354329.9400000008,5750.17999999976
18883,2022-06-24 15:35:00,-1896.25,358183.8700000006,354329.9400000008,3853.92999999976
18884,2022-06-24 15:40:00,182.01,358365.8800000006,354329.9400000008,4035.9399999997695
18885,2022-06-24 15:45:00,-518.79,357847.0900000006,354329.9400000008,3517.1499999997905
18886,2022-06-24 15:50:00,1474.8,359321.8900000006,354329.9400000008,4991.949999999779
18887,2022-06-24 15:55:00,1438.61,360760.5000000006,354329.9400000008,6430.559999999765
18888,2022-06-24 16:00:00,-1289.61,359470.8900000006,354329.9400000008,5140.949999999779
18889,2022-06-24 16:05:00,1997.22,361468.11000000057,354329.9400000008,7138.169999999751
18890,2022-06-24 16:10:00,1459.41,362927.52000000054,354329.9400000008,8597.579999999725
18891,2022-06-24 16:15:00,528.33,363455.85000000056,354329.9400000008,9125.909999999742
18892,2022-06-24 16:20:00,-474.93,362980.92000000057,354329.9400000008,8650.979999999749
18893,2022-06-24 16:25:00,-1563.09,361417.83000000054,354329.9400000008,7087.889999999723
18894,2022-06-24 16:30:00,413.62,361831.45000000054,354329.9400000008,7501.509999999718
18895,2022-06-24 16:35:00,-795.03,361036.4200000005,354329.9400000008,6706.47999999969
18896,2022-06-24 16:40:00,28.54,361064.9600000005,354329.9400000008,6735.019999999669
18897,2022-06-24 16:45:00,-1882.41,359182.5500000005,354329.9400000008,4852.609999999695
18898,2022-06-24 16:50:00,-1547.62,357634.9300000005,354329.9400000008,3304.9899999996996
18899,2022-06-24 16:55:00,-1931.36,355703.57000000053,354329.9400000008,1373.6299999997136
18900,2022-06-25 08:00:00,1798.78,357502.35000000056,355703.57000000053,1798.780000000028
18901,2022-06-25 08:05:00,48.31,357550.66000000056,355703.57000000053,1847.0900000000256
18902,2022-06-25 08:10:00,-106.48,357444.1800000006,355703.57000000053,1740.6100000000442
18903,2022-06-25 08:15:00,1453.32,358897.5000000006,355703.57000000053,3193.930000000051
18904,2022-06-25 08:20:00,1678.94,360576.4400000006,355703.57000000053,4872.870000000054
18905,2022-06-25 08:25:00,1041.56,361618.0000000006,355703.57000000053,5914.430000000051
18906,2022-06-25 08:30:00,-965.0,360653.0000000006,355703.57000000053,4949.430000000051
18907,2022-06-25 08:35:00,591.05,361244.05000000057,355703.57000000053,5540.48000000004
18908,2022-06-25 08:40:00,-1924.36,359319.6900000006,355703.57000000053,3616.1200000000536
18909,2022-06-25 08:45:00,1898.6,361218.29000000056,355703.57000000053,5514.72000000003
18910,2022-06-25 08:50:00,-637.38,360580.91000000056,355703.57000000053,4877.340000000026
18911,2022-06-25 08:55:00,553.09,361134.0000000006,355703.57000000053,5430.430000000051
18912,2022-06-25 09:00:00,-1739.11,359394.8900000006,355703.57000000053,3691.320000000065
18913,2022-06-25 09:05:00,-1704.3,357690.5900000006,355703.57000000053,1987.0200000000768
18914,2022-06-25 09:10:00,-1095.03,356595.5600000006,355703.57000000053,891.9900000000489
18915,2022-06-25 09:15:00,-1538.84,355056.72000000055,355703.57000000053,-646.8499999999767
18916,2022-06-25 09:20:00,514.34,355571.0600000006,355703.57000000053,-132.5099999999511
18917,2022-06-25 09:25:00,84.41,355655.47000000055,355703.57000000053,-48.09999999997672
18918,2022-06-25 09:30:00,-99.22,355556.2500000006,355703.57000000053,-147.31999999994878
18919,2022-06-25 09:35:00,1470.37,357026.6200000006,355703.57000000053,1323.0500000000466
18920,2022-06-25 09:40:00,1741.02,358767.6400000006,355703.57000000053,3064.070000000065
18921,2022-06-25 09:45:00,-1330.01,357437.6300000006,355703.57000000053,1734.0600000000559
18922,2022-06-25 09:50:00,993.44,358431.0700000006,355703.57000000053,2727.500000000058
18923,2022-06-25 09:55:00,-206.11,358224.9600000006,355703.57000000053,2521.390000000072
18924,2022-06-25 10:00:00,1836.09,360061.0500000006,355703.57000000053,4357.480000000098
18925,2022-06-25 10:05:00,694.4,360755.45000000065,355703.57000000053,5051.880000000121
18926,2022-06-25 10:10:00,1996.26,362751.71000000066,355703.57000000053,7048.14000000013
18927,2022-06-25 10:15:00,390.42,363142.13000000064,355703.57000000053,7438.560000000114
18928,2022-06-25 10:20:00,-509.18,362632.95000000065,355703.57000000053,6929.380000000121
18929,2022-06-25 10:25:00,1673.61,364306.56000000064,355703.57000000053,8602.990000000107
18930,2022-06-25 10:30:00,1841.38,366147.94000000064,355703.57000000053,10444.370000000112
18931,2022-06-25 10:35:00,1514.34,367662.28000000067,355703.57000000053,11958.710000000137
18932,2022-06-25 10:40:00,-599.4,367062.88000000064,355703.57000000053,11359.310000000114
18933,2022-06-25 10:45:00,1715.03,368777.9100000007,355703.57000000053,13074.340000000142
18934,2022-06-25 10:50:00,293.76,369071.6700000007,355703.57000000053,13368.100000000151
18935,2022-06-25 10:55:00,305.49,369377.1600000007,355703.57000000053,13673.590000000142
18936,2022-06-25 11:00:00,707.21,370084.3700000007,355703.57000000053,14380.800000000163
18937,2022-06-25 11:05:00,-920.24,369164.1300000007,355703.57000000053,13460.560000000172
18938,2022-06-25 11:10:00,-35.71,369128.4200000007,355703.57000000053,13424.850000000151
18939,2022-06-25 11:15:00,1952.0,371080.4200000007,355703.57000000053,15376.850000000151
18940,2022-06-25 11:20:00,-85.05,370995.3700000007,355703.57000000053,15291.800000000163
18941,2022-06-25 11:25:00,40.7,371036.0700000007,355703.57000000053,15332.500000000175
18942,2022-06-25 11:30:00,624.8,371660.8700000007,355703.57000000053,15957.300000000163
18943,2022-06-25 11:35:00,-448.36,371212.5100000007,355703.57000000053,15508.940000000177
18944,2022-06-25 11:40:00,1064.75,372277.2600000007,355703.57000000053,16573.690000000177
18945,2022-06-25 11:45:00,-1863.57,370413.6900000007,355703.57000000053,14710.12000000017
18946,2022-06-25 11:50:00,1317.46,371731.1500000007,355703.57000000053,16027.580000000191
18947,2022-06-25 11:55:00,1572.27,373303.42000000074,355703.57000000053,17599.85000000021
18948,2022-06-25 12:00:00,1387.46,374690.88000000076,355703.57000000053,18987.31000000023
18949,2022-06-25 12:05:00,-1348.64,373342.24000000075,355703.57000000053,17638.670000000217
18950,2022-06-25 12:10:00,-1703.48,371638.76000000077,355703.57000000053,15935.190000000235
18951,2022-06-25 12:15:00,-89.2,371549.56000000075,355703.57000000053,15845.990000000224
18952,2022-06-25 12:20:00,806.59,372356.1500000008,355703.57000000053,16652.58000000025
18953,2022-06-25 12:25:00,-763.27,371592.88000000076,355703.57000000053,15889.31000000023
18954,2022-06-25 12:30:00,1726.15,373319.0300000008,355703.57000000053,17615.460000000254
18955,2022-06-25 12:35:00,-446.28,372872.75000000076,355703.57000000053,17169.180000000226
18956,2022-06-25 12:40:00,535.53,373408.2800000008,355703.57000000053,17704.710000000254
18957,2022-06-25 12:45:00,1727.35,375135.63000000076,355703.57000000053,19432.06000000023
18958,2022-06-25 12:50:00,-910.9,374224.73000000074,355703.57000000053,18521.160000000207
18959,2022-06-25 12:55:00,-1957.6,372267.13000000076,355703.57000000053,16563.56000000023
18960,2022-06-25 13:00:00,1033.87,373301.00000000076,355703.57000000053,17597.430000000226
18961,2022-06-25 13:05:00,258.51,373559.51000000077,355703.57000000053,17855.940000000235
18962,2022-06-25 13:10:00,1311.73,374871.24000000075,355703.57000000053,19167.670000000217
18963,2022-06-25 13:15:00,-1729.25,373141.99000000075,355703.57000000053,17438.420000000217
18964,2022-06-25 13:20:00,1620.24,374762.23000000074,355703.57000000053,19058.660000000207
18965,2022-06-25 13:25:00,-878.61,373883.62000000075,355703.57000000053,18180.05000000022
18966,2022-06-25 13:30:00,1551.44,375435.06000000075,355703.57000000053,19731.490000000224
18967,2022-06-25 13:35:00,1271.74,376706.80000000075,355703.57000000053,21003.230000000214
18968,2022-06-25 13:40:00,287.54,376994.3400000007,355703.57000000053,21290.770000000193
18969,2022-06-25 13:45:00,11.94,377006.2800000007,355703.57000000053,21302.710000000196
18970,2022-06-25 13:50:00,-103.63,376902.6500000007,355703.57000000053,21199.08000000019
18971,2022-06-25 13:55:00,844.45,377747.10000000073,355703.57000000053,22043.530000000203
18972,2022-06-25 14:00:00,-1551.55,376195.55000000075,355703.57000000053,20491.980000000214
18973,2022-06-25 14:05:00,-122.14,376073.41000000073,355703.57000000053,20369.8400000002
18974,2022-06-25 14:10:00,699.27,376772.68000000075,355703.57000000053,21069.11000000022
18975,2022-06-25 14:15:00,1377.01,378149.69000000076,355703.57000000053,22446.120000000228
18976,2022-06-25 14:20:00,-1323.44,376826.25000000076,355703.57000000053,21122.680000000226
18977,2022-06-25 14:25:00,-1995.64,374830.61000000074,355703.57000000053,19127.040000000212
18978,2022-06-25 14:30:00,-1885.14,372945.4700000007,355703.57000000053,17241.900000000198
18979,2022-06-25 14:35:00,628.72,373574.1900000007,355703.57000000053,17870.62000000017
18980,2022-06-25 14:40:00,1155.85,374730.0400000007,355703.57000000053,19026.470000000147
18981,2022-06-25 14:45:00,-700.96,374029.08000000066,355703.57000000053,18325.510000000126
18982,2022-06-25 14:50:00,-1451.33,372577.75000000064,355703.57000000053,16874.18000000011
18983,2022-06-25 14:55:00,-924.39,371653.3600000006,355703.57000000053,15949.790000000095
18984,2022-06-25 15:00:00,-291.64,371361.7200000006,355703.57000000053,15658.150000000081
18985,2022-06-25 15:05:00,1542.3,372904.0200000006,355703.57000000053,17200.45000000007
18986,2022-06-25 15:10:00,127.92,373031.9400000006,355703.57000000053,17328.370000000054
18987,2022-06-25 15:15:00,594.42,373626.36000000057,355703.57000000053,17922.790000000037
18988,2022-06-25 15:20:00,1782.65,375409.0100000006,355703.57000000053,19705.44000000006
18989,2022-06-25 15:25:00,-1987.2,373421.8100000006,355703.57000000053,17718.24000000005
18990,2022-06-25 15:30:00,-951.82,372469.9900000006,355703.57000000053,16766.420000000042
18991,2022-06-25 15:35:00,-554.91,371915.0800000006,355703.57000000053,16211.510000000068
18992,2022-06-25 15:40:00,791.92,372707.0000000006,355703.57000000053,17003.43000000005
18993,2022-06-25 15:45:00,-435.61,372271.3900000006,355703.57000000053,16567.820000000065
18994,2022-06-25 15:50:00,1497.16,373768.55000000057,355703.57000000053,18064.98000000004
18995,2022-06-25 15:55:00,-1007.26,372761.29000000056,355703.57000000053,17057.72000000003
18996,2022-06-25 16:00:00,382.32,373143.61000000057,355703.57000000053,17440.040000000037
18997,2022-06-25 16:05:00,235.83,373379.4400000006,355703.57000000053,17675.870000000054
18998,2022-06-25 16:10:00,723.8,374103.2400000006,355703.57000000053,18399.670000000042
18999,2022-06-25 16:15:00,-21.96,374081.28000000055,355703.57000000053,18377.71000000002
19000,2022-06-25 16:20:00,1436.44,375517.72000000055,355703.57000000053,19814.150000000023
19001,2022-06-25 16:25:00,-1101.88,374415.84000000055,355703.57000000053,18712.27000000002
19002,2022-06-25 16:30:00,551.56,374967.40000000055,355703.57000000053,19263.830000000016
19003,2022-06-25 16:35:00,1904.45,376871.85000000056,355703.57000000053,21168.280000000028
19004,2022-06-25 16:40:00,879.78,377751.6300000006,355703.57000000053,22048.060000000056
19005,2022-06-25 16:45:00,-808.54,376943.0900000006,355703.57000000053,21239.520000000077
19006,2022-06-25 16:50:00,942.61,377885.7000000006,355703.57000000053,22182.130000000063
19007,2022-06-25 16:55:00,-108.78,377776.92000000057,355703.57000000053,22073.350000000035
19008,2022-06-26 08:00:00,1704.0,379480.92000000057,377776.92000000057,1704.0
19009,2022-06-26 08:05:00,1499.45,380980.3700000006,377776.92000000057,3203.4500000000116
19010,2022-06-26 08:10:00,-1249.85,379730.5200000006,377776.92000000057,1953.600000000035
19011,2022-06-26 08:15:00,14.43,379744.9500000006,377776.92000000057,1968.030000000028
19012,2022-06-26 08:20:00,877.98,380622.9300000006,377776.92000000057,2846.0100000000093
19013,2022-06-26 08:25:00,-180.69,380442.2400000006,377776.92000000057,2665.320000000007
19014,2022-06-26 08:30:00,-160.57,380281.67000000057,377776.92000000057,2504.75
19015,2022-06-26 08:35:00,1014.33,381296.0000000006,377776.92000000057,3519.0800000000163
19016,2022-06-26 08:40:00,-434.5,380861.5000000006,377776.92000000057,3084.5800000000163
19017,2022-06-26 08:45:00,993.72,381855.22000000055,377776.92000000057,4078.2999999999884
19018,2022-06-26 08:50:00,1439.79,383295.01000000053,377776.92000000057,5518.089999999967
19019,2022-06-26 08:55:00,-431.94,382863.07000000053,377776.92000000057,5086.149999999965
19020,2022-06-26 09:00:00,1950.57,384813.64000000054,377776.92000000057,7036.719999999972
19021,2022-06-26 09:05:00,1087.87,385901.51000000053,377776.92000000057,8124.589999999967
19022,2022-06-26 09:10:00,-659.1,385242.41000000056,377776.92000000057,7465.489999999991
19023,2022-06-26 09:15:00,-1836.34,383406.07000000053,377776.92000000057,5629.149999999965
19024,2022-06-26 09:20:00,1957.87,385363.9400000005,377776.92000000057,7587.01999999996
19025,2022-06-26 09:25:00,-725.21,384638.7300000005,377776.92000000057,6861.8099999999395
19026,2022-06-26 09:30:00,1375.27,386014.0000000005,377776.92000000057,8237.079999999958
19027,2022-06-26 09:35:00,-1377.18,384636.82000000053,377776.92000000057,6859.899999999965
19028,2022-06-26 09:40:00,326.65,384963.47000000055,377776.92000000057,7186.549999999988
19029,2022-06-26 09:45:00,-1775.48,383187.9900000006,377776.92000000057,5411.070000000007
19030,2022-06-26 09:50:00,-1515.27,381672.72000000055,377776.92000000057,3895.7999999999884
19031,2022-06-26 09:55:00,1329.34,383002.0600000006,377776.92000000057,5225.140000000014
19032,2022-06-26 10:00:00,-74.9,382927.16000000056,377776.92000000057,5150.239999999991
19033,2022-06-26 10:05:00,-819.39,382107.77000000054,377776.92000000057,4330.849999999977
19034,2022-06-26 10:10:00,-163.24,381944.53000000055,377776.92000000057,4167.609999999986
19035,2022-06-26 10:15:00,1637.37,383581.90000000055,377776.92000000057,5804.979999999981
19036,2022-06-26 10:20:00,-901.08,382680.82000000053,377776.92000000057,4903.899999999965
19037,2022-06-26 10:25:00,1798.57,384479.39000000054,377776.92000000057,6702.469999999972
19038,2022-06-26 10:30:00,1580.72,386060.1100000005,377776.92000000057,8283.189999999944
19039,2022-06-26 10:35:00,1555.75,387615.8600000005,377776.92000000057,9838.939999999944
19040,2022-06-26 10:40:00,-991.13,386624.7300000005,377776.92000000057,8847.80999999994
19041,2022-06-26 10:45:00,1151.11,387775.8400000005,377776.92000000057,9998.919999999925
19042,2022-06-26 10:50:00,1510.66,389286.50000000047,377776.92000000057,11509.5799999999
19043,2022-06-26 10:55:00,-1321.9,387964.60000000044,377776.92000000057,10187.679999999877
19044,2022-06-26 11:00:00,-548.13,387416.47000000044,377776.92000000057,9639.549999999872
19045,2022-06-26 11:05:00,301.79,387718.2600000004,377776.92000000057,9941.339999999851
19046,2022-06-26 11:10:00,-9.13,387709.1300000004,377776.92000000057,9932.209999999846
19047,2022-06-26 11:15:00,-1313.55,386395.5800000004,377776.92000000057,8618.659999999858
19048,2022-06-26 11:20:00,-116.9,386278.6800000004,377776.92000000057,8501.759999999835
19049,2022-06-26 11:25:00,-657.82,385620.8600000004,377776.92000000057,7843.939999999828
19050,2022-06-26 11:30:00,401.55,386022.4100000004,377776.92000000057,8245.489999999816
19051,2022-06-26 11:35:00,-1334.71,384687.70000000036,377776.92000000057,6910.779999999795
19052,2022-06-26 11:40:00,-1240.75,383446.95000000036,377776.92000000057,5670.029999999795
19053,2022-06-26 11:45:00,-686.06,382760.89000000036,377776.92000000057,4983.969999999797
19054,2022-06-26 11:50:00,-1345.74,381415.1500000004,377776.92000000057,3638.2299999998068
19055,2022-06-26 11:55:00,1497.05,382912.20000000036,377776.92000000057,5135.279999999795
19056,2022-06-26 12:00:00,428.87,383341.07000000036,377776.92000000057,5564.14999999979
19057,2022-06-26 12:05:00,-321.18,383019.89000000036,377776.92000000057,5242.969999999797
19058,2022-06-26 12:10:00,-1281.6,381738.2900000004,377776.92000000057,3961.3699999998207
19059,2022-06-26 12:15:00,1274.99,383013.2800000004,377776.92000000057,5236.359999999811
19060,2022-06-26 12:20:00,-1311.07,381702.21000000037,377776.92000000057,3925.2899999998044
19061,2022-06-26 12:25:00,9.81,381712.02000000037,377776.92000000057,3935.099999999802
19062,2022-06-26 12:30:00,818.68,382530.70000000036,377776.92000000057,4753.779999999795
19063,2022-06-26 12:35:00,-885.72,381644.9800000004,377776.92000000057,3868.059999999823
19064,2022-06-26 12:40:00,1115.42,382760.4000000004,377776.92000000057,4983.479999999807
19065,2022-06-26 12:45:00,-1795.83,380964.57000000036,377776.92000000057,3187.6499999997905
19066,2022-06-26 12:50:00,-247.13,380717.44000000035,377776.92000000057,2940.519999999786
19067,2022-06-26 12:55:00,-927.73,379789.71000000037,377776.92000000057,2012.7899999998044
19068,2022-06-26 13:00:00,289.7,380079.4100000004,377776.92000000057,2302.489999999816
19069,2022-06-26 13:05:00,600.81,380680.2200000004,377776.92000000057,2903.2999999998137
19070,2022-06-26 13:10:00,-1270.97,379409.2500000004,377776.92000000057,1632.3299999998417
19071,2022-06-26 13:15:00,778.93,380188.1800000004,377776.92000000057,2411.2599999998347
19072,2022-06-26 13:20:00,23.02,380211.2000000004,377776.92000000057,2434.2799999998533
19073,2022-06-26 13:25:00,1593.78,381804.98000000045,377776.92000000057,4028.0599999998813
19074,2022-06-26 13:30:00,-1923.1,379881.88000000047,377776.92000000057,2104.9599999999045
19075,2022-06-26 13:35:00,-199.36,379682.5200000005,377776.92000000057,1905.5999999999185
19076,2022-06-26 13:40:00,-1373.97,378308.5500000005,377776.92000000057,531.6299999999464
19077,2022-06-26 13:45:00,-55.09,378253.4600000005,377776.92000000057,476.53999999992084
19078,2022-06-26 13:50:00,1677.07,379930.5300000005,377776.92000000057,2153.609999999928
19079,2022-06-26 13:55:00,-1106.15,378824.38000000047,377776.92000000057,1047.4599999999045
19080,2022-06-26 14:00:00,-233.84,378590.54000000044,377776.92000000057,813.6199999998789
19081,2022-06-26 14:05:00,-1207.82,377382.72000000044,377776.92000000057,-394.20000000012806
19082,2022-06-26 14:10:00,1380.89,378763.61000000045,377776.92000000057,986.6899999998859
19083,2022-06-26 14:15:00,-8.57,378755.04000000044,377776.92000000057,978.1199999998789
19084,2022-06-26 14:20:00,1044.77,379799.81000000046,377776.92000000057,2022.8899999998976
19085,2022-06-26 14:25:00,501.4,380301.2100000005,377776.92000000057,2524.289999999921
19086,2022-06-26 14:30:00,1285.62,381586.8300000005,377776.92000000057,3809.909999999916
19087,2022-06-26 14:35:00,1393.38,382980.2100000005,377776.92000000057,5203.289999999921
19088,2022-06-26 14:40:00,93.24,383073.4500000005,377776.92000000057,5296.5299999999115
19089,2022-06-26 14:45:00,-1499.66,381573.7900000005,377776.92000000057,3796.869999999937
19090,2022-06-26 14:50:00,-1886.76,379687.0300000005,377776.92000000057,1910.1099999999278
19091,2022-06-26 14:55:00,-306.84,379380.19000000047,377776.92000000057,1603.2699999999022
19092,2022-06-26 15:00:00,-1048.08,378332.11000000045,377776.92000000057,555.1899999998859
19093,2022-06-26 15:05:00,1268.11,379600.22000000044,377776.92000000057,1823.299999999872
19094,2022-06-26 15:10:00,222.56,379822.78000000044,377776.92000000057,2045.8599999998696
19095,2022-06-26 15:15:00,-878.68,378944.10000000044,377776.92000000057,1167.1799999998766
19096,2022-06-26 15:20:00,1543.89,380487.99000000046,377776.92000000057,2711.0699999998906
19097,2022-06-26 15:25:00,1366.14,381854.13000000047,377776.92000000057,4077.2099999999045
19098,2022-06-26 15:30:00,831.73,382685.86000000045,377776.92000000057,4908.939999999886
19099,2022-06-26 15:35:00,-1222.02,381463.84000000043,377776.92000000057,3686.9199999998673
19100,2022-06-26 15:40:00,-13.97,381449.87000000046,377776.92000000057,3672.949999999895
19101,2022-06-26 15:45:00,-1008.46,380441.41000000044,377776.92000000057,2664.4899999998743
19102,2022-06-26 15:50:00,-1481.68,378959.73000000045,377776.92000000057,1182.8099999998813
19103,2022-06-26 15:55:00,-744.21,378215.5200000004,377776.92000000057,438.5999999998603
19104,2022-06-26 16:00:00,-1987.15,376228.3700000004,377776.92000000057,-1548.550000000163
19105,2022-06-26 16:05:00,-48.15,376180.2200000004,377776.92000000057,-1596.7000000001863
19106,2022-06-26 16:10:00,-983.88,375196.3400000004,377776.92000000057,-2580.580000000191
19107,2022-06-26 16:15:00,1131.93,376328.27000000037,377776.92000000057,-1448.650000000198
19108,2022-06-26 16:20:00,-822.19,375506.08000000037,377776.92000000057,-2270.8400000002002
19109,2022-06-26 16:25:00,1005.49,376511.57000000036,377776.92000000057,-1265.3500000002095
19110,2022-06-26 16:30:00,1829.59,378341.1600000004,377776.92000000057,564.2399999998161
19111,2022-06-26 16:35:00,-636.33,377704.83000000037,377776.92000000057,-72.09000000020023
19112,2022-06-26 16:40:00,-1511.56,376193.27000000037,377776.92000000057,-1583.650000000198
19113,2022-06-26 16:45:00,-342.69,375850.58000000037,377776.92000000057,-1926.3400000002002
19114,2022-06-26 16:50:00,-319.22,375531.3600000004,377776.92000000057,-2245.5600000001723
19115,2022-06-26 16:55:00,-253.59,375277.77000000037,377776.92000000057,-2499.150000000198
19116,2022-06-27 08:00:00,-1939.01,373338.76000000036,375277.77000000037,-1939.0100000000093
19117,2022-06-27 08:05:00,-1285.87,372052.89000000036,375277.77000000037,-3224.8800000000047
19118,2022-06-27 08:10:00,-799.73,371253.1600000004,375277.77000000037,-4024.609999999986
19119,2022-06-27 08:15:00,-1862.77,369390.39000000036,375277.77000000037,-5887.380000000005
19120,2022-06-27 08:20:00,-1338.49,368051.9000000004,375277.77000000037,-7225.869999999995
19121,2022-06-27 08:25:00,540.49,368592.39000000036,375277.77000000037,-6685.380000000005
19122,2022-06-27 08:30:00,1755.81,370348.20000000036,375277.77000000037,-4929.570000000007
19123,2022-06-27 08:35:00,1651.71,371999.9100000004,375277.77000000037,-3277.859999999986
19124,2022-06-27 08:40:00,-325.66,371674.2500000004,375277.77000000037,-3603.5199999999604
19125,2022-06-27 08:45:00,1028.26,372702.5100000004,375277.77000000037,-2575.259999999951
19126,2022-06-27 08:50:00,-1523.0,371179.5100000004,375277.77000000037,-4098.259999999951
19127,2022-06-27 08:55:00,910.21,372089.72000000044,375277.77000000037,-3188.04999999993
19128,2022-06-27 09:00:00,-136.24,371953.48000000045,375277.77000000037,-3324.289999999921
19129,2022-06-27 09:05:00,1321.34,373274.8200000005,375277.77000000037,-2002.9499999998952
19130,2022-06-27 09:10:00,925.76,374200.5800000005,375277.77000000037,-1077.189999999886
19131,2022-06-27 09:15:00,1556.08,375756.6600000005,375277.77000000037,478.8900000001304
19132,2022-06-27 09:20:00,1974.05,377730.7100000005,375277.77000000037,2452.9400000001187
19133,2022-06-27 09:25:00,141.28,377871.9900000005,375277.77000000037,2594.2200000001467
19134,2022-06-27 09:30:00,1815.92,379687.9100000005,375277.77000000037,4410.14000000013
19135,2022-06-27 09:35:00,-790.21,378897.7000000005,375277.77000000037,3619.9300000001094
19136,2022-06-27 09:40:00,237.25,379134.9500000005,375277.77000000037,3857.1800000001094
19137,2022-06-27 09:45:00,-648.92,378486.0300000005,375277.77000000037,3208.2600000001257
19138,2022-06-27 09:50:00,1618.15,380104.1800000005,375277.77000000037,4826.410000000149
19139,2022-06-27 09:55:00,703.35,380807.5300000005,375277.77000000037,5529.760000000126
19140,2022-06-27 10:00:00,-545.14,380262.3900000005,375277.77000000037,4984.620000000112
19141,2022-06-27 10:05:00,1705.18,381967.5700000005,375277.77000000037,6689.800000000105
19142,2022-06-27 10:10:00,1581.3,383548.87000000046,375277.77000000037,8271.100000000093
19143,2022-06-27 10:15:00,832.9,384381.7700000005,375277.77000000037,9104.000000000116
19144,2022-06-27 10:20:00,-1601.86,382779.9100000005,375277.77000000037,7502.14000000013
19145,2022-06-27 10:25:00,1391.88,384171.7900000005,375277.77000000037,8894.020000000135
19146,2022-06-27 10:30:00,-1218.7,382953.0900000005,375277.77000000037,7675.320000000123
19147,2022-06-27 10:35:00,-1614.66,381338.4300000005,375277.77000000037,6060.660000000149
19148,2022-06-27 10:40:00,796.54,382134.9700000005,375277.77000000037,6857.200000000128
19149,2022-06-27 10:45:00,-167.81,381967.1600000005,375277.77000000037,6689.39000000013
19150,2022-06-27 10:50:00,1413.97,383381.13000000047,375277.77000000037,8103.360000000102
19151,2022-06-27 10:55:00,-1560.93,381820.2000000005,375277.77000000037,6542.430000000109
19152,2022-06-27 11:00:00,402.48,382222.68000000046,375277.77000000037,6944.910000000091
19153,2022-06-27 11:05:00,1686.19,383908.87000000046,375277.77000000037,8631.100000000093
19154,2022-06-27 11:10:00,-1528.5,382380.37000000046,375277.77000000037,7102.600000000093
19155,2022-06-27 11:15:00,-384.81,381995.56000000046,375277.77000000037,6717.7900000000955
19156,2022-06-27 11:20:00,-606.18,381389.38000000047,375277.77000000037,6111.610000000102
19157,2022-06-27 11:25:00,24.32,381413.7000000005,375277.77000000037,6135.930000000109
19158,2022-06-27 11:30:00,-1571.89,379841.81000000046,375277.77000000037,4564.0400000000955
19159,2022-06-27 11:35:00,-300.39,379541.42000000045,375277.77000000037,4263.6500000000815
19160,2022-06-27 11:40:00,-167.01,379374.41000000044,375277.77000000037,4096.640000000072
19161,2022-06-27 11:45:00,1862.74,381237.15000000043,375277.77000000037,5959.380000000063
19162,2022-06-27 11:50:00,350.63,381587.78000000044,375277.77000000037,6310.0100000000675
19163,2022-06-27 11:55:00,-683.23,380904.55000000045,375277.77000000037,5626.780000000086
19164,2022-06-27 12:00:00,135.96,381040.5100000005,375277.77000000037,5762.740000000107
19165,2022-06-27 12:05:00,204.25,381244.7600000005,375277.77000000037,5966.990000000107
19166,2022-06-27 12:10:00,-301.38,380943.38000000047,375277.77000000037,5665.610000000102
19167,2022-06-27 12:15:00,1631.02,382574.4000000005,375277.77000000037,7296.630000000121
19168,2022-06-27 12:20:00,-133.27,382441.13000000047,375277.77000000037,7163.360000000102
19169,2022-06-27 12:25:00,430.49,382871.62000000046,375277.77000000037,7593.850000000093
19170,2022-06-27 12:30:00,1429.59,384301.2100000005,375277.77000000037,9023.440000000119
19171,2022-06-27 12:35:00,-1111.11,383190.1000000005,375277.77000000037,7912.330000000133
19172,2022-06-27 12:40:00,1220.26,384410.3600000005,375277.77000000037,9132.590000000142
19173,2022-06-27 12:45:00,-1625.02,382785.3400000005,375277.77000000037,7507.570000000123
19174,2022-06-27 12:50:00,1070.62,383855.9600000005,375277.77000000037,8578.190000000119
19175,2022-06-27 12:55:00,287.32,384143.2800000005,375277.77000000037,8865.510000000126
19176,2022-06-27 13:00:00,-565.58,383577.7000000005,375277.77000000037,8299.93000000011
19177,2022-06-27 13:05:00,-632.23,382945.4700000005,375277.77000000037,7667.700000000128
19178,2022-06-27 13:10:00,1954.86,384900.3300000005,375277.77000000037,9622.560000000114
19179,2022-06-27 13:15:00,-1270.25,383630.0800000005,375277.77000000037,8352.310000000114
19180,2022-06-27 13:20:00,-1500.78,382129.30000000045,375277.77000000037,6851.530000000086
19181,2022-06-27 13:25:00,1494.37,383623.67000000045,375277.77000000037,8345.900000000081
19182,2022-06-27 13:30:00,1017.13,384640.80000000045,375277.77000000037,9363.030000000086
19183,2022-06-27 13:35:00,-591.99,384048.81000000046,375277.77000000037,8771.040000000095
19184,2022-06-27 13:40:00,1523.46,385572.2700000005,375277.77000000037,10294.500000000116
19185,2022-06-27 13:45:00,-737.1,384835.1700000005,375277.77000000037,9557.40000000014
19186,2022-06-27 13:50:00,178.1,385013.2700000005,375277.77000000037,9735.500000000116
19187,2022-06-27 13:55:00,-1072.43,383940.8400000005,375277.77000000037,8663.070000000123
19188,2022-06-27 14:00:00,-878.16,383062.6800000005,375277.77000000037,7784.910000000149
19189,2022-06-27 14:05:00,399.94,383462.6200000005,375277.77000000037,8184.850000000151
19190,2022-06-27 14:10:00,1364.77,384827.39000000054,375277.77000000037,9549.62000000017
19191,2022-06-27 14:15:00,-1035.81,383791.58000000054,375277.77000000037,8513.810000000172
19192,2022-06-27 14:20:00,314.82,384106.40000000055,375277.77000000037,8828.63000000018
19193,2022-06-27 14:25:00,1522.49,385628.89000000054,375277.77000000037,10351.12000000017
19194,2022-06-27 14:30:00,-443.13,385185.76000000053,375277.77000000037,9907.990000000165
19195,2022-06-27 14:35:00,-623.2,384562.5600000005,375277.77000000037,9284.790000000154
19196,2022-06-27 14:40:00,68.09,384630.65000000055,375277.77000000037,9352.88000000018
19197,2022-06-27 14:45:00,-251.55,384379.10000000056,375277.77000000037,9101.330000000191
19198,2022-06-27 14:50:00,536.56,384915.66000000056,375277.77000000037,9637.890000000189
19199,2022-06-27 14:55:00,647.2,385562.86000000057,375277.77000000037,10285.0900000002
19200,2022-06-27 15:00:00,1495.52,387058.3800000006,375277.77000000037,11780.610000000219
19201,2022-06-27 15:05:00,-1537.75,385520.6300000006,375277.77000000037,10242.860000000219
19202,2022-06-27 15:10:00,158.69,385679.3200000006,375277.77000000037,10401.550000000221
19203,2022-06-27 15:15:00,1942.03,387621.3500000006,375277.77000000037,12343.58000000025
19204,2022-06-27 15:20:00,-1005.56,386615.7900000006,375277.77000000037,11338.020000000251
19205,2022-06-27 15:25:00,-1497.1,385118.69000000064,375277.77000000037,9840.920000000275
19206,2022-06-27 15:30:00,-1848.33,383270.3600000006,375277.77000000037,7992.590000000258
19207,2022-06-27 15:35:00,-133.14,383137.2200000006,375277.77000000037,7859.4500000002445
19208,2022-06-27 15:40:00,-1343.45,381793.7700000006,375277.77000000037,6516.000000000233
19209,2022-06-27 15:45:00,608.17,382401.9400000006,375277.77000000037,7124.1700000002165
19210,2022-06-27 15:50:00,-667.47,381734.4700000006,375277.77000000037,6456.7000000002445
19211,2022-06-27 15:55:00,-840.83,380893.6400000006,375277.77000000037,5615.870000000228
19212,2022-06-27 16:00:00,125.75,381019.3900000006,375277.77000000037,5741.620000000228
19213,2022-06-27 16:05:00,1468.51,382487.9000000006,375277.77000000037,7210.1300000002375
19214,2022-06-27 16:10:00,-1199.44,381288.4600000006,375277.77000000037,6010.690000000235
19215,2022-06-27 16:15:00,-1189.4,380099.0600000006,375277.77000000037,4821.290000000212
19216,2022-06-27 16:20:00,122.53,380221.5900000006,375277.77000000037,4943.82000000024
19217,2022-06-27 16:25:00,-70.94,380150.6500000006,375277.77000000037,4872.8800000002375
19218,2022-06-27 16:30:00,602.73,380753.3800000006,375277.77000000037,5475.610000000219
19219,2022-06-27 16:35:00,1822.14,382575.5200000006,375277.77000000037,7297.750000000233
19220,2022-06-27 16:40:00,1540.48,384116.0000000006,375277.77000000037,8838.230000000214
19221,2022-06-27 16:45:00,-845.5,383270.5000000006,375277.77000000037,7992.730000000214
19222,2022-06-27 16:50:00,-1218.84,382051.66000000056,375277.77000000037,6773.890000000189
19223,2022-06-27 16:55:00,1426.61,383478.27000000054,375277.77000000037,8200.500000000175
19224,2022-06-28 08:00:00,393.84,383872.11000000057,383478.27000000054,393.8400000000256
19225,2022-06-28 08:05:00,67.7,383939.8100000006,383478.27000000054,461.54000000003725
19226,2022-06-28 08:10:00,-1595.06,382344.7500000006,383478.27000000054,-1133.5199999999604
19227,2022-06-28 08:15:00,-37.39,382307.36000000057,383478.27000000054,-1170.9099999999744
19228,2022-06-28 08:20:00,-206.88,382100.48000000056,383478.27000000054,-1377.789999999979
19229,2022-06-28 08:25:00,-154.82,381945.66000000056,383478.27000000054,-1532.609999999986
19230,2022-06-28 08:30:00,348.41,382294.07000000053,383478.27000000054,-1184.2000000000116
19231,2022-06-28 08:35:00,258.89,382552.96000000054,383478.27000000054,-925.3099999999977
19232,2022-06-28 08:40:00,1547.97,384100.9300000005,383478.27000000054,622.6599999999744
19233,2022-06-28 08:45:00,496.1,384597.0300000005,383478.27000000054,1118.759999999951
19234,2022-06-28 08:50:00,-1198.17,383398.8600000005,383478.27000000054,-79.4100000000326
19235,2022-06-28 08:55:00,-97.8,383301.0600000005,383478.27000000054,-177.21000000002095
19236,2022-06-28 09:00:00,-798.61,382502.45000000054,383478.27000000054,-975.820000000007
19237,2022-06-28 09:05:00,-1966.86,380535.59000000055,383478.27000000054,-2942.679999999993
19238,2022-06-28 09:10:00,1960.05,382495.64000000054,383478.27000000054,-982.6300000000047
19239,2022-06-28 09:15:00,1520.36,384016.0000000005,383478.27000000054,537.7299999999814
19240,2022-06-28 09:20:00,1096.41,385112.4100000005,383478.27000000054,1634.1399999999558
19241,2022-06-28 09:25:00,-1044.23,384068.1800000005,383478.27000000054,589.9099999999744
19242,2022-06-28 09:30:00,-1865.65,382202.5300000005,383478.27000000054,-1275.740000000049
19243,2022-06-28 09:35:00,-1893.68,380308.8500000005,383478.27000000054,-3169.420000000042
19244,2022-06-28 09:40:00,-1827.92,378480.9300000005,383478.27000000054,-4997.340000000026
19245,2022-06-28 09:45:00,31.54,378512.4700000005,383478.27000000054,-4965.800000000047
19246,2022-06-28 09:50:00,421.9,378934.3700000005,383478.27000000054,-4543.900000000023
19247,2022-06-28 09:55:00,1892.77,380827.14000000054,383478.27000000054,-2651.1300000000047
19248,2022-06-28 10:00:00,-871.36,379955.78000000055,383478.27000000054,-3522.4899999999907
19249,2022-06-28 10:05:00,-1853.16,378102.6200000006,383478.27000000054,-5375.649999999965
19250,2022-06-28 10:10:00,-1814.51,376288.11000000057,383478.27000000054,-7190.159999999974
19251,2022-06-28 10:15:00,-1463.5,374824.61000000057,383478.27000000054,-8653.659999999974
19252,2022-06-28 10:20:00,-1213.44,373611.17000000057,383478.27000000054,-9867.099999999977
19253,2022-06-28 10:25:00,-711.92,372899.2500000006,383478.27000000054,-10579.01999999996
19254,2022-06-28 10:30:00,911.77,373811.0200000006,383478.27000000054,-9667.249999999942
19255,2022-06-28 10:35:00,927.92,374738.9400000006,383478.27000000054,-8739.329999999958
19256,2022-06-28 10:40:00,1210.03,375948.9700000006,383478.27000000054,-7529.29999999993
19257,2022-06-28 10:45:00,417.08,376366.0500000006,383478.27000000054,-7112.219999999914
19258,2022-06-28 10:50:00,-8.86,376357.19000000064,383478.27000000054,-7121.0799999999
19259,2022-06-28 10:55:00,-1351.66,375005.53000000067,383478.27000000054,-8472.739999999874
19260,2022-06-28 11:00:00,1340.98,376346.51000000065,383478.27000000054,-7131.759999999893
19261,2022-06-28 11:05:00,461.8,376808.31000000064,383478.27000000054,-6669.9599999999045
19262,2022-06-28 11:10:00,1648.01,378456.32000000065,383478.27000000054,-5021.949999999895
19263,2022-06-28 11:15:00,1401.81,379858.13000000064,383478.27000000054,-3620.1399999998976
19264,2022-06-28 11:20:00,276.4,380134.53000000067,383478.27000000054,-3343.7399999998743
19265,2022-06-28 11:25:00,-1826.88,378307.65000000066,383478.27000000054,-5170.619999999879
19266,2022-06-28 11:30:00,-113.73,378193.9200000007,383478.27000000054,-5284.34999999986
19267,2022-06-28 11:35:00,-445.02,377748.90000000066,383478.27000000054,-5729.369999999879
19268,2022-06-28 11:40:00,-1169.22,376579.6800000007,383478.27000000054,-6898.589999999851
19269,2022-06-28 11:45:00,722.17,377301.8500000007,383478.27000000054,-6176.419999999867
19270,2022-06-28 11:50:00,-168.84,377133.01000000065,383478.27000000054,-6345.259999999893
19271,2022-06-28 11:55:00,1787.0,378920.01000000065,383478.27000000054,-4558.259999999893
19272,2022-06-28 12:00:00,-1987.28,376932.7300000006,383478.27000000054,-6545.539999999921
19273,2022-06-28 12:05:00,-356.54,376576.19000000064,383478.27000000054,-6902.0799999999
19274,2022-06-28 12:10:00,-1086.56,375489.63000000064,383478.27000000054,-7988.639999999898
19275,2022-06-28 12:15:00,-546.82,374942.81000000064,383478.27000000054,-8535.459999999905
19276,2022-06-28 12:20:00,-212.28,374730.5300000006,383478.27000000054,-8747.739999999932
19277,2022-06-28 12:25:00,1205.7,375936.2300000006,383478.27000000054,-7542.039999999921
19278,2022-06-28 12:30:00,-844.47,375091.76000000065,383478.27000000054,-8386.509999999893
19279,2022-06-28 12:35:00,292.64,375384.40000000066,383478.27000000054,-8093.869999999879
19280,2022-06-28 12:40:00,-768.58,374615.82000000065,383478.27000000054,-8862.449999999895
19281,2022-06-28 12:45:00,1013.54,375629.3600000006,383478.27000000054,-7848.909999999916
19282,2022-06-28 12:50:00,460.29,376089.6500000006,383478.27000000054,-7388.619999999937
19283,2022-06-28 12:55:00,-935.27,375154.3800000006,383478.27000000054,-8323.889999999956
19284,2022-06-28 13:00:00,784.02,375938.4000000006,383478.27000000054,-7539.869999999937
19285,2022-06-28 13:05:00,359.71,376298.1100000006,383478.27000000054,-7180.159999999916
19286,2022-06-28 13:10:00,434.77,376732.88000000064,383478.27000000054,-6745.389999999898
19287,2022-06-28 13:15:00,919.63,377652.51000000065,383478.27000000054,-5825.759999999893
19288,2022-06-28 13:20:00,-1202.4,376450.1100000006,383478.27000000054,-7028.159999999916
19289,2022-06-28 13:25:00,-1215.37,375234.74000000063,383478.27000000054,-8243.529999999912
19290,2022-06-28 13:30:00,-274.67,374960.07000000065,383478.27000000054,-8518.199999999895
19291,2022-06-28 13:35:00,1021.81,375981.88000000064,383478.27000000054,-7496.389999999898
19292,2022-06-28 13:40:00,984.88,376966.76000000065,383478.27000000054,-6511.509999999893
19293,2022-06-28 13:45:00,1254.07,378220.83000000066,383478.27000000054,-5257.439999999886
19294,2022-06-28 13:50:00,900.81,379121.64000000065,383478.27000000054,-4356.629999999888
19295,2022-06-28 13:55:00,912.18,380033.82000000065,383478.27000000054,-3444.449999999895
19296,2022-06-28 14:00:00,851.64,380885.46000000066,383478.27000000054,-2592.8099999998813
19297,2022-06-28 14:05:00,1115.44,382000.90000000066,383478.27000000054,-1477.369999999879
19298,2022-06-28 14:10:00,-91.34,381909.56000000064,383478.27000000054,-1568.7099999999045
19299,2022-06-28 14:15:00,-1448.01,380461.5500000006,383478.27000000054,-3016.719999999914
19300,2022-06-28 14:20:00,-995.88,379465.6700000006,383478.27000000054,-4012.5999999999185
19301,2022-06-28 14:25:00,1538.67,381004.3400000006,383478.27000000054,-2473.929999999935
19302,2022-06-28 14:30:00,939.54,381943.8800000006,383478.27000000054,-1534.3899999999558
19303,2022-06-28 14:35:00,-538.51,381405.3700000006,383478.27000000054,-2072.899999999965
19304,2022-06-28 14:40:00,-1954.01,379451.36000000057,383478.27000000054,-4026.9099999999744
19305,2022-06-28 14:45:00,1888.9,381340.2600000006,383478.27000000054,-2138.009999999951
19306,2022-06-28 14:50:00,-1316.17,380024.0900000006,383478.27000000054,-3454.179999999935
19307,2022-06-28 14:55:00,68.29,380092.3800000006,383478.27000000054,-3385.8899999999558
19308,2022-06-28 15:00:00,952.24,381044.6200000006,383478.27000000054,-2433.649999999965
19309,2022-06-28 15:05:00,1243.94,382288.5600000006,383478.27000000054,-1189.7099999999627
19310,2022-06-28 15:10:00,-1281.52,381007.04000000056,383478.27000000054,-2471.2299999999814
19311,2022-06-28 15:15:00,893.59,381900.6300000006,383478.27000000054,-1577.6399999999558
19312,2022-06-28 15:20:00,857.23,382757.86000000057,383478.27000000054,-720.4099999999744
19313,2022-06-28 15:25:00,-878.52,381879.34000000055,383478.27000000054,-1598.929999999993
19314,2022-06-28 15:30:00,-778.2,381101.14000000054,383478.27000000054,-2377.1300000000047
19315,2022-06-28 15:35:00,870.54,381971.6800000005,383478.27000000054,-1506.5900000000256
19316,2022-06-28 15:40:00,-74.36,381897.32000000053,383478.27000000054,-1580.9500000000116
19317,2022-06-28 15:45:00,-368.27,381529.0500000005,383478.27000000054,-1949.2200000000303
19318,2022-06-28 15:50:00,-1041.72,380487.33000000054,383478.27000000054,-2990.9400000000023
19319,2022-06-28 15:55:00,-808.24,379679.09000000055,383478.27000000054,-3799.179999999993
19320,2022-06-28 16:00:00,-683.75,378995.34000000055,383478.27000000054,-4482.929999999993
19321,2022-06-28 16:05:00,685.41,379680.7500000005,383478.27000000054,-3797.5200000000186
19322,2022-06-28 16:10:00,-766.32,378914.4300000005,383478.27000000054,-4563.840000000026
19323,2022-06-28 16:15:00,1519.09,380433.52000000054,383478.27000000054,-3044.75
19324,2022-06-28 16:20:00,1396.96,381830.48000000056,383478.27000000054,-1647.789999999979
19325,2022-06-28 16:25:00,-766.35,381064.1300000006,383478.27000000054,-2414.1399999999558
19326,2022-06-28 16:30:00,1006.07,382070.2000000006,383478.27000000054,-1408.0699999999488
19327,2022-06-28 16:35:00,-1787.35,380282.8500000006,383478.27000000054,-3195.4199999999255
19328,2022-06-28 16:40:00,401.63,380684.4800000006,383478.27000000054,-2793.789999999921
19329,2022-06-28 16:45:00,-739.9,379944.5800000006,383478.27000000054,-3533.689999999944
19330,2022-06-28 16:50:00,-949.28,378995.30000000057,383478.27000000054,-4482.969999999972
19331,2022-06-28 16:55:00,1345.21,380340.5100000006,383478.27000000054,-3137.759999999951
19332,2022-06-29 08:00:00,824.69,381165.2000000006,380340.5100000006,824.6900000000023
19333,2022-06-29 08:05:00,796.75,381961.9500000006,380340.5100000006,1621.4400000000023
19334,2022-06-29 08:10:00,-1234.71,380727.2400000006,380340.5100000006,386.7299999999814
19335,2022-06-29 08:15:00,-1614.97,379112.2700000006,380340.5100000006,-1228.2399999999907
19336,2022-06-29 08:20:00,136.4,379248.6700000006,380340.5100000006,-1091.8399999999674
19337,2022-06-29 08:25:00,-129.43,379119.24000000063,380340.5100000006,-1221.2699999999604
19338,2022-06-29 08:30:00,-831.71,378287.5300000006,380340.5100000006,-2052.9799999999814
19339,2022-06-29 08:35:00,-739.93,377547.6000000006,380340.5100000006,-2792.9099999999744
19340,2022-06-29 08:40:00,-308.19,377239.4100000006,380340.5100000006,-3101.0999999999767
19341,2022-06-29 08:45:00,-475.85,376763.56000000064,380340.5100000006,-3576.9499999999534
19342,2022-06-29 08:50:00,-1132.22,375631.34000000067,380340.5100000006,-4709.1699999999255
19343,2022-06-29 08:55:00,1823.65,377454.9900000007,380340.5100000006,-2885.519999999902
19344,2022-06-29 09:00:00,1755.49,379210.4800000007,380340.5100000006,-1130.0299999999115
19345,2022-06-29 09:05:00,-1932.66,377277.8200000007,380340.5100000006,-3062.689999999886
19346,2022-06-29 09:10:00,-1452.0,375825.8200000007,380340.5100000006,-4514.689999999886
19347,2022-06-29 09:15:00,-1860.41,373965.41000000073,380340.5100000006,-6375.09999999986
19348,2022-06-29 09:20:00,-1353.71,372611.7000000007,380340.5100000006,-7728.809999999881
19349,2022-06-29 09:25:00,1626.25,374237.9500000007,380340.5100000006,-6102.559999999881
19350,2022-06-29 09:30:00,-814.77,373423.1800000007,380340.5100000006,-6917.3299999999
19351,2022-06-29 09:35:00,-375.28,373047.90000000066,380340.5100000006,-7292.609999999928
19352,2022-06-29 09:40:00,-1323.32,371724.58000000066,380340.5100000006,-8615.929999999935
19353,2022-06-29 09:45:00,1428.38,373152.96000000066,380340.5100000006,-7187.54999999993
19354,2022-06-29 09:50:00,-9.55,373143.4100000007,380340.5100000006,-7197.0999999999185
19355,2022-06-29 09:55:00,-188.48,372954.9300000007,380340.5100000006,-7385.5799999999
19356,2022-06-29 10:00:00,1817.13,374772.0600000007,380340.5100000006,-5568.449999999895
19357,2022-06-29 10:05:00,25.86,374797.9200000007,380340.5100000006,-5542.589999999909
19358,2022-06-29 10:10:00,1755.25,376553.1700000007,380340.5100000006,-3787.339999999909
19359,2022-06-29 10:15:00,1326.42,377879.59000000067,380340.5100000006,-2460.9199999999255
19360,2022-06-29 10:20:00,-286.96,377592.63000000064,380340.5100000006,-2747.8799999999464
19361,2022-06-29 10:25:00,-558.84,377033.7900000006,380340.5100000006,-3306.719999999972
19362,2022-06-29 10:30:00,-1905.64,375128.1500000006,380340.5100000006,-5212.359999999986
19363,2022-06-29 10:35:00,-132.19,374995.9600000006,380340.5100000006,-5344.549999999988
19364,2022-06-29 10:40:00,-1369.73,373626.2300000006,380340.5100000006,-6714.27999999997
19365,2022-06-29 10:45:00,902.97,374529.2000000006,380340.5100000006,-5811.309999999998
19366,2022-06-29 10:50:00,-1006.91,373522.2900000006,380340.5100000006,-6818.219999999972
19367,2022-06-29 10:55:00,-1891.44,371630.8500000006,380340.5100000006,-8709.659999999974
19368,2022-06-29 11:00:00,-466.47,371164.38000000064,380340.5100000006,-9176.129999999946
19369,2022-06-29 11:05:00,288.52,371452.90000000066,380340.5100000006,-8887.609999999928
19370,2022-06-29 11:10:00,-298.66,371154.2400000007,380340.5100000006,-9186.269999999902
19371,2022-06-29 11:15:00,211.91,371366.15000000066,380340.5100000006,-8974.359999999928
19372,2022-06-29 11:20:00,-822.52,370543.63000000064,380340.5100000006,-9796.879999999946
19373,2022-06-29 11:25:00,1118.58,371662.21000000066,380340.5100000006,-8678.29999999993
19374,2022-06-29 11:30:00,-1421.47,370240.7400000007,380340.5100000006,-10099.769999999902
19375,2022-06-29 11:35:00,1783.17,372023.9100000007,380340.5100000006,-8316.599999999919
19376,2022-06-29 11:40:00,423.59,372447.5000000007,380340.5100000006,-7893.009999999893
19377,2022-06-29 11:45:00,-885.79,371561.7100000007,380340.5100000006,-8778.799999999872
19378,2022-06-29 11:50:00,1862.66,373424.3700000007,380340.5100000006,-6916.139999999898
19379,2022-06-29 11:55:00,1120.42,374544.7900000007,380340.5100000006,-5795.719999999914
19380,2022-06-29 12:00:00,-311.28,374233.51000000065,380340.5100000006,-6106.999999999942
19381,2022-06-29 12:05:00,-223.8,374009.71000000066,380340.5100000006,-6330.79999999993
19382,2022-06-29 12:10:00,-561.74,373447.97000000067,380340.5100000006,-6892.539999999921
19383,2022-06-29 12:15:00,-43.4,373404.57000000065,380340.5100000006,-6935.939999999944
19384,2022-06-29 12:20:00,-1288.45,372116.12000000064,380340.5100000006,-8224.389999999956
19385,2022-06-29 12:25:00,-1698.32,370417.8000000006,380340.5100000006,-9922.709999999963
19386,2022-06-29 12:30:00,-194.15,370223.6500000006,380340.5100000006,-10116.859999999986
19387,2022-06-29 12:35:00,341.9,370565.5500000006,380340.5100000006,-9774.959999999963
19388,2022-06-29 12:40:00,1714.02,372279.57000000065,380340.5100000006,-8060.939999999944
19389,2022-06-29 12:45:00,1413.87,373693.44000000064,380340.5100000006,-6647.069999999949
19390,2022-06-29 12:50:00,987.29,374680.7300000006,380340.5100000006,-5659.77999999997
19391,2022-06-29 12:55:00,-4.55,374676.18000000063,380340.5100000006,-5664.329999999958
19392,2022-06-29 13:00:00,-1761.18,372915.00000000064,380340.5100000006,-7425.509999999951
19393,2022-06-29 13:05:00,1219.29,374134.2900000006,380340.5100000006,-6206.219999999972
19394,2022-06-29 13:10:00,1342.75,375477.0400000006,380340.5100000006,-4863.469999999972
19395,2022-06-29 13:15:00,-1089.52,374387.5200000006,380340.5100000006,-5952.989999999991
19396,2022-06-29 13:20:00,-1468.18,372919.3400000006,380340.5100000006,-7421.169999999984
19397,2022-06-29 13:25:00,1134.88,374054.2200000006,380340.5100000006,-6286.289999999979
19398,2022-06-29 13:30:00,261.23,374315.4500000006,380340.5100000006,-6025.059999999998
19399,2022-06-29 13:35:00,1096.52,375411.9700000006,380340.5100000006,-4928.539999999979
19400,2022-06-29 13:40:00,-1376.66,374035.31000000064,380340.5100000006,-6305.199999999953
19401,2022-06-29 13:45:00,176.34,374211.65000000066,380340.5100000006,-6128.859999999928
19402,2022-06-29 13:50:00,-786.67,373424.9800000007,380340.5100000006,-6915.5299999999115
19403,2022-06-29 13:55:00,-978.57,372446.4100000007,380340.5100000006,-7894.0999999999185
19404,2022-06-29 14:00:00,1633.01,374079.4200000007,380340.5100000006,-6261.089999999909
19405,2022-06-29 14:05:00,224.31,374303.7300000007,380340.5100000006,-6036.7799999999115
19406,2022-06-29 14:10:00,18.41,374322.14000000065,380340.5100000006,-6018.369999999937
19407,2022-06-29 14:15:00,-562.41,373759.7300000007,380340.5100000006,-6580.7799999999115
19408,2022-06-29 14:20:00,-1470.87,372288.8600000007,380340.5100000006,-8051.649999999907
19409,2022-06-29 14:25:00,875.96,373164.8200000007,380340.5100000006,-7175.689999999886
19410,2022-06-29 14:30:00,661.04,373825.8600000007,380340.5100000006,-6514.649999999907
19411,2022-06-29 14:35:00,1189.57,375015.4300000007,380340.5100000006,-5325.0799999999
19412,2022-06-29 14:40:00,921.56,375936.9900000007,380340.5100000006,-4403.519999999902
19413,2022-06-29 14:45:00,1475.02,377412.0100000007,380340.5100000006,-2928.4999999998836
19414,2022-06-29 14:50:00,433.85,377845.8600000007,380340.5100000006,-2494.649999999907
19415,2022-06-29 14:55:00,1194.66,379040.52000000066,380340.5100000006,-1299.9899999999325
19416,2022-06-29 15:00:00,-1236.64,377803.88000000064,380340.5100000006,-2536.6299999999464
19417,2022-06-29 15:05:00,1076.1,378879.9800000006,380340.5100000006,-1460.5299999999697
19418,2022-06-29 15:10:00,455.39,379335.37000000064,380340.5100000006,-1005.1399999999558
19419,2022-06-29 15:15:00,-955.65,378379.7200000006,380340.5100000006,-1960.789999999979
19420,2022-06-29 15:20:00,-32.25,378347.4700000006,380340.5100000006,-1993.039999999979
19421,2022-06-29 15:25:00,-1211.67,377135.8000000006,380340.5100000006,-3204.7099999999627
19422,2022-06-29 15:30:00,260.36,377396.1600000006,380340.5100000006,-2944.3499999999767
19423,2022-06-29 15:35:00,-543.36,376852.8000000006,380340.5100000006,-3487.7099999999627
19424,2022-06-29 15:40:00,1569.82,378422.62000000064,380340.5100000006,-1917.8899999999558
19425,2022-06-29 15:45:00,1791.46,380214.08000000066,380340.5100000006,-126.42999999993481
19426,2022-06-29 15:50:00,320.93,380535.01000000065,380340.5100000006,194.5000000000582
19427,2022-06-29 15:55:00,1650.37,382185.38000000064,380340.5100000006,1844.8700000000536
19428,2022-06-29 16:00:00,-1055.29,381130.09000000067,380340.5100000006,789.5800000000745
19429,2022-06-29 16:05:00,1203.9,382333.9900000007,380340.5100000006,1993.4800000000978
19430,2022-06-29 16:10:00,1550.23,383884.22000000067,380340.5100000006,3543.710000000079
19431,2022-06-29 16:15:00,1697.16,385581.38000000064,380340.5100000006,5240.870000000054
19432,2022-06-29 16:20:00,1933.3,387514.68000000063,380340.5100000006,7174.170000000042
19433,2022-06-29 16:25:00,637.96,388152.64000000065,380340.5100000006,7812.130000000063
19434,2022-06-29 16:30:00,-835.9,387316.74000000063,380340.5100000006,6976.23000000004
19435,2022-06-29 16:35:00,965.09,388281.83000000066,380340.5100000006,7941.320000000065
19436,2022-06-29 16:40:00,-1618.75,386663.08000000066,380340.5100000006,6322.570000000065
19437,2022-06-29 16:45:00,1041.28,387704.3600000007,380340.5100000006,7363.850000000093
19438,2022-06-29 16:50:00,-207.19,387497.1700000007,380340.5100000006,7156.660000000091
19439,2022-06-29 16:55:00,1026.79,388523.96000000066,380340.5100000006,8183.45000000007
19440,2022-06-30 08:00:00,-50.92,388473.0400000007,388523.96000000066,-50.9199999999837
19441,2022-06-30 08:05:00,-116.17,388356.8700000007,388523.96000000066,-167.0899999999674
19442,2022-06-30 08:10:00,-224.02,388132.8500000007,388523.96000000066,-391.10999999998603
19443,2022-06-30 08:15:00,-1889.02,386243.83000000066,388523.96000000066,-2280.1300000000047
19444,2022-06-30 08:20:00,-1500.82,384743.01000000065,388523.96000000066,-3780.9500000000116
19445,2022-06-30 08:25:00,1017.69,385760.70000000065,388523.96000000066,-2763.2600000000093
19446,2022-06-30 08:30:00,1082.92,386843.62000000064,388523.96000000066,-1680.3400000000256
19447,2022-06-30 08:35:00,-930.42,385913.20000000065,388523.96000000066,-2610.7600000000093
19448,2022-06-30 08:40:00,1990.89,387904.09000000067,388523.96000000066,-619.8699999999953
19449,2022-06-30 08:45:00,-1425.98,386478.1100000007,388523.96000000066,-2045.8499999999767
19450,2022-06-30 08:50:00,-295.09,386183.02000000066,388523.96000000066,-2340.9400000000023
19451,2022-06-30 08:55:00,1262.67,387445.69000000064,388523.96000000066,-1078.2700000000186
19452,2022-06-30 09:00:00,276.42,387722.1100000006,388523.96000000066,-801.8500000000349
19453,2022-06-30 09:05:00,1894.24,389616.3500000006,388523.96000000066,1092.3899999999558
19454,2022-06-30 09:10:00,-1790.7,387825.6500000006,388523.96000000066,-698.3100000000559
19455,2022-06-30 09:15:00,-1944.35,385881.3000000006,388523.96000000066,-2642.6600000000326
19456,2022-06-30 09:20:00,140.98,386022.2800000006,388523.96000000066,-2501.680000000051
19457,2022-06-30 09:25:00,-1524.81,384497.4700000006,388523.96000000066,-4026.490000000049
19458,2022-06-30 09:30:00,-1917.44,382580.0300000006,388523.96000000066,-5943.930000000051
19459,2022-06-30 09:35:00,781.89,383361.9200000006,388523.96000000066,-5162.040000000037
19460,2022-06-30 09:40:00,443.26,383805.18000000063,388523.96000000066,-4718.780000000028
19461,2022-06-30 09:45:00,1330.19,385135.37000000064,388523.96000000066,-3388.5900000000256
19462,2022-06-30 09:50:00,-837.75,384297.62000000064,388523.96000000066,-4226.340000000026
19463,2022-06-30 09:55:00,1488.01,385785.63000000064,388523.96000000066,-2738.3300000000163
19464,2022-06-30 10:00:00,-594.22,385191.4100000007,388523.96000000066,-3332.5499999999884
19465,2022-06-30 10:05:00,815.34,386006.7500000007,388523.96000000066,-2517.2099999999627
19466,2022-06-30 10:10:00,608.91,386615.6600000007,388523.96000000066,-1908.2999999999884
19467,2022-06-30 10:15:00,597.75,387213.4100000007,388523.96000000066,-1310.5499999999884
19468,2022-06-30 10:20:00,1087.91,388301.32000000065,388523.96000000066,-222.64000000001397
19469,2022-06-30 10:25:00,-497.75,387803.57000000065,388523.96000000066,-720.390000000014
19470,2022-06-30 10:30:00,-1783.43,386020.14000000065,388523.96000000066,-2503.820000000007
19471,2022-06-30 10:35:00,1377.62,387397.76000000065,388523.96000000066,-1126.2000000000116
19472,2022-06-30 10:40:00,-1830.45,385567.31000000064,388523.96000000066,-2956.6500000000233
19473,2022-06-30 10:45:00,528.59,386095.90000000066,388523.96000000066,-2428.0599999999977
19474,2022-06-30 10:50:00,-360.33,385735.57000000065,388523.96000000066,-2788.390000000014
19475,2022-06-30 10:55:00,-1471.27,384264.3000000006,388523.96000000066,-4259.660000000033
19476,2022-06-30 11:00:00,-1470.85,382793.45000000065,388523.96000000066,-5730.510000000009
19477,2022-06-30 11:05:00,-204.15,382589.3000000006,388523.96000000066,-5934.660000000033
19478,2022-06-30 11:10:00,-376.23,382213.07000000065,388523.96000000066,-6310.890000000014
19479,2022-06-30 11:15:00,1675.41,383888.4800000006,388523.96000000066,-4635.48000000004
19480,2022-06-30 11:20:00,-1852.54,382035.94000000064,388523.96000000066,-6488.020000000019
19481,2022-06-30 11:25:00,1895.0,383930.94000000064,388523.96000000066,-4593.020000000019
19482,2022-06-30 11:30:00,558.37,384489.31000000064,388523.96000000066,-4034.6500000000233
19483,2022-06-30 11:35:00,-1526.44,382962.87000000064,388523.96000000066,-5561.090000000026
19484,2022-06-30 11:40:00,-1772.81,381190.06000000064,388523.96000000066,-7333.900000000023
19485,2022-06-30 11:45:00,-509.26,380680.8000000006,388523.96000000066,-7843.160000000033
19486,2022-06-30 11:50:00,-491.76,380189.0400000006,388523.96000000066,-8334.920000000042
19487,2022-06-30 11:55:00,-1468.87,378720.1700000006,388523.96000000066,-9803.790000000037
19488,2022-06-30 12:00:00,-1025.57,377694.6000000006,388523.96000000066,-10829.360000000044
19489,2022-06-30 12:05:00,415.32,378109.9200000006,388523.96000000066,-10414.040000000037
19490,2022-06-30 12:10:00,-1287.21,376822.7100000006,388523.96000000066,-11701.250000000058
19491,2022-06-30 12:15:00,833.03,377655.74000000063,388523.96000000066,-10868.22000000003
19492,2022-06-30 12:20:00,1720.7,379376.44000000064,388523.96000000066,-9147.520000000019
19493,2022-06-30 12:25:00,1989.17,381365.6100000006,388523.96000000066,-7158.350000000035
19494,2022-06-30 12:30:00,19.87,381385.4800000006,388523.96000000066,-7138.48000000004
19495,2022-06-30 12:35:00,-1888.79,379496.69000000064,388523.96000000066,-9027.270000000019
19496,2022-06-30 12:40:00,438.51,379935.20000000065,388523.96000000066,-8588.76000000001
19497,2022-06-30 12:45:00,1466.97,381402.1700000006,388523.96000000066,-7121.790000000037
19498,2022-06-30 12:50:00,-997.01,380405.1600000006,388523.96000000066,-8118.800000000047
19499,2022-06-30 12:55:00,1242.4,381647.56000000064,388523.96000000066,-6876.400000000023
19500,2022-06-30 13:00:00,1334.88,382982.44000000064,388523.96000000066,-5541.520000000019
19501,2022-06-30 13:05:00,159.49,383141.93000000063,388523.96000000066,-5382.030000000028
19502,2022-06-30 13:10:00,-498.77,382643.1600000006,388523.96000000066,-5880.800000000047
19503,2022-06-30 13:15:00,-90.53,382552.6300000006,388523.96000000066,-5971.3300000000745
19504,2022-06-30 13:20:00,321.5,382874.1300000006,388523.96000000066,-5649.8300000000745
19505,2022-06-30 13:25:00,-1008.09,381866.04000000056,388523.96000000066,-6657.9200000001
19506,2022-06-30 13:30:00,945.01,382811.05000000057,388523.96000000066,-5712.910000000091
19507,2022-06-30 13:35:00,1440.88,384251.9300000006,388523.96000000066,-4272.030000000086
19508,2022-06-30 13:40:00,-800.32,383451.61000000057,388523.96000000066,-5072.350000000093
19509,2022-06-30 13:45:00,-1993.04,381458.5700000006,388523.96000000066,-7065.390000000072
19510,2022-06-30 13:50:00,214.1,381672.67000000057,388523.96000000066,-6851.2900000000955
19511,2022-06-30 13:55:00,1240.4,382913.0700000006,388523.96000000066,-5610.890000000072
19512,2022-06-30 14:00:00,564.73,383477.80000000057,388523.96000000066,-5046.160000000091
19513,2022-06-30 14:05:00,-1574.34,381903.46000000054,388523.96000000066,-6620.500000000116
19514,2022-06-30 14:10:00,486.78,382390.2400000006,388523.96000000066,-6133.7200000000885
19515,2022-06-30 14:15:00,-1914.76,380475.48000000056,388523.96000000066,-8048.480000000098
19516,2022-06-30 14:20:00,405.01,380880.4900000006,388523.96000000066,-7643.4700000000885
19517,2022-06-30 14:25:00,500.16,381380.65000000055,388523.96000000066,-7143.310000000114
19518,2022-06-30 14:30:00,-1138.9,380241.7500000005,388523.96000000066,-8282.210000000137
19519,2022-06-30 14:35:00,1362.05,381603.8000000005,388523.96000000066,-6920.160000000149
19520,2022-06-30 14:40:00,-311.06,381292.7400000005,388523.96000000066,-7231.220000000147
19521,2022-06-30 14:45:00,182.12,381474.8600000005,388523.96000000066,-7049.100000000151
19522,2022-06-30 14:50:00,-1146.37,380328.4900000005,388523.96000000066,-8195.470000000147
19523,2022-06-30 14:55:00,275.61,380604.1000000005,388523.96000000066,-7919.860000000161
19524,2022-06-30 15:00:00,-1296.02,379308.0800000005,388523.96000000066,-9215.88000000018
19525,2022-06-30 15:05:00,-433.57,378874.5100000005,388523.96000000066,-9649.450000000186
19526,2022-06-30 15:10:00,73.35,378947.86000000045,388523.96000000066,-9576.10000000021
19527,2022-06-30 15:15:00,1369.79,380317.65000000043,388523.96000000066,-8206.31000000023
19528,2022-06-30 15:20:00,-361.68,379955.97000000044,388523.96000000066,-8567.990000000224
19529,2022-06-30 15:25:00,-272.37,379683.60000000044,388523.96000000066,-8840.360000000219
19530,2022-06-30 15:30:00,-1459.49,378224.11000000045,388523.96000000066,-10299.85000000021
19531,2022-06-30 15:35:00,1358.62,379582.73000000045,388523.96000000066,-8941.230000000214
19532,2022-06-30 15:40:00,1570.21,381152.94000000047,388523.96000000066,-7371.020000000193
19533,2022-06-30 15:45:00,-1085.4,380067.54000000044,388523.96000000066,-8456.420000000217
19534,2022-06-30 15:50:00,1031.47,381099.0100000004,388523.96000000066,-7424.9500000002445
19535,2022-06-30 15:55:00,-1547.21,379551.8000000004,388523.96000000066,-8972.160000000265
19536,2022-06-30 16:00:00,-614.16,378937.6400000004,388523.96000000066,-9586.32000000024
19537,2022-06-30 16:05:00,644.43,379582.0700000004,388523.96000000066,-8941.890000000247
19538,2022-06-30 16:10:00,1411.87,380993.9400000004,388523.96000000066,-7530.0200000002515
19539,2022-06-30 16:15:00,1573.13,382567.0700000004,388523.96000000066,-5956.890000000247
19540,2022-06-30 16:20:00,-514.63,382052.4400000004,388523.96000000066,-6471.5200000002515
19541,2022-06-30 16:25:00,-1542.2,380510.2400000004,388523.96000000066,-8013.720000000263
19542,2022-06-30 16:30:00,1359.47,381869.71000000037,388523.96000000066,-6654.250000000291
19543,2022-06-30 16:35:00,682.96,382552.6700000004,388523.96000000066,-5971.29000000027
19544,2022-06-30 16:40:00,-246.24,382306.4300000004,388523.96000000066,-6217.530000000261
19545,2022-06-30 16:45:00,396.9,382703.3300000004,388523.96000000066,-5820.6300000002375
19546,2022-06-30 16:50:00,-1528.64,381174.6900000004,388523.96000000066,-7349.2700000002515
19547,2022-06-30 16:55:00,1970.79,383145.4800000004,388523.96000000066,-5378.480000000272
19548,2022-07-01 08:00:00,840.52,383986.0000000004,383145.4800000004,840.5200000000186
19549,2022-07-01 08:05:00,-577.88,383408.1200000004,383145.4800000004,262.64000000001397
19550,2022-07-01 08:10:00,820.99,384229.1100000004,383145.4800000004,1083.6300000000047
19551,2022-07-01 08:15:00,-230.53,383998.58000000037,383145.4800000004,853.0999999999767
19552,2022-07-01 08:20:00,-383.78,383614.80000000034,383145.4800000004,469.3199999999488
19553,2022-07-01 08:25:00,595.12,384209.92000000033,383145.4800000004,1064.4399999999441
19554,2022-07-01 08:30:00,-258.39,383951.5300000003,383145.4800000004,806.0499999999302
19555,2022-07-01 08:35:00,129.16,384080.6900000003,383145.4800000004,935.2099999999045
19556,2022-07-01 08:40:00,-1829.61,382251.0800000003,383145.4800000004,-894.4000000000815
19557,2022-07-01 08:45:00,-383.98,381867.1000000003,383145.4800000004,-1278.3800000000629
19558,2022-07-01 08:50:00,497.34,382364.44000000035,383145.4800000004,-781.0400000000373
19559,2022-07-01 08:55:00,495.1,382859.5400000003,383145.4800000004,-285.94000000006054
19560,2022-07-01 09:00:00,-1045.14,381814.4000000003,383145.4800000004,-1331.0800000000745
19561,2022-07-01 09:05:00,1614.98,383429.3800000003,383145.4800000004,283.89999999990687
19562,2022-07-01 09:10:00,1658.27,385087.6500000003,383145.4800000004,1942.1699999999255
19563,2022-07-01 09:15:00,-460.62,384627.0300000003,383145.4800000004,1481.5499999999302
19564,2022-07-01 09:20:00,-392.05,384234.98000000033,383145.4800000004,1089.4999999999418
19565,2022-07-01 09:25:00,-1335.47,382899.51000000036,383145.4800000004,-245.97000000003027
19566,2022-07-01 09:30:00,471.14,383370.6500000004,383145.4800000004,225.1699999999837
19567,2022-07-01 09:35:00,-1099.79,382270.8600000004,383145.4800000004,-874.6199999999953
19568,2022-07-01 09:40:00,-1587.86,380683.0000000004,383145.4800000004,-2462.4799999999814
19569,2022-07-01 09:45:00,-1551.99,379131.0100000004,383145.4800000004,-4014.469999999972
19570,2022-07-01 09:50:00,1350.35,380481.3600000004,383145.4800000004,-2664.1199999999953
19571,2022-07-01 09:55:00,-784.75,379696.6100000004,383145.4800000004,-3448.8699999999953
19572,2022-07-01 10:00:00,-1214.75,378481.8600000004,383145.4800000004,-4663.619999999995
19573,2022-07-01 10:05:00,-1993.13,376488.7300000004,383145.4800000004,-6656.75
19574,2022-07-01 10:10:00,1225.17,377713.9000000004,383145.4800000004,-5431.580000000016
19575,2022-07-01 10:15:00,-1493.03,376220.87000000034,383145.4800000004,-6924.610000000044
19576,2022-07-01 10:20:00,-1577.69,374643.18000000034,383145.4800000004,-8502.300000000047
19577,2022-07-01 10:25:00,563.54,375206.7200000003,383145.4800000004,-7938.7600000000675
19578,2022-07-01 10:30:00,582.35,375789.0700000003,383145.4800000004,-7356.410000000091
19579,2022-07-01 10:35:00,1110.13,376899.2000000003,383145.4800000004,-6246.280000000086
19580,2022-07-01 10:40:00,-73.25,376825.9500000003,383145.4800000004,-6319.530000000086
19581,2022-07-01 10:45:00,-488.61,376337.3400000003,383145.4800000004,-6808.140000000072
19582,2022-07-01 10:50:00,-124.29,376213.05000000034,383145.4800000004,-6932.430000000051
19583,2022-07-01 10:55:00,866.35,377079.4000000003,383145.4800000004,-6066.0800000000745
19584,2022-07-01 11:00:00,950.18,378029.5800000003,383145.4800000004,-5115.9000000000815
19585,2022-07-01 11:05:00,57.14,378086.7200000003,383145.4800000004,-5058.7600000000675
19586,2022-07-01 11:10:00,-1265.35,376821.37000000034,383145.4800000004,-6324.110000000044
19587,2022-07-01 11:15:00,1059.74,377881.11000000034,383145.4800000004,-5264.370000000054
19588,2022-07-01 11:20:00,-470.84,377410.2700000003,383145.4800000004,-5735.210000000079
19589,2022-07-01 11:25:00,-646.14,376764.1300000003,383145.4800000004,-6381.350000000093
19590,2022-07-01 11:30:00,-1109.51,375654.6200000003,383145.4800000004,-7490.860000000102
19591,2022-07-01 11:35:00,1525.01,377179.6300000003,383145.4800000004,-5965.850000000093
19592,2022-07-01 11:40:00,-283.06,376896.5700000003,383145.4800000004,-6248.910000000091
19593,2022-07-01 11:45:00,-1308.71,375587.8600000003,383145.4800000004,-7557.620000000112
19594,2022-07-01 11:50:00,1876.73,377464.59000000026,383145.4800000004,-5680.89000000013
19595,2022-07-01 11:55:00,132.33,377596.9200000003,383145.4800000004,-5548.560000000114
19596,2022-07-01 12:00:00,35.5,377632.4200000003,383145.4800000004,-5513.060000000114
19597,2022-07-01 12:05:00,358.51,377990.9300000003,383145.4800000004,-5154.550000000105
19598,2022-07-01 12:10:00,-945.91,377045.0200000003,383145.4800000004,-6100.460000000079
19599,2022-07-01 12:15:00,-311.68,376733.3400000003,383145.4800000004,-6412.140000000072
19600,2022-07-01 12:20:00,-305.59,376427.7500000003,383145.4800000004,-6717.730000000098
19601,2022-07-01 12:25:00,-238.99,376188.7600000003,383145.4800000004,-6956.7200000000885
19602,2022-07-01 12:30:00,-1153.08,375035.6800000003,383145.4800000004,-8109.800000000105
19603,2022-07-01 12:35:00,-1079.79,373955.8900000003,383145.4800000004,-9189.590000000084
19604,2022-07-01 12:40:00,-1413.37,372542.5200000003,383145.4800000004,-10602.96000000008
19605,2022-07-01 12:45:00,1617.58,374160.1000000003,383145.4800000004,-8985.380000000063
19606,2022-07-01 12:50:00,-1804.46,372355.6400000003,383145.4800000004,-10789.840000000084
19607,2022-07-01 12:55:00,846.55,373202.1900000003,383145.4800000004,-9943.290000000095
19608,2022-07-01 13:00:00,-710.41,372491.7800000003,383145.4800000004,-10653.70000000007
19609,2022-07-01 13:05:00,-1649.58,370842.2000000003,383145.4800000004,-12303.280000000086
19610,2022-07-01 13:10:00,-939.34,369902.8600000003,383145.4800000004,-13242.620000000112
19611,2022-07-01 13:15:00,498.15,370401.0100000003,383145.4800000004,-12744.470000000088
19612,2022-07-01 13:20:00,-116.73,370284.2800000003,383145.4800000004,-12861.20000000007
19613,2022-07-01 13:25:00,-659.18,369625.1000000003,383145.4800000004,-13520.380000000063
19614,2022-07-01 13:30:00,-663.54,368961.56000000035,383145.4800000004,-14183.920000000042
19615,2022-07-01 13:35:00,-695.77,368265.7900000003,383145.4800000004,-14879.69000000006
19616,2022-07-01 13:40:00,1077.08,369342.87000000034,383145.4800000004,-13802.610000000044
19617,2022-07-01 13:45:00,378.76,369721.63000000035,383145.4800000004,-13423.850000000035
19618,2022-07-01 13:50:00,518.85,370240.48000000033,383145.4800000004,-12905.000000000058
19619,2022-07-01 13:55:00,1811.73,372052.2100000003,383145.4800000004,-11093.270000000077
19620,2022-07-01 14:00:00,-1431.68,370620.5300000003,383145.4800000004,-12524.95000000007
19621,2022-07-01 14:05:00,-1148.25,369472.2800000003,383145.4800000004,-13673.20000000007
19622,2022-07-01 14:10:00,771.49,370243.7700000003,383145.4800000004,-12901.71000000008
19623,2022-07-01 14:15:00,786.4,371030.17000000033,383145.4800000004,-12115.310000000056
19624,2022-07-01 14:20:00,816.42,371846.5900000003,383145.4800000004,-11298.890000000072
19625,2022-07-01 14:25:00,1251.99,373098.5800000003,383145.4800000004,-10046.900000000081
19626,2022-07-01 14:30:00,1603.07,374701.6500000003,383145.4800000004,-8443.830000000075
19627,2022-07-01 14:35:00,-1228.95,373472.7000000003,383145.4800000004,-9672.780000000086
19628,2022-07-01 14:40:00,-1742.73,371729.9700000003,383145.4800000004,-11415.510000000068
19629,2022-07-01 14:45:00,-997.47,370732.50000000035,383145.4800000004,-12412.98000000004
19630,2022-07-01 14:50:00,-1243.82,369488.68000000034,383145.4800000004,-13656.800000000047
19631,2022-07-01 14:55:00,797.48,370286.1600000003,383145.4800000004,-12859.320000000065
19632,2022-07-01 15:00:00,1912.57,372198.73000000033,383145.4800000004,-10946.750000000058
19633,2022-07-01 15:05:00,-1527.95,370670.7800000003,383145.4800000004,-12474.70000000007
19634,2022-07-01 15:10:00,1867.4,372538.18000000034,383145.4800000004,-10607.300000000047
19635,2022-07-01 15:15:00,-1921.57,370616.61000000034,383145.4800000004,-12528.870000000054
19636,2022-07-01 15:20:00,-1480.01,369136.6000000003,383145.4800000004,-14008.880000000063
19637,2022-07-01 15:25:00,-1429.24,367707.36000000034,383145.4800000004,-15438.120000000054
19638,2022-07-01 15:30:00,-1333.77,366373.5900000003,383145.4800000004,-16771.890000000072
19639,2022-07-01 15:35:00,1431.18,367804.7700000003,383145.4800000004,-15340.71000000008
19640,2022-07-01 15:40:00,1866.94,369671.7100000003,383145.4800000004,-13473.770000000077
19641,2022-07-01 15:45:00,-794.06,368877.6500000003,383145.4800000004,-14267.830000000075
19642,2022-07-01 15:50:00,1933.03,370810.68000000034,383145.4800000004,-12334.800000000047
19643,2022-07-01 15:55:00,-1958.54,368852.14000000036,383145.4800000004,-14293.340000000026
19644,2022-07-01 16:00:00,-817.97,368034.1700000004,383145.4800000004,-15111.309999999998
19645,2022-07-01 16:05:00,285.67,368319.8400000004,383145.4800000004,-14825.640000000014
19646,2022-07-01 16:10:00,804.13,369123.9700000004,383145.4800000004,-14021.51000000001
19647,2022-07-01 16:15:00,-1797.61,367326.3600000004,383145.4800000004,-15819.119999999995
19648,2022-07-01 16:20:00,-710.72,366615.6400000004,383145.4800000004,-16529.839999999967
19649,2022-07-01 16:25:00,139.44,366755.0800000004,383145.4800000004,-16390.399999999965
19650,2022-07-01 16:30:00,67.14,366822.22000000044,383145.4800000004,-16323.259999999951
19651,2022-07-01 16:35:00,-260.76,366561.4600000004,383145.4800000004,-16584.01999999996
19652,2022-07-01 16:40:00,611.94,367173.40000000043,383145.4800000004,-15972.079999999958
19653,2022-07-01 16:45:00,797.53,367970.93000000046,383145.4800000004,-15174.54999999993
19654,2022-07-01 16:50:00,-1607.49,366363.44000000047,383145.4800000004,-16782.03999999992
19655,2022-07-01 16:55:00,-691.01,365672.43000000046,383145.4800000004,-17473.04999999993
19656,2022-07-02 08:00:00,-339.41,365333.0200000005,365672.43000000046,-339.4099999999744
19657,2022-07-02 08:05:00,-880.82,364452.2000000005,365672.43000000046,-1220.2299999999814
19658,2022-07-02 08:10:00,-1065.62,363386.5800000005,365672.43000000046,-2285.8499999999767
19659,2022-07-02 08:15:00,-1945.56,361441.0200000005,365672.43000000046,-4231.409999999974
19660,2022-07-02 08:20:00,1429.03,362870.0500000005,365672.43000000046,-2802.3799999999464
19661,2022-07-02 08:25:00,-77.8,362792.2500000005,365672.43000000046,-2880.179999999935
19662,2022-07-02 08:30:00,637.37,363429.6200000005,365672.43000000046,-2242.8099999999395
19663,2022-07-02 08:35:00,-1689.27,361740.3500000005,365672.43000000046,-3932.079999999958
19664,2022-07-02 08:40:00,-1200.73,360539.6200000005,365672.43000000046,-5132.8099999999395
19665,2022-07-02 08:45:00,-949.02,359590.6000000005,365672.43000000046,-6081.829999999958
19666,2022-07-02 08:50:00,-1394.97,358195.6300000005,365672.43000000046,-7476.79999999993
19667,2022-07-02 08:55:00,571.58,358767.21000000054,365672.43000000046,-6905.219999999914
19668,2022-07-02 09:00:00,-1911.25,356855.96000000054,365672.43000000046,-8816.469999999914
19669,2022-07-02 09:05:00,138.22,356994.1800000005,365672.43000000046,-8678.249999999942
19670,2022-07-02 09:10:00,1478.19,358472.3700000005,365672.43000000046,-7200.0599999999395
19671,2022-07-02 09:15:00,722.07,359194.4400000005,365672.43000000046,-6477.9899999999325
19672,2022-07-02 09:20:00,870.56,360065.0000000005,365672.43000000046,-5607.429999999935
19673,2022-07-02 09:25:00,-136.75,359928.2500000005,365672.43000000046,-5744.179999999935
19674,2022-07-02 09:30:00,-844.34,359083.9100000005,365672.43000000046,-6588.51999999996
19675,2022-07-02 09:35:00,612.34,359696.2500000005,365672.43000000046,-5976.179999999935
19676,2022-07-02 09:40:00,-1463.24,358233.01000000053,365672.43000000046,-7439.4199999999255
19677,2022-07-02 09:45:00,-552.97,357680.04000000056,365672.43000000046,-7992.389999999898
19678,2022-07-02 09:50:00,-704.4,356975.64000000054,365672.43000000046,-8696.78999999992
19679,2022-07-02 09:55:00,-958.28,356017.3600000005,365672.43000000046,-9655.069999999949
19680,2022-07-02 10:00:00,-314.23,355703.1300000005,365672.43000000046,-9969.29999999993
19681,2022-07-02 10:05:00,-1690.77,354012.3600000005,365672.43000000046,-11660.069999999949
19682,2022-07-02 10:10:00,980.34,354992.70000000054,365672.43000000046,-10679.729999999923
19683,2022-07-02 10:15:00,1740.89,356733.59000000055,365672.43000000046,-8938.83999999991
19684,2022-07-02 10:20:00,380.93,357114.52000000054,365672.43000000046,-8557.909999999916
19685,2022-07-02 10:25:00,41.24,357155.76000000053,365672.43000000046,-8516.669999999925
19686,2022-07-02 10:30:00,-1142.39,356013.3700000005,365672.43000000046,-9659.05999999994
19687,2022-07-02 10:35:00,-1167.19,354846.1800000005,365672.43000000046,-10826.249999999942
19688,2022-07-02 10:40:00,1907.51,356753.6900000005,365672.43000000046,-8918.739999999932
19689,2022-07-02 10:45:00,-1378.1,355375.59000000055,365672.43000000046,-10296.83999999991
19690,2022-07-02 10:50:00,-643.7,354731.89000000054,365672.43000000046,-10940.53999999992
19691,2022-07-02 10:55:00,1947.74,356679.6300000005,365672.43000000046,-8992.79999999993
19692,2022-07-02 11:00:00,1480.54,358160.1700000005,365672.43000000046,-7512.259999999951
19693,2022-07-02 11:05:00,-19.38,358140.7900000005,365672.43000000046,-7531.639999999956
19694,2022-07-02 11:10:00,821.75,358962.5400000005,365672.43000000046,-6709.889999999956
19695,2022-07-02 11:15:00,-1041.76,357920.7800000005,365672.43000000046,-7751.649999999965
19696,2022-07-02 11:20:00,-923.93,356996.8500000005,365672.43000000046,-8675.579999999958
19697,2022-07-02 11:25:00,-617.69,356379.1600000005,365672.43000000046,-9293.26999999996
19698,2022-07-02 11:30:00,433.13,356812.2900000005,365672.43000000046,-8860.139999999956
19699,2022-07-02 11:35:00,650.93,357463.2200000005,365672.43000000046,-8209.209999999963
19700,2022-07-02 11:40:00,1659.99,359123.2100000005,365672.43000000046,-6549.219999999972
19701,2022-07-02 11:45:00,-1338.84,357784.37000000046,365672.43000000046,-7888.059999999998
19702,2022-07-02 11:50:00,1565.55,359349.92000000045,365672.43000000046,-6322.510000000009
19703,2022-07-02 11:55:00,-832.31,358517.61000000045,365672.43000000046,-7154.820000000007
19704,2022-07-02 12:00:00,823.12,359340.73000000045,365672.43000000046,-6331.700000000012
19705,2022-07-02 12:05:00,1685.17,361025.90000000043,365672.43000000046,-4646.530000000028
19706,2022-07-02 12:10:00,948.48,361974.3800000004,365672.43000000046,-3698.0500000000466
19707,2022-07-02 12:15:00,-1998.36,359976.0200000004,365672.43000000046,-5696.410000000033
19708,2022-07-02 12:20:00,1695.22,361671.2400000004,365672.43000000046,-4001.1900000000605
19709,2022-07-02 12:25:00,915.73,362586.9700000004,365672.43000000046,-3085.460000000079
19710,2022-07-02 12:30:00,-1926.27,360660.70000000036,365672.43000000046,-5011.730000000098
19711,2022-07-02 12:35:00,-1828.21,358832.49000000034,365672.43000000046,-6839.940000000119
19712,2022-07-02 12:40:00,1531.98,360364.4700000003,365672.43000000046,-5307.960000000137
19713,2022-07-02 12:45:00,-1697.1,358667.37000000034,365672.43000000046,-7005.060000000114
19714,2022-07-02 12:50:00,-539.98,358127.39000000036,365672.43000000046,-7545.0400000000955
19715,2022-07-02 12:55:00,-1875.72,356251.6700000004,365672.43000000046,-9420.760000000068
19716,2022-07-02 13:00:00,701.32,356952.9900000004,365672.43000000046,-8719.44000000006
19717,2022-07-02 13:05:00,1597.25,358550.2400000004,365672.43000000046,-7122.1900000000605
19718,2022-07-02 13:10:00,-401.19,358149.0500000004,365672.43000000046,-7523.380000000063
19719,2022-07-02 13:15:00,-879.74,357269.3100000004,365672.43000000046,-8403.120000000054
19720,2022-07-02 13:20:00,485.35,357754.6600000004,365672.43000000046,-7917.770000000077
19721,2022-07-02 13:25:00,-308.81,357445.8500000004,365672.43000000046,-8226.580000000075
19722,2022-07-02 13:30:00,762.74,358208.5900000004,365672.43000000046,-7463.840000000084
19723,2022-07-02 13:35:00,-1869.6,356338.9900000004,365672.43000000046,-9333.44000000006
19724,2022-07-02 13:40:00,-227.84,356111.1500000004,365672.43000000046,-9561.280000000086
19725,2022-07-02 13:45:00,1395.95,357507.1000000004,365672.43000000046,-8165.3300000000745
19726,2022-07-02 13:50:00,1083.96,358591.0600000004,365672.43000000046,-7081.370000000054
19727,2022-07-02 13:55:00,494.13,359085.1900000004,365672.43000000046,-6587.240000000049
19728,2022-07-02 14:00:00,-846.75,358238.4400000004,365672.43000000046,-7433.990000000049
19729,2022-07-02 14:05:00,-686.67,357551.7700000004,365672.43000000046,-8120.660000000033
19730,2022-07-02 14:10:00,361.11,357912.8800000004,365672.43000000046,-7759.550000000047
19731,2022-07-02 14:15:00,-1573.08,356339.8000000004,365672.43000000046,-9332.630000000063
19732,2022-07-02 14:20:00,-1798.63,354541.1700000004,365672.43000000046,-11131.260000000068
19733,2022-07-02 14:25:00,1054.19,355595.3600000004,365672.43000000046,-10077.070000000065
19734,2022-07-02 14:30:00,-1005.02,354590.3400000004,365672.43000000046,-11082.090000000084
19735,2022-07-02 14:35:00,434.39,355024.7300000004,365672.43000000046,-10647.70000000007
19736,2022-07-02 14:40:00,-1777.97,353246.7600000004,365672.43000000046,-12425.670000000042
19737,2022-07-02 14:45:00,1961.52,355208.28000000044,365672.43000000046,-10464.150000000023
19738,2022-07-02 14:50:00,-1548.92,353659.36000000045,365672.43000000046,-12013.070000000007
19739,2022-07-02 14:55:00,489.17,354148.53000000044,365672.43000000046,-11523.900000000023
19740,2022-07-02 15:00:00,1168.32,355316.85000000044,365672.43000000046,-10355.580000000016
19741,2022-07-02 15:05:00,377.54,355694.3900000004,365672.43000000046,-9978.040000000037
19742,2022-07-02 15:10:00,-395.05,355299.34000000043,365672.43000000046,-10373.090000000026
19743,2022-07-02 15:15:00,-26.26,355273.0800000004,365672.43000000046,-10399.350000000035
19744,2022-07-02 15:20:00,1216.64,356489.72000000044,365672.43000000046,-9182.710000000021
19745,2022-07-02 15:25:00,-1650.19,354839.53000000044,365672.43000000046,-10832.900000000023
19746,2022-07-02 15:30:00,-1666.76,353172.7700000004,365672.43000000046,-12499.660000000033
19747,2022-07-02 15:35:00,-238.54,352934.23000000045,365672.43000000046,-12738.200000000012
19748,2022-07-02 15:40:00,1788.88,354723.11000000045,365672.43000000046,-10949.320000000007
19749,2022-07-02 15:45:00,239.33,354962.44000000047,365672.43000000046,-10709.98999999999
19750,2022-07-02 15:50:00,-1363.67,353598.7700000005,365672.43000000046,-12073.659999999974
19751,2022-07-02 15:55:00,906.63,354505.4000000005,365672.43000000046,-11167.02999999997
19752,2022-07-02 16:00:00,521.32,355026.7200000005,365672.43000000046,-10645.709999999963
19753,2022-07-02 16:05:00,1645.68,356672.4000000005,365672.43000000046,-9000.02999999997
19754,2022-07-02 16:10:00,-1995.59,354676.81000000046,365672.43000000046,-10995.619999999995
19755,2022-07-02 16:15:00,1766.0,356442.81000000046,365672.43000000046,-9229.619999999995
19756,2022-07-02 16:20:00,1954.15,358396.9600000005,365672.43000000046,-7275.469999999972
19757,2022-07-02 16:25:00,-559.81,357837.1500000005,365672.43000000046,-7835.27999999997
19758,2022-07-02 16:30:00,821.44,358658.5900000005,365672.43000000046,-7013.839999999967
19759,2022-07-02 16:35:00,-835.51,357823.0800000005,365672.43000000046,-7849.349999999977
19760,2022-07-02 16:40:00,15.75,357838.8300000005,365672.43000000046,-7833.599999999977
19761,2022-07-02 16:45:00,-853.63,356985.2000000005,365672.43000000046,-8687.229999999981
19762,2022-07-02 16:50:00,-1043.56,355941.6400000005,365672.43000000046,-9730.789999999979
19763,2022-07-02 16:55:00,136.75,356078.3900000005,365672.43000000046,-9594.039999999979
19764,2022-07-03 08:00:00,-548.98,355529.4100000005,356078.3900000005,-548.9799999999814
19765,2022-07-03 08:05:00,1311.49,356840.9000000005,356078.3900000005,762.5100000000093
19766,2022-07-03 08:10:00,-703.83,356137.0700000005,356078.3900000005,58.679999999993015
19767,2022-07-03 08:15:00,-1252.25,354884.8200000005,356078.3900000005,-1193.570000000007
19768,2022-07-03 08:20:00,-758.35,354126.4700000005,356078.3900000005,-1951.9199999999837
19769,2022-07-03 08:25:00,397.21,354523.6800000005,356078.3900000005,-1554.7099999999627
19770,2022-07-03 08:30:00,-949.96,353573.7200000005,356078.3900000005,-2504.6699999999837
19771,2022-07-03 08:35:00,1539.97,355113.69000000047,356078.3900000005,-964.7000000000116
19772,2022-07-03 08:40:00,-221.36,354892.3300000005,356078.3900000005,-1186.0599999999977
19773,2022-07-03 08:45:00,-750.26,354142.0700000005,356078.3900000005,-1936.320000000007
19774,2022-07-03 08:50:00,606.76,354748.8300000005,356078.3900000005,-1329.5599999999977
19775,2022-07-03 08:55:00,1026.81,355775.6400000005,356078.3900000005,-302.75
19776,2022-07-03 09:00:00,1678.78,357454.4200000005,356078.3900000005,1376.030000000028
19777,2022-07-03 09:05:00,1588.84,359043.26000000053,356078.3900000005,2964.8700000000536
19778,2022-07-03 09:10:00,-1062.49,357980.77000000054,356078.3900000005,1902.3800000000629
19779,2022-07-03 09:15:00,-1564.14,356416.6300000005,356078.3900000005,338.2400000000489
19780,2022-07-03 09:20:00,1053.29,357469.9200000005,356078.3900000005,1391.530000000028
19781,2022-07-03 09:25:00,715.39,358185.3100000005,356078.3900000005,2106.920000000042
19782,2022-07-03 09:30:00,-1161.19,357024.1200000005,356078.3900000005,945.7300000000396
19783,2022-07-03 09:35:00,821.25,357845.3700000005,356078.3900000005,1766.9800000000396
19784,2022-07-03 09:40:00,-1989.99,355855.3800000005,356078.3900000005,-223.0099999999511
19785,2022-07-03 09:45:00,-1944.02,353911.3600000005,356078.3900000005,-2167.0299999999697
19786,2022-07-03 09:50:00,-403.81,353507.5500000005,356078.3900000005,-2570.8399999999674
19787,2022-07-03 09:55:00,-1487.15,352020.4000000005,356078.3900000005,-4057.9899999999907
19788,2022-07-03 10:00:00,664.57,352684.9700000005,356078.3900000005,-3393.4199999999837
19789,2022-07-03 10:05:00,-1501.21,351183.7600000005,356078.3900000005,-4894.630000000005
19790,2022-07-03 10:10:00,-1049.46,350134.30000000045,356078.3900000005,-5944.090000000026
19791,2022-07-03 10:15:00,-217.24,349917.06000000046,356078.3900000005,-6161.330000000016
19792,2022-07-03 10:20:00,718.3,350635.36000000045,356078.3900000005,-5443.030000000028
19793,2022-07-03 10:25:00,1058.65,351694.0100000005,356078.3900000005,-4384.380000000005
19794,2022-07-03 10:30:00,-944.81,350749.2000000005,356078.3900000005,-5329.190000000002
19795,2022-07-03 10:35:00,-107.79,350641.4100000005,356078.3900000005,-5436.979999999981
19796,2022-07-03 10:40:00,-1923.6,348717.8100000005,356078.3900000005,-7360.579999999958
19797,2022-07-03 10:45:00,139.63,348857.4400000005,356078.3900000005,-7220.949999999953
19798,2022-07-03 10:50:00,-1.22,348856.22000000055,356078.3900000005,-7222.1699999999255
19799,2022-07-03 10:55:00,1193.7,350049.92000000057,356078.3900000005,-6028.469999999914
19800,2022-07-03 11:00:00,-126.26,349923.66000000056,356078.3900000005,-6154.729999999923
19801,2022-07-03 11:05:00,-404.93,349518.73000000056,356078.3900000005,-6559.659999999916
19802,2022-07-03 11:10:00,1817.35,351336.08000000054,356078.3900000005,-4742.3099999999395
19803,2022-07-03 11:15:00,628.23,351964.3100000005,356078.3900000005,-4114.079999999958
19804,2022-07-03 11:20:00,1323.84,353288.15000000055,356078.3900000005,-2790.2399999999325
19805,2022-07-03 11:25:00,1579.14,354867.29000000056,356078.3900000005,-1211.0999999999185
19806,2022-07-03 11:30:00,-206.86,354660.4300000006,356078.3900000005,-1417.9599999999045
19807,2022-07-03 11:35:00,-1632.76,353027.67000000057,356078.3900000005,-3050.719999999914
19808,2022-07-03 11:40:00,-973.35,352054.3200000006,356078.3900000005,-4024.0699999998906
19809,2022-07-03 11:45:00,902.97,352957.29000000056,356078.3900000005,-3121.0999999999185
19810,2022-07-03 11:50:00,1701.53,354658.8200000006,356078.3900000005,-1419.5699999998906
19811,2022-07-03 11:55:00,1354.33,356013.1500000006,356078.3900000005,-65.23999999987427
19812,2022-07-03 12:00:00,1191.92,357205.0700000006,356078.3900000005,1126.6800000001094
19813,2022-07-03 12:05:00,-848.49,356356.5800000006,356078.3900000005,278.19000000011874
19814,2022-07-03 12:10:00,-1509.58,354847.0000000006,356078.3900000005,-1231.3899999998976
19815,2022-07-03 12:15:00,-1103.89,353743.11000000057,356078.3900000005,-2335.2799999999115
19816,2022-07-03 12:20:00,-333.04,353410.0700000006,356078.3900000005,-2668.3199999998906
19817,2022-07-03 12:25:00,-1639.91,351770.1600000006,356078.3900000005,-4308.229999999865
19818,2022-07-03 12:30:00,1056.96,352827.12000000064,356078.3900000005,-3251.269999999844
19819,2022-07-03 12:35:00,-998.6,351828.52000000066,356078.3900000005,-4249.869999999821
19820,2022-07-03 12:40:00,1196.47,353024.99000000063,356078.3900000005,-3053.3999999998487
19821,2022-07-03 12:45:00,1345.09,354370.08000000066,356078.3900000005,-1708.309999999823
19822,2022-07-03 12:50:00,-1166.96,353203.12000000064,356078.3900000005,-2875.269999999844
19823,2022-07-03 12:55:00,1854.15,355057.27000000066,356078.3900000005,-1021.1199999998207
19824,2022-07-03 13:00:00,175.13,355232.40000000066,356078.3900000005,-845.9899999998161
19825,2022-07-03 13:05:00,-1105.76,354126.64000000065,356078.3900000005,-1951.7499999998254
19826,2022-07-03 13:10:00,1135.65,355262.2900000007,356078.3900000005,-816.0999999998021
19827,2022-07-03 13:15:00,-1465.3,353796.9900000007,356078.3900000005,-2281.3999999997905
19828,2022-07-03 13:20:00,204.99,354001.9800000007,356078.3900000005,-2076.4099999997998
19829,2022-07-03 13:25:00,1422.69,355424.6700000007,356078.3900000005,-653.7199999997974
19830,2022-07-03 13:30:00,709.97,356134.64000000065,356078.3900000005,56.25000000017462
19831,2022-07-03 13:35:00,1567.79,357702.43000000063,356078.3900000005,1624.0400000001537
19832,2022-07-03 13:40:00,1775.59,359478.02000000066,356078.3900000005,3399.6300000001793
19833,2022-07-03 13:45:00,572.7,360050.72000000067,356078.3900000005,3972.330000000191
19834,2022-07-03 13:50:00,969.53,361020.2500000007,356078.3900000005,4941.860000000219
19835,2022-07-03 13:55:00,-1304.33,359715.9200000007,356078.3900000005,3637.5300000002026
19836,2022-07-03 14:00:00,678.94,360394.8600000007,356078.3900000005,4316.470000000205
19837,2022-07-03 14:05:00,280.48,360675.34000000067,356078.3900000005,4596.950000000186
19838,2022-07-03 14:10:00,-176.31,360499.03000000067,356078.3900000005,4420.640000000189
19839,2022-07-03 14:15:00,-256.81,360242.22000000067,356078.3900000005,4163.830000000191
19840,2022-07-03 14:20:00,874.0,361116.22000000067,356078.3900000005,5037.830000000191
19841,2022-07-03 14:25:00,419.78,361536.0000000007,356078.3900000005,5457.610000000219
19842,2022-07-03 14:30:00,-1264.96,360271.0400000007,356078.3900000005,4192.650000000198
19843,2022-07-03 14:35:00,-1977.46,358293.58000000066,356078.3900000005,2215.190000000177
19844,2022-07-03 14:40:00,1199.89,359493.47000000067,356078.3900000005,3415.080000000191
19845,2022-07-03 14:45:00,1969.89,361463.3600000007,356078.3900000005,5384.970000000205
19846,2022-07-03 14:50:00,-0.89,361462.47000000067,356078.3900000005,5384.080000000191
19847,2022-07-03 14:55:00,1433.68,362896.15000000066,356078.3900000005,6817.760000000184
19848,2022-07-03 15:00:00,-279.9,362616.25000000064,356078.3900000005,6537.860000000161
19849,2022-07-03 15:05:00,549.95,363166.20000000065,356078.3900000005,7087.810000000172
19850,2022-07-03 15:10:00,-1269.41,361896.7900000007,356078.3900000005,5818.400000000198
19851,2022-07-03 15:15:00,1546.34,363443.1300000007,356078.3900000005,7364.7400000002235
19852,2022-07-03 15:20:00,539.12,363982.2500000007,356078.3900000005,7903.860000000219
19853,2022-07-03 15:25:00,-1153.87,362828.3800000007,356078.3900000005,6749.9900000002235
19854,2022-07-03 15:30:00,1773.2,364601.5800000007,356078.3900000005,8523.190000000235
19855,2022-07-03 15:35:00,-1210.22,363391.36000000074,356078.3900000005,7312.970000000263
19856,2022-07-03 15:40:00,-1725.68,361665.68000000075,356078.3900000005,5587.29000000027
19857,2022-07-03 15:45:00,-1306.74,360358.94000000076,356078.3900000005,4280.550000000279
19858,2022-07-03 15:50:00,-885.4,359473.54000000074,356078.3900000005,3395.150000000256
19859,2022-07-03 15:55:00,-802.11,358671.43000000075,356078.3900000005,2593.04000000027
19860,2022-07-03 16:00:00,-824.65,357846.7800000007,356078.3900000005,1768.3900000002468
19861,2022-07-03 16:05:00,-593.01,357253.7700000007,356078.3900000005,1175.3800000002375
19862,2022-07-03 16:10:00,-229.52,357024.2500000007,356078.3900000005,945.8600000002189
19863,2022-07-03 16:15:00,1016.6,358040.8500000007,356078.3900000005,1962.4600000001956
19864,2022-07-03 16:20:00,-1331.3,356709.5500000007,356078.3900000005,631.1600000002072
19865,2022-07-03 16:25:00,1619.82,358329.3700000007,356078.3900000005,2250.980000000214
19866,2022-07-03 16:30:00,-788.7,357540.6700000007,356078.3900000005,1462.2800000002026
19867,2022-07-03 16:35:00,1696.95,359237.6200000007,356078.3900000005,3159.230000000214
19868,2022-07-03 16:40:00,120.97,359358.59000000067,356078.3900000005,3280.2000000001863
19869,2022-07-03 16:45:00,295.23,359653.82000000065,356078.3900000005,3575.4300000001676
19870,2022-07-03 16:50:00,-729.86,358923.96000000066,356078.3900000005,2845.5700000001816
19871,2022-07-03 16:55:00,-978.58,357945.38000000064,356078.3900000005,1866.9900000001653
19872,2022-07-04 08:00:00,1383.95,359329.33000000066,357945.38000000064,1383.9500000000116
19873,2022-07-04 08:05:00,-1180.88,358148.45000000065,357945.38000000064,203.07000000000698
19874,2022-07-04 08:10:00,203.97,358352.4200000006,357945.38000000064,407.03999999997905
19875,2022-07-04 08:15:00,944.06,359296.4800000006,357945.38000000064,1351.0999999999767
19876,2022-07-04 08:20:00,-1252.93,358043.5500000006,357945.38000000064,98.1699999999837
19877,2022-07-04 08:25:00,1384.77,359428.32000000065,357945.38000000064,1482.9400000000023
19878,2022-07-04 08:30:00,-840.73,358587.59000000067,357945.38000000064,642.210000000021
19879,2022-07-04 08:35:00,1161.57,359749.1600000007,357945.38000000064,1803.780000000028
19880,2022-07-04 08:40:00,68.2,359817.3600000007,357945.38000000064,1871.9800000000396
19881,2022-07-04 08:45:00,1150.53,360967.8900000007,357945.38000000064,3022.5100000000675
19882,2022-07-04 08:50:00,-695.81,360272.0800000007,357945.38000000064,2326.70000000007
19883,2022-07-04 08:55:00,-319.66,359952.42000000074,357945.38000000064,2007.0400000000955
19884,2022-07-04 09:00:00,1423.89,361376.31000000075,357945.38000000064,3430.9300000001094
19885,2022-07-04 09:05:00,-1618.88,359757.43000000075,357945.38000000064,1812.0500000001048
19886,2022-07-04 09:10:00,-575.8,359181.63000000076,357945.38000000064,1236.2500000001164
19887,2022-07-04 09:15:00,1269.1,360450.73000000074,357945.38000000064,2505.350000000093
19888,2022-07-04 09:20:00,1602.14,362052.87000000075,357945.38000000064,4107.490000000107
19889,2022-07-04 09:25:00,-1094.56,360958.31000000075,357945.38000000064,3012.9300000001094
19890,2022-07-04 09:30:00,-607.59,360350.7200000007,357945.38000000064,2405.340000000084
19891,2022-07-04 09:35:00,1347.38,361698.10000000073,357945.38000000064,3752.7200000000885
19892,2022-07-04 09:40:00,-676.48,361021.62000000075,357945.38000000064,3076.240000000107
19893,2022-07-04 09:45:00,-381.54,360640.0800000008,357945.38000000064,2694.700000000128
19894,2022-07-04 09:50:00,1447.28,362087.3600000008,357945.38000000064,4141.980000000156
19895,2022-07-04 09:55:00,-1904.19,360183.1700000008,357945.38000000064,2237.7900000001537
19896,2022-07-04 10:00:00,792.7,360975.8700000008,357945.38000000064,3030.4900000001653
19897,2022-07-04 10:05:00,-717.66,360258.21000000084,357945.38000000064,2312.830000000191
19898,2022-07-04 10:10:00,-1254.86,359003.35000000085,357945.38000000064,1057.970000000205
19899,2022-07-04 10:15:00,1175.2,360178.55000000086,357945.38000000064,2233.1700000002165
19900,2022-07-04 10:20:00,1655.13,361833.68000000087,357945.38000000064,3888.300000000221
19901,2022-07-04 10:25:00,907.31,362740.99000000086,357945.38000000064,4795.610000000219
19902,2022-07-04 10:30:00,750.88,363491.87000000087,357945.38000000064,5546.4900000002235
19903,2022-07-04 10:35:00,-56.19,363435.68000000087,357945.38000000064,5490.300000000221
19904,2022-07-04 10:40:00,-571.04,362864.6400000009,357945.38000000064,4919.260000000242
19905,2022-07-04 10:45:00,-697.95,362166.6900000009,357945.38000000064,4221.3100000002305
19906,2022-07-04 10:50:00,-1536.64,360630.05000000086,357945.38000000064,2684.6700000002165
19907,2022-07-04 10:55:00,820.62,361450.67000000086,357945.38000000064,3505.290000000212
19908,2022-07-04 11:00:00,0.68,361451.35000000085,357945.38000000064,3505.970000000205
19909,2022-07-04 11:05:00,1064.18,362515.53000000084,357945.38000000064,4570.150000000198
19910,2022-07-04 11:10:00,332.2,362847.73000000085,357945.38000000064,4902.35000000021
19911,2022-07-04 11:15:00,1089.92,363937.65000000084,357945.38000000064,5992.270000000193
19912,2022-07-04 11:20:00,952.5,364890.15000000084,357945.38000000064,6944.770000000193
19913,2022-07-04 11:25:00,1023.65,365913.80000000086,357945.38000000064,7968.4200000002165
19914,2022-07-04 11:30:00,1689.62,367603.42000000086,357945.38000000064,9658.040000000212
19915,2022-07-04 11:35:00,-1205.83,366397.59000000084,357945.38000000064,8452.210000000196
19916,2022-07-04 11:40:00,-1228.73,365168.86000000086,357945.38000000064,7223.480000000214
19917,2022-07-04 11:45:00,1638.03,366806.8900000009,357945.38000000064,8861.510000000242
19918,2022-07-04 11:50:00,-1781.42,365025.4700000009,357945.38000000064,7080.090000000258
19919,2022-07-04 11:55:00,845.24,365870.7100000009,357945.38000000064,7925.330000000249
19920,2022-07-04 12:00:00,1174.76,367045.4700000009,357945.38000000064,9100.090000000258
19921,2022-07-04 12:05:00,890.22,367935.6900000009,357945.38000000064,9990.31000000023
19922,2022-07-04 12:10:00,-1212.87,366722.8200000009,357945.38000000064,8777.440000000235
19923,2022-07-04 12:15:00,-1702.7,365020.12000000087,357945.38000000064,7074.7400000002235
19924,2022-07-04 12:20:00,-1174.75,363845.37000000087,357945.38000000064,5899.9900000002235
19925,2022-07-04 12:25:00,-1582.72,362262.6500000009,357945.38000000064,4317.2700000002515
19926,2022-07-04 12:30:00,-1208.34,361054.31000000087,357945.38000000064,3108.930000000226
19927,2022-07-04 12:35:00,1526.82,362581.1300000009,357945.38000000064,4635.750000000233
19928,2022-07-04 12:40:00,-1295.13,361286.0000000009,357945.38000000064,3340.620000000228
19929,2022-07-04 12:45:00,-597.55,360688.4500000009,357945.38000000064,2743.07000000024
19930,2022-07-04 12:50:00,1761.23,362449.68000000087,357945.38000000064,4504.300000000221
19931,2022-07-04 12:55:00,247.35,362697.03000000084,357945.38000000064,4751.650000000198
19932,2022-07-04 13:00:00,229.63,362926.66000000085,357945.38000000064,4981.280000000203
19933,2022-07-04 13:05:00,982.68,363909.34000000084,357945.38000000064,5963.960000000196
19934,2022-07-04 13:10:00,1792.84,365702.18000000087,357945.38000000064,7756.800000000221
19935,2022-07-04 13:15:00,-308.4,365393.78000000084,357945.38000000064,7448.400000000198
19936,2022-07-04 13:20:00,179.38,365573.16000000085,357945.38000000064,7627.780000000203
19937,2022-07-04 13:25:00,-1695.92,363877.24000000086,357945.38000000064,5931.860000000219
19938,2022-07-04 13:30:00,302.21,364179.4500000009,357945.38000000064,6234.07000000024
19939,2022-07-04 13:35:00,-1840.17,362339.2800000009,357945.38000000064,4393.900000000256
19940,2022-07-04 13:40:00,-1416.44,360922.8400000009,357945.38000000064,2977.460000000254
19941,2022-07-04 13:45:00,-961.16,359961.6800000009,357945.38000000064,2016.3000000002794
19942,2022-07-04 13:50:00,-632.54,359329.14000000095,357945.38000000064,1383.7600000003004
19943,2022-07-04 13:55:00,-1289.97,358039.170000001,357945.38000000064,93.79000000032829
19944,2022-07-04 14:00:00,-1298.42,356740.750000001,357945.38000000064,-1204.6299999996554
19945,2022-07-04 14:05:00,1422.77,358163.520000001,357945.38000000064,218.14000000036322
19946,2022-07-04 14:10:00,-13.36,358150.160000001,357945.38000000064,204.78000000037719
19947,2022-07-04 14:15:00,530.37,358680.530000001,357945.38000000064,735.1500000003725
19948,2022-07-04 14:20:00,782.04,359462.570000001,357945.38000000064,1517.1900000003516
19949,2022-07-04 14:25:00,-1205.46,358257.110000001,357945.38000000064,311.7300000003306
19950,2022-07-04 14:30:00,-223.76,358033.35000000097,357945.38000000064,87.9700000003213
19951,2022-07-04 14:35:00,1261.73,359295.08000000095,357945.38000000064,1349.7000000003027
19952,2022-07-04 14:40:00,746.05,360041.13000000094,357945.38000000064,2095.750000000291
19953,2022-07-04 14:45:00,898.84,360939.97000000096,357945.38000000064,2994.5900000003166
19954,2022-07-04 14:50:00,844.01,361783.980000001,357945.38000000064,3838.600000000326
19955,2022-07-04 14:55:00,-889.7,360894.28000000096,357945.38000000064,2948.9000000003143
19956,2022-07-04 15:00:00,1753.85,362648.13000000094,357945.38000000064,4702.750000000291
19957,2022-07-04 15:05:00,-27.55,362620.58000000095,357945.38000000064,4675.200000000303
19958,2022-07-04 15:10:00,1667.87,364288.45000000094,357945.38000000064,6343.070000000298
19959,2022-07-04 15:15:00,-1520.03,362768.4200000009,357945.38000000064,4823.04000000027
19960,2022-07-04 15:20:00,1240.36,364008.7800000009,357945.38000000064,6063.400000000256
19961,2022-07-04 15:25:00,-189.15,363819.6300000009,357945.38000000064,5874.250000000233
19962,2022-07-04 15:30:00,-994.97,362824.6600000009,357945.38000000064,4879.280000000261
19963,2022-07-04 15:35:00,1594.55,364419.2100000009,357945.38000000064,6473.830000000249
19964,2022-07-04 15:40:00,1971.41,366390.62000000087,357945.38000000064,8445.240000000224
19965,2022-07-04 15:45:00,-562.4,365828.22000000085,357945.38000000064,7882.8400000002
19966,2022-07-04 15:50:00,-712.57,365115.65000000084,357945.38000000064,7170.270000000193
19967,2022-07-04 15:55:00,-530.6,364585.05000000086,357945.38000000064,6639.6700000002165
19968,2022-07-04 16:00:00,-624.3,363960.7500000009,357945.38000000064,6015.370000000228
19969,2022-07-04 16:05:00,-1685.2,362275.55000000086,357945.38000000064,4330.1700000002165
19970,2022-07-04 16:10:00,-1180.31,361095.24000000086,357945.38000000064,3149.860000000219
19971,2022-07-04 16:15:00,1591.36,362686.60000000085,357945.38000000064,4741.220000000205
19972,2022-07-04 16:20:00,393.86,363080.46000000084,357945.38000000064,5135.080000000191
19973,2022-07-04 16:25:00,622.87,363703.33000000083,357945.38000000064,5757.950000000186
19974,2022-07-04 16:30:00,689.73,364393.0600000008,357945.38000000064,6447.680000000168
19975,2022-07-04 16:35:00,382.39,364775.4500000008,357945.38000000064,6830.070000000182
19976,2022-07-04 16:40:00,1558.95,366334.40000000084,357945.38000000064,8389.020000000193
19977,2022-07-04 16:45:00,-1112.05,365222.35000000085,357945.38000000064,7276.970000000205
19978,2022-07-04 16:50:00,977.13,366199.48000000085,357945.38000000064,8254.10000000021
19979,2022-07-04 16:55:00,1073.53,367273.0100000009,357945.38000000064,9327.630000000237
19980,2022-07-05 08:00:00,-234.37,367038.6400000009,367273.0100000009,-234.36999999999534
19981,2022-07-05 08:05:00,1635.94,368674.5800000009,367273.0100000009,1401.570000000007
19982,2022-07-05 08:10:00,1705.59,370380.1700000009,367273.0100000009,3107.1600000000326
19983,2022-07-05 08:15:00,700.94,371081.1100000009,367273.0100000009,3808.100000000035
19984,2022-07-05 08:20:00,1761.65,372842.76000000094,367273.0100000009,5569.750000000058
19985,2022-07-05 08:25:00,1190.0,374032.76000000094,367273.0100000009,6759.750000000058
19986,2022-07-05 08:30:00,646.16,374678.9200000009,367273.0100000009,7405.910000000033
19987,2022-07-05 08:35:00,-656.09,374022.8300000009,367273.0100000009,6749.820000000007
19988,2022-07-05 08:40:00,241.28,374264.1100000009,367273.0100000009,6991.100000000035
19989,2022-07-05 08:45:00,-798.95,373465.1600000009,367273.0100000009,6192.150000000023
19990,2022-07-05 08:50:00,-1303.1,372162.0600000009,367273.0100000009,4889.050000000047
19991,2022-07-05 08:55:00,1199.18,373361.2400000009,367273.0100000009,6088.23000000004
19992,2022-07-05 09:00:00,-358.54,373002.70000000094,367273.0100000009,5729.6900000000605
19993,2022-07-05 09:05:00,-45.78,372956.9200000009,367273.0100000009,5683.910000000033
19994,2022-07-05 09:10:00,-734.71,372222.2100000009,367273.0100000009,4949.200000000012
19995,2022-07-05 09:15:00,1817.56,374039.7700000009,367273.0100000009,6766.760000000009
19996,2022-07-05 09:20:00,1355.31,375395.0800000009,367273.0100000009,8122.070000000007
19997,2022-07-05 09:25:00,1873.81,377268.8900000009,367273.0100000009,9995.880000000005
19998,2022-07-05 09:30:00,-1912.0,375356.8900000009,367273.0100000009,8083.880000000005
19999,2022-07-05 09:35:00,-366.29,374990.6000000009,367273.0100000009,7717.590000000026
20000,2022-07-05 09:40:00,1331.9,376322.50000000093,367273.0100000009,9049.490000000049
20001,2022-07-05 09:45:00,1524.67,377847.1700000009,367273.0100000009,10574.160000000033
20002,2022-07-05 09:50:00,263.87,378111.0400000009,367273.0100000009,10838.030000000028
20003,2022-07-05 09:55:00,1885.1,379996.1400000009,367273.0100000009,12723.130000000005
20004,2022-07-05 10:00:00,996.45,380992.5900000009,367273.0100000009,13719.580000000016
20005,2022-07-05 10:05:00,-1875.63,379116.9600000009,367273.0100000009,11843.950000000012
20006,2022-07-05 10:10:00,-1367.47,377749.4900000009,367273.0100000009,10476.48000000004
20007,2022-07-05 10:15:00,1419.28,379168.77000000095,367273.0100000009,11895.760000000068
20008,2022-07-05 10:20:00,-509.55,378659.22000000096,367273.0100000009,11386.21000000008
20009,2022-07-05 10:25:00,482.07,379141.29000000097,367273.0100000009,11868.280000000086
20010,2022-07-05 10:30:00,-1349.85,377791.440000001,367273.0100000009,10518.43000000011
20011,2022-07-05 10:35:00,-1353.62,376437.820000001,367273.0100000009,9164.810000000114
20012,2022-07-05 10:40:00,-1419.63,375018.190000001,367273.0100000009,7745.180000000109
20013,2022-07-05 10:45:00,1285.05,376303.240000001,367273.0100000009,9030.230000000098
20014,2022-07-05 10:50:00,-1653.93,374649.310000001,367273.0100000009,7376.300000000105
20015,2022-07-05 10:55:00,277.58,374926.890000001,367273.0100000009,7653.880000000121
20016,2022-07-05 11:00:00,-956.41,373970.48000000103,367273.0100000009,6697.470000000147
20017,2022-07-05 11:05:00,766.58,374737.06000000105,367273.0100000009,7464.050000000163
20018,2022-07-05 11:10:00,631.18,375368.24000000104,367273.0100000009,8095.230000000156
20019,2022-07-05 11:15:00,480.8,375849.040000001,367273.0100000009,8576.030000000144
20020,2022-07-05 11:20:00,1111.57,376960.61000000103,367273.0100000009,9687.600000000151
20021,2022-07-05 11:25:00,-154.08,376806.530000001,367273.0100000009,9533.520000000135
20022,2022-07-05 11:30:00,1330.98,378137.510000001,367273.0100000009,10864.500000000116
20023,2022-07-05 11:35:00,424.78,378562.290000001,367273.0100000009,11289.280000000144
20024,2022-07-05 11:40:00,1122.41,379684.700000001,367273.0100000009,12411.690000000119
20025,2022-07-05 11:45:00,-231.96,379452.740000001,367273.0100000009,12179.730000000098
20026,2022-07-05 11:50:00,-1460.3,377992.440000001,367273.0100000009,10719.43000000011
20027,2022-07-05 11:55:00,-762.58,377229.860000001,367273.0100000009,9956.850000000093
20028,2022-07-05 12:00:00,-1078.92,376150.940000001,367273.0100000009,8877.93000000011
20029,2022-07-05 12:05:00,1085.16,377236.10000000097,367273.0100000009,9963.090000000084
20030,2022-07-05 12:10:00,1383.24,378619.34000000096,367273.0100000009,11346.330000000075
20031,2022-07-05 12:15:00,1445.48,380064.82000000094,367273.0100000009,12791.810000000056
20032,2022-07-05 12:20:00,779.32,380844.14000000095,367273.0100000009,13571.130000000063
20033,2022-07-05 12:25:00,152.42,380996.5600000009,367273.0100000009,13723.550000000047
20034,2022-07-05 12:30:00,1099.42,382095.9800000009,367273.0100000009,14822.97000000003
20035,2022-07-05 12:35:00,-1890.08,380205.9000000009,367273.0100000009,12932.890000000014
20036,2022-07-05 12:40:00,748.77,380954.6700000009,367273.0100000009,13681.660000000033
20037,2022-07-05 12:45:00,549.44,381504.1100000009,367273.0100000009,14231.100000000035
20038,2022-07-05 12:50:00,1004.95,382509.0600000009,367273.0100000009,15236.050000000047
20039,2022-07-05 12:55:00,1064.31,383573.3700000009,367273.0100000009,16300.360000000044
20040,2022-07-05 13:00:00,1458.04,385031.4100000009,367273.0100000009,17758.400000000023
20041,2022-07-05 13:05:00,-681.75,384349.6600000009,367273.0100000009,17076.650000000023
20042,2022-07-05 13:10:00,265.87,384615.5300000009,367273.0100000009,17342.52000000002
20043,2022-07-05 13:15:00,-741.85,383873.6800000009,367273.0100000009,16600.670000000042
20044,2022-07-05 13:20:00,497.33,384371.01000000094,367273.0100000009,17098.00000000006
20045,2022-07-05 13:25:00,-101.27,384269.7400000009,367273.0100000009,16996.73000000004
20046,2022-07-05 13:30:00,-1002.99,383266.75000000093,367273.0100000009,15993.740000000049
20047,2022-07-05 13:35:00,12.44,383279.19000000093,367273.0100000009,16006.180000000051
20048,2022-07-05 13:40:00,830.81,384110.00000000093,367273.0100000009,16836.99000000005
20049,2022-07-05 13:45:00,501.59,384611.59000000096,367273.0100000009,17338.580000000075
20050,2022-07-05 13:50:00,-993.46,383618.13000000094,367273.0100000009,16345.120000000054
20051,2022-07-05 13:55:00,-135.45,383482.6800000009,367273.0100000009,16209.670000000042
20052,2022-07-05 14:00:00,294.02,383776.70000000094,367273.0100000009,16503.69000000006
20053,2022-07-05 14:05:00,-1155.44,382621.26000000094,367273.0100000009,15348.250000000058
20054,2022-07-05 14:10:00,156.5,382777.76000000094,367273.0100000009,15504.750000000058
20055,2022-07-05 14:15:00,1600.04,384377.8000000009,367273.0100000009,17104.790000000037
20056,2022-07-05 14:20:00,-883.89,383493.9100000009,367273.0100000009,16220.900000000023
20057,2022-07-05 14:25:00,-1968.3,381525.6100000009,367273.0100000009,14252.600000000035
20058,2022-07-05 14:30:00,-1010.29,380515.32000000094,367273.0100000009,13242.310000000056
20059,2022-07-05 14:35:00,-1924.58,378590.7400000009,367273.0100000009,11317.73000000004
20060,2022-07-05 14:40:00,1842.55,380433.2900000009,367273.0100000009,13160.280000000028
20061,2022-07-05 14:45:00,-881.18,379552.1100000009,367273.0100000009,12279.100000000035
20062,2022-07-05 14:50:00,518.4,380070.51000000094,367273.0100000009,12797.500000000058
20063,2022-07-05 14:55:00,1621.25,381691.76000000094,367273.0100000009,14418.750000000058
20064,2022-07-05 15:00:00,880.23,382571.9900000009,367273.0100000009,15298.98000000004
20065,2022-07-05 15:05:00,548.45,383120.44000000093,367273.0100000009,15847.430000000051
20066,2022-07-05 15:10:00,1154.55,384274.9900000009,367273.0100000009,17001.98000000004
20067,2022-07-05 15:15:00,-69.22,384205.77000000095,367273.0100000009,16932.760000000068
20068,2022-07-05 15:20:00,-1182.34,383023.4300000009,367273.0100000009,15750.420000000042
20069,2022-07-05 15:25:00,1008.55,384031.9800000009,367273.0100000009,16758.97000000003
20070,2022-07-05 15:30:00,541.13,384573.1100000009,367273.0100000009,17300.100000000035
20071,2022-07-05 15:35:00,992.29,385565.4000000009,367273.0100000009,18292.390000000014
20072,2022-07-05 15:40:00,1357.13,386922.5300000009,367273.0100000009,19649.52000000002
20073,2022-07-05 15:45:00,262.05,387184.5800000009,367273.0100000009,19911.570000000007
20074,2022-07-05 15:50:00,-1679.94,385504.6400000009,367273.0100000009,18231.630000000005
20075,2022-07-05 15:55:00,240.94,385745.5800000009,367273.0100000009,18472.570000000007
20076,2022-07-05 16:00:00,-1942.85,383802.7300000009,367273.0100000009,16529.72000000003
20077,2022-07-05 16:05:00,1378.6,385181.3300000009,367273.0100000009,17908.320000000007
20078,2022-07-05 16:10:00,1652.28,386833.6100000009,367273.0100000009,19560.600000000035
20079,2022-07-05 16:15:00,-1252.72,385580.89000000095,367273.0100000009,18307.880000000063
20080,2022-07-05 16:20:00,890.45,386471.34000000096,367273.0100000009,19198.330000000075
20081,2022-07-05 16:25:00,-847.76,385623.58000000095,367273.0100000009,18350.570000000065
20082,2022-07-05 16:30:00,-362.22,385261.360000001,367273.0100000009,17988.350000000093
20083,2022-07-05 16:35:00,717.42,385978.78000000096,367273.0100000009,18705.770000000077
20084,2022-07-05 16:40:00,-1822.13,384156.65000000095,367273.0100000009,16883.640000000072
20085,2022-07-05 16:45:00,847.72,385004.3700000009,367273.0100000009,17731.360000000044
20086,2022-07-05 16:50:00,-1340.37,383664.00000000093,367273.0100000009,16390.99000000005
20087,2022-07-05 16:55:00,-1628.25,382035.75000000093,367273.0100000009,14762.740000000049
20088,2022-07-06 08:00:00,-74.36,381961.39000000095,382035.75000000093,-74.35999999998603
20089,2022-07-06 08:05:00,1006.7,382968.09000000096,382035.75000000093,932.3400000000256
20090,2022-07-06 08:10:00,-328.26,382639.83000000095,382035.75000000093,604.0800000000163
20091,2022-07-06 08:15:00,1770.49,384410.32000000094,382035.75000000093,2374.570000000007
20092,2022-07-06 08:20:00,1921.03,386331.35000000097,382035.75000000093,4295.600000000035
20093,2022-07-06 08:25:00,1823.67,388155.02000000095,382035.75000000093,6119.270000000019
20094,2022-07-06 08:30:00,1031.59,389186.610000001,382035.75000000093,7150.860000000044
20095,2022-07-06 08:35:00,-254.37,388932.240000001,382035.75000000093,6896.490000000049
20096,2022-07-06 08:40:00,-696.4,388235.84000000096,382035.75000000093,6200.090000000026
20097,2022-07-06 08:45:00,612.93,388848.77000000095,382035.75000000093,6813.020000000019
20098,2022-07-06 08:50:00,1017.06,389865.83000000095,382035.75000000093,7830.080000000016
20099,2022-07-06 08:55:00,-525.74,389340.09000000096,382035.75000000093,7304.340000000026
20100,2022-07-06 09:00:00,825.23,390165.32000000094,382035.75000000093,8129.570000000007
20101,2022-07-06 09:05:00,1968.67,392133.9900000009,382035.75000000093,10098.23999999999
20102,2022-07-06 09:10:00,-1807.48,390326.51000000094,382035.75000000093,8290.76000000001
20103,2022-07-06 09:15:00,-1265.45,389061.0600000009,382035.75000000093,7025.309999999998
20104,2022-07-06 09:20:00,-1599.26,387461.8000000009,382035.75000000093,5426.049999999988
20105,2022-07-06 09:25:00,1945.62,389407.4200000009,382035.75000000093,7371.669999999984
20106,2022-07-06 09:30:00,-340.6,389066.82000000094,382035.75000000093,7031.070000000007
20107,2022-07-06 09:35:00,877.42,389944.2400000009,382035.75000000093,7908.489999999991
20108,2022-07-06 09:40:00,530.39,390474.63000000094,382035.75000000093,8438.880000000005
20109,2022-07-06 09:45:00,1402.7,391877.33000000095,382035.75000000093,9841.580000000016
20110,2022-07-06 09:50:00,-764.14,391113.19000000093,382035.75000000093,9077.440000000002
20111,2022-07-06 09:55:00,1049.46,392162.65000000095,382035.75000000093,10126.900000000023
20112,2022-07-06 10:00:00,1864.34,394026.990000001,382035.75000000093,11991.240000000049
20113,2022-07-06 10:05:00,532.49,394559.480000001,382035.75000000093,12523.73000000004
20114,2022-07-06 10:10:00,1741.04,396300.52000000095,382035.75000000093,14264.770000000019
20115,2022-07-06 10:15:00,964.14,397264.66000000096,382035.75000000093,15228.910000000033
20116,2022-07-06 10:20:00,473.66,397738.32000000094,382035.75000000093,15702.570000000007
20117,2022-07-06 10:25:00,467.52,398205.84000000096,382035.75000000093,16170.090000000026
20118,2022-07-06 10:30:00,1607.93,399813.77000000095,382035.75000000093,17778.02000000002
20119,2022-07-06 10:35:00,-1043.92,398769.85000000097,382035.75000000093,16734.100000000035
20120,2022-07-06 10:40:00,1049.88,399819.730000001,382035.75000000093,17783.98000000004
20121,2022-07-06 10:45:00,297.35,400117.08000000095,382035.75000000093,18081.330000000016
20122,2022-07-06 10:50:00,-1659.27,398457.8100000009,382035.75000000093,16422.059999999998
20123,2022-07-06 10:55:00,1940.01,400397.82000000094,382035.75000000093,18362.070000000007
20124,2022-07-06 11:00:00,-410.05,399987.77000000095,382035.75000000093,17952.02000000002
20125,2022-07-06 11:05:00,1691.02,401678.79000000097,382035.75000000093,19643.040000000037
20126,2022-07-06 11:10:00,1826.64,403505.430000001,382035.75000000093,21469.68000000005
20127,2022-07-06 11:15:00,450.38,403955.810000001,382035.75000000093,21920.060000000056
20128,2022-07-06 11:20:00,-925.17,403030.640000001,382035.75000000093,20994.890000000072
20129,2022-07-06 11:25:00,410.47,403441.110000001,382035.75000000093,21405.360000000044
20130,2022-07-06 11:30:00,1.3,403442.41000000096,382035.75000000093,21406.660000000033
20131,2022-07-06 11:35:00,-779.59,402662.82000000094,382035.75000000093,20627.070000000007
20132,2022-07-06 11:40:00,1472.11,404134.9300000009,382035.75000000093,22099.179999999993
20133,2022-07-06 11:45:00,-1557.14,402577.7900000009,382035.75000000093,20542.03999999998
20134,2022-07-06 11:50:00,-1188.72,401389.07000000094,382035.75000000093,19353.320000000007
20135,2022-07-06 11:55:00,1351.2,402740.27000000095,382035.75000000093,20704.52000000002
20136,2022-07-06 12:00:00,-1119.71,401620.5600000009,382035.75000000093,19584.809999999998
20137,2022-07-06 12:05:00,-654.04,400966.52000000095,382035.75000000093,18930.77000000002
20138,2022-07-06 12:10:00,-1620.11,399346.41000000096,382035.75000000093,17310.660000000033
20139,2022-07-06 12:15:00,-1633.99,397712.420000001,382035.75000000093,15676.670000000042
20140,2022-07-06 12:20:00,119.42,397831.84000000096,382035.75000000093,15796.090000000026
20141,2022-07-06 12:25:00,-1128.2,396703.64000000095,382035.75000000093,14667.890000000014
20142,2022-07-06 12:30:00,1783.42,398487.0600000009,382035.75000000093,16451.309999999998
20143,2022-07-06 12:35:00,1997.73,400484.7900000009,382035.75000000093,18449.03999999998
20144,2022-07-06 12:40:00,-419.44,400065.3500000009,382035.75000000093,18029.599999999977
20145,2022-07-06 12:45:00,-1223.36,398841.9900000009,382035.75000000093,16806.23999999999
20146,2022-07-06 12:50:00,-200.41,398641.58000000095,382035.75000000093,16605.830000000016
20147,2022-07-06 12:55:00,1890.71,400532.29000000097,382035.75000000093,18496.540000000037
20148,2022-07-06 13:00:00,-655.65,399876.64000000095,382035.75000000093,17840.890000000014
20149,2022-07-06 13:05:00,-301.75,399574.89000000095,382035.75000000093,17539.140000000014
20150,2022-07-06 13:10:00,-1206.16,398368.730000001,382035.75000000093,16332.98000000004
20151,2022-07-06 13:15:00,-286.07,398082.66000000096,382035.75000000093,16046.910000000033
20152,2022-07-06 13:20:00,1948.88,400031.54000000097,382035.75000000093,17995.790000000037
20153,2022-07-06 13:25:00,1934.94,401966.480000001,382035.75000000093,19930.73000000004
20154,2022-07-06 13:30:00,-1200.57,400765.91000000096,382035.75000000093,18730.160000000033
20155,2022-07-06 13:35:00,895.35,401661.26000000094,382035.75000000093,19625.51000000001
20156,2022-07-06 13:40:00,-1787.02,399874.2400000009,382035.75000000093,17838.48999999999
20157,2022-07-06 13:45:00,829.74,400703.9800000009,382035.75000000093,18668.22999999998
20158,2022-07-06 13:50:00,1452.88,402156.8600000009,382035.75000000093,20121.109999999986
20159,2022-07-06 13:55:00,1175.73,403332.5900000009,382035.75000000093,21296.839999999967
20160,2022-07-06 14:00:00,1227.19,404559.7800000009,382035.75000000093,22524.02999999997
20161,2022-07-06 14:05:00,-1368.89,403190.8900000009,382035.75000000093,21155.139999999956
20162,2022-07-06 14:10:00,-159.09,403031.80000000086,382035.75000000093,20996.04999999993
20163,2022-07-06 14:15:00,327.12,403358.92000000086,382035.75000000093,21323.169999999925
20164,2022-07-06 14:20:00,-1700.45,401658.47000000085,382035.75000000093,19622.719999999914
20165,2022-07-06 14:25:00,-824.62,400833.85000000085,382035.75000000093,18798.09999999992
20166,2022-07-06 14:30:00,-180.62,400653.23000000085,382035.75000000093,18617.479999999923
20167,2022-07-06 14:35:00,862.83,401516.06000000087,382035.75000000093,19480.30999999994
20168,2022-07-06 14:40:00,1323.65,402839.7100000009,382035.75000000093,20803.959999999963
20169,2022-07-06 14:45:00,-1889.96,400949.7500000009,382035.75000000093,18913.99999999994
20170,2022-07-06 14:50:00,-1591.94,399357.81000000087,382035.75000000093,17322.05999999994
20171,2022-07-06 14:55:00,812.91,400170.72000000085,382035.75000000093,18134.969999999914
20172,2022-07-06 15:00:00,47.27,400217.99000000086,382035.75000000093,18182.239999999932
20173,2022-07-06 15:05:00,-205.65,400012.34000000084,382035.75000000093,17976.58999999991
20174,2022-07-06 15:10:00,519.11,400531.4500000008,382035.75000000093,18495.699999999895
20175,2022-07-06 15:15:00,-275.15,400256.3000000008,382035.75000000093,18220.549999999872
20176,2022-07-06 15:20:00,-441.33,399814.9700000008,382035.75000000093,17779.219999999856
20177,2022-07-06 15:25:00,1843.42,401658.39000000077,382035.75000000093,19622.63999999984
20178,2022-07-06 15:30:00,1993.36,403651.75000000076,382035.75000000093,21615.999999999825
20179,2022-07-06 15:35:00,42.93,403694.68000000075,382035.75000000093,21658.92999999982
20180,2022-07-06 15:40:00,74.13,403768.81000000075,382035.75000000093,21733.059999999823
20181,2022-07-06 15:45:00,813.02,404581.8300000008,382035.75000000093,22546.07999999984
20182,2022-07-06 15:50:00,-966.07,403615.76000000077,382035.75000000093,21580.009999999835
20183,2022-07-06 15:55:00,854.08,404469.8400000008,382035.75000000093,22434.08999999985
20184,2022-07-06 16:00:00,1250.69,405720.5300000008,382035.75000000093,23684.779999999853
20185,2022-07-06 16:05:00,1540.08,407260.6100000008,382035.75000000093,25224.85999999987
20186,2022-07-06 16:10:00,-1905.67,405354.9400000008,382035.75000000093,23319.189999999886
20187,2022-07-06 16:15:00,-108.75,405246.1900000008,382035.75000000093,23210.439999999886
20188,2022-07-06 16:20:00,61.29,405307.4800000008,382035.75000000093,23271.729999999865
20189,2022-07-06 16:25:00,-1900.01,403407.4700000008,382035.75000000093,21371.719999999856
20190,2022-07-06 16:30:00,-596.38,402811.0900000008,382035.75000000093,20775.33999999985
20191,2022-07-06 16:35:00,-1837.29,400973.8000000008,382035.75000000093,18938.049999999872
20192,2022-07-06 16:40:00,-1613.76,399360.0400000008,382035.75000000093,17324.289999999863
20193,2022-07-06 16:45:00,-555.64,398804.4000000008,382035.75000000093,16768.64999999985
20194,2022-07-06 16:50:00,-953.48,397850.9200000008,382035.75000000093,15815.169999999867
20195,2022-07-06 16:55:00,816.91,398667.8300000008,382035.75000000093,16632.07999999984
20196,2022-07-07 08:00:00,-1449.24,397218.5900000008,398667.8300000008,-1449.2399999999907
20197,2022-07-07 08:05:00,-211.11,397007.4800000008,398667.8300000008,-1660.3499999999767
20198,2022-07-07 08:10:00,-1920.01,395087.4700000008,398667.8300000008,-3580.359999999986
20199,2022-07-07 08:15:00,1460.91,396548.38000000076,398667.8300000008,-2119.4500000000116
20200,2022-07-07 08:20:00,-938.66,395609.7200000008,398667.8300000008,-3058.109999999986
20201,2022-07-07 08:25:00,1216.76,396826.4800000008,398667.8300000008,-1841.3499999999767
20202,2022-07-07 08:30:00,-80.25,396746.2300000008,398667.8300000008,-1921.5999999999767
20203,2022-07-07 08:35:00,753.84,397500.0700000008,398667.8300000008,-1167.759999999951
20204,2022-07-07 08:40:00,-202.81,397297.2600000008,398667.8300000008,-1370.5699999999488
20205,2022-07-07 08:45:00,612.55,397909.8100000008,398667.8300000008,-758.0199999999604
20206,2022-07-07 08:50:00,1573.66,399483.4700000008,398667.8300000008,815.640000000014
20207,2022-07-07 08:55:00,264.31,399747.7800000008,398667.8300000008,1079.9500000000116
20208,2022-07-07 09:00:00,-1913.27,397834.51000000077,398667.8300000008,-833.320000000007
20209,2022-07-07 09:05:00,1334.88,399169.39000000077,398667.8300000008,501.5599999999977
20210,2022-07-07 09:10:00,-1422.24,397747.1500000008,398667.8300000008,-920.679999999993
20211,2022-07-07 09:15:00,-1705.22,396041.9300000008,398667.8300000008,-2625.899999999965
20212,2022-07-07 09:20:00,1378.08,397420.0100000008,398667.8300000008,-1247.8199999999488
20213,2022-07-07 09:25:00,1307.96,398727.97000000085,398667.8300000008,60.14000000007218
20214,2022-07-07 09:30:00,-1493.96,397234.0100000008,398667.8300000008,-1433.8199999999488
20215,2022-07-07 09:35:00,-541.29,396692.72000000085,398667.8300000008,-1975.1099999999278
20216,2022-07-07 09:40:00,-800.27,395892.4500000008,398667.8300000008,-2775.3799999999464
20217,2022-07-07 09:45:00,121.76,396014.21000000084,398667.8300000008,-2653.619999999937
20218,2022-07-07 09:50:00,1346.19,397360.40000000084,398667.8300000008,-1307.4299999999348
20219,2022-07-07 09:55:00,1107.03,398467.43000000087,398667.8300000008,-200.39999999990687
20220,2022-07-07 10:00:00,995.81,399463.24000000086,398667.8300000008,795.4100000000908
20221,2022-07-07 10:05:00,-1638.46,397824.78000000084,398667.8300000008,-843.0499999999302
20222,2022-07-07 10:10:00,891.13,398715.91000000085,398667.8300000008,48.080000000074506
20223,2022-07-07 10:15:00,-1996.82,396719.09000000084,398667.8300000008,-1948.7399999999325
20224,2022-07-07 10:20:00,183.73,396902.8200000008,398667.8300000008,-1765.009999999951
20225,2022-07-07 10:25:00,377.02,397279.84000000084,398667.8300000008,-1387.9899999999325
20226,2022-07-07 10:30:00,103.24,397383.08000000083,398667.8300000008,-1284.7499999999418
20227,2022-07-07 10:35:00,-1311.4,396071.6800000008,398667.8300000008,-2596.149999999965
20228,2022-07-07 10:40:00,522.03,396593.71000000084,398667.8300000008,-2074.119999999937
20229,2022-07-07 10:45:00,-691.94,395901.77000000083,398667.8300000008,-2766.0599999999395
20230,2022-07-07 10:50:00,120.85,396022.6200000008,398667.8300000008,-2645.2099999999627
20231,2022-07-07 10:55:00,-898.61,395124.0100000008,398667.8300000008,-3543.819999999949
20232,2022-07-07 11:00:00,1428.68,396552.6900000008,398667.8300000008,-2115.1399999999558
20233,2022-07-07 11:05:00,993.7,397546.3900000008,398667.8300000008,-1121.4399999999441
20234,2022-07-07 11:10:00,463.62,398010.0100000008,398667.8300000008,-657.8199999999488
20235,2022-07-07 11:15:00,-99.51,397910.5000000008,398667.8300000008,-757.3299999999581
20236,2022-07-07 11:20:00,1126.12,399036.6200000008,398667.8300000008,368.79000000003725
20237,2022-07-07 11:25:00,-399.52,398637.1000000008,398667.8300000008,-30.729999999981374
20238,2022-07-07 11:30:00,-254.94,398382.1600000008,398667.8300000008,-285.6699999999837
20239,2022-07-07 11:35:00,1183.02,399565.1800000008,398667.8300000008,897.3500000000349
20240,2022-07-07 11:40:00,-258.62,399306.5600000008,398667.8300000008,638.7300000000396
20241,2022-07-07 11:45:00,419.64,399726.2000000008,398667.8300000008,1058.3700000000536
20242,2022-07-07 11:50:00,-1737.12,397989.08000000083,398667.8300000008,-678.7499999999418
20243,2022-07-07 11:55:00,-1782.34,396206.7400000008,398667.8300000008,-2461.0899999999674
20244,2022-07-07 12:00:00,1420.37,397627.1100000008,398667.8300000008,-1040.719999999972
20245,2022-07-07 12:05:00,1621.36,399248.4700000008,398667.8300000008,580.640000000014
20246,2022-07-07 12:10:00,-1102.14,398146.3300000008,398667.8300000008,-521.5
20247,2022-07-07 12:15:00,-1017.02,397129.31000000075,398667.8300000008,-1538.5200000000186
20248,2022-07-07 12:20:00,-1351.2,395778.11000000074,398667.8300000008,-2889.7200000000303
20249,2022-07-07 12:25:00,-802.72,394975.39000000077,398667.8300000008,-3692.4400000000023
20250,2022-07-07 12:30:00,-953.26,394022.13000000076,398667.8300000008,-4645.700000000012
20251,2022-07-07 12:35:00,918.63,394940.76000000077,398667.8300000008,-3727.070000000007
20252,2022-07-07 12:40:00,1685.35,396626.11000000074,398667.8300000008,-2041.7200000000303
20253,2022-07-07 12:45:00,-702.77,395923.3400000007,398667.8300000008,-2744.490000000049
20254,2022-07-07 12:50:00,-202.09,395721.2500000007,398667.8300000008,-2946.5800000000745
20255,2022-07-07 12:55:00,660.57,396381.8200000007,398667.8300000008,-2286.0100000000675
20256,2022-07-07 13:00:00,1790.9,398172.7200000007,398667.8300000008,-495.11000000004424
20257,2022-07-07 13:05:00,-543.77,397628.9500000007,398667.8300000008,-1038.8800000000629
20258,2022-07-07 13:10:00,1012.47,398641.4200000007,398667.8300000008,-26.410000000090804
20259,2022-07-07 13:15:00,1422.93,400064.3500000007,398667.8300000008,1396.5199999999022
20260,2022-07-07 13:20:00,-861.2,399203.15000000066,398667.8300000008,535.3199999998906
20261,2022-07-07 13:25:00,-676.93,398526.22000000067,398667.8300000008,-141.61000000010245
20262,2022-07-07 13:30:00,-647.49,397878.7300000007,398667.8300000008,-789.1000000000931
20263,2022-07-07 13:35:00,-1015.72,396863.0100000007,398667.8300000008,-1804.8200000000652
20264,2022-07-07 13:40:00,-1821.97,395041.04000000074,398667.8300000008,-3626.7900000000373
20265,2022-07-07 13:45:00,-1713.44,393327.60000000073,398667.8300000008,-5340.23000000004
20266,2022-07-07 13:50:00,-1621.24,391706.36000000074,398667.8300000008,-6961.47000000003
20267,2022-07-07 13:55:00,-1822.32,389884.04000000074,398667.8300000008,-8783.790000000037
20268,2022-07-07 14:00:00,-1323.96,388560.0800000007,398667.8300000008,-10107.750000000058
20269,2022-07-07 14:05:00,-1775.42,386784.66000000073,398667.8300000008,-11883.170000000042
20270,2022-07-07 14:10:00,-1604.17,385180.49000000075,398667.8300000008,-13487.340000000026
20271,2022-07-07 14:15:00,136.11,385316.60000000073,398667.8300000008,-13351.23000000004
20272,2022-07-07 14:20:00,-1525.51,383791.0900000007,398667.8300000008,-14876.740000000049
20273,2022-07-07 14:25:00,-606.03,383185.0600000007,398667.8300000008,-15482.770000000077
20274,2022-07-07 14:30:00,-1045.49,382139.5700000007,398667.8300000008,-16528.260000000068
20275,2022-07-07 14:35:00,-315.72,381823.85000000073,398667.8300000008,-16843.98000000004
20276,2022-07-07 14:40:00,1563.92,383387.7700000007,398667.8300000008,-15280.060000000056
20277,2022-07-07 14:45:00,-202.51,383185.2600000007,398667.8300000008,-15482.570000000065
20278,2022-07-07 14:50:00,-1603.48,381581.7800000007,398667.8300000008,-17086.050000000047
20279,2022-07-07 14:55:00,-27.49,381554.29000000074,398667.8300000008,-17113.540000000037
20280,2022-07-07 15:00:00,18.35,381572.6400000007,398667.8300000008,-17095.19000000006
20281,2022-07-07 15:05:00,1245.68,382818.3200000007,398667.8300000008,-15849.510000000068
20282,2022-07-07 15:10:00,1781.55,384599.8700000007,398667.8300000008,-14067.96000000008
20283,2022-07-07 15:15:00,-1590.51,383009.3600000007,398667.8300000008,-15658.470000000088
20284,2022-07-07 15:20:00,-1048.65,381960.71000000066,398667.8300000008,-16707.12000000011
20285,2022-07-07 15:25:00,-1680.85,380279.8600000007,398667.8300000008,-18387.97000000009
20286,2022-07-07 15:30:00,638.57,380918.4300000007,398667.8300000008,-17749.40000000008
20287,2022-07-07 15:35:00,-1254.64,379663.7900000007,398667.8300000008,-19004.040000000095
20288,2022-07-07 15:40:00,-965.97,378697.8200000007,398667.8300000008,-19970.010000000068
20289,2022-07-07 15:45:00,1582.59,380280.41000000073,398667.8300000008,-18387.420000000042
20290,2022-07-07 15:50:00,-1484.35,378796.06000000075,398667.8300000008,-19871.77000000002
20291,2022-07-07 15:55:00,1603.16,380399.2200000007,398667.8300000008,-18268.610000000044
20292,2022-07-07 16:00:00,1033.56,381432.7800000007,398667.8300000008,-17235.050000000047
20293,2022-07-07 16:05:00,-618.34,380814.4400000007,398667.8300000008,-17853.390000000072
20294,2022-07-07 16:10:00,-744.9,380069.5400000007,398667.8300000008,-18598.290000000095
20295,2022-07-07 16:15:00,-1739.32,378330.22000000067,398667.8300000008,-20337.610000000102
20296,2022-07-07 16:20:00,-36.4,378293.82000000065,398667.8300000008,-20374.010000000126
20297,2022-07-07 16:25:00,781.44,379075.26000000065,398667.8300000008,-19592.570000000123
20298,2022-07-07 16:30:00,-988.02,378087.24000000063,398667.8300000008,-20580.590000000142
20299,2022-07-07 16:35:00,-717.94,377369.3000000006,398667.8300000008,-21298.530000000144
20300,2022-07-07 16:40:00,-113.14,377256.1600000006,398667.8300000008,-21411.67000000016
20301,2022-07-07 16:45:00,-1114.48,376141.68000000063,398667.8300000008,-22526.15000000014
20302,2022-07-07 16:50:00,1696.98,377838.6600000006,398667.8300000008,-20829.17000000016
20303,2022-07-07 16:55:00,-281.33,377557.3300000006,398667.8300000008,-21110.500000000175
20304,2022-07-08 08:00:00,842.31,378399.6400000006,377557.3300000006,842.3099999999977
20305,2022-07-08 08:05:00,-1598.92,376800.7200000006,377557.3300000006,-756.609999999986
20306,2022-07-08 08:10:00,-550.1,376250.62000000064,377557.3300000006,-1306.7099999999627
20307,2022-07-08 08:15:00,-1492.03,374758.5900000006,377557.3300000006,-2798.7399999999907
20308,2022-07-08 08:20:00,-22.02,374736.5700000006,377557.3300000006,-2820.7600000000093
20309,2022-07-08 08:25:00,-888.45,373848.1200000006,377557.3300000006,-3709.210000000021
20310,2022-07-08 08:30:00,-86.49,373761.6300000006,377557.3300000006,-3795.7000000000116
20311,2022-07-08 08:35:00,1575.13,375336.7600000006,377557.3300000006,-2220.570000000007
20312,2022-07-08 08:40:00,-1663.82,373672.9400000006,377557.3300000006,-3884.390000000014
20313,2022-07-08 08:45:00,1073.5,374746.4400000006,377557.3300000006,-2810.890000000014
20314,2022-07-08 08:50:00,-1907.8,372838.6400000006,377557.3300000006,-4718.690000000002
20315,2022-07-08 08:55:00,224.25,373062.8900000006,377557.3300000006,-4494.440000000002
20316,2022-07-08 09:00:00,-1603.33,371459.5600000006,377557.3300000006,-6097.770000000019
20317,2022-07-08 09:05:00,-1604.6,369854.9600000006,377557.3300000006,-7702.369999999995
20318,2022-07-08 09:10:00,-729.05,369125.9100000006,377557.3300000006,-8431.419999999984
20319,2022-07-08 09:15:00,1597.25,370723.1600000006,377557.3300000006,-6834.169999999984
20320,2022-07-08 09:20:00,-1698.13,369025.0300000006,377557.3300000006,-8532.299999999988
20321,2022-07-08 09:25:00,1496.14,370521.1700000006,377557.3300000006,-7036.159999999974
20322,2022-07-08 09:30:00,-1722.05,368799.12000000064,377557.3300000006,-8758.209999999963
20323,2022-07-08 09:35:00,-464.99,368334.13000000064,377557.3300000006,-9223.199999999953
20324,2022-07-08 09:40:00,829.19,369163.32000000065,377557.3300000006,-8394.009999999951
20325,2022-07-08 09:45:00,-1557.43,367605.89000000065,377557.3300000006,-9951.439999999944
20326,2022-07-08 09:50:00,973.1,368578.99000000063,377557.3300000006,-8978.339999999967
20327,2022-07-08 09:55:00,-1028.64,367550.3500000006,377557.3300000006,-10006.979999999981
20328,2022-07-08 10:00:00,581.92,368132.2700000006,377557.3300000006,-9425.059999999998
20329,2022-07-08 10:05:00,-880.5,367251.7700000006,377557.3300000006,-10305.559999999998
20330,2022-07-08 10:10:00,1264.88,368516.6500000006,377557.3300000006,-9040.679999999993
20331,2022-07-08 10:15:00,849.65,369366.3000000006,377557.3300000006,-8191.02999999997
20332,2022-07-08 10:20:00,1741.74,371108.0400000006,377557.3300000006,-6449.289999999979
20333,2022-07-08 10:25:00,-1992.11,369115.93000000063,377557.3300000006,-8441.399999999965
20334,2022-07-08 10:30:00,-554.4,368561.5300000006,377557.3300000006,-8995.799999999988
20335,2022-07-08 10:35:00,-1970.24,366591.2900000006,377557.3300000006,-10966.039999999979
20336,2022-07-08 10:40:00,97.24,366688.5300000006,377557.3300000006,-10868.799999999988
20337,2022-07-08 10:45:00,-1592.42,365096.1100000006,377557.3300000006,-12461.219999999972
20338,2022-07-08 10:50:00,-1785.68,363310.43000000063,377557.3300000006,-14246.899999999965
20339,2022-07-08 10:55:00,846.73,364157.1600000006,377557.3300000006,-13400.169999999984
20340,2022-07-08 11:00:00,-1861.24,362295.9200000006,377557.3300000006,-15261.409999999974
20341,2022-07-08 11:05:00,-1955.36,360340.56000000064,377557.3300000006,-17216.76999999996
20342,2022-07-08 11:10:00,1449.86,361790.4200000006,377557.3300000006,-15766.909999999974
20343,2022-07-08 11:15:00,1780.11,363570.5300000006,377557.3300000006,-13986.799999999988
20344,2022-07-08 11:20:00,1829.42,365399.9500000006,377557.3300000006,-12157.380000000005
20345,2022-07-08 11:25:00,-773.57,364626.3800000006,377557.3300000006,-12930.950000000012
20346,2022-07-08 11:30:00,1537.85,366164.23000000056,377557.3300000006,-11393.100000000035
20347,2022-07-08 11:35:00,-1584.27,364579.96000000054,377557.3300000006,-12977.370000000054
20348,2022-07-08 11:40:00,-1863.73,362716.23000000056,377557.3300000006,-14841.100000000035
20349,2022-07-08 11:45:00,-623.32,362092.91000000056,377557.3300000006,-15464.420000000042
20350,2022-07-08 11:50:00,-236.48,361856.4300000006,377557.3300000006,-15700.900000000023
20351,2022-07-08 11:55:00,-1930.89,359925.54000000056,377557.3300000006,-17631.790000000037
20352,2022-07-08 12:00:00,1729.58,361655.1200000006,377557.3300000006,-15902.210000000021
20353,2022-07-08 12:05:00,-1818.89,359836.23000000056,377557.3300000006,-17721.100000000035
20354,2022-07-08 12:10:00,1280.56,361116.79000000056,377557.3300000006,-16440.540000000037
20355,2022-07-08 12:15:00,1987.61,363104.40000000055,377557.3300000006,-14452.930000000051
20356,2022-07-08 12:20:00,-1306.59,361797.8100000005,377557.3300000006,-15759.520000000077
20357,2022-07-08 12:25:00,1392.72,363190.5300000005,377557.3300000006,-14366.800000000105
20358,2022-07-08 12:30:00,-931.1,362259.4300000005,377557.3300000006,-15297.900000000081
20359,2022-07-08 12:35:00,-1522.01,360737.4200000005,377557.3300000006,-16819.91000000009
20360,2022-07-08 12:40:00,-1728.04,359009.3800000005,377557.3300000006,-18547.95000000007
20361,2022-07-08 12:45:00,-461.36,358548.02000000054,377557.3300000006,-19009.310000000056
20362,2022-07-08 12:50:00,1795.09,360343.11000000057,377557.3300000006,-17214.22000000003
20363,2022-07-08 12:55:00,1841.83,362184.9400000006,377557.3300000006,-15372.390000000014
20364,2022-07-08 13:00:00,521.71,362706.6500000006,377557.3300000006,-14850.679999999993
20365,2022-07-08 13:05:00,-811.49,361895.1600000006,377557.3300000006,-15662.169999999984
20366,2022-07-08 13:10:00,-299.82,361595.3400000006,377557.3300000006,-15961.98999999999
20367,2022-07-08 13:15:00,1819.59,363414.93000000063,377557.3300000006,-14142.399999999965
20368,2022-07-08 13:20:00,-1775.98,361638.95000000065,377557.3300000006,-15918.379999999946
20369,2022-07-08 13:25:00,814.91,362453.8600000006,377557.3300000006,-15103.469999999972
20370,2022-07-08 13:30:00,1299.38,363753.24000000063,377557.3300000006,-13804.089999999967
20371,2022-07-08 13:35:00,-1512.31,362240.93000000063,377557.3300000006,-15316.399999999965
20372,2022-07-08 13:40:00,-1049.76,361191.1700000006,377557.3300000006,-16366.159999999974
20373,2022-07-08 13:45:00,1230.2,362421.37000000064,377557.3300000006,-15135.959999999963
20374,2022-07-08 13:50:00,1572.78,363994.15000000066,377557.3300000006,-13563.179999999935
20375,2022-07-08 13:55:00,-1363.45,362630.70000000065,377557.3300000006,-14926.629999999946
20376,2022-07-08 14:00:00,1740.82,364371.52000000066,377557.3300000006,-13185.80999999994
20377,2022-07-08 14:05:00,-1627.3,362744.22000000067,377557.3300000006,-14813.109999999928
20378,2022-07-08 14:10:00,-993.25,361750.97000000067,377557.3300000006,-15806.359999999928
20379,2022-07-08 14:15:00,-1317.02,360433.95000000065,377557.3300000006,-17123.379999999946
20380,2022-07-08 14:20:00,820.02,361253.97000000067,377557.3300000006,-16303.359999999928
20381,2022-07-08 14:25:00,329.44,361583.4100000007,377557.3300000006,-15973.919999999925
20382,2022-07-08 14:30:00,-1452.63,360130.78000000067,377557.3300000006,-17426.54999999993
20383,2022-07-08 14:35:00,433.63,360564.4100000007,377557.3300000006,-16992.919999999925
20384,2022-07-08 14:40:00,-1818.79,358745.6200000007,377557.3300000006,-18811.709999999905
20385,2022-07-08 14:45:00,890.8,359636.4200000007,377557.3300000006,-17920.909999999916
20386,2022-07-08 14:50:00,-810.66,358825.7600000007,377557.3300000006,-18731.56999999989
20387,2022-07-08 14:55:00,777.81,359603.5700000007,377557.3300000006,-17953.759999999893
20388,2022-07-08 15:00:00,-1163.67,358439.9000000007,377557.3300000006,-19117.429999999877
20389,2022-07-08 15:05:00,-239.8,358200.10000000073,377557.3300000006,-19357.229999999865
20390,2022-07-08 15:10:00,1671.11,359871.2100000007,377557.3300000006,-17686.11999999988
20391,2022-07-08 15:15:00,872.91,360744.1200000007,377557.3300000006,-16813.209999999905
20392,2022-07-08 15:20:00,-752.18,359991.9400000007,377557.3300000006,-17565.389999999898
20393,2022-07-08 15:25:00,884.25,360876.1900000007,377557.3300000006,-16681.139999999898
20394,2022-07-08 15:30:00,1315.26,362191.4500000007,377557.3300000006,-15365.879999999888
20395,2022-07-08 15:35:00,-915.5,361275.9500000007,377557.3300000006,-16281.379999999888
20396,2022-07-08 15:40:00,-836.89,360439.0600000007,377557.3300000006,-17118.269999999902
20397,2022-07-08 15:45:00,1293.32,361732.3800000007,377557.3300000006,-15824.949999999895
20398,2022-07-08 15:50:00,-1606.86,360125.5200000007,377557.3300000006,-17431.80999999988
20399,2022-07-08 15:55:00,-1106.23,359019.29000000074,377557.3300000006,-18538.039999999863
20400,2022-07-08 16:00:00,1759.47,360778.7600000007,377557.3300000006,-16778.56999999989
20401,2022-07-08 16:05:00,-122.06,360656.7000000007,377557.3300000006,-16900.62999999989
20402,2022-07-08 16:10:00,-1037.94,359618.7600000007,377557.3300000006,-17938.56999999989
20403,2022-07-08 16:15:00,-1931.91,357686.85000000073,377557.3300000006,-19870.479999999865
20404,2022-07-08 16:20:00,1663.32,359350.17000000074,377557.3300000006,-18207.159999999858
20405,2022-07-08 16:25:00,-629.15,358721.0200000007,377557.3300000006,-18836.30999999988
20406,2022-07-08 16:30:00,1395.08,360116.10000000073,377557.3300000006,-17441.229999999865
20407,2022-07-08 16:35:00,1807.58,361923.68000000075,377557.3300000006,-15633.649999999849
20408,2022-07-08 16:40:00,-1291.52,360632.16000000073,377557.3300000006,-16925.169999999867
20409,2022-07-08 16:45:00,502.6,361134.7600000007,377557.3300000006,-16422.56999999989
20410,2022-07-08 16:50:00,-1606.56,359528.2000000007,377557.3300000006,-18029.12999999989
20411,2022-07-08 16:55:00,-1261.84,358266.3600000007,377557.3300000006,-19290.969999999914
20412,2022-07-09 08:00:00,449.85,358716.21000000066,358266.3600000007,449.8499999999767
20413,2022-07-09 08:05:00,-466.84,358249.37000000064,358266.3600000007,-16.990000000048894
20414,2022-07-09 08:10:00,-632.65,357616.7200000006,358266.3600000007,-649.6400000000722
20415,2022-07-09 08:15:00,-884.69,356732.0300000006,358266.3600000007,-1534.3300000000745
20416,2022-07-09 08:20:00,608.65,357340.68000000063,358266.3600000007,-925.6800000000512
20417,2022-07-09 08:25:00,-1063.87,356276.81000000064,358266.3600000007,-1989.5500000000466
20418,2022-07-09 08:30:00,1573.51,357850.32000000065,358266.3600000007,-416.04000000003725
20419,2022-07-09 08:35:00,-858.53,356991.7900000006,358266.3600000007,-1274.5700000000652
20420,2022-07-09 08:40:00,-669.74,356322.0500000006,358266.3600000007,-1944.3100000000559
20421,2022-07-09 08:45:00,-1846.94,354475.1100000006,358266.3600000007,-3791.250000000058
20422,2022-07-09 08:50:00,98.75,354573.8600000006,358266.3600000007,-3692.500000000058
20423,2022-07-09 08:55:00,190.99,354764.8500000006,358266.3600000007,-3501.5100000000675
20424,2022-07-09 09:00:00,-754.56,354010.2900000006,358266.3600000007,-4256.070000000065
20425,2022-07-09 09:05:00,-223.68,353786.6100000006,358266.3600000007,-4479.750000000058
20426,2022-07-09 09:10:00,-1271.59,352515.0200000006,358266.3600000007,-5751.340000000084
20427,2022-07-09 09:15:00,472.67,352987.6900000006,358266.3600000007,-5278.6700000001
20428,2022-07-09 09:20:00,-54.04,352933.6500000006,358266.3600000007,-5332.710000000079
20429,2022-07-09 09:25:00,1005.89,353939.5400000006,358266.3600000007,-4326.820000000065
20430,2022-07-09 09:30:00,1225.19,355164.7300000006,358266.3600000007,-3101.630000000063
20431,2022-07-09 09:35:00,-230.25,354934.4800000006,358266.3600000007,-3331.880000000063
20432,2022-07-09 09:40:00,1479.13,356413.6100000006,358266.3600000007,-1852.7500000000582
20433,2022-07-09 09:45:00,-1303.57,355110.0400000006,358266.3600000007,-3156.320000000065
20434,2022-07-09 09:50:00,-1696.78,353413.2600000006,358266.3600000007,-4853.100000000093
20435,2022-07-09 09:55:00,-1291.48,352121.7800000006,358266.3600000007,-6144.5800000000745
20436,2022-07-09 10:00:00,694.24,352816.0200000006,358266.3600000007,-5450.340000000084
20437,2022-07-09 10:05:00,114.59,352930.6100000006,358266.3600000007,-5335.750000000058
20438,2022-07-09 10:10:00,1445.42,354376.0300000006,358266.3600000007,-3890.3300000000745
20439,2022-07-09 10:15:00,-1016.0,353360.0300000006,358266.3600000007,-4906.3300000000745
20440,2022-07-09 10:20:00,977.18,354337.2100000006,358266.3600000007,-3929.1500000000815
20441,2022-07-09 10:25:00,-1653.75,352683.4600000006,358266.3600000007,-5582.9000000000815
20442,2022-07-09 10:30:00,-1297.72,351385.74000000063,358266.3600000007,-6880.620000000054
20443,2022-07-09 10:35:00,1604.96,352990.70000000065,358266.3600000007,-5275.660000000033
20444,2022-07-09 10:40:00,920.36,353911.06000000064,358266.3600000007,-4355.300000000047
20445,2022-07-09 10:45:00,-32.6,353878.46000000066,358266.3600000007,-4387.900000000023
20446,2022-07-09 10:50:00,1362.61,355241.07000000065,358266.3600000007,-3025.2900000000373
20447,2022-07-09 10:55:00,-135.82,355105.25000000064,358266.3600000007,-3161.1100000000442
20448,2022-07-09 11:00:00,-1318.35,353786.90000000066,358266.3600000007,-4479.460000000021
20449,2022-07-09 11:05:00,-1623.06,352163.84000000067,358266.3600000007,-6102.520000000019
20450,2022-07-09 11:10:00,1423.0,353586.84000000067,358266.3600000007,-4679.520000000019
20451,2022-07-09 11:15:00,-118.48,353468.3600000007,358266.3600000007,-4798.0
20452,2022-07-09 11:20:00,-1985.48,351482.8800000007,358266.3600000007,-6783.479999999981
20453,2022-07-09 11:25:00,179.43,351662.3100000007,358266.3600000007,-6604.049999999988
20454,2022-07-09 11:30:00,1357.44,353019.7500000007,358266.3600000007,-5246.609999999986
20455,2022-07-09 11:35:00,225.74,353245.4900000007,358266.3600000007,-5020.869999999995
20456,2022-07-09 11:40:00,401.39,353646.8800000007,358266.3600000007,-4619.479999999981
20457,2022-07-09 11:45:00,85.38,353732.2600000007,358266.3600000007,-4534.099999999977
20458,2022-07-09 11:50:00,-199.42,353532.8400000007,358266.3600000007,-4733.51999999996
20459,2022-07-09 11:55:00,853.25,354386.0900000007,358266.3600000007,-3880.2699999999604
20460,2022-07-09 12:00:00,-1356.76,353029.3300000007,358266.3600000007,-5237.02999999997
20461,2022-07-09 12:05:00,-1507.41,351521.92000000074,358266.3600000007,-6744.439999999944
20462,2022-07-09 12:10:00,186.05,351707.9700000007,358266.3600000007,-6558.389999999956
20463,2022-07-09 12:15:00,1377.43,353085.4000000007,358266.3600000007,-5180.959999999963
20464,2022-07-09 12:20:00,-1885.65,351199.7500000007,358266.3600000007,-7066.609999999986
20465,2022-07-09 12:25:00,1998.38,353198.1300000007,358266.3600000007,-5068.229999999981
20466,2022-07-09 12:30:00,473.16,353671.2900000007,358266.3600000007,-4595.070000000007
20467,2022-07-09 12:35:00,-389.37,353281.9200000007,358266.3600000007,-4984.440000000002
20468,2022-07-09 12:40:00,-58.28,353223.64000000065,358266.3600000007,-5042.72000000003
20469,2022-07-09 12:45:00,-929.42,352294.22000000067,358266.3600000007,-5972.140000000014
20470,2022-07-09 12:50:00,-169.28,352124.94000000064,358266.3600000007,-6141.420000000042
20471,2022-07-09 12:55:00,1553.49,353678.43000000063,358266.3600000007,-4587.930000000051
20472,2022-07-09 13:00:00,-444.14,353234.2900000006,358266.3600000007,-5032.070000000065
20473,2022-07-09 13:05:00,1213.99,354448.2800000006,358266.3600000007,-3818.0800000000745
20474,2022-07-09 13:10:00,-1305.68,353142.6000000006,358266.3600000007,-5123.7600000000675
20475,2022-07-09 13:15:00,83.16,353225.7600000006,358266.3600000007,-5040.600000000093
20476,2022-07-09 13:20:00,-1297.1,351928.6600000006,358266.3600000007,-6337.70000000007
20477,2022-07-09 13:25:00,604.76,352533.4200000006,358266.3600000007,-5732.9400000000605
20478,2022-07-09 13:30:00,783.51,353316.93000000063,358266.3600000007,-4949.430000000051
20479,2022-07-09 13:35:00,-1826.83,351490.1000000006,358266.3600000007,-6776.2600000000675
20480,2022-07-09 13:40:00,-246.46,351243.6400000006,358266.3600000007,-7022.7200000000885
20481,2022-07-09 13:45:00,740.29,351983.9300000006,358266.3600000007,-6282.430000000109
20482,2022-07-09 13:50:00,-1427.5,350556.4300000006,358266.3600000007,-7709.930000000109
20483,2022-07-09 13:55:00,-1156.88,349399.55000000057,358266.3600000007,-8866.810000000114
20484,2022-07-09 14:00:00,-990.17,348409.3800000006,358266.3600000007,-9856.980000000098
20485,2022-07-09 14:05:00,1869.17,350278.55000000057,358266.3600000007,-7987.810000000114
20486,2022-07-09 14:10:00,1653.45,351932.0000000006,358266.3600000007,-6334.360000000102
20487,2022-07-09 14:15:00,-458.92,351473.0800000006,358266.3600000007,-6793.280000000086
20488,2022-07-09 14:20:00,1810.41,353283.4900000006,358266.3600000007,-4982.870000000112
20489,2022-07-09 14:25:00,-1109.38,352174.11000000057,358266.3600000007,-6092.250000000116
20490,2022-07-09 14:30:00,-1229.46,350944.65000000055,358266.3600000007,-7321.710000000137
20491,2022-07-09 14:35:00,-228.46,350716.1900000005,358266.3600000007,-7550.170000000158
20492,2022-07-09 14:40:00,-398.63,350317.5600000005,358266.3600000007,-7948.800000000163
20493,2022-07-09 14:45:00,-194.64,350122.9200000005,358266.3600000007,-8143.440000000177
20494,2022-07-09 14:50:00,-206.91,349916.01000000053,358266.3600000007,-8350.350000000151
20495,2022-07-09 14:55:00,1228.53,351144.54000000056,358266.3600000007,-7121.820000000123
20496,2022-07-09 15:00:00,-580.93,350563.61000000057,358266.3600000007,-7702.750000000116
20497,2022-07-09 15:05:00,1805.78,352369.3900000006,358266.3600000007,-5896.9700000000885
20498,2022-07-09 15:10:00,1364.3,353733.6900000006,358266.3600000007,-4532.6700000001
20499,2022-07-09 15:15:00,1351.37,355085.0600000006,358266.3600000007,-3181.300000000105
20500,2022-07-09 15:20:00,1997.22,357082.28000000055,358266.3600000007,-1184.0800000001327
20501,2022-07-09 15:25:00,-796.87,356285.41000000056,358266.3600000007,-1980.950000000128
20502,2022-07-09 15:30:00,-1952.71,354332.70000000054,358266.3600000007,-3933.660000000149
20503,2022-07-09 15:35:00,-1476.75,352855.95000000054,358266.3600000007,-5410.410000000149
20504,2022-07-09 15:40:00,274.81,353130.76000000053,358266.3600000007,-5135.600000000151
20505,2022-07-09 15:45:00,-402.01,352728.7500000005,358266.3600000007,-5537.610000000161
20506,2022-07-09 15:50:00,629.61,353358.3600000005,358266.3600000007,-4908.000000000175
20507,2022-07-09 15:55:00,1667.31,355025.6700000005,358266.3600000007,-3240.690000000177
20508,2022-07-09 16:00:00,84.29,355109.9600000005,358266.3600000007,-3156.400000000198
20509,2022-07-09 16:05:00,-845.92,354264.0400000005,358266.3600000007,-4002.3200000001816
20510,2022-07-09 16:10:00,1043.34,355307.3800000005,358266.3600000007,-2958.980000000156
20511,2022-07-09 16:15:00,396.29,355703.6700000005,358266.3600000007,-2562.690000000177
20512,2022-07-09 16:20:00,1629.75,357333.4200000005,358266.3600000007,-932.940000000177
20513,2022-07-09 16:25:00,204.15,357537.57000000053,358266.3600000007,-728.7900000001537
20514,2022-07-09 16:30:00,728.82,358266.39000000054,358266.3600000007,0.029999999853316694
20515,2022-07-09 16:35:00,-1206.58,357059.8100000005,358266.3600000007,-1206.550000000163
20516,2022-07-09 16:40:00,-1726.75,355333.0600000005,358266.3600000007,-2933.300000000163
20517,2022-07-09 16:45:00,-73.42,355259.64000000054,358266.3600000007,-3006.7200000001467
20518,2022-07-09 16:50:00,425.49,355685.1300000005,358266.3600000007,-2581.230000000156
20519,2022-07-09 16:55:00,821.25,356506.3800000005,358266.3600000007,-1759.980000000156
20520,2022-07-10 08:00:00,-1795.12,354711.26000000053,356506.3800000005,-1795.1199999999953
20521,2022-07-10 08:05:00,-570.49,354140.77000000054,356506.3800000005,-2365.609999999986
20522,2022-07-10 08:10:00,-857.79,353282.98000000056,356506.3800000005,-3223.399999999965
20523,2022-07-10 08:15:00,-212.82,353070.16000000056,356506.3800000005,-3436.219999999972
20524,2022-07-10 08:20:00,1828.22,354898.3800000005,356506.3800000005,-1608.0
20525,2022-07-10 08:25:00,651.3,355549.6800000005,356506.3800000005,-956.7000000000116
20526,2022-07-10 08:30:00,-973.15,354576.5300000005,356506.3800000005,-1929.850000000035
20527,2022-07-10 08:35:00,-1031.7,353544.8300000005,356506.3800000005,-2961.5500000000466
20528,2022-07-10 08:40:00,-1558.09,351986.74000000046,356506.3800000005,-4519.640000000072
20529,2022-07-10 08:45:00,872.48,352859.22000000044,356506.3800000005,-3647.160000000091
20530,2022-07-10 08:50:00,-46.53,352812.6900000004,356506.3800000005,-3693.6900000001187
20531,2022-07-10 08:55:00,-452.28,352360.4100000004,356506.3800000005,-4145.970000000147
20532,2022-07-10 09:00:00,-1267.88,351092.5300000004,356506.3800000005,-5413.850000000151
20533,2022-07-10 09:05:00,1983.22,353075.75000000035,356506.3800000005,-3430.6300000001793
20534,2022-07-10 09:10:00,-670.89,352404.86000000034,356506.3800000005,-4101.520000000193
20535,2022-07-10 09:15:00,34.67,352439.5300000003,356506.3800000005,-4066.8500000002095
20536,2022-07-10 09:20:00,1638.89,354078.42000000033,356506.3800000005,-2427.9600000001956
20537,2022-07-10 09:25:00,-1840.95,352237.4700000003,356506.3800000005,-4268.910000000207
20538,2022-07-10 09:30:00,1413.96,353651.43000000034,356506.3800000005,-2854.9500000001863
20539,2022-07-10 09:35:00,-340.36,353311.07000000036,356506.3800000005,-3195.3100000001723
20540,2022-07-10 09:40:00,-1618.59,351692.48000000033,356506.3800000005,-4813.900000000198
20541,2022-07-10 09:45:00,152.75,351845.23000000033,356506.3800000005,-4661.150000000198
20542,2022-07-10 09:50:00,-612.5,351232.73000000033,356506.3800000005,-5273.650000000198
20543,2022-07-10 09:55:00,348.5,351581.23000000033,356506.3800000005,-4925.150000000198
20544,2022-07-10 10:00:00,1498.9,353080.13000000035,356506.3800000005,-3426.2500000001746
20545,2022-07-10 10:05:00,-1219.55,351860.58000000037,356506.3800000005,-4645.800000000163
20546,2022-07-10 10:10:00,-1547.67,350312.9100000004,356506.3800000005,-6193.470000000147
20547,2022-07-10 10:15:00,-175.28,350137.63000000035,356506.3800000005,-6368.750000000175
20548,2022-07-10 10:20:00,134.94,350272.57000000036,356506.3800000005,-6233.810000000172
20549,2022-07-10 10:25:00,864.25,351136.82000000036,356506.3800000005,-5369.560000000172
20550,2022-07-10 10:30:00,1811.21,352948.0300000004,356506.3800000005,-3558.3500000001513
20551,2022-07-10 10:35:00,-241.69,352706.3400000004,356506.3800000005,-3800.0400000001537
20552,2022-07-10 10:40:00,687.44,353393.7800000004,356506.3800000005,-3112.6000000001513
20553,2022-07-10 10:45:00,-1978.32,351415.46000000037,356506.3800000005,-5090.920000000158
20554,2022-07-10 10:50:00,-344.37,351071.0900000004,356506.3800000005,-5435.290000000154
20555,2022-07-10 10:55:00,-1596.11,349474.9800000004,356506.3800000005,-7031.40000000014
20556,2022-07-10 11:00:00,-1784.74,347690.2400000004,356506.3800000005,-8816.14000000013
20557,2022-07-10 11:05:00,-1058.61,346631.6300000004,356506.3800000005,-9874.750000000116
20558,2022-07-10 11:10:00,-706.66,345924.97000000044,356506.3800000005,-10581.41000000009
20559,2022-07-10 11:15:00,-1981.04,343943.93000000046,356506.3800000005,-12562.45000000007
20560,2022-07-10 11:20:00,-51.69,343892.24000000046,356506.3800000005,-12614.140000000072
20561,2022-07-10 11:25:00,1954.34,345846.5800000005,356506.3800000005,-10659.800000000047
20562,2022-07-10 11:30:00,-1549.72,344296.8600000005,356506.3800000005,-12209.520000000019
20563,2022-07-10 11:35:00,-1929.58,342367.2800000005,356506.3800000005,-14139.100000000035
20564,2022-07-10 11:40:00,1707.27,344074.5500000005,356506.3800000005,-12431.830000000016
20565,2022-07-10 11:45:00,1667.22,345741.7700000005,356506.3800000005,-10764.610000000044
20566,2022-07-10 11:50:00,580.07,346321.8400000005,356506.3800000005,-10184.540000000037
20567,2022-07-10 11:55:00,-623.53,345698.31000000046,356506.3800000005,-10808.070000000065
20568,2022-07-10 12:00:00,-1855.17,343843.1400000005,356506.3800000005,-12663.240000000049
20569,2022-07-10 12:05:00,89.54,343932.68000000046,356506.3800000005,-12573.70000000007
20570,2022-07-10 12:10:00,-138.14,343794.54000000044,356506.3800000005,-12711.840000000084
20571,2022-07-10 12:15:00,1471.29,345265.8300000004,356506.3800000005,-11240.550000000105
20572,2022-07-10 12:20:00,-1646.01,343619.8200000004,356506.3800000005,-12886.560000000114
20573,2022-07-10 12:25:00,-1239.52,342380.3000000004,356506.3800000005,-14126.080000000133
20574,2022-07-10 12:30:00,1339.55,343719.8500000004,356506.3800000005,-12786.530000000144
20575,2022-07-10 12:35:00,173.38,343893.2300000004,356506.3800000005,-12613.15000000014
20576,2022-07-10 12:40:00,-304.84,343588.39000000036,356506.3800000005,-12917.990000000165
20577,2022-07-10 12:45:00,-1847.65,341740.74000000034,356506.3800000005,-14765.640000000189
20578,2022-07-10 12:50:00,1468.91,343209.6500000003,356506.3800000005,-13296.730000000214
20579,2022-07-10 12:55:00,-1796.44,341413.2100000003,356506.3800000005,-15093.170000000217
20580,2022-07-10 13:00:00,-1094.96,340318.2500000003,356506.3800000005,-16188.130000000237
20581,2022-07-10 13:05:00,403.65,340721.9000000003,356506.3800000005,-15784.480000000214
20582,2022-07-10 13:10:00,-461.99,340259.9100000003,356506.3800000005,-16246.470000000205
20583,2022-07-10 13:15:00,1483.49,341743.4000000003,356506.3800000005,-14762.980000000214
20584,2022-07-10 13:20:00,346.7,342090.1000000003,356506.3800000005,-14416.280000000203
20585,2022-07-10 13:25:00,-1350.17,340739.93000000034,356506.3800000005,-15766.450000000186
20586,2022-07-10 13:30:00,1432.6,342172.5300000003,356506.3800000005,-14333.85000000021
20587,2022-07-10 13:35:00,-980.84,341191.6900000003,356506.3800000005,-15314.690000000235
20588,2022-07-10 13:40:00,1638.92,342830.6100000003,356506.3800000005,-13675.770000000251
20589,2022-07-10 13:45:00,-1856.16,340974.4500000003,356506.3800000005,-15531.930000000226
20590,2022-07-10 13:50:00,-372.22,340602.23000000033,356506.3800000005,-15904.150000000198
20591,2022-07-10 13:55:00,-1187.46,339414.7700000003,356506.3800000005,-17091.61000000022
20592,2022-07-10 14:00:00,1855.12,341269.8900000003,356506.3800000005,-15236.490000000224
20593,2022-07-10 14:05:00,-101.58,341168.3100000003,356506.3800000005,-15338.07000000024
20594,2022-07-10 14:10:00,-1693.77,339474.54000000027,356506.3800000005,-17031.84000000026
20595,2022-07-10 14:15:00,1920.21,341394.7500000003,356506.3800000005,-15111.630000000237
20596,2022-07-10 14:20:00,-80.69,341314.0600000003,356506.3800000005,-15192.32000000024
20597,2022-07-10 14:25:00,-1766.85,339547.2100000003,356506.3800000005,-16959.170000000217
20598,2022-07-10 14:30:00,-96.98,339450.23000000033,356506.3800000005,-17056.150000000198
20599,2022-07-10 14:35:00,-664.34,338785.8900000003,356506.3800000005,-17720.490000000224
20600,2022-07-10 14:40:00,-856.74,337929.1500000003,356506.3800000005,-18577.230000000214
20601,2022-07-10 14:45:00,-1347.79,336581.36000000034,356506.3800000005,-19925.020000000193
20602,2022-07-10 14:50:00,-17.2,336564.1600000003,356506.3800000005,-19942.220000000205
20603,2022-07-10 14:55:00,921.87,337486.0300000003,356506.3800000005,-19020.35000000021
20604,2022-07-10 15:00:00,977.13,338463.1600000003,356506.3800000005,-18043.220000000205
20605,2022-07-10 15:05:00,-1316.61,337146.55000000034,356506.3800000005,-19359.83000000019
20606,2022-07-10 15:10:00,1224.61,338371.1600000003,356506.3800000005,-18135.220000000205
20607,2022-07-10 15:15:00,-344.71,338026.4500000003,356506.3800000005,-18479.930000000226
20608,2022-07-10 15:20:00,681.32,338707.7700000003,356506.3800000005,-17798.61000000022
20609,2022-07-10 15:25:00,-485.54,338222.23000000033,356506.3800000005,-18284.150000000198
20610,2022-07-10 15:30:00,-1254.13,336968.1000000003,356506.3800000005,-19538.280000000203
20611,2022-07-10 15:35:00,619.18,337587.2800000003,356506.3800000005,-18919.10000000021
20612,2022-07-10 15:40:00,1193.86,338781.1400000003,356506.3800000005,-17725.240000000224
20613,2022-07-10 15:45:00,421.77,339202.9100000003,356506.3800000005,-17303.470000000205
20614,2022-07-10 15:50:00,-1842.09,337360.8200000003,356506.3800000005,-19145.56000000023
20615,2022-07-10 15:55:00,1631.64,338992.4600000003,356506.3800000005,-17513.920000000217
20616,2022-07-10 16:00:00,-750.49,338241.9700000003,356506.3800000005,-18264.410000000207
20617,2022-07-10 16:05:00,-1048.97,337193.00000000035,356506.3800000005,-19313.38000000018
20618,2022-07-10 16:10:00,1805.26,338998.26000000036,356506.3800000005,-17508.12000000017
20619,2022-07-10 16:15:00,749.74,339748.00000000035,356506.3800000005,-16758.38000000018
20620,2022-07-10 16:20:00,1575.16,341323.1600000003,356506.3800000005,-15183.220000000205
20621,2022-07-10 16:25:00,-1167.51,340155.6500000003,356506.3800000005,-16350.730000000214
20622,2022-07-10 16:30:00,486.88,340642.5300000003,356506.3800000005,-15863.85000000021
20623,2022-07-10 16:35:00,130.2,340772.73000000033,356506.3800000005,-15733.650000000198
20624,2022-07-10 16:40:00,-1538.3,339234.43000000034,356506.3800000005,-17271.950000000186
20625,2022-07-10 16:45:00,1857.54,341091.9700000003,356506.3800000005,-15414.410000000207
20626,2022-07-10 16:50:00,203.89,341295.86000000034,356506.3800000005,-15210.520000000193
20627,2022-07-10 16:55:00,714.5,342010.36000000034,356506.3800000005,-14496.020000000193
20628,2022-07-11 08:00:00,-1767.23,340243.13000000035,342010.36000000034,-1767.2299999999814
20629,2022-07-11 08:05:00,-662.05,339581.08000000037,342010.36000000034,-2429.2799999999697
20630,2022-07-11 08:10:00,1003.11,340584.19000000035,342010.36000000034,-1426.1699999999837
20631,2022-07-11 08:15:00,-495.11,340089.08000000037,342010.36000000034,-1921.2799999999697
20632,2022-07-11 08:20:00,-1520.61,338568.4700000004,342010.36000000034,-3441.8899999999558
20633,2022-07-11 08:25:00,-1918.56,336649.9100000004,342010.36000000034,-5360.449999999953
20634,2022-07-11 08:30:00,-771.54,335878.3700000004,342010.36000000034,-6131.9899999999325
20635,2022-07-11 08:35:00,-2.33,335876.0400000004,342010.36000000034,-6134.319999999949
20636,2022-07-11 08:40:00,1566.18,337442.2200000004,342010.36000000034,-4568.139999999956
20637,2022-07-11 08:45:00,358.41,337800.63000000035,342010.36000000034,-4209.729999999981
20638,2022-07-11 08:50:00,-1277.42,336523.21000000037,342010.36000000034,-5487.149999999965
20639,2022-07-11 08:55:00,1236.88,337760.0900000004,342010.36000000034,-4250.26999999996
20640,2022-07-11 09:00:00,1013.67,338773.76000000036,342010.36000000034,-3236.5999999999767
20641,2022-07-11 09:05:00,576.32,339350.08000000037,342010.36000000034,-2660.2799999999697
20642,2022-07-11 09:10:00,213.46,339563.5400000004,342010.36000000034,-2446.819999999949
20643,2022-07-11 09:15:00,1258.78,340822.3200000004,342010.36000000034,-1188.0399999999208
20644,2022-07-11 09:20:00,-1169.75,339652.5700000004,342010.36000000034,-2357.789999999921
20645,2022-07-11 09:25:00,-1635.58,338016.9900000004,342010.36000000034,-3993.369999999937
20646,2022-07-11 09:30:00,379.16,338396.1500000004,342010.36000000034,-3614.2099999999627
20647,2022-07-11 09:35:00,-1600.55,336795.6000000004,342010.36000000034,-5214.759999999951
20648,2022-07-11 09:40:00,-593.22,336202.3800000004,342010.36000000034,-5807.979999999923
20649,2022-07-11 09:45:00,1068.37,337270.7500000004,342010.36000000034,-4739.609999999928
20650,2022-07-11 09:50:00,-1200.9,336069.8500000004,342010.36000000034,-5940.509999999951
20651,2022-07-11 09:55:00,21.11,336090.96000000037,342010.36000000034,-5919.399999999965
20652,2022-07-11 10:00:00,-1159.0,334931.96000000037,342010.36000000034,-7078.399999999965
20653,2022-07-11 10:05:00,1192.83,336124.7900000004,342010.36000000034,-5885.569999999949
20654,2022-07-11 10:10:00,1569.64,337694.4300000004,342010.36000000034,-4315.929999999935
20655,2022-07-11 10:15:00,-369.1,337325.3300000004,342010.36000000034,-4685.0299999999115
20656,2022-07-11 10:20:00,-1786.45,335538.8800000004,342010.36000000034,-6471.479999999923
20657,2022-07-11 10:25:00,1416.56,336955.4400000004,342010.36000000034,-5054.9199999999255
20658,2022-07-11 10:30:00,-1076.02,335879.4200000004,342010.36000000034,-6130.939999999944
20659,2022-07-11 10:35:00,481.01,336360.4300000004,342010.36000000034,-5649.929999999935
20660,2022-07-11 10:40:00,1653.02,338013.4500000004,342010.36000000034,-3996.909999999916
20661,2022-07-11 10:45:00,1787.13,339800.5800000004,342010.36000000034,-2209.7799999999115
20662,2022-07-11 10:50:00,-1625.67,338174.91000000044,342010.36000000034,-3835.449999999895
20663,2022-07-11 10:55:00,1210.15,339385.06000000046,342010.36000000034,-2625.299999999872
20664,2022-07-11 11:00:00,12.77,339397.8300000005,342010.36000000034,-2612.5299999998533
20665,2022-07-11 11:05:00,963.21,340361.0400000005,342010.36000000034,-1649.3199999998324
20666,2022-07-11 11:10:00,108.52,340469.5600000005,342010.36000000034,-1540.7999999998137
20667,2022-07-11 11:15:00,195.15,340664.71000000054,342010.36000000034,-1345.6499999997905
20668,2022-07-11 11:20:00,-1171.63,339493.08000000054,342010.36000000034,-2517.279999999795
20669,2022-07-11 11:25:00,-320.98,339172.10000000056,342010.36000000034,-2838.2599999997765
20670,2022-07-11 11:30:00,-234.35,338937.7500000006,342010.36000000034,-3072.609999999753
20671,2022-07-11 11:35:00,1294.53,340232.2800000006,342010.36000000034,-1778.0799999997253
20672,2022-07-11 11:40:00,-1155.41,339076.87000000064,342010.36000000034,-2933.4899999996996
20673,2022-07-11 11:45:00,-378.52,338698.3500000006,342010.36000000034,-3312.0099999997183
20674,2022-07-11 11:50:00,1568.08,340266.43000000063,342010.36000000034,-1743.929999999702
20675,2022-07-11 11:55:00,-1750.38,338516.0500000006,342010.36000000034,-3494.3099999997066
20676,2022-07-11 12:00:00,-1482.09,337033.9600000006,342010.36000000034,-4976.399999999732
20677,2022-07-11 12:05:00,1766.55,338800.5100000006,342010.36000000034,-3209.849999999744
20678,2022-07-11 12:10:00,661.16,339461.67000000057,342010.36000000034,-2548.6899999997695
20679,2022-07-11 12:15:00,-1714.46,337747.21000000054,342010.36000000034,-4263.14999999979
20680,2022-07-11 12:20:00,678.65,338425.86000000057,342010.36000000034,-3584.499999999767
20681,2022-07-11 12:25:00,-819.83,337606.03000000055,342010.36000000034,-4404.3299999997835
20682,2022-07-11 12:30:00,684.63,338290.66000000056,342010.36000000034,-3719.699999999779
20683,2022-07-11 12:35:00,-438.24,337852.42000000057,342010.36000000034,-4157.9399999997695
20684,2022-07-11 12:40:00,-450.76,337401.66000000056,342010.36000000034,-4608.699999999779
20685,2022-07-11 12:45:00,1221.62,338623.28000000055,342010.36000000034,-3387.0799999997835
20686,2022-07-11 12:50:00,1109.89,339733.17000000057,342010.36000000034,-2277.1899999997695
20687,2022-07-11 12:55:00,627.15,340360.3200000006,342010.36000000034,-1650.0399999997462
20688,2022-07-11 13:00:00,240.2,340600.5200000006,342010.36000000034,-1409.8399999997346
20689,2022-07-11 13:05:00,941.84,341542.3600000006,342010.36000000034,-467.99999999970896
20690,2022-07-11 13:10:00,787.77,342330.13000000064,342010.36000000034,319.77000000030966
20691,2022-07-11 13:15:00,-237.83,342092.3000000006,342010.36000000034,81.94000000029337
20692,2022-07-11 13:20:00,194.14,342286.44000000064,342010.36000000034,276.08000000030734
20693,2022-07-11 13:25:00,-522.43,341764.01000000065,342010.36000000034,-246.34999999968568
20694,2022-07-11 13:30:00,-187.64,341576.37000000064,342010.36000000034,-433.98999999969965
20695,2022-07-11 13:35:00,-1404.82,340171.5500000006,342010.36000000034,-1838.8099999997066
20696,2022-07-11 13:40:00,-1316.62,338854.93000000063,342010.36000000034,-3155.429999999702
20697,2022-07-11 13:45:00,1137.03,339991.96000000066,342010.36000000034,-2018.399999999674
20698,2022-07-11 13:50:00,-437.98,339553.9800000007,342010.36000000034,-2456.3799999996554
20699,2022-07-11 13:55:00,220.77,339774.7500000007,342010.36000000034,-2235.609999999637
20700,2022-07-11 14:00:00,-403.9,339370.8500000007,342010.36000000034,-2639.50999999966
20701,2022-07-11 14:05:00,1366.92,340737.77000000066,342010.36000000034,-1272.5899999996764
20702,2022-07-11 14:10:00,-540.65,340197.12000000064,342010.36000000034,-1813.2399999996996
20703,2022-07-11 14:15:00,1571.77,341768.89000000065,342010.36000000034,-241.46999999968102
20704,2022-07-11 14:20:00,1258.81,343027.70000000065,342010.36000000034,1017.3400000003166
20705,2022-07-11 14:25:00,114.05,343141.75000000064,342010.36000000034,1131.390000000305
20706,2022-07-11 14:30:00,-1954.62,341187.13000000064,342010.36000000034,-823.2299999996903
20707,2022-07-11 14:35:00,-102.16,341084.97000000067,342010.36000000034,-925.3899999996647
20708,2022-07-11 14:40:00,-781.11,340303.8600000007,342010.36000000034,-1706.4999999996508
20709,2022-07-11 14:45:00,-157.11,340146.7500000007,342010.36000000034,-1863.6099999996368
20710,2022-07-11 14:50:00,239.15,340385.9000000007,342010.36000000034,-1624.4599999996135
20711,2022-07-11 14:55:00,591.33,340977.23000000074,342010.36000000034,-1033.1299999995972
20712,2022-07-11 15:00:00,544.81,341522.04000000074,342010.36000000034,-488.31999999959953
20713,2022-07-11 15:05:00,1094.75,342616.79000000074,342010.36000000034,606.4300000004005
20714,2022-07-11 15:10:00,877.38,343494.17000000074,342010.36000000034,1483.8100000004051
20715,2022-07-11 15:15:00,-1432.56,342061.61000000074,342010.36000000034,51.250000000407454
20716,2022-07-11 15:20:00,-767.95,341293.66000000073,342010.36000000034,-716.6999999996042
20717,2022-07-11 15:25:00,-1247.51,340046.1500000007,342010.36000000034,-1964.2099999996135
20718,2022-07-11 15:30:00,1798.16,341844.3100000007,342010.36000000034,-166.0499999996391
20719,2022-07-11 15:35:00,1132.01,342976.3200000007,342010.36000000034,965.9600000003702
20720,2022-07-11 15:40:00,875.22,343851.5400000007,342010.36000000034,1841.1800000003423
20721,2022-07-11 15:45:00,-1687.98,342163.5600000007,342010.36000000034,153.2000000003609
20722,2022-07-11 15:50:00,126.36,342289.9200000007,342010.36000000034,279.5600000003469
20723,2022-07-11 15:55:00,-1025.24,341264.6800000007,342010.36000000034,-745.6799999996438
20724,2022-07-11 16:00:00,1841.79,343106.47000000067,342010.36000000034,1096.1100000003353
20725,2022-07-11 16:05:00,337.08,343443.5500000007,342010.36000000034,1433.1900000003516
20726,2022-07-11 16:10:00,927.67,344371.22000000067,342010.36000000034,2360.8600000003353
20727,2022-07-11 16:15:00,728.7,345099.9200000007,342010.36000000034,3089.560000000347
20728,2022-07-11 16:20:00,-471.06,344628.8600000007,342010.36000000034,2618.5000000003492
20729,2022-07-11 16:25:00,-548.25,344080.6100000007,342010.36000000034,2070.2500000003492
20730,2022-07-11 16:30:00,1064.38,345144.9900000007,342010.36000000034,3134.630000000354
20731,2022-07-11 16:35:00,1273.98,346418.97000000067,342010.36000000034,4408.610000000335
20732,2022-07-11 16:40:00,1280.18,347699.15000000066,342010.36000000034,5688.790000000328
20733,2022-07-11 16:45:00,-1071.82,346627.33000000066,342010.36000000034,4616.970000000321
20734,2022-07-11 16:50:00,-821.98,345805.3500000007,342010.36000000034,3794.99000000034
20735,2022-07-11 16:55:00,1014.42,346819.77000000066,342010.36000000034,4809.410000000324
20736,2022-07-12 08:00:00,1848.86,348668.63000000064,346819.77000000066,1848.859999999986
20737,2022-07-12 08:05:00,726.75,349395.38000000064,346819.77000000066,2575.609999999986
20738,2022-07-12 08:10:00,-1231.5,348163.88000000064,346819.77000000066,1344.109999999986
20739,2022-07-12 08:15:00,-841.46,347322.4200000006,346819.77000000066,502.6499999999651
20740,2022-07-12 08:20:00,-606.08,346716.3400000006,346819.77000000066,-103.43000000005122
20741,2022-07-12 08:25:00,805.09,347521.43000000063,346819.77000000066,701.6599999999744
20742,2022-07-12 08:30:00,1938.75,349460.18000000063,346819.77000000066,2640.4099999999744
20743,2022-07-12 08:35:00,-446.6,349013.58000000066,346819.77000000066,2193.8099999999977
20744,2022-07-12 08:40:00,1452.46,350466.0400000007,346819.77000000066,3646.2700000000186
20745,2022-07-12 08:45:00,658.21,351124.2500000007,346819.77000000066,4304.48000000004
20746,2022-07-12 08:50:00,-683.39,350440.8600000007,346819.77000000066,3621.0900000000256
20747,2022-07-12 08:55:00,1101.42,351542.28000000067,346819.77000000066,4722.510000000009
20748,2022-07-12 09:00:00,1667.81,353210.09000000067,346819.77000000066,6390.320000000007
20749,2022-07-12 09:05:00,-1930.12,351279.97000000067,346819.77000000066,4460.200000000012
20750,2022-07-12 09:10:00,-1605.31,349674.6600000007,346819.77000000066,2854.890000000014
20751,2022-07-12 09:15:00,477.03,350151.6900000007,346819.77000000066,3331.920000000042
20752,2022-07-12 09:20:00,1687.85,351839.5400000007,346819.77000000066,5019.770000000019
20753,2022-07-12 09:25:00,-1066.52,350773.02000000066,346819.77000000066,3953.25
20754,2022-07-12 09:30:00,-270.69,350502.33000000066,346819.77000000066,3682.5599999999977
20755,2022-07-12 09:35:00,1381.8,351884.13000000064,346819.77000000066,5064.359999999986
20756,2022-07-12 09:40:00,-1541.44,350342.69000000064,346819.77000000066,3522.9199999999837
20757,2022-07-12 09:45:00,1912.0,352254.69000000064,346819.77000000066,5434.919999999984
20758,2022-07-12 09:50:00,-1341.61,350913.08000000066,346819.77000000066,4093.3099999999977
20759,2022-07-12 09:55:00,986.34,351899.4200000007,346819.77000000066,5079.650000000023
20760,2022-07-12 10:00:00,-1707.33,350192.09000000067,346819.77000000066,3372.320000000007
20761,2022-07-12 10:05:00,86.84,350278.9300000007,346819.77000000066,3459.1600000000326
20762,2022-07-12 10:10:00,330.69,350609.6200000007,346819.77000000066,3789.850000000035
20763,2022-07-12 10:15:00,1733.17,352342.7900000007,346819.77000000066,5523.020000000019
20764,2022-07-12 10:20:00,-1398.66,350944.1300000007,346819.77000000066,4124.360000000044
20765,2022-07-12 10:25:00,-1592.56,349351.5700000007,346819.77000000066,2531.8000000000466
20766,2022-07-12 10:30:00,-420.19,348931.3800000007,346819.77000000066,2111.6100000000442
20767,2022-07-12 10:35:00,-1305.97,347625.41000000073,346819.77000000066,805.6400000000722
20768,2022-07-12 10:40:00,-843.33,346782.0800000007,346819.77000000066,-37.68999999994412
20769,2022-07-12 10:45:00,-671.84,346110.2400000007,346819.77000000066,-709.5299999999697
20770,2022-07-12 10:50:00,603.9,346714.1400000007,346819.77000000066,-105.62999999994645
20771,2022-07-12 10:55:00,-1894.24,344819.9000000007,346819.77000000066,-1999.8699999999371
20772,2022-07-12 11:00:00,-674.7,344145.2000000007,346819.77000000066,-2674.569999999949
20773,2022-07-12 11:05:00,-1268.67,342876.5300000007,346819.77000000066,-3943.2399999999325
20774,2022-07-12 11:10:00,-1210.38,341666.1500000007,346819.77000000066,-5153.619999999937
20775,2022-07-12 11:15:00,-845.82,340820.3300000007,346819.77000000066,-5999.439999999944
20776,2022-07-12 11:20:00,1227.31,342047.6400000007,346819.77000000066,-4772.129999999946
20777,2022-07-12 11:25:00,-1803.9,340243.7400000007,346819.77000000066,-6576.02999999997
20778,2022-07-12 11:30:00,-1657.39,338586.3500000007,346819.77000000066,-8233.419999999984
20779,2022-07-12 11:35:00,217.4,338803.7500000007,346819.77000000066,-8016.01999999996
20780,2022-07-12 11:40:00,-319.84,338483.9100000007,346819.77000000066,-8335.859999999986
20781,2022-07-12 11:45:00,852.7,339336.6100000007,346819.77000000066,-7483.159999999974
20782,2022-07-12 11:50:00,950.13,340286.7400000007,346819.77000000066,-6533.02999999997
20783,2022-07-12 11:55:00,1652.73,341939.47000000067,346819.77000000066,-4880.299999999988
20784,2022-07-12 12:00:00,-577.94,341361.53000000067,346819.77000000066,-5458.239999999991
20785,2022-07-12 12:05:00,1662.34,343023.8700000007,346819.77000000066,-3795.899999999965
20786,2022-07-12 12:10:00,685.31,343709.1800000007,346819.77000000066,-3110.5899999999674
20787,2022-07-12 12:15:00,-1671.8,342037.3800000007,346819.77000000066,-4782.389999999956
20788,2022-07-12 12:20:00,379.82,342417.2000000007,346819.77000000066,-4402.569999999949
20789,2022-07-12 12:25:00,929.81,343347.0100000007,346819.77000000066,-3472.759999999951
20790,2022-07-12 12:30:00,1623.78,344970.79000000074,346819.77000000066,-1848.9799999999232
20791,2022-07-12 12:35:00,762.62,345733.41000000073,346819.77000000066,-1086.3599999999278
20792,2022-07-12 12:40:00,-216.54,345516.87000000075,346819.77000000066,-1302.8999999999069
20793,2022-07-12 12:45:00,508.33,346025.20000000077,346819.77000000066,-794.5699999998906
20794,2022-07-12 12:50:00,698.61,346723.81000000075,346819.77000000066,-95.95999999990454
20795,2022-07-12 12:55:00,720.98,347444.79000000074,346819.77000000066,625.0200000000768
20796,2022-07-12 13:00:00,-803.37,346641.42000000074,346819.77000000066,-178.3499999999185
20797,2022-07-12 13:05:00,1290.06,347931.48000000074,346819.77000000066,1111.7100000000792
20798,2022-07-12 13:10:00,-1939.26,345992.2200000007,346819.77000000066,-827.5499999999302
20799,2022-07-12 13:15:00,-259.69,345732.5300000007,346819.77000000066,-1087.2399999999325
20800,2022-07-12 13:20:00,1668.93,347401.4600000007,346819.77000000066,581.6900000000605
20801,2022-07-12 13:25:00,350.55,347752.0100000007,346819.77000000066,932.2400000000489
20802,2022-07-12 13:30:00,-115.83,347636.1800000007,346819.77000000066,816.4100000000326
20803,2022-07-12 13:35:00,1473.35,349109.53000000067,346819.77000000066,2289.7600000000093
20804,2022-07-12 13:40:00,1221.12,350330.65000000066,346819.77000000066,3510.8800000000047
20805,2022-07-12 13:45:00,1620.02,351950.6700000007,346819.77000000066,5130.900000000023
20806,2022-07-12 13:50:00,904.69,352855.3600000007,346819.77000000066,6035.590000000026
20807,2022-07-12 13:55:00,-1583.68,351271.6800000007,346819.77000000066,4451.910000000033
20808,2022-07-12 14:00:00,-712.29,350559.3900000007,346819.77000000066,3739.6200000000536
20809,2022-07-12 14:05:00,1914.36,352473.7500000007,346819.77000000066,5653.98000000004
20810,2022-07-12 14:10:00,-1268.41,351205.3400000007,346819.77000000066,4385.570000000065
20811,2022-07-12 14:15:00,-972.57,350232.7700000007,346819.77000000066,3413.000000000058
20812,2022-07-12 14:20:00,1512.41,351745.1800000007,346819.77000000066,4925.410000000033
20813,2022-07-12 14:25:00,1151.31,352896.4900000007,346819.77000000066,6076.72000000003
20814,2022-07-12 14:30:00,-1440.74,351455.7500000007,346819.77000000066,4635.98000000004
20815,2022-07-12 14:35:00,1352.86,352808.6100000007,346819.77000000066,5988.840000000026
20816,2022-07-12 14:40:00,-132.62,352675.9900000007,346819.77000000066,5856.22000000003
20817,2022-07-12 14:45:00,940.7,353616.6900000007,346819.77000000066,6796.920000000042
20818,2022-07-12 14:50:00,527.23,354143.9200000007,346819.77000000066,7324.150000000023
20819,2022-07-12 14:55:00,1096.4,355240.3200000007,346819.77000000066,8420.550000000047
20820,2022-07-12 15:00:00,-1745.03,353495.2900000007,346819.77000000066,6675.520000000019
20821,2022-07-12 15:05:00,-1729.52,351765.77000000066,346819.77000000066,4946.0
20822,2022-07-12 15:10:00,-654.25,351111.52000000066,346819.77000000066,4291.75
20823,2022-07-12 15:15:00,984.69,352096.21000000066,346819.77000000066,5276.440000000002
20824,2022-07-12 15:20:00,1448.06,353544.27000000066,346819.77000000066,6724.5
20825,2022-07-12 15:25:00,-110.3,353433.97000000067,346819.77000000066,6614.200000000012
20826,2022-07-12 15:30:00,144.57,353578.5400000007,346819.77000000066,6758.770000000019
20827,2022-07-12 15:35:00,312.5,353891.0400000007,346819.77000000066,7071.270000000019
20828,2022-07-12 15:40:00,81.72,353972.76000000065,346819.77000000066,7152.989999999991
20829,2022-07-12 15:45:00,-1697.85,352274.9100000007,346819.77000000066,5455.140000000014
20830,2022-07-12 15:50:00,-1814.61,350460.3000000007,346819.77000000066,3640.530000000028
20831,2022-07-12 15:55:00,1746.32,352206.6200000007,346819.77000000066,5386.850000000035
20832,2022-07-12 16:00:00,-1835.89,350370.7300000007,346819.77000000066,3550.960000000021
20833,2022-07-12 16:05:00,1694.88,352065.6100000007,346819.77000000066,5245.840000000026
20834,2022-07-12 16:10:00,1437.29,353502.90000000066,346819.77000000066,6683.130000000005
20835,2022-07-12 16:15:00,-614.86,352888.0400000007,346819.77000000066,6068.270000000019
20836,2022-07-12 16:20:00,1748.52,354636.5600000007,346819.77000000066,7816.790000000037
20837,2022-07-12 16:25:00,1258.54,355895.1000000007,346819.77000000066,9075.330000000016
20838,2022-07-12 16:30:00,607.38,356502.4800000007,346819.77000000066,9682.710000000021
20839,2022-07-12 16:35:00,-495.3,356007.1800000007,346819.77000000066,9187.410000000033
20840,2022-07-12 16:40:00,1333.35,357340.53000000067,346819.77000000066,10520.76000000001
20841,2022-07-12 16:45:00,-588.19,356752.34000000067,346819.77000000066,9932.570000000007
20842,2022-07-12 16:50:00,1689.05,358441.39000000065,346819.77000000066,11621.619999999995
20843,2022-07-12 16:55:00,-376.72,358064.6700000007,346819.77000000066,11244.900000000023
20844,2022-07-13 08:00:00,-1956.85,356107.8200000007,358064.6700000007,-1956.8499999999767
20845,2022-07-13 08:05:00,-1386.63,354721.1900000007,358064.6700000007,-3343.4799999999814
20846,2022-07-13 08:10:00,-374.87,354346.3200000007,358064.6700000007,-3718.3499999999767
20847,2022-07-13 08:15:00,88.87,354435.1900000007,358064.6700000007,-3629.4799999999814
20848,2022-07-13 08:20:00,-1609.1,352826.0900000007,358064.6700000007,-5238.579999999958
20849,2022-07-13 08:25:00,1134.78,353960.87000000075,358064.6700000007,-4103.79999999993
20850,2022-07-13 08:30:00,1778.32,355739.19000000076,358064.6700000007,-2325.479999999923
20851,2022-07-13 08:35:00,-709.74,355029.45000000077,358064.6700000007,-3035.219999999914
20852,2022-07-13 08:40:00,1057.95,356087.4000000008,358064.6700000007,-1977.2699999999022
20853,2022-07-13 08:45:00,-446.03,355641.37000000075,358064.6700000007,-2423.29999999993
20854,2022-07-13 08:50:00,-668.06,354973.31000000075,358064.6700000007,-3091.359999999928
20855,2022-07-13 08:55:00,1281.35,356254.66000000073,358064.6700000007,-1810.009999999951
20856,2022-07-13 09:00:00,1611.53,357866.19000000076,358064.6700000007,-198.47999999992317
20857,2022-07-13 09:05:00,344.9,358211.0900000008,358064.6700000007,146.42000000010012
20858,2022-07-13 09:10:00,-1610.73,356600.3600000008,358064.6700000007,-1464.3099999998813
20859,2022-07-13 09:15:00,1246.99,357847.3500000008,358064.6700000007,-217.31999999989057
20860,2022-07-13 09:20:00,890.98,358738.3300000008,358064.6700000007,673.6600000000908
20861,2022-07-13 09:25:00,1594.18,360332.51000000077,358064.6700000007,2267.840000000084
20862,2022-07-13 09:30:00,-1157.48,359175.0300000008,358064.6700000007,1110.3600000001024
20863,2022-07-13 09:35:00,-654.04,358520.9900000008,358064.6700000007,456.3200000001234
20864,2022-07-13 09:40:00,-404.12,358116.8700000008,358064.6700000007,52.20000000012806
20865,2022-07-13 09:45:00,1675.9,359792.77000000083,358064.6700000007,1728.1000000001513
20866,2022-07-13 09:50:00,1779.9,361572.67000000086,358064.6700000007,3508.0000000001746
20867,2022-07-13 09:55:00,557.07,362129.74000000086,358064.6700000007,4065.0700000001816
20868,2022-07-13 10:00:00,1711.59,363841.3300000009,358064.6700000007,5776.660000000207
20869,2022-07-13 10:05:00,17.01,363858.3400000009,358064.6700000007,5793.6700000002165
20870,2022-07-13 10:10:00,-1167.37,362690.9700000009,358064.6700000007,4626.300000000221
20871,2022-07-13 10:15:00,-990.72,361700.25000000093,358064.6700000007,3635.580000000249
20872,2022-07-13 10:20:00,1706.59,363406.84000000096,358064.6700000007,5342.170000000275
20873,2022-07-13 10:25:00,-988.09,362418.75000000093,358064.6700000007,4354.080000000249
20874,2022-07-13 10:30:00,-1649.67,360769.08000000095,358064.6700000007,2704.4100000002654
20875,2022-07-13 10:35:00,-709.26,360059.82000000094,358064.6700000007,1995.1500000002561
20876,2022-07-13 10:40:00,735.68,360795.50000000093,358064.6700000007,2730.830000000249
20877,2022-07-13 10:45:00,-755.72,360039.78000000096,358064.6700000007,1975.110000000277
20878,2022-07-13 10:50:00,1764.94,361804.72000000096,358064.6700000007,3740.0500000002794
20879,2022-07-13 10:55:00,-191.15,361613.57000000094,358064.6700000007,3548.900000000256
20880,2022-07-13 11:00:00,-860.42,360753.15000000095,358064.6700000007,2688.4800000002724
20881,2022-07-13 11:05:00,125.54,360878.69000000093,358064.6700000007,2814.0200000002515
20882,2022-07-13 11:10:00,469.89,361348.58000000095,358064.6700000007,3283.9100000002654
20883,2022-07-13 11:15:00,432.2,361780.78000000096,358064.6700000007,3716.110000000277
20884,2022-07-13 11:20:00,1502.86,363283.64000000095,358064.6700000007,5218.970000000263
20885,2022-07-13 11:25:00,519.99,363803.63000000094,358064.6700000007,5738.960000000254
20886,2022-07-13 11:30:00,-130.67,363672.96000000095,358064.6700000007,5608.29000000027
20887,2022-07-13 11:35:00,-1483.69,362189.27000000095,358064.6700000007,4124.600000000268
20888,2022-07-13 11:40:00,-809.63,361379.64000000095,358064.6700000007,3314.970000000263
20889,2022-07-13 11:45:00,-1917.94,359461.70000000094,358064.6700000007,1397.0300000002608
20890,2022-07-13 11:50:00,1023.35,360485.0500000009,358064.6700000007,2420.3800000002375
20891,2022-07-13 11:55:00,-1711.73,358773.32000000094,358064.6700000007,708.6500000002561
20892,2022-07-13 12:00:00,-1334.29,357439.03000000096,358064.6700000007,-625.6399999997229
20893,2022-07-13 12:05:00,303.15,357742.180000001,358064.6700000007,-322.48999999969965
20894,2022-07-13 12:10:00,-183.68,357558.500000001,358064.6700000007,-506.16999999969266
20895,2022-07-13 12:15:00,-1942.54,355615.960000001,358064.6700000007,-2448.7099999996717
20896,2022-07-13 12:20:00,71.28,355687.24000000104,358064.6700000007,-2377.4299999996438
20897,2022-07-13 12:25:00,181.39,355868.63000000105,358064.6700000007,-2196.03999999963
20898,2022-07-13 12:30:00,314.76,356183.39000000106,358064.6700000007,-1881.2799999996205
20899,2022-07-13 12:35:00,-1697.02,354486.37000000104,358064.6700000007,-3578.299999999639
20900,2022-07-13 12:40:00,-812.44,353673.93000000104,358064.6700000007,-4390.739999999641
20901,2022-07-13 12:45:00,-527.47,353146.46000000107,358064.6700000007,-4918.2099999996135
20902,2022-07-13 12:50:00,883.85,354030.31000000105,358064.6700000007,-4034.359999999637
20903,2022-07-13 12:55:00,1901.75,355932.06000000105,358064.6700000007,-2132.609999999637
20904,2022-07-13 13:00:00,174.38,356106.44000000105,358064.6700000007,-1958.2299999996321
20905,2022-07-13 13:05:00,-729.43,355377.01000000106,358064.6700000007,-2687.659999999625
20906,2022-07-13 13:10:00,-673.57,354703.44000000105,358064.6700000007,-3361.229999999632
20907,2022-07-13 13:15:00,-893.08,353810.36000000103,358064.6700000007,-4254.309999999648
20908,2022-07-13 13:20:00,400.8,354211.160000001,358064.6700000007,-3853.50999999966
20909,2022-07-13 13:25:00,739.74,354950.900000001,358064.6700000007,-3113.7699999996694
20910,2022-07-13 13:30:00,727.06,355677.960000001,358064.6700000007,-2386.7099999996717
20911,2022-07-13 13:35:00,1881.05,357559.010000001,358064.6700000007,-505.65999999968335
20912,2022-07-13 13:40:00,-460.43,357098.580000001,358064.6700000007,-966.0899999996764
20913,2022-07-13 13:45:00,1995.91,359094.490000001,358064.6700000007,1029.820000000298
20914,2022-07-13 13:50:00,196.0,359290.490000001,358064.6700000007,1225.820000000298
20915,2022-07-13 13:55:00,1235.09,360525.580000001,358064.6700000007,2460.9100000003236
20916,2022-07-13 14:00:00,-887.05,359638.530000001,358064.6700000007,1573.8600000003353
20917,2022-07-13 14:05:00,-921.17,358717.36000000103,358064.6700000007,652.6900000003516
20918,2022-07-13 14:10:00,-1336.13,357381.23000000103,358064.6700000007,-683.4399999996531
20919,2022-07-13 14:15:00,1637.92,359019.150000001,358064.6700000007,954.4800000003306
20920,2022-07-13 14:20:00,-874.83,358144.320000001,358064.6700000007,79.65000000031432
20921,2022-07-13 14:25:00,174.93,358319.250000001,358064.6700000007,254.58000000030734
20922,2022-07-13 14:30:00,-1206.29,357112.960000001,358064.6700000007,-951.7099999996717
20923,2022-07-13 14:35:00,-1915.85,355197.11000000103,358064.6700000007,-2867.5599999996484
20924,2022-07-13 14:40:00,-1158.0,354039.11000000103,358064.6700000007,-4025.5599999996484
20925,2022-07-13 14:45:00,1295.3,355334.410000001,358064.6700000007,-2730.25999999966
20926,2022-07-13 14:50:00,232.39,355566.80000000104,358064.6700000007,-2497.869999999646
20927,2022-07-13 14:55:00,1013.72,356580.520000001,358064.6700000007,-1484.149999999674
20928,2022-07-13 15:00:00,1055.39,357635.910000001,358064.6700000007,-428.75999999966007
20929,2022-07-13 15:05:00,555.31,358191.220000001,358064.6700000007,126.5500000003376
20930,2022-07-13 15:10:00,-453.09,357738.130000001,358064.6700000007,-326.539999999688
20931,2022-07-13 15:15:00,-900.41,356837.720000001,358064.6700000007,-1226.9499999996624
20932,2022-07-13 15:20:00,1297.91,358135.630000001,358064.6700000007,70.960000000312
20933,2022-07-13 15:25:00,-1498.59,356637.04000000097,358064.6700000007,-1427.6299999997136
20934,2022-07-13 15:30:00,1652.17,358289.21000000095,358064.6700000007,224.54000000027008
20935,2022-07-13 15:35:00,1047.41,359336.6200000009,358064.6700000007,1271.9500000002445
20936,2022-07-13 15:40:00,1194.79,360531.4100000009,358064.6700000007,2466.7400000002235
20937,2022-07-13 15:45:00,1684.6,362216.0100000009,358064.6700000007,4151.3400000002
20938,2022-07-13 15:50:00,319.11,362535.12000000087,358064.6700000007,4470.450000000186
20939,2022-07-13 15:55:00,-1450.19,361084.93000000087,358064.6700000007,3020.260000000184
20940,2022-07-13 16:00:00,-1184.08,359900.85000000085,358064.6700000007,1836.1800000001676
20941,2022-07-13 16:05:00,-938.04,358962.81000000087,358064.6700000007,898.1400000001886
20942,2022-07-13 16:10:00,1992.72,360955.53000000084,358064.6700000007,2890.8600000001607
20943,2022-07-13 16:15:00,-386.51,360569.02000000083,358064.6700000007,2504.3500000001513
20944,2022-07-13 16:20:00,-469.18,360099.84000000084,358064.6700000007,2035.1700000001583
20945,2022-07-13 16:25:00,1515.44,361615.28000000084,358064.6700000007,3550.6100000001607
20946,2022-07-13 16:30:00,-1913.34,359701.9400000008,358064.6700000007,1637.270000000135
20947,2022-07-13 16:35:00,-658.24,359043.7000000008,358064.6700000007,979.0300000001444
20948,2022-07-13 16:40:00,-494.45,358549.2500000008,358064.6700000007,484.5800000001327
20949,2022-07-13 16:45:00,1570.26,360119.5100000008,358064.6700000007,2054.840000000142
20950,2022-07-13 16:50:00,1764.77,361884.28000000084,358064.6700000007,3819.6100000001607
20951,2022-07-13 16:55:00,1857.72,363742.0000000008,358064.6700000007,5677.330000000133
20952,2022-07-14 08:00:00,923.42,364665.4200000008,363742.0000000008,923.4199999999837
20953,2022-07-14 08:05:00,1672.41,366337.8300000008,363742.0000000008,2595.829999999958
20954,2022-07-14 08:10:00,-1904.32,364433.51000000077,363742.0000000008,691.5099999999511
20955,2022-07-14 08:15:00,-949.13,363484.38000000076,363742.0000000008,-257.62000000005355
20956,2022-07-14 08:20:00,-890.12,362594.26000000077,363742.0000000008,-1147.740000000049
20957,2022-07-14 08:25:00,1159.12,363753.38000000076,363742.0000000008,11.379999999946449
20958,2022-07-14 08:30:00,-4.56,363748.82000000076,363742.0000000008,6.819999999948777
20959,2022-07-14 08:35:00,1454.45,365203.2700000008,363742.0000000008,1461.2699999999604
20960,2022-07-14 08:40:00,-587.23,364616.0400000008,363742.0000000008,874.039999999979
20961,2022-07-14 08:45:00,-1905.82,362710.2200000008,363742.0000000008,-1031.780000000028
20962,2022-07-14 08:50:00,-896.59,361813.63000000076,363742.0000000008,-1928.3700000000536
20963,2022-07-14 08:55:00,-770.7,361042.93000000075,363742.0000000008,-2699.070000000065
20964,2022-07-14 09:00:00,637.22,361680.1500000007,363742.0000000008,-2061.850000000093
20965,2022-07-14 09:05:00,-285.8,361394.35000000073,363742.0000000008,-2347.6500000000815
20966,2022-07-14 09:10:00,996.59,362390.94000000076,363742.0000000008,-1351.0600000000559
20967,2022-07-14 09:15:00,-1717.5,360673.44000000076,363742.0000000008,-3068.560000000056
20968,2022-07-14 09:20:00,-1844.15,358829.29000000074,363742.0000000008,-4912.710000000079
20969,2022-07-14 09:25:00,262.68,359091.9700000007,363742.0000000008,-4650.030000000086
20970,2022-07-14 09:30:00,-582.57,358509.4000000007,363742.0000000008,-5232.600000000093
20971,2022-07-14 09:35:00,-1613.26,356896.1400000007,363742.0000000008,-6845.860000000102
20972,2022-07-14 09:40:00,322.62,357218.7600000007,363742.0000000008,-6523.240000000107
20973,2022-07-14 09:45:00,-1010.32,356208.4400000007,363742.0000000008,-7533.560000000114
20974,2022-07-14 09:50:00,1768.06,357976.5000000007,363742.0000000008,-5765.500000000116
20975,2022-07-14 09:55:00,-344.49,357632.0100000007,363742.0000000008,-6109.990000000107
20976,2022-07-14 10:00:00,560.83,358192.8400000007,363742.0000000008,-5549.160000000091
20977,2022-07-14 10:05:00,1402.25,359595.0900000007,363742.0000000008,-4146.910000000091
20978,2022-07-14 10:10:00,-1411.17,358183.92000000074,363742.0000000008,-5558.0800000000745
20979,2022-07-14 10:15:00,1226.64,359410.56000000075,363742.0000000008,-4331.4400000000605
20980,2022-07-14 10:20:00,-1019.75,358390.81000000075,363742.0000000008,-5351.1900000000605
20981,2022-07-14 10:25:00,723.78,359114.5900000008,363742.0000000008,-4627.410000000033
20982,2022-07-14 10:30:00,124.63,359239.2200000008,363742.0000000008,-4502.780000000028
20983,2022-07-14 10:35:00,1144.34,360383.5600000008,363742.0000000008,-3358.4400000000023
20984,2022-07-14 10:40:00,-860.71,359522.8500000008,363742.0000000008,-4219.150000000023
20985,2022-07-14 10:45:00,1398.42,360921.2700000008,363742.0000000008,-2820.7300000000396
20986,2022-07-14 10:50:00,1967.91,362889.18000000075,363742.0000000008,-852.8200000000652
20987,2022-07-14 10:55:00,-238.61,362650.57000000076,363742.0000000008,-1091.4300000000512
20988,2022-07-14 11:00:00,73.12,362723.69000000076,363742.0000000008,-1018.3100000000559
20989,2022-07-14 11:05:00,927.1,363650.79000000074,363742.0000000008,-91.21000000007916
20990,2022-07-14 11:10:00,-207.21,363443.5800000007,363742.0000000008,-298.4200000001001
20991,2022-07-14 11:15:00,-1493.1,361950.48000000074,363742.0000000008,-1791.5200000000768
20992,2022-07-14 11:20:00,-1584.36,360366.12000000075,363742.0000000008,-3375.880000000063
20993,2022-07-14 11:25:00,1178.26,361544.38000000076,363742.0000000008,-2197.6200000000536
20994,2022-07-14 11:30:00,462.23,362006.61000000074,363742.0000000008,-1735.3900000000722
20995,2022-07-14 11:35:00,1682.03,363688.64000000077,363742.0000000008,-53.36000000004424
20996,2022-07-14 11:40:00,-613.77,363074.87000000075,363742.0000000008,-667.1300000000629
20997,2022-07-14 11:45:00,-1741.12,361333.75000000076,363742.0000000008,-2408.250000000058
20998,2022-07-14 11:50:00,-1700.46,359633.29000000074,363742.0000000008,-4108.710000000079
20999,2022-07-14 11:55:00,185.05,359818.3400000007,363742.0000000008,-3923.660000000091
21000,2022-07-14 12:00:00,1693.08,361511.42000000074,363742.0000000008,-2230.5800000000745
21001,2022-07-14 12:05:00,-1097.13,360414.29000000074,363742.0000000008,-3327.710000000079
21002,2022-07-14 12:10:00,134.42,360548.7100000007,363742.0000000008,-3193.2900000000955
21003,2022-07-14 12:15:00,1195.05,361743.7600000007,363742.0000000008,-1998.240000000107
21004,2022-07-14 12:20:00,467.03,362210.79000000074,363742.0000000008,-1531.2100000000792
21005,2022-07-14 12:25:00,-626.77,361584.0200000007,363742.0000000008,-2157.980000000098
21006,2022-07-14 12:30:00,-1439.19,360144.8300000007,363742.0000000008,-3597.1700000001
21007,2022-07-14 12:35:00,1472.16,361616.9900000007,363742.0000000008,-2125.0100000001257
21008,2022-07-14 12:40:00,-1351.08,360265.9100000007,363742.0000000008,-3476.090000000142
21009,2022-07-14 12:45:00,1401.7,361667.6100000007,363742.0000000008,-2074.3900000001304
21010,2022-07-14 12:50:00,1251.18,362918.7900000007,363742.0000000008,-823.2100000001374
21011,2022-07-14 12:55:00,269.94,363188.7300000007,363742.0000000008,-553.270000000135
21012,2022-07-14 13:00:00,-198.86,362989.8700000007,363742.0000000008,-752.1300000001211
21013,2022-07-14 13:05:00,-1869.89,361119.9800000007,363742.0000000008,-2622.020000000135
21014,2022-07-14 13:10:00,231.99,361351.97000000067,363742.0000000008,-2390.0300000001444
21015,2022-07-14 13:15:00,1924.96,363276.9300000007,363742.0000000008,-465.0700000001234
21016,2022-07-14 13:20:00,-910.03,362366.90000000066,363742.0000000008,-1375.1000000001513
21017,2022-07-14 13:25:00,-1430.03,360936.87000000064,363742.0000000008,-2805.1300000001793
21018,2022-07-14 13:30:00,-800.95,360135.9200000006,363742.0000000008,-3606.080000000191
21019,2022-07-14 13:35:00,-1245.23,358890.69000000064,363742.0000000008,-4851.310000000172
21020,2022-07-14 13:40:00,220.57,359111.26000000065,363742.0000000008,-4630.740000000165
21021,2022-07-14 13:45:00,712.53,359823.7900000007,363742.0000000008,-3918.2100000001374
21022,2022-07-14 13:50:00,1632.45,361456.2400000007,363742.0000000008,-2285.7600000001257
21023,2022-07-14 13:55:00,-592.27,360863.97000000067,363742.0000000008,-2878.0300000001444
21024,2022-07-14 14:00:00,-398.87,360465.1000000007,363742.0000000008,-3276.9000000001397
21025,2022-07-14 14:05:00,511.2,360976.3000000007,363742.0000000008,-2765.700000000128
21026,2022-07-14 14:10:00,-41.35,360934.9500000007,363742.0000000008,-2807.050000000105
21027,2022-07-14 14:15:00,1282.86,362217.8100000007,363742.0000000008,-1524.1900000001187
21028,2022-07-14 14:20:00,1777.42,363995.2300000007,363742.0000000008,253.22999999986496
21029,2022-07-14 14:25:00,1910.97,365906.20000000065,363742.0000000008,2164.199999999837
21030,2022-07-14 14:30:00,-1491.98,364414.22000000067,363742.0000000008,672.2199999998556
21031,2022-07-14 14:35:00,168.81,364583.03000000067,363742.0000000008,841.0299999998533
21032,2022-07-14 14:40:00,-758.64,363824.39000000065,363742.0000000008,82.38999999983935
21033,2022-07-14 14:45:00,1574.91,365399.3000000006,363742.0000000008,1657.2999999998137
21034,2022-07-14 14:50:00,-1973.8,363425.50000000064,363742.0000000008,-316.5000000001746
21035,2022-07-14 14:55:00,-1326.35,362099.15000000066,363742.0000000008,-1642.8500000001513
21036,2022-07-14 15:00:00,-308.17,361790.9800000007,363742.0000000008,-1951.020000000135
21037,2022-07-14 15:05:00,866.26,362657.2400000007,363742.0000000008,-1084.7600000001257
21038,2022-07-14 15:10:00,859.55,363516.7900000007,363742.0000000008,-225.21000000013737
21039,2022-07-14 15:15:00,-1228.03,362288.76000000065,363742.0000000008,-1453.2400000001653
21040,2022-07-14 15:20:00,618.98,362907.74000000063,363742.0000000008,-834.2600000001839
21041,2022-07-14 15:25:00,-1130.51,361777.2300000006,363742.0000000008,-1964.7700000001932
21042,2022-07-14 15:30:00,1189.94,362967.1700000006,363742.0000000008,-774.8300000001909
21043,2022-07-14 15:35:00,702.88,363670.0500000006,363742.0000000008,-71.95000000018626
21044,2022-07-14 15:40:00,876.63,364546.68000000063,363742.0000000008,804.6799999998184
21045,2022-07-14 15:45:00,-570.79,363975.89000000065,363742.0000000008,233.88999999983935
21046,2022-07-14 15:50:00,-1478.17,362497.72000000067,363742.0000000008,-1244.2800000001444
21047,2022-07-14 15:55:00,1668.51,364166.2300000007,363742.0000000008,424.22999999986496
21048,2022-07-14 16:00:00,1959.97,366126.20000000065,363742.0000000008,2384.199999999837
21049,2022-07-14 16:05:00,1447.14,367573.34000000067,363742.0000000008,3831.339999999851
21050,2022-07-14 16:10:00,-1130.58,366442.76000000065,363742.0000000008,2700.7599999998347
21051,2022-07-14 16:15:00,1107.83,367550.59000000067,363742.0000000008,3808.589999999851
21052,2022-07-14 16:20:00,1072.56,368623.15000000066,363742.0000000008,4881.149999999849
21053,2022-07-14 16:25:00,1554.21,370177.3600000007,363742.0000000008,6435.35999999987
21054,2022-07-14 16:30:00,-1641.1,368536.2600000007,363742.0000000008,4794.259999999893
21055,2022-07-14 16:35:00,1635.18,370171.4400000007,363742.0000000008,6429.439999999886
21056,2022-07-14 16:40:00,1724.1,371895.5400000007,363742.0000000008,8153.539999999863
21057,2022-07-14 16:45:00,1985.5,373881.0400000007,363742.0000000008,10139.039999999863
21058,2022-07-14 16:50:00,-1389.3,372491.7400000007,363742.0000000008,8749.739999999874
21059,2022-07-14 16:55:00,1240.09,373731.8300000007,363742.0000000008,9989.8299999999
21060,2022-07-15 08:00:00,-1492.56,372239.2700000007,373731.8300000007,-1492.5599999999977
21061,2022-07-15 08:05:00,-701.63,371537.6400000007,373731.8300000007,-2194.1900000000023
21062,2022-07-15 08:10:00,-1994.3,369543.3400000007,373731.8300000007,-4188.489999999991
21063,2022-07-15 08:15:00,-508.21,369035.1300000007,373731.8300000007,-4696.700000000012
21064,2022-07-15 08:20:00,-1508.42,367526.7100000007,373731.8300000007,-6205.119999999995
21065,2022-07-15 08:25:00,22.28,367548.99000000075,373731.8300000007,-6182.839999999967
21066,2022-07-15 08:30:00,-1803.84,365745.1500000007,373731.8300000007,-7986.679999999993
21067,2022-07-15 08:35:00,438.52,366183.67000000074,373731.8300000007,-7548.159999999974
21068,2022-07-15 08:40:00,1296.49,367480.16000000073,373731.8300000007,-6251.669999999984
21069,2022-07-15 08:45:00,901.51,368381.67000000074,373731.8300000007,-5350.159999999974
21070,2022-07-15 08:50:00,43.32,368424.99000000075,373731.8300000007,-5306.839999999967
21071,2022-07-15 08:55:00,746.34,369171.3300000008,373731.8300000007,-4560.499999999942
21072,2022-07-15 09:00:00,429.58,369600.9100000008,373731.8300000007,-4130.9199999999255
21073,2022-07-15 09:05:00,1281.1,370882.01000000077,373731.8300000007,-2849.819999999949
21074,2022-07-15 09:10:00,-1769.98,369112.0300000008,373731.8300000007,-4619.79999999993
21075,2022-07-15 09:15:00,650.25,369762.2800000008,373731.8300000007,-3969.54999999993
21076,2022-07-15 09:20:00,-1016.14,368746.14000000077,373731.8300000007,-4985.689999999944
21077,2022-07-15 09:25:00,1894.71,370640.8500000008,373731.8300000007,-3090.979999999923
21078,2022-07-15 09:30:00,-823.2,369817.6500000008,373731.8300000007,-3914.179999999935
21079,2022-07-15 09:35:00,-988.54,368829.1100000008,373731.8300000007,-4902.719999999914
21080,2022-07-15 09:40:00,328.58,369157.6900000008,373731.8300000007,-4574.139999999898
21081,2022-07-15 09:45:00,-924.42,368233.27000000083,373731.8300000007,-5498.559999999881
21082,2022-07-15 09:50:00,-347.96,367885.3100000008,373731.8300000007,-5846.519999999902
21083,2022-07-15 09:55:00,1092.14,368977.4500000008,373731.8300000007,-4754.379999999888
21084,2022-07-15 10:00:00,-464.67,368512.78000000084,373731.8300000007,-5219.049999999872
21085,2022-07-15 10:05:00,123.99,368636.77000000083,373731.8300000007,-5095.059999999881
21086,2022-07-15 10:10:00,-1692.78,366943.9900000008,373731.8300000007,-6787.839999999909
21087,2022-07-15 10:15:00,-229.08,366714.9100000008,373731.8300000007,-7016.9199999999255
21088,2022-07-15 10:20:00,1379.64,368094.5500000008,373731.8300000007,-5637.2799999999115
21089,2022-07-15 10:25:00,1760.06,369854.6100000008,373731.8300000007,-3877.219999999914
21090,2022-07-15 10:30:00,-128.96,369725.6500000008,373731.8300000007,-4006.179999999935
21091,2022-07-15 10:35:00,-1359.7,368365.95000000077,373731.8300000007,-5365.879999999946
21092,2022-07-15 10:40:00,1540.3,369906.25000000076,373731.8300000007,-3825.579999999958
21093,2022-07-15 10:45:00,193.6,370099.85000000073,373731.8300000007,-3631.9799999999814
21094,2022-07-15 10:50:00,-887.38,369212.4700000007,373731.8300000007,-4519.359999999986
21095,2022-07-15 10:55:00,-259.04,368953.43000000075,373731.8300000007,-4778.399999999965
21096,2022-07-15 11:00:00,-384.1,368569.3300000008,373731.8300000007,-5162.499999999942
21097,2022-07-15 11:05:00,339.3,368908.63000000076,373731.8300000007,-4823.199999999953
21098,2022-07-15 11:10:00,1352.61,370261.24000000075,373731.8300000007,-3470.5899999999674
21099,2022-07-15 11:15:00,1489.55,371750.79000000074,373731.8300000007,-1981.039999999979
21100,2022-07-15 11:20:00,-846.55,370904.24000000075,373731.8300000007,-2827.5899999999674
21101,2022-07-15 11:25:00,-1728.92,369175.32000000076,373731.8300000007,-4556.509999999951
21102,2022-07-15 11:30:00,-1138.84,368036.48000000074,373731.8300000007,-5695.349999999977
21103,2022-07-15 11:35:00,1517.38,369553.86000000074,373731.8300000007,-4177.969999999972
21104,2022-07-15 11:40:00,171.75,369725.61000000074,373731.8300000007,-4006.219999999972
21105,2022-07-15 11:45:00,1009.69,370735.30000000075,373731.8300000007,-2996.5299999999697
21106,2022-07-15 11:50:00,-1774.74,368960.56000000075,373731.8300000007,-4771.26999999996
21107,2022-07-15 11:55:00,526.2,369486.76000000077,373731.8300000007,-4245.069999999949
21108,2022-07-15 12:00:00,1781.99,371268.75000000076,373731.8300000007,-2463.079999999958
21109,2022-07-15 12:05:00,-1721.23,369547.5200000008,373731.8300000007,-4184.3099999999395
21110,2022-07-15 12:10:00,1761.94,371309.4600000008,373731.8300000007,-2422.369999999937
21111,2022-07-15 12:15:00,-985.65,370323.81000000075,373731.8300000007,-3408.0199999999604
21112,2022-07-15 12:20:00,1046.2,371370.01000000077,373731.8300000007,-2361.819999999949
21113,2022-07-15 12:25:00,-128.81,371241.20000000077,373731.8300000007,-2490.6299999999464
21114,2022-07-15 12:30:00,-957.82,370283.38000000076,373731.8300000007,-3448.4499999999534
21115,2022-07-15 12:35:00,500.38,370783.76000000077,373731.8300000007,-2948.069999999949
21116,2022-07-15 12:40:00,431.84,371215.6000000008,373731.8300000007,-2516.229999999923
21117,2022-07-15 12:45:00,1151.9,372367.5000000008,373731.8300000007,-1364.3299999998999
21118,2022-07-15 12:50:00,1773.19,374140.6900000008,373731.8300000007,408.86000000010245
21119,2022-07-15 12:55:00,565.07,374705.7600000008,373731.8300000007,973.9300000001094
21120,2022-07-15 13:00:00,-1137.1,373568.66000000085,373731.8300000007,-163.1699999998673
21121,2022-07-15 13:05:00,-1823.96,371744.7000000008,373731.8300000007,-1987.1299999998882
21122,2022-07-15 13:10:00,1583.04,373327.7400000008,373731.8300000007,-404.0899999999092
21123,2022-07-15 13:15:00,232.04,373559.7800000008,373731.8300000007,-172.04999999993015
21124,2022-07-15 13:20:00,-528.16,373031.6200000008,373731.8300000007,-700.2099999999045
21125,2022-07-15 13:25:00,-1941.89,371089.7300000008,373731.8300000007,-2642.0999999999185
21126,2022-07-15 13:30:00,-554.8,370534.9300000008,373731.8300000007,-3196.899999999907
21127,2022-07-15 13:35:00,-739.68,369795.2500000008,373731.8300000007,-3936.5799999999
21128,2022-07-15 13:40:00,-875.39,368919.8600000008,373731.8300000007,-4811.969999999914
21129,2022-07-15 13:45:00,519.46,369439.3200000008,373731.8300000007,-4292.509999999893
21130,2022-07-15 13:50:00,-1795.41,367643.91000000085,373731.8300000007,-6087.919999999867
21131,2022-07-15 13:55:00,1887.88,369531.79000000085,373731.8300000007,-4200.039999999863
21132,2022-07-15 14:00:00,1696.76,371228.55000000086,373731.8300000007,-2503.2799999998533
21133,2022-07-15 14:05:00,-1470.55,369758.0000000009,373731.8300000007,-3973.8299999998417
21134,2022-07-15 14:10:00,-1086.07,368671.93000000087,373731.8300000007,-5059.899999999849
21135,2022-07-15 14:15:00,641.66,369313.59000000084,373731.8300000007,-4418.239999999874
21136,2022-07-15 14:20:00,-1067.29,368246.30000000086,373731.8300000007,-5485.529999999853
21137,2022-07-15 14:25:00,-652.61,367593.6900000009,373731.8300000007,-6138.139999999839
21138,2022-07-15 14:30:00,-1491.85,366101.8400000009,373731.8300000007,-7629.989999999816
21139,2022-07-15 14:35:00,-999.97,365101.8700000009,373731.8300000007,-8629.959999999788
21140,2022-07-15 14:40:00,-1752.01,363349.8600000009,373731.8300000007,-10381.969999999797
21141,2022-07-15 14:45:00,1467.56,364817.4200000009,373731.8300000007,-8914.4099999998
21142,2022-07-15 14:50:00,1327.91,366145.3300000009,373731.8300000007,-7586.499999999825
21143,2022-07-15 14:55:00,1164.55,367309.8800000009,373731.8300000007,-6421.949999999837
21144,2022-07-15 15:00:00,1133.08,368442.9600000009,373731.8300000007,-5288.869999999821
21145,2022-07-15 15:05:00,714.02,369156.9800000009,373731.8300000007,-4574.849999999802
21146,2022-07-15 15:10:00,336.44,369493.4200000009,373731.8300000007,-4238.4099999998
21147,2022-07-15 15:15:00,127.31,369620.7300000009,373731.8300000007,-4111.099999999802
21148,2022-07-15 15:20:00,-643.93,368976.8000000009,373731.8300000007,-4755.029999999795
21149,2022-07-15 15:25:00,431.02,369407.82000000094,373731.8300000007,-4324.0099999997765
21150,2022-07-15 15:30:00,1645.64,371053.46000000095,373731.8300000007,-2678.3699999997625
21151,2022-07-15 15:35:00,-1257.3,369796.16000000096,373731.8300000007,-3935.669999999751
21152,2022-07-15 15:40:00,-1353.41,368442.750000001,373731.8300000007,-5289.079999999725
21153,2022-07-15 15:45:00,1749.2,370191.950000001,373731.8300000007,-3539.8799999997136
21154,2022-07-15 15:50:00,-1674.81,368517.140000001,373731.8300000007,-5214.689999999711
21155,2022-07-15 15:55:00,989.04,369506.180000001,373731.8300000007,-4225.649999999732
21156,2022-07-15 16:00:00,961.77,370467.950000001,373731.8300000007,-3263.8799999997136
21157,2022-07-15 16:05:00,-1011.51,369456.440000001,373731.8300000007,-4275.389999999723
21158,2022-07-15 16:10:00,1607.93,371064.370000001,373731.8300000007,-2667.45999999973
21159,2022-07-15 16:15:00,1805.1,372869.47000000096,373731.8300000007,-862.3599999997532
21160,2022-07-15 16:20:00,1835.25,374704.72000000096,373731.8300000007,972.8900000002468
21161,2022-07-15 16:25:00,-1885.19,372819.53000000096,373731.8300000007,-912.2999999997555
21162,2022-07-15 16:30:00,-1962.71,370856.82000000094,373731.8300000007,-2875.0099999997765
21163,2022-07-15 16:35:00,1469.96,372326.78000000096,373731.8300000007,-1405.0499999997555
21164,2022-07-15 16:40:00,-1600.67,370726.110000001,373731.8300000007,-3005.7199999997392
21165,2022-07-15 16:45:00,11.93,370738.04000000097,373731.8300000007,-2993.789999999746
21166,2022-07-15 16:50:00,845.69,371583.730000001,373731.8300000007,-2148.099999999744
21167,2022-07-15 16:55:00,-1037.31,370546.420000001,373731.8300000007,-3185.4099999997416
21168,2022-07-16 08:00:00,895.72,371442.14000000095,370546.420000001,895.7199999999721
21169,2022-07-16 08:05:00,1101.42,372543.5600000009,370546.420000001,1997.1399999999558
21170,2022-07-16 08:10:00,368.58,372912.14000000095,370546.420000001,2365.719999999972
21171,2022-07-16 08:15:00,1250.9,374163.04000000097,370546.420000001,3616.6199999999953
21172,2022-07-16 08:20:00,892.43,375055.47000000096,370546.420000001,4509.049999999988
21173,2022-07-16 08:25:00,-34.33,375021.14000000095,370546.420000001,4474.719999999972
21174,2022-07-16 08:30:00,1781.97,376803.1100000009,370546.420000001,6256.689999999944
21175,2022-07-16 08:35:00,1070.06,377873.1700000009,370546.420000001,7326.749999999942
21176,2022-07-16 08:40:00,618.66,378491.8300000009,370546.420000001,7945.409999999916
21177,2022-07-16 08:45:00,-1650.7,376841.1300000009,370546.420000001,6294.7099999999045
21178,2022-07-16 08:50:00,-1546.86,375294.2700000009,370546.420000001,4747.8499999999185
21179,2022-07-16 08:55:00,-1547.31,373746.9600000009,370546.420000001,3200.539999999921
21180,2022-07-16 09:00:00,894.93,374641.8900000009,370546.420000001,4095.469999999914
21181,2022-07-16 09:05:00,1939.28,376581.1700000009,370546.420000001,6034.749999999942
21182,2022-07-16 09:10:00,1142.9,377724.07000000094,370546.420000001,7177.649999999965
21183,2022-07-16 09:15:00,437.96,378162.03000000096,370546.420000001,7615.609999999986
21184,2022-07-16 09:20:00,-1951.21,376210.82000000094,370546.420000001,5664.399999999965
21185,2022-07-16 09:25:00,1235.97,377446.7900000009,370546.420000001,6900.369999999937
21186,2022-07-16 09:30:00,868.32,378315.1100000009,370546.420000001,7768.689999999944
21187,2022-07-16 09:35:00,-125.33,378189.7800000009,370546.420000001,7643.359999999928
21188,2022-07-16 09:40:00,-1609.25,376580.5300000009,370546.420000001,6034.109999999928
21189,2022-07-16 09:45:00,-1276.66,375303.8700000009,370546.420000001,4757.449999999953
21190,2022-07-16 09:50:00,-543.87,374760.00000000093,370546.420000001,4213.579999999958
21191,2022-07-16 09:55:00,908.41,375668.4100000009,370546.420000001,5121.9899999999325
21192,2022-07-16 10:00:00,-59.86,375608.5500000009,370546.420000001,5062.129999999946
21193,2022-07-16 10:05:00,869.42,376477.9700000009,370546.420000001,5931.54999999993
21194,2022-07-16 10:10:00,362.79,376840.7600000009,370546.420000001,6294.339999999909
21195,2022-07-16 10:15:00,1976.9,378817.6600000009,370546.420000001,8271.239999999932
21196,2022-07-16 10:20:00,-115.05,378702.6100000009,370546.420000001,8156.189999999944
21197,2022-07-16 10:25:00,-62.89,378639.7200000009,370546.420000001,8093.29999999993
21198,2022-07-16 10:30:00,-122.28,378517.4400000009,370546.420000001,7971.019999999902
21199,2022-07-16 10:35:00,179.44,378696.8800000009,370546.420000001,8150.4599999999045
21200,2022-07-16 10:40:00,1847.07,380543.9500000009,370546.420000001,9997.529999999912
21201,2022-07-16 10:45:00,-1168.01,379375.9400000009,370546.420000001,8829.519999999902
21202,2022-07-16 10:50:00,1883.2,381259.1400000009,370546.420000001,10712.719999999914
21203,2022-07-16 10:55:00,-1153.9,380105.24000000086,370546.420000001,9558.81999999989
21204,2022-07-16 11:00:00,-1460.08,378645.16000000085,370546.420000001,8098.739999999874
21205,2022-07-16 11:05:00,1618.46,380263.62000000087,370546.420000001,9717.199999999895
21206,2022-07-16 11:10:00,1734.46,381998.0800000009,370546.420000001,11451.659999999916
21207,2022-07-16 11:15:00,1310.37,383308.4500000009,370546.420000001,12762.029999999912
21208,2022-07-16 11:20:00,838.96,384147.4100000009,370546.420000001,13600.989999999932
21209,2022-07-16 11:25:00,1390.22,385537.6300000009,370546.420000001,14991.209999999905
21210,2022-07-16 11:30:00,-1081.84,384455.79000000085,370546.420000001,13909.369999999879
21211,2022-07-16 11:35:00,1250.48,385706.27000000083,370546.420000001,15159.84999999986
21212,2022-07-16 11:40:00,774.9,386481.17000000086,370546.420000001,15934.749999999884
21213,2022-07-16 11:45:00,13.59,386494.7600000009,370546.420000001,15948.33999999991
21214,2022-07-16 11:50:00,1843.74,388338.5000000009,370546.420000001,17792.0799999999
21215,2022-07-16 11:55:00,728.05,389066.55000000086,370546.420000001,18520.12999999989
21216,2022-07-16 12:00:00,-1998.51,387068.04000000085,370546.420000001,16521.61999999988
21217,2022-07-16 12:05:00,1332.15,388400.1900000009,370546.420000001,17853.769999999902
21218,2022-07-16 12:10:00,1003.16,389403.35000000085,370546.420000001,18856.929999999877
21219,2022-07-16 12:15:00,-213.76,389189.59000000084,370546.420000001,18643.169999999867
21220,2022-07-16 12:20:00,1531.35,390720.9400000008,370546.420000001,20174.519999999844
21221,2022-07-16 12:25:00,503.72,391224.6600000008,370546.420000001,20678.239999999816
21222,2022-07-16 12:30:00,-155.39,391069.2700000008,370546.420000001,20522.849999999802
21223,2022-07-16 12:35:00,-1887.37,389181.9000000008,370546.420000001,18635.479999999807
21224,2022-07-16 12:40:00,897.02,390078.9200000008,370546.420000001,19532.499999999825
21225,2022-07-16 12:45:00,1704.84,391783.7600000008,370546.420000001,21237.33999999985
21226,2022-07-16 12:50:00,1463.91,393247.6700000008,370546.420000001,22701.249999999825
21227,2022-07-16 12:55:00,626.28,393873.9500000008,370546.420000001,23327.529999999853
21228,2022-07-16 13:00:00,849.61,394723.5600000008,370546.420000001,24177.13999999984
21229,2022-07-16 13:05:00,-1748.26,392975.3000000008,370546.420000001,22428.87999999983
21230,2022-07-16 13:10:00,-1198.6,391776.7000000008,370546.420000001,21230.279999999853
21231,2022-07-16 13:15:00,652.76,392429.46000000084,370546.420000001,21883.039999999863
21232,2022-07-16 13:20:00,620.39,393049.85000000085,370546.420000001,22503.429999999877
21233,2022-07-16 13:25:00,-1446.02,391603.83000000083,370546.420000001,21057.409999999858
21234,2022-07-16 13:30:00,606.81,392210.6400000008,370546.420000001,21664.219999999856
21235,2022-07-16 13:35:00,1103.15,393313.79000000085,370546.420000001,22767.36999999988
21236,2022-07-16 13:40:00,-525.61,392788.18000000087,370546.420000001,22241.759999999893
21237,2022-07-16 13:45:00,-1870.89,390917.29000000085,370546.420000001,20370.86999999988
21238,2022-07-16 13:50:00,-433.13,390484.16000000085,370546.420000001,19937.739999999874
21239,2022-07-16 13:55:00,849.98,391334.1400000008,370546.420000001,20787.719999999856
21240,2022-07-16 14:00:00,-441.12,390893.02000000083,370546.420000001,20346.59999999986
21241,2022-07-16 14:05:00,1300.43,392193.4500000008,370546.420000001,21647.029999999853
21242,2022-07-16 14:10:00,-1131.04,391062.41000000085,370546.420000001,20515.989999999874
21243,2022-07-16 14:15:00,1646.45,392708.86000000086,370546.420000001,22162.439999999886
21244,2022-07-16 14:20:00,-560.7,392148.16000000085,370546.420000001,21601.739999999874
21245,2022-07-16 14:25:00,457.41,392605.5700000008,370546.420000001,22059.14999999985
21246,2022-07-16 14:30:00,-732.06,391873.5100000008,370546.420000001,21327.08999999985
21247,2022-07-16 14:35:00,1258.9,393132.41000000085,370546.420000001,22585.989999999874
21248,2022-07-16 14:40:00,-1210.53,391921.8800000008,370546.420000001,21375.459999999846
21249,2022-07-16 14:45:00,679.69,392601.5700000008,370546.420000001,22055.14999999985
21250,2022-07-16 14:50:00,-851.45,391750.1200000008,370546.420000001,21203.699999999837
21251,2022-07-16 14:55:00,-1215.45,390534.6700000008,370546.420000001,19988.249999999825
21252,2022-07-16 15:00:00,947.82,391482.4900000008,370546.420000001,20936.069999999832
21253,2022-07-16 15:05:00,-1323.73,390158.7600000008,370546.420000001,19612.33999999985
21254,2022-07-16 15:10:00,1996.21,392154.97000000085,370546.420000001,21608.549999999872
21255,2022-07-16 15:15:00,1367.97,393522.9400000008,370546.420000001,22976.519999999844
21256,2022-07-16 15:20:00,-1555.72,391967.22000000085,370546.420000001,21420.799999999872
21257,2022-07-16 15:25:00,1330.19,393297.41000000085,370546.420000001,22750.989999999874
21258,2022-07-16 15:30:00,-1493.57,391803.84000000084,370546.420000001,21257.419999999867
21259,2022-07-16 15:35:00,-171.48,391632.36000000086,370546.420000001,21085.939999999886
21260,2022-07-16 15:40:00,1904.44,393536.80000000086,370546.420000001,22990.37999999989
21261,2022-07-16 15:45:00,850.83,394387.6300000009,370546.420000001,23841.209999999905
21262,2022-07-16 15:50:00,-224.07,394163.56000000087,370546.420000001,23617.139999999898
21263,2022-07-16 15:55:00,-1968.31,392195.2500000009,370546.420000001,21648.8299999999
21264,2022-07-16 16:00:00,-1955.65,390239.60000000085,370546.420000001,19693.179999999877
21265,2022-07-16 16:05:00,-1119.69,389119.91000000085,370546.420000001,18573.489999999874
21266,2022-07-16 16:10:00,437.09,389557.0000000009,370546.420000001,19010.5799999999
21267,2022-07-16 16:15:00,-1555.5,388001.5000000009,370546.420000001,17455.0799999999
21268,2022-07-16 16:20:00,-1648.03,386353.47000000085,370546.420000001,15807.049999999872
21269,2022-07-16 16:25:00,-1629.74,384723.73000000085,370546.420000001,14177.309999999881
21270,2022-07-16 16:30:00,314.5,385038.23000000085,370546.420000001,14491.809999999881
21271,2022-07-16 16:35:00,-1457.45,383580.78000000084,370546.420000001,13034.35999999987
21272,2022-07-16 16:40:00,1535.59,385116.37000000087,370546.420000001,14569.949999999895
21273,2022-07-16 16:45:00,-1936.68,383179.6900000009,370546.420000001,12633.269999999902
21274,2022-07-16 16:50:00,-1502.81,381676.8800000009,370546.420000001,11130.459999999905
21275,2022-07-16 16:55:00,1489.33,383166.2100000009,370546.420000001,12619.78999999992
21276,2022-07-17 08:00:00,-1369.73,381796.4800000009,383166.2100000009,-1369.7299999999814
21277,2022-07-17 08:05:00,-879.65,380916.8300000009,383166.2100000009,-2249.3800000000047
21278,2022-07-17 08:10:00,1856.13,382772.9600000009,383166.2100000009,-393.25
21279,2022-07-17 08:15:00,814.85,383587.81000000087,383166.2100000009,421.5999999999767
21280,2022-07-17 08:20:00,962.99,384550.80000000086,383166.2100000009,1384.5899999999674
21281,2022-07-17 08:25:00,1146.78,385697.5800000009,383166.2100000009,2531.3699999999953
21282,2022-07-17 08:30:00,-750.38,384947.2000000009,383166.2100000009,1780.9899999999907
21283,2022-07-17 08:35:00,-1805.17,383142.0300000009,383166.2100000009,-24.179999999993015
21284,2022-07-17 08:40:00,-904.09,382237.9400000009,383166.2100000009,-928.2700000000186
21285,2022-07-17 08:45:00,-465.47,381772.4700000009,383166.2100000009,-1393.7399999999907
21286,2022-07-17 08:50:00,-1842.88,379929.5900000009,383166.2100000009,-3236.6199999999953
21287,2022-07-17 08:55:00,-1815.09,378114.5000000009,383166.2100000009,-5051.710000000021
21288,2022-07-17 09:00:00,-217.96,377896.54000000085,383166.2100000009,-5269.670000000042
21289,2022-07-17 09:05:00,-492.28,377404.2600000008,383166.2100000009,-5761.95000000007
21290,2022-07-17 09:10:00,1966.91,379371.1700000008,383166.2100000009,-3795.0400000000955
21291,2022-07-17 09:15:00,1928.58,381299.7500000008,383166.2100000009,-1866.4600000000792
21292,2022-07-17 09:20:00,1301.11,382600.8600000008,383166.2100000009,-565.3500000000931
21293,2022-07-17 09:25:00,1000.4,383601.2600000008,383166.2100000009,435.04999999993015
21294,2022-07-17 09:30:00,594.26,384195.52000000083,383166.2100000009,1029.3099999999395
21295,2022-07-17 09:35:00,537.08,384732.60000000085,383166.2100000009,1566.3899999999558
21296,2022-07-17 09:40:00,-1324.8,383407.80000000086,383166.2100000009,241.5899999999674
21297,2022-07-17 09:45:00,83.39,383491.1900000009,383166.2100000009,324.9799999999814
21298,2022-07-17 09:50:00,510.42,384001.61000000086,383166.2100000009,835.3999999999651
21299,2022-07-17 09:55:00,301.96,384303.5700000009,383166.2100000009,1137.359999999986
21300,2022-07-17 10:00:00,1092.92,385396.49000000086,383166.2100000009,2230.2799999999697
21301,2022-07-17 10:05:00,-269.55,385126.9400000009,383166.2100000009,1960.7299999999814
21302,2022-07-17 10:10:00,-575.69,384551.2500000009,383166.2100000009,1385.039999999979
21303,2022-07-17 10:15:00,-845.18,383706.0700000009,383166.2100000009,539.859999999986
21304,2022-07-17 10:20:00,179.51,383885.5800000009,383166.2100000009,719.3699999999953
21305,2022-07-17 10:25:00,-973.57,382912.0100000009,383166.2100000009,-254.20000000001164
21306,2022-07-17 10:30:00,-913.37,381998.6400000009,383166.2100000009,-1167.570000000007
21307,2022-07-17 10:35:00,-443.68,381554.9600000009,383166.2100000009,-1611.25
21308,2022-07-17 10:40:00,545.02,382099.9800000009,383166.2100000009,-1066.2299999999814
21309,2022-07-17 10:45:00,713.74,382813.7200000009,383166.2100000009,-352.4899999999907
21310,2022-07-17 10:50:00,1372.72,384186.4400000009,383166.2100000009,1020.2299999999814
21311,2022-07-17 10:55:00,-1504.6,382681.8400000009,383166.2100000009,-484.36999999999534
21312,2022-07-17 11:00:00,1809.71,384491.5500000009,383166.2100000009,1325.3400000000256
21313,2022-07-17 11:05:00,1754.61,386246.1600000009,383166.2100000009,3079.9500000000116
21314,2022-07-17 11:10:00,-137.82,386108.3400000009,383166.2100000009,2942.1300000000047
21315,2022-07-17 11:15:00,-1789.16,384319.1800000009,383166.2100000009,1152.9700000000303
21316,2022-07-17 11:20:00,-1071.52,383247.6600000009,383166.2100000009,81.45000000001164
21317,2022-07-17 11:25:00,1393.3,384640.9600000009,383166.2100000009,1474.75
21318,2022-07-17 11:30:00,-992.01,383648.9500000009,383166.2100000009,482.7399999999907
21319,2022-07-17 11:35:00,-1437.57,382211.3800000009,383166.2100000009,-954.8300000000163
21320,2022-07-17 11:40:00,791.39,383002.7700000009,383166.2100000009,-163.44000000000233
21321,2022-07-17 11:45:00,-1299.25,381703.5200000009,383166.2100000009,-1462.6900000000023
21322,2022-07-17 11:50:00,-589.04,381114.4800000009,383166.2100000009,-2051.7299999999814
21323,2022-07-17 11:55:00,-292.15,380822.3300000009,383166.2100000009,-2343.8800000000047
21324,2022-07-17 12:00:00,589.05,381411.3800000009,383166.2100000009,-1754.8300000000163
21325,2022-07-17 12:05:00,313.46,381724.8400000009,383166.2100000009,-1441.3699999999953
21326,2022-07-17 12:10:00,1038.32,382763.1600000009,383166.2100000009,-403.04999999998836
21327,2022-07-17 12:15:00,-801.19,381961.9700000009,383166.2100000009,-1204.2399999999907
21328,2022-07-17 12:20:00,-1372.45,380589.5200000009,383166.2100000009,-2576.6900000000023
21329,2022-07-17 12:25:00,1326.53,381916.0500000009,383166.2100000009,-1250.1599999999744
21330,2022-07-17 12:30:00,-299.48,381616.57000000094,383166.2100000009,-1549.6399999999558
21331,2022-07-17 12:35:00,-1497.8,380118.77000000095,383166.2100000009,-3047.439999999944
21332,2022-07-17 12:40:00,-1214.22,378904.550000001,383166.2100000009,-4261.659999999916
21333,2022-07-17 12:45:00,154.0,379058.550000001,383166.2100000009,-4107.659999999916
21334,2022-07-17 12:50:00,685.35,379743.90000000095,383166.2100000009,-3422.3099999999395
21335,2022-07-17 12:55:00,103.42,379847.32000000094,383166.2100000009,-3318.8899999999558
21336,2022-07-17 13:00:00,984.98,380832.3000000009,383166.2100000009,-2333.9099999999744
21337,2022-07-17 13:05:00,91.91,380924.2100000009,383166.2100000009,-2242.0
21338,2022-07-17 13:10:00,-1882.82,379041.3900000009,383166.2100000009,-4124.820000000007
21339,2022-07-17 13:15:00,-792.37,378249.0200000009,383166.2100000009,-4917.190000000002
21340,2022-07-17 13:20:00,112.26,378361.2800000009,383166.2100000009,-4804.929999999993
21341,2022-07-17 13:25:00,476.59,378837.8700000009,383166.2100000009,-4328.339999999967
21342,2022-07-17 13:30:00,-1610.59,377227.2800000009,383166.2100000009,-5938.929999999993
21343,2022-07-17 13:35:00,-1007.25,376220.0300000009,383166.2100000009,-6946.179999999993
21344,2022-07-17 13:40:00,1060.01,377280.0400000009,383166.2100000009,-5886.169999999984
21345,2022-07-17 13:45:00,496.48,377776.5200000009,383166.2100000009,-5389.690000000002
21346,2022-07-17 13:50:00,1021.04,378797.56000000087,383166.2100000009,-4368.650000000023
21347,2022-07-17 13:55:00,627.03,379424.5900000009,383166.2100000009,-3741.6199999999953
21348,2022-07-17 14:00:00,737.15,380161.7400000009,383166.2100000009,-3004.469999999972
21349,2022-07-17 14:05:00,137.64,380299.38000000094,383166.2100000009,-2866.829999999958
21350,2022-07-17 14:10:00,-1365.92,378933.46000000095,383166.2100000009,-4232.749999999942
21351,2022-07-17 14:15:00,1813.51,380746.97000000096,383166.2100000009,-2419.2399999999325
21352,2022-07-17 14:20:00,-1790.62,378956.35000000097,383166.2100000009,-4209.859999999928
21353,2022-07-17 14:25:00,209.94,379166.29000000097,383166.2100000009,-3999.9199999999255
21354,2022-07-17 14:30:00,1582.42,380748.71000000095,383166.2100000009,-2417.499999999942
21355,2022-07-17 14:35:00,853.87,381602.58000000095,383166.2100000009,-1563.6299999999464
21356,2022-07-17 14:40:00,-1978.26,379624.32000000094,383166.2100000009,-3541.8899999999558
21357,2022-07-17 14:45:00,103.53,379727.85000000097,383166.2100000009,-3438.359999999928
21358,2022-07-17 14:50:00,1576.62,381304.47000000096,383166.2100000009,-1861.7399999999325
21359,2022-07-17 14:55:00,1072.3,382376.77000000095,383166.2100000009,-789.4399999999441
21360,2022-07-17 15:00:00,583.32,382960.09000000096,383166.2100000009,-206.11999999993714
21361,2022-07-17 15:05:00,153.79,383113.88000000094,383166.2100000009,-52.32999999995809
21362,2022-07-17 15:10:00,1509.76,384623.64000000095,383166.2100000009,1457.4300000000512
21363,2022-07-17 15:15:00,-1865.38,382758.26000000094,383166.2100000009,-407.94999999995343
21364,2022-07-17 15:20:00,915.17,383673.4300000009,383166.2100000009,507.22000000003027
21365,2022-07-17 15:25:00,-258.04,383415.39000000095,383166.2100000009,249.18000000005122
21366,2022-07-17 15:30:00,-978.37,382437.02000000095,383166.2100000009,-729.1899999999441
21367,2022-07-17 15:35:00,178.86,382615.88000000094,383166.2100000009,-550.3299999999581
21368,2022-07-17 15:40:00,821.34,383437.22000000096,383166.2100000009,271.0100000000675
21369,2022-07-17 15:45:00,-1582.81,381854.41000000096,383166.2100000009,-1311.7999999999302
21370,2022-07-17 15:50:00,-522.32,381332.09000000096,383166.2100000009,-1834.1199999999371
21371,2022-07-17 15:55:00,-1722.8,379609.29000000097,383166.2100000009,-3556.9199999999255
21372,2022-07-17 16:00:00,1641.46,381250.750000001,383166.2100000009,-1915.4599999999045
21373,2022-07-17 16:05:00,859.89,382110.640000001,383166.2100000009,-1055.5699999998906
21374,2022-07-17 16:10:00,-691.65,381418.990000001,383166.2100000009,-1747.2199999999139
21375,2022-07-17 16:15:00,1332.51,382751.500000001,383166.2100000009,-414.70999999990454
21376,2022-07-17 16:20:00,-1491.78,381259.72000000096,383166.2100000009,-1906.4899999999325
21377,2022-07-17 16:25:00,-774.14,380485.58000000095,383166.2100000009,-2680.6299999999464
21378,2022-07-17 16:30:00,1369.29,381854.8700000009,383166.2100000009,-1311.3399999999674
21379,2022-07-17 16:35:00,1910.07,383764.94000000093,383166.2100000009,598.7300000000396
21380,2022-07-17 16:40:00,1061.78,384826.72000000096,383166.2100000009,1660.5100000000675
21381,2022-07-17 16:45:00,1582.28,386409.000000001,383166.2100000009,3242.7900000000955
21382,2022-07-17 16:50:00,520.63,386929.630000001,383166.2100000009,3763.4200000001
21383,2022-07-17 16:55:00,-287.68,386641.950000001,383166.2100000009,3475.740000000107
21384,2022-07-18 08:00:00,688.85,387330.800000001,386641.950000001,688.8499999999767
21385,2022-07-18 08:05:00,1731.33,389062.130000001,386641.950000001,2420.179999999993
21386,2022-07-18 08:10:00,831.19,389893.320000001,386641.950000001,3251.3699999999953
21387,2022-07-18 08:15:00,1230.41,391123.730000001,386641.950000001,4481.77999999997
21388,2022-07-18 08:20:00,-87.5,391036.230000001,386641.950000001,4394.27999999997
21389,2022-07-18 08:25:00,-1769.48,389266.750000001,386641.950000001,2624.7999999999884
21390,2022-07-18 08:30:00,-197.36,389069.390000001,386641.950000001,2427.4400000000023
21391,2022-07-18 08:35:00,-293.96,388775.430000001,386641.950000001,2133.4799999999814
21392,2022-07-18 08:40:00,1969.23,390744.66000000096,386641.950000001,4102.709999999963
21393,2022-07-18 08:45:00,-1326.94,389417.72000000096,386641.950000001,2775.7699999999604
21394,2022-07-18 08:50:00,-1996.43,387421.29000000097,386641.950000001,779.3399999999674
21395,2022-07-18 08:55:00,1876.65,389297.940000001,386641.950000001,2655.9899999999907
21396,2022-07-18 09:00:00,766.44,390064.380000001,386641.950000001,3422.429999999993
21397,2022-07-18 09:05:00,1662.26,391726.640000001,386641.950000001,5084.690000000002
21398,2022-07-18 09:10:00,506.76,392233.400000001,386641.950000001,5591.450000000012
21399,2022-07-18 09:15:00,-1274.17,390959.23000000103,386641.950000001,4317.280000000028
21400,2022-07-18 09:20:00,-1097.61,389861.62000000104,386641.950000001,3219.670000000042
21401,2022-07-18 09:25:00,215.82,390077.44000000105,386641.950000001,3435.490000000049
21402,2022-07-18 09:30:00,1233.34,391310.7800000011,386641.950000001,4668.8300000000745
21403,2022-07-18 09:35:00,1399.53,392710.3100000011,386641.950000001,6068.360000000102
21404,2022-07-18 09:40:00,-1199.93,391510.3800000011,386641.950000001,4868.430000000109
21405,2022-07-18 09:45:00,-619.15,390891.2300000011,386641.950000001,4249.280000000086
21406,2022-07-18 09:50:00,-192.57,390698.6600000011,386641.950000001,4056.710000000079
21407,2022-07-18 09:55:00,-1899.85,388798.8100000011,386641.950000001,2156.8600000001024
21408,2022-07-18 10:00:00,1563.3,390362.1100000011,386641.950000001,3720.160000000091
21409,2022-07-18 10:05:00,-688.66,389673.4500000011,386641.950000001,3031.5000000001164
21410,2022-07-18 10:10:00,-1307.44,388366.0100000011,386641.950000001,1724.060000000114
21411,2022-07-18 10:15:00,1164.75,389530.7600000011,386641.950000001,2888.810000000114
21412,2022-07-18 10:20:00,-1898.97,387631.79000000114,386641.950000001,989.840000000142
21413,2022-07-18 10:25:00,1377.9,389009.69000000117,386641.950000001,2367.7400000001653
21414,2022-07-18 10:30:00,-1278.39,387731.30000000115,386641.950000001,1089.3500000001513
21415,2022-07-18 10:35:00,-318.99,387412.31000000116,386641.950000001,770.3600000001607
21416,2022-07-18 10:40:00,256.86,387669.17000000115,386641.950000001,1027.2200000001467
21417,2022-07-18 10:45:00,-615.9,387053.2700000011,386641.950000001,411.3200000001234
21418,2022-07-18 10:50:00,-270.9,386782.3700000011,386641.950000001,140.42000000010012
21419,2022-07-18 10:55:00,1854.52,388636.8900000011,386641.950000001,1994.9400000001187
21420,2022-07-18 11:00:00,-1210.27,387426.6200000011,386641.950000001,784.6700000001001
21421,2022-07-18 11:05:00,-568.5,386858.1200000011,386641.950000001,216.17000000010012
21422,2022-07-18 11:10:00,-1925.94,384932.1800000011,386641.950000001,-1709.7699999999022
21423,2022-07-18 11:15:00,1079.11,386011.2900000011,386641.950000001,-630.6599999999162
21424,2022-07-18 11:20:00,637.05,386648.3400000011,386641.950000001,6.3900000000721775
21425,2022-07-18 11:25:00,-1930.3,384718.0400000011,386641.950000001,-1923.9099999999162
21426,2022-07-18 11:30:00,-1261.91,383456.1300000011,386641.950000001,-3185.8199999998906
21427,2022-07-18 11:35:00,1786.8,385242.9300000011,386641.950000001,-1399.0199999999022
21428,2022-07-18 11:40:00,-827.12,384415.8100000011,386641.950000001,-2226.1399999998976
21429,2022-07-18 11:45:00,1548.75,385964.5600000011,386641.950000001,-677.3899999998976
21430,2022-07-18 11:50:00,-1405.38,384559.1800000011,386641.950000001,-2082.769999999902
21431,2022-07-18 11:55:00,-615.11,383944.0700000011,386641.950000001,-2697.8799999998882
21432,2022-07-18 12:00:00,1015.7,384959.7700000011,386641.950000001,-1682.1799999998766
21433,2022-07-18 12:05:00,1454.93,386414.7000000011,386641.950000001,-227.24999999988358
21434,2022-07-18 12:10:00,1047.3,387462.0000000011,386641.950000001,820.0500000001048
21435,2022-07-18 12:15:00,-1999.38,385462.6200000011,386641.950000001,-1179.3299999998999
21436,2022-07-18 12:20:00,1931.81,387394.4300000011,386641.950000001,752.4800000000978
21437,2022-07-18 12:25:00,-1930.81,385463.6200000011,386641.950000001,-1178.3299999998999
21438,2022-07-18 12:30:00,924.76,386388.3800000011,386641.950000001,-253.56999999989057
21439,2022-07-18 12:35:00,1737.64,388126.0200000011,386641.950000001,1484.0700000001234
21440,2022-07-18 12:40:00,-1997.73,386128.29000000114,386641.950000001,-513.659999999858
21441,2022-07-18 12:45:00,-1474.56,384653.73000000115,386641.950000001,-1988.2199999998556
21442,2022-07-18 12:50:00,1643.47,386297.2000000011,386641.950000001,-344.7499999998836
21443,2022-07-18 12:55:00,-1188.35,385108.85000000114,386641.950000001,-1533.0999999998603
21444,2022-07-18 13:00:00,1397.23,386506.0800000011,386641.950000001,-135.86999999987893
21445,2022-07-18 13:05:00,-1444.31,385061.7700000011,386641.950000001,-1580.1799999998766
21446,2022-07-18 13:10:00,-257.96,384803.8100000011,386641.950000001,-1838.1399999998976
21447,2022-07-18 13:15:00,564.41,385368.2200000011,386641.950000001,-1273.7299999999232
21448,2022-07-18 13:20:00,288.48,385656.70000000106,386641.950000001,-985.2499999999418
21449,2022-07-18 13:25:00,-1430.92,384225.7800000011,386641.950000001,-2416.1699999999255
21450,2022-07-18 13:30:00,-1219.52,383006.26000000106,386641.950000001,-3635.689999999944
21451,2022-07-18 13:35:00,-1053.22,381953.0400000011,386641.950000001,-4688.909999999916
21452,2022-07-18 13:40:00,845.41,382798.45000000106,386641.950000001,-3843.499999999942
21453,2022-07-18 13:45:00,1316.9,384115.3500000011,386641.950000001,-2526.5999999999185
21454,2022-07-18 13:50:00,314.57,384429.9200000011,386641.950000001,-2212.0299999999115
21455,2022-07-18 13:55:00,-124.28,384305.64000000106,386641.950000001,-2336.3099999999395
21456,2022-07-18 14:00:00,-812.22,383493.4200000011,386641.950000001,-3148.5299999999115
21457,2022-07-18 14:05:00,1200.64,384694.0600000011,386641.950000001,-1947.8899999998976
21458,2022-07-18 14:10:00,-1742.32,382951.7400000011,386641.950000001,-3690.2099999999045
21459,2022-07-18 14:15:00,1216.15,384167.8900000011,386641.950000001,-2474.0599999998813
21460,2022-07-18 14:20:00,1063.79,385231.6800000011,386641.950000001,-1410.2699999999022
21461,2022-07-18 14:25:00,1799.33,387031.0100000011,386641.950000001,389.0600000001141
21462,2022-07-18 14:30:00,-453.78,386577.2300000011,386641.950000001,-64.71999999991385
21463,2022-07-18 14:35:00,-1850.29,384726.9400000011,386641.950000001,-1915.009999999893
21464,2022-07-18 14:40:00,-381.66,384345.28000000113,386641.950000001,-2296.6699999998673
21465,2022-07-18 14:45:00,-1216.23,383129.05000000115,386641.950000001,-3512.8999999998487
21466,2022-07-18 14:50:00,498.93,383627.98000000115,386641.950000001,-3013.9699999998556
21467,2022-07-18 14:55:00,-1615.54,382012.44000000117,386641.950000001,-4629.509999999835
21468,2022-07-18 15:00:00,1485.3,383497.74000000115,386641.950000001,-3144.2099999998463
21469,2022-07-18 15:05:00,-1907.68,381590.06000000116,386641.950000001,-5051.889999999839
21470,2022-07-18 15:10:00,254.72,381844.78000000113,386641.950000001,-4797.169999999867
21471,2022-07-18 15:15:00,1854.9,383699.68000000116,386641.950000001,-2942.269999999844
21472,2022-07-18 15:20:00,-466.24,383233.44000000117,386641.950000001,-3408.5099999998347
21473,2022-07-18 15:25:00,347.29,383580.73000000115,386641.950000001,-3061.2199999998556
21474,2022-07-18 15:30:00,-280.82,383299.91000000114,386641.950000001,-3342.0399999998626
21475,2022-07-18 15:35:00,1224.25,384524.16000000114,386641.950000001,-2117.7899999998626
21476,2022-07-18 15:40:00,1345.85,385870.0100000011,386641.950000001,-771.9399999998859
21477,2022-07-18 15:45:00,-1605.59,384264.4200000011,386641.950000001,-2377.5299999999115
21478,2022-07-18 15:50:00,1479.46,385743.8800000011,386641.950000001,-898.0699999998906
21479,2022-07-18 15:55:00,-1828.27,383915.6100000011,386641.950000001,-2726.339999999909
21480,2022-07-18 16:00:00,-1573.08,382342.5300000011,386641.950000001,-4299.4199999999255
21481,2022-07-18 16:05:00,626.14,382968.6700000011,386641.950000001,-3673.2799999999115
21482,2022-07-18 16:10:00,-852.21,382116.46000000107,386641.950000001,-4525.4899999999325
21483,2022-07-18 16:15:00,-1936.74,380179.7200000011,386641.950000001,-6462.229999999923
21484,2022-07-18 16:20:00,-1494.69,378685.0300000011,386641.950000001,-7956.9199999999255
21485,2022-07-18 16:25:00,1219.65,379904.6800000011,386641.950000001,-6737.269999999902
21486,2022-07-18 16:30:00,-778.6,379126.0800000011,386641.950000001,-7515.869999999879
21487,2022-07-18 16:35:00,-977.9,378148.1800000011,386641.950000001,-8493.769999999902
21488,2022-07-18 16:40:00,1733.98,379882.1600000011,386641.950000001,-6759.789999999921
21489,2022-07-18 16:45:00,1958.53,381840.6900000011,386641.950000001,-4801.259999999893
21490,2022-07-18 16:50:00,587.37,382428.0600000011,386641.950000001,-4213.889999999898
21491,2022-07-18 16:55:00,690.94,383119.0000000011,386641.950000001,-3522.949999999895
21492,2022-07-19 08:00:00,1001.27,384120.2700000011,383119.0000000011,1001.2700000000186
21493,2022-07-19 08:05:00,1222.95,385343.22000000114,383119.0000000011,2224.2200000000303
21494,2022-07-19 08:10:00,739.68,386082.90000000113,383119.0000000011,2963.9000000000233
21495,2022-07-19 08:15:00,39.19,386122.09000000113,383119.0000000011,3003.0900000000256
21496,2022-07-19 08:20:00,-1142.62,384979.47000000114,383119.0000000011,1860.4700000000303
21497,2022-07-19 08:25:00,-1444.0,383535.47000000114,383119.0000000011,416.47000000003027
21498,2022-07-19 08:30:00,-1388.88,382146.59000000113,383119.0000000011,-972.4099999999744
21499,2022-07-19 08:35:00,-745.58,381401.0100000011,383119.0000000011,-1717.9899999999907
21500,2022-07-19 08:40:00,-1122.12,380278.8900000011,383119.0000000011,-2840.109999999986
21501,2022-07-19 08:45:00,18.33,380297.22000000114,383119.0000000011,-2821.7799999999697
21502,2022-07-19 08:50:00,-1290.92,379006.30000000115,383119.0000000011,-4112.699999999953
21503,2022-07-19 08:55:00,1464.73,380471.03000000113,383119.0000000011,-2647.969999999972
21504,2022-07-19 09:00:00,1493.94,381964.97000000114,383119.0000000011,-1154.0299999999697
21505,2022-07-19 09:05:00,-780.23,381184.74000000115,383119.0000000011,-1934.259999999951
21506,2022-07-19 09:10:00,1100.05,382284.79000000114,383119.0000000011,-834.2099999999627
21507,2022-07-19 09:15:00,1194.02,383478.81000000116,383119.0000000011,359.8100000000559
21508,2022-07-19 09:20:00,-609.16,382869.6500000012,383119.0000000011,-249.3499999999185
21509,2022-07-19 09:25:00,37.26,382906.9100000012,383119.0000000011,-212.0899999999092
21510,2022-07-19 09:30:00,-834.89,382072.0200000012,383119.0000000011,-1046.9799999999232
21511,2022-07-19 09:35:00,-1612.02,380460.00000000116,383119.0000000011,-2658.999999999942
21512,2022-07-19 09:40:00,-1883.65,378576.35000000114,383119.0000000011,-4542.649999999965
21513,2022-07-19 09:45:00,-1720.47,376855.88000000117,383119.0000000011,-6263.119999999937
21514,2022-07-19 09:50:00,1941.0,378796.88000000117,383119.0000000011,-4322.119999999937
21515,2022-07-19 09:55:00,-1238.63,377558.25000000116,383119.0000000011,-5560.749999999942
21516,2022-07-19 10:00:00,-1013.19,376545.06000000116,383119.0000000011,-6573.939999999944
21517,2022-07-19 10:05:00,-1817.38,374727.68000000116,383119.0000000011,-8391.319999999949
21518,2022-07-19 10:10:00,1400.16,376127.84000000113,383119.0000000011,-6991.159999999974
21519,2022-07-19 10:15:00,330.51,376458.35000000114,383119.0000000011,-6660.649999999965
21520,2022-07-19 10:20:00,-880.63,375577.72000000114,383119.0000000011,-7541.27999999997
21521,2022-07-19 10:25:00,909.07,376486.79000000114,383119.0000000011,-6632.209999999963
21522,2022-07-19 10:30:00,-776.12,375710.67000000115,383119.0000000011,-7408.329999999958
21523,2022-07-19 10:35:00,-1759.1,373951.5700000012,383119.0000000011,-9167.429999999935
21524,2022-07-19 10:40:00,-232.01,373719.56000000116,383119.0000000011,-9399.439999999944
21525,2022-07-19 10:45:00,405.29,374124.85000000114,383119.0000000011,-8994.149999999965
21526,2022-07-19 10:50:00,-954.68,373170.17000000115,383119.0000000011,-9948.829999999958
21527,2022-07-19 10:55:00,792.12,373962.29000000114,383119.0000000011,-9156.709999999963
21528,2022-07-19 11:00:00,261.07,374223.36000000115,383119.0000000011,-8895.639999999956
21529,2022-07-19 11:05:00,-754.63,373468.73000000115,383119.0000000011,-9650.26999999996
21530,2022-07-19 11:10:00,18.56,373487.29000000114,383119.0000000011,-9631.709999999963
21531,2022-07-19 11:15:00,-1858.5,371628.79000000114,383119.0000000011,-11490.209999999963
21532,2022-07-19 11:20:00,1643.05,373271.84000000113,383119.0000000011,-9847.159999999974
21533,2022-07-19 11:25:00,713.93,373985.7700000011,383119.0000000011,-9133.229999999981
21534,2022-07-19 11:30:00,1216.64,375202.41000000114,383119.0000000011,-7916.589999999967
21535,2022-07-19 11:35:00,1767.85,376970.2600000011,383119.0000000011,-6148.739999999991
21536,2022-07-19 11:40:00,383.54,377353.8000000011,383119.0000000011,-5765.200000000012
21537,2022-07-19 11:45:00,-1105.39,376248.4100000011,383119.0000000011,-6870.590000000026
21538,2022-07-19 11:50:00,-1409.4,374839.01000000106,383119.0000000011,-8279.990000000049
21539,2022-07-19 11:55:00,117.64,374956.6500000011,383119.0000000011,-8162.350000000035
21540,2022-07-19 12:00:00,-917.03,374039.62000000104,383119.0000000011,-9079.380000000063
21541,2022-07-19 12:05:00,344.96,374384.58000000106,383119.0000000011,-8734.420000000042
21542,2022-07-19 12:10:00,-1690.93,372693.6500000011,383119.0000000011,-10425.350000000035
21543,2022-07-19 12:15:00,1540.54,374234.19000000105,383119.0000000011,-8884.810000000056
21544,2022-07-19 12:20:00,537.03,374771.2200000011,383119.0000000011,-8347.780000000028
21545,2022-07-19 12:25:00,-1043.57,373727.6500000011,383119.0000000011,-9391.350000000035
21546,2022-07-19 12:30:00,1369.75,375097.4000000011,383119.0000000011,-8021.600000000035
21547,2022-07-19 12:35:00,-1273.85,373823.5500000011,383119.0000000011,-9295.450000000012
21548,2022-07-19 12:40:00,-90.36,373733.1900000011,383119.0000000011,-9385.809999999998
21549,2022-07-19 12:45:00,-1645.94,372087.2500000011,383119.0000000011,-11031.75
21550,2022-07-19 12:50:00,1253.48,373340.7300000011,383119.0000000011,-9778.270000000019
21551,2022-07-19 12:55:00,1570.18,374910.9100000011,383119.0000000011,-8208.090000000026
21552,2022-07-19 13:00:00,1895.38,376806.2900000011,383119.0000000011,-6312.710000000021
21553,2022-07-19 13:05:00,408.66,377214.95000000106,383119.0000000011,-5904.050000000047
21554,2022-07-19 13:10:00,-255.61,376959.3400000011,383119.0000000011,-6159.660000000033
21555,2022-07-19 13:15:00,-355.06,376604.2800000011,383119.0000000011,-6514.72000000003
21556,2022-07-19 13:20:00,549.21,377153.4900000011,383119.0000000011,-5965.510000000009
21557,2022-07-19 13:25:00,1989.84,379143.3300000011,383119.0000000011,-3975.6699999999837
21558,2022-07-19 13:30:00,-43.37,379099.9600000011,383119.0000000011,-4019.039999999979
21559,2022-07-19 13:35:00,1292.27,380392.23000000115,383119.0000000011,-2726.7699999999604
21560,2022-07-19 13:40:00,-1122.41,379269.8200000012,383119.0000000011,-3849.179999999935
21561,2022-07-19 13:45:00,-1898.15,377371.67000000115,383119.0000000011,-5747.329999999958
21562,2022-07-19 13:50:00,-789.77,376581.90000000113,383119.0000000011,-6537.099999999977
21563,2022-07-19 13:55:00,1229.32,377811.22000000114,383119.0000000011,-5307.77999999997
21564,2022-07-19 14:00:00,-216.44,377594.78000000113,383119.0000000011,-5524.219999999972
21565,2022-07-19 14:05:00,-1024.77,376570.0100000011,383119.0000000011,-6548.989999999991
21566,2022-07-19 14:10:00,1347.6,377917.6100000011,383119.0000000011,-5201.390000000014
21567,2022-07-19 14:15:00,101.57,378019.1800000011,383119.0000000011,-5099.820000000007
21568,2022-07-19 14:20:00,550.08,378569.2600000011,383119.0000000011,-4549.739999999991
21569,2022-07-19 14:25:00,1247.07,379816.3300000011,383119.0000000011,-3302.6699999999837
21570,2022-07-19 14:30:00,1021.99,380838.3200000011,383119.0000000011,-2280.679999999993
21571,2022-07-19 14:35:00,660.06,381498.3800000011,383119.0000000011,-1620.6199999999953
21572,2022-07-19 14:40:00,-801.19,380697.1900000011,383119.0000000011,-2421.8099999999977
21573,2022-07-19 14:45:00,-214.88,380482.3100000011,383119.0000000011,-2636.6900000000023
21574,2022-07-19 14:50:00,1767.61,382249.9200000011,383119.0000000011,-869.0800000000163
21575,2022-07-19 14:55:00,-142.7,382107.2200000011,383119.0000000011,-1011.7800000000279
21576,2022-07-19 15:00:00,-1992.55,380114.6700000011,383119.0000000011,-3004.3300000000163
21577,2022-07-19 15:05:00,-1368.64,378746.0300000011,383119.0000000011,-4372.97000000003
21578,2022-07-19 15:10:00,-583.8,378162.2300000011,383119.0000000011,-4956.770000000019
21579,2022-07-19 15:15:00,-821.38,377340.8500000011,383119.0000000011,-5778.150000000023
21580,2022-07-19 15:20:00,1092.13,378432.9800000011,383119.0000000011,-4686.020000000019
21581,2022-07-19 15:25:00,-514.63,377918.3500000011,383119.0000000011,-5200.650000000023
21582,2022-07-19 15:30:00,953.57,378871.9200000011,383119.0000000011,-4247.080000000016
21583,2022-07-19 15:35:00,639.06,379510.9800000011,383119.0000000011,-3608.0200000000186
21584,2022-07-19 15:40:00,1250.22,380761.20000000106,383119.0000000011,-2357.8000000000466
21585,2022-07-19 15:45:00,965.44,381726.64000000106,383119.0000000011,-1392.3600000000442
21586,2022-07-19 15:50:00,-781.39,380945.25000000105,383119.0000000011,-2173.750000000058
21587,2022-07-19 15:55:00,-1466.31,379478.94000000105,383119.0000000011,-3640.060000000056
21588,2022-07-19 16:00:00,-859.87,378619.07000000105,383119.0000000011,-4499.930000000051
21589,2022-07-19 16:05:00,1211.74,379830.81000000105,383119.0000000011,-3288.1900000000605
21590,2022-07-19 16:10:00,1350.72,381181.530000001,383119.0000000011,-1937.4700000000885
21591,2022-07-19 16:15:00,-127.07,381054.460000001,383119.0000000011,-2064.5400000000955
21592,2022-07-19 16:20:00,372.74,381427.200000001,383119.0000000011,-1691.8000000001048
21593,2022-07-19 16:25:00,476.5,381903.700000001,383119.0000000011,-1215.3000000001048
21594,2022-07-19 16:30:00,830.08,382733.780000001,383119.0000000011,-385.2200000000885
21595,2022-07-19 16:35:00,-1724.96,381008.820000001,383119.0000000011,-2110.1800000001094
21596,2022-07-19 16:40:00,-1527.36,379481.460000001,383119.0000000011,-3637.5400000000955
21597,2022-07-19 16:45:00,-83.34,379398.120000001,383119.0000000011,-3720.880000000121
21598,2022-07-19 16:50:00,784.17,380182.29000000097,383119.0000000011,-2936.7100000001374
21599,2022-07-19 16:55:00,1605.65,381787.940000001,383119.0000000011,-1331.060000000114
21600,2022-07-20 08:00:00,-1369.4,380418.54000000097,381787.940000001,-1369.4000000000233
21601,2022-07-20 08:05:00,342.33,380760.870000001,381787.940000001,-1027.070000000007
21602,2022-07-20 08:10:00,-1422.07,379338.800000001,381787.940000001,-2449.140000000014
21603,2022-07-20 08:15:00,-1884.56,377454.240000001,381787.940000001,-4333.700000000012
21604,2022-07-20 08:20:00,-297.29,377156.950000001,381787.940000001,-4630.989999999991
21605,2022-07-20 08:25:00,579.59,377736.540000001,381787.940000001,-4051.399999999965
21606,2022-07-20 08:30:00,-57.8,377678.74000000104,381787.940000001,-4109.199999999953
21607,2022-07-20 08:35:00,1653.13,379331.87000000104,381787.940000001,-2456.069999999949
21608,2022-07-20 08:40:00,186.48,379518.350000001,381787.940000001,-2269.5899999999674
21609,2022-07-20 08:45:00,1415.55,380933.900000001,381787.940000001,-854.039999999979
21610,2022-07-20 08:50:00,-537.63,380396.270000001,381787.940000001,-1391.6699999999837
21611,2022-07-20 08:55:00,-215.52,380180.750000001,381787.940000001,-1607.1900000000023
21612,2022-07-20 09:00:00,1154.85,381335.60000000097,381787.940000001,-452.3400000000256
21613,2022-07-20 09:05:00,100.8,381436.40000000095,381787.940000001,-351.54000000003725
21614,2022-07-20 09:10:00,-1064.26,380372.14000000095,381787.940000001,-1415.8000000000466
21615,2022-07-20 09:15:00,256.65,380628.79000000097,381787.940000001,-1159.1500000000233
21616,2022-07-20 09:20:00,-314.69,380314.10000000097,381787.940000001,-1473.8400000000256
21617,2022-07-20 09:25:00,-654.04,379660.060000001,381787.940000001,-2127.8800000000047
21618,2022-07-20 09:30:00,1312.79,380972.85000000097,381787.940000001,-815.0900000000256
21619,2022-07-20 09:35:00,-494.05,380478.800000001,381787.940000001,-1309.140000000014
21620,2022-07-20 09:40:00,-1352.24,379126.560000001,381787.940000001,-2661.3800000000047
21621,2022-07-20 09:45:00,1402.35,380528.91000000096,381787.940000001,-1259.030000000028
21622,2022-07-20 09:50:00,1406.41,381935.32000000094,381787.940000001,147.37999999994645
21623,2022-07-20 09:55:00,-1566.25,380369.07000000094,381787.940000001,-1418.8700000000536
21624,2022-07-20 10:00:00,-922.39,379446.6800000009,381787.940000001,-2341.2600000000675
21625,2022-07-20 10:05:00,529.29,379975.9700000009,381787.940000001,-1811.9700000000885
21626,2022-07-20 10:10:00,420.47,380396.4400000009,381787.940000001,-1391.5000000001164
21627,2022-07-20 10:15:00,1459.53,381855.9700000009,381787.940000001,68.02999999991152
21628,2022-07-20 10:20:00,-273.1,381582.8700000009,381787.940000001,-205.0700000000652
21629,2022-07-20 10:25:00,280.44,381863.3100000009,381787.940000001,75.36999999993714
21630,2022-07-20 10:30:00,637.18,382500.4900000009,381787.940000001,712.5499999999302
21631,2022-07-20 10:35:00,1527.9,384028.39000000095,381787.940000001,2240.4499999999534
21632,2022-07-20 10:40:00,-166.81,383861.58000000095,381787.940000001,2073.6399999999558
21633,2022-07-20 10:45:00,-377.46,383484.1200000009,381787.940000001,1696.1799999999348
21634,2022-07-20 10:50:00,-919.27,382564.8500000009,381787.940000001,776.9099999999162
21635,2022-07-20 10:55:00,1955.39,384520.2400000009,381787.940000001,2732.29999999993
21636,2022-07-20 11:00:00,-931.17,383589.07000000094,381787.940000001,1801.1299999999464
21637,2022-07-20 11:05:00,0.06,383589.13000000094,381787.940000001,1801.1899999999441
21638,2022-07-20 11:10:00,-1516.69,382072.44000000093,381787.940000001,284.4999999999418
21639,2022-07-20 11:15:00,-160.98,381911.46000000095,381787.940000001,123.51999999996042
21640,2022-07-20 11:20:00,1540.21,383451.670000001,381787.940000001,1663.7299999999814
21641,2022-07-20 11:25:00,-8.97,383442.700000001,381787.940000001,1654.7600000000093
21642,2022-07-20 11:30:00,-1763.5,381679.200000001,381787.940000001,-108.73999999999069
21643,2022-07-20 11:35:00,-951.56,380727.640000001,381787.940000001,-1060.2999999999884
21644,2022-07-20 11:40:00,-541.83,380185.810000001,381787.940000001,-1602.1300000000047
21645,2022-07-20 11:45:00,645.93,380831.740000001,381787.940000001,-956.2000000000116
21646,2022-07-20 11:50:00,-548.93,380282.810000001,381787.940000001,-1505.1300000000047
21647,2022-07-20 11:55:00,-356.54,379926.270000001,381787.940000001,-1861.6699999999837
21648,2022-07-20 12:00:00,584.79,380511.060000001,381787.940000001,-1276.8800000000047
21649,2022-07-20 12:05:00,-1119.08,379391.980000001,381787.940000001,-2395.960000000021
21650,2022-07-20 12:10:00,-96.25,379295.730000001,381787.940000001,-2492.210000000021
21651,2022-07-20 12:15:00,596.15,379891.880000001,381787.940000001,-1896.0599999999977
21652,2022-07-20 12:20:00,-1046.55,378845.330000001,381787.940000001,-2942.609999999986
21653,2022-07-20 12:25:00,784.54,379629.870000001,381787.940000001,-2158.070000000007
21654,2022-07-20 12:30:00,1493.77,381123.640000001,381787.940000001,-664.2999999999884
21655,2022-07-20 12:35:00,743.7,381867.340000001,381787.940000001,79.40000000002328
21656,2022-07-20 12:40:00,-366.69,381500.650000001,381787.940000001,-287.28999999997905
21657,2022-07-20 12:45:00,983.32,382483.970000001,381787.940000001,696.0300000000279
21658,2022-07-20 12:50:00,392.31,382876.280000001,381787.940000001,1088.3400000000256
21659,2022-07-20 12:55:00,793.74,383670.020000001,381787.940000001,1882.0800000000163
21660,2022-07-20 13:00:00,-527.2,383142.820000001,381787.940000001,1354.8800000000047
21661,2022-07-20 13:05:00,389.59,383532.410000001,381787.940000001,1744.4700000000303
21662,2022-07-20 13:10:00,797.76,384330.17000000103,381787.940000001,2542.2300000000396
21663,2022-07-20 13:15:00,235.05,384565.220000001,381787.940000001,2777.280000000028
21664,2022-07-20 13:20:00,626.32,385191.540000001,381787.940000001,3403.600000000035
21665,2022-07-20 13:25:00,1121.44,386312.98000000103,381787.940000001,4525.040000000037
21666,2022-07-20 13:30:00,442.3,386755.280000001,381787.940000001,4967.340000000026
21667,2022-07-20 13:35:00,1883.61,388638.890000001,381787.940000001,6850.950000000012
21668,2022-07-20 13:40:00,-1719.21,386919.680000001,381787.940000001,5131.739999999991
21669,2022-07-20 13:45:00,578.78,387498.460000001,381787.940000001,5710.520000000019
21670,2022-07-20 13:50:00,1516.69,389015.150000001,381787.940000001,7227.210000000021
21671,2022-07-20 13:55:00,-323.33,388691.820000001,381787.940000001,6903.880000000005
21672,2022-07-20 14:00:00,1684.69,390376.510000001,381787.940000001,8588.570000000007
21673,2022-07-20 14:05:00,-194.03,390182.480000001,381787.940000001,8394.539999999979
21674,2022-07-20 14:10:00,-236.8,389945.680000001,381787.940000001,8157.739999999991
21675,2022-07-20 14:15:00,-668.37,389277.310000001,381787.940000001,7489.369999999995
21676,2022-07-20 14:20:00,1690.62,390967.930000001,381787.940000001,9179.98999999999
21677,2022-07-20 14:25:00,1283.24,392251.170000001,381787.940000001,10463.229999999981
21678,2022-07-20 14:30:00,480.64,392731.810000001,381787.940000001,10943.869999999995
21679,2022-07-20 14:35:00,-1173.91,391557.900000001,381787.940000001,9769.960000000021
21680,2022-07-20 14:40:00,-1020.29,390537.61000000103,381787.940000001,8749.670000000042
21681,2022-07-20 14:45:00,989.06,391526.67000000103,381787.940000001,9738.73000000004
21682,2022-07-20 14:50:00,-1514.17,390012.50000000105,381787.940000001,8224.560000000056
21683,2022-07-20 14:55:00,463.74,390476.24000000104,381787.940000001,8688.300000000047
21684,2022-07-20 15:00:00,1584.3,392060.540000001,381787.940000001,10272.600000000035
21685,2022-07-20 15:05:00,-1671.62,390388.92000000103,381787.940000001,8600.98000000004
21686,2022-07-20 15:10:00,-1645.97,388742.95000000106,381787.940000001,6955.0100000000675
21687,2022-07-20 15:15:00,1542.59,390285.5400000011,381787.940000001,8497.600000000093
21688,2022-07-20 15:20:00,895.71,391181.2500000011,381787.940000001,9393.310000000114
21689,2022-07-20 15:25:00,1836.1,393017.3500000011,381787.940000001,11229.41000000009
21690,2022-07-20 15:30:00,-1725.24,391292.1100000011,381787.940000001,9504.1700000001
21691,2022-07-20 15:35:00,-458.66,390833.4500000011,381787.940000001,9045.510000000126
21692,2022-07-20 15:40:00,-1196.44,389637.0100000011,381787.940000001,7849.070000000123
21693,2022-07-20 15:45:00,923.85,390560.8600000011,381787.940000001,8772.9200000001
21694,2022-07-20 15:50:00,56.28,390617.1400000011,381787.940000001,8829.200000000128
21695,2022-07-20 15:55:00,1124.48,391741.6200000011,381787.940000001,9953.68000000011
21696,2022-07-20 16:00:00,-1523.4,390218.2200000011,381787.940000001,8430.280000000086
21697,2022-07-20 16:05:00,-1329.23,388888.9900000011,381787.940000001,7101.050000000105
21698,2022-07-20 16:10:00,687.24,389576.2300000011,381787.940000001,7788.2900000000955
21699,2022-07-20 16:15:00,-1721.58,387854.6500000011,381787.940000001,6066.710000000079
21700,2022-07-20 16:20:00,-739.28,387115.37000000104,381787.940000001,5327.430000000051
21701,2022-07-20 16:25:00,-158.99,386956.38000000105,381787.940000001,5168.4400000000605
21702,2022-07-20 16:30:00,-1126.4,385829.98000000103,381787.940000001,4042.0400000000373
21703,2022-07-20 16:35:00,-1298.88,384531.100000001,381787.940000001,2743.1600000000326
21704,2022-07-20 16:40:00,-712.29,383818.81000000105,381787.940000001,2030.8700000000536
21705,2022-07-20 16:45:00,-710.59,383108.220000001,381787.940000001,1320.280000000028
21706,2022-07-20 16:50:00,723.78,383832.00000000105,381787.940000001,2044.0600000000559
21707,2022-07-20 16:55:00,226.84,384058.8400000011,381787.940000001,2270.9000000000815
21708,2022-07-21 08:00:00,1963.79,386022.63000000105,384058.8400000011,1963.789999999979
21709,2022-07-21 08:05:00,669.85,386692.48000000103,384058.8400000011,2633.6399999999558
21710,2022-07-21 08:10:00,-1690.07,385002.410000001,384058.8400000011,943.5699999999488
21711,2022-07-21 08:15:00,-1746.89,383255.520000001,384058.8400000011,-803.3200000000652
21712,2022-07-21 08:20:00,-535.87,382719.650000001,384058.8400000011,-1339.1900000000605
21713,2022-07-21 08:25:00,1321.48,384041.130000001,384058.8400000011,-17.710000000079162
21714,2022-07-21 08:30:00,1545.11,385586.240000001,384058.8400000011,1527.3999999999069
21715,2022-07-21 08:35:00,-1644.61,383941.630000001,384058.8400000011,-117.21000000007916
21716,2022-07-21 08:40:00,1003.54,384945.170000001,384058.8400000011,886.3299999998999
21717,2022-07-21 08:45:00,-66.03,384879.14000000095,384058.8400000011,820.2999999998719
21718,2022-07-21 08:50:00,475.81,385354.95000000094,384058.8400000011,1296.1099999998696
21719,2022-07-21 08:55:00,-61.06,385293.89000000095,384058.8400000011,1235.049999999872
21720,2022-07-21 09:00:00,1320.27,386614.16000000096,384058.8400000011,2555.3199999998906
21721,2022-07-21 09:05:00,1991.34,388605.500000001,384058.8400000011,4546.659999999916
21722,2022-07-21 09:10:00,1641.19,390246.690000001,384058.8400000011,6187.8499999999185
21723,2022-07-21 09:15:00,-1206.36,389040.330000001,384058.8400000011,4981.4899999999325
21724,2022-07-21 09:20:00,1664.87,390705.200000001,384058.8400000011,6646.359999999928
21725,2022-07-21 09:25:00,374.59,391079.790000001,384058.8400000011,7020.949999999953
21726,2022-07-21 09:30:00,455.62,391535.410000001,384058.8400000011,7476.569999999949
21727,2022-07-21 09:35:00,1883.38,393418.790000001,384058.8400000011,9359.949999999953
21728,2022-07-21 09:40:00,-1861.0,391557.790000001,384058.8400000011,7498.949999999953
21729,2022-07-21 09:45:00,-568.02,390989.770000001,384058.8400000011,6930.929999999935
21730,2022-07-21 09:50:00,352.06,391341.830000001,384058.8400000011,7282.9899999999325
21731,2022-07-21 09:55:00,-1603.73,389738.100000001,384058.8400000011,5679.259999999951
21732,2022-07-21 10:00:00,-74.2,389663.900000001,384058.8400000011,5605.0599999999395
21733,2022-07-21 10:05:00,1253.18,390917.080000001,384058.8400000011,6858.2399999999325
21734,2022-07-21 10:10:00,1182.87,392099.950000001,384058.8400000011,8041.109999999928
21735,2022-07-21 10:15:00,-1686.56,390413.390000001,384058.8400000011,6354.54999999993
21736,2022-07-21 10:20:00,-1941.71,388471.680000001,384058.8400000011,4412.839999999909
21737,2022-07-21 10:25:00,471.24,388942.920000001,384058.8400000011,4884.0799999999
21738,2022-07-21 10:30:00,-640.92,388302.000000001,384058.8400000011,4243.159999999916
21739,2022-07-21 10:35:00,1391.65,389693.650000001,384058.8400000011,5634.8099999999395
21740,2022-07-21 10:40:00,-1982.3,387711.350000001,384058.8400000011,3652.509999999951
21741,2022-07-21 10:45:00,-200.77,387510.580000001,384058.8400000011,3451.7399999999325
21742,2022-07-21 10:50:00,-1462.26,386048.320000001,384058.8400000011,1989.4799999999232
21743,2022-07-21 10:55:00,1560.67,387608.990000001,384058.8400000011,3550.149999999907
21744,2022-07-21 11:00:00,-746.4,386862.59000000096,384058.8400000011,2803.7499999998836
21745,2022-07-21 11:05:00,-872.49,385990.10000000097,384058.8400000011,1931.259999999893
21746,2022-07-21 11:10:00,-170.18,385819.920000001,384058.8400000011,1761.0799999998999
21747,2022-07-21 11:15:00,-1254.81,384565.110000001,384058.8400000011,506.2699999999022
21748,2022-07-21 11:20:00,-1752.24,382812.870000001,384058.8400000011,-1245.9700000000885
21749,2022-07-21 11:25:00,-1487.49,381325.380000001,384058.8400000011,-2733.460000000079
21750,2022-07-21 11:30:00,955.04,382280.420000001,384058.8400000011,-1778.4200000001001
21751,2022-07-21 11:35:00,1966.62,384247.04000000097,384058.8400000011,188.19999999989523
21752,2022-07-21 11:40:00,-932.33,383314.71000000095,384058.8400000011,-744.1300000001211
21753,2022-07-21 11:45:00,-556.84,382757.8700000009,384058.8400000011,-1300.9700000001467
21754,2022-07-21 11:50:00,509.0,383266.8700000009,384058.8400000011,-791.9700000001467
21755,2022-07-21 11:55:00,165.92,383432.7900000009,384058.8400000011,-626.050000000163
21756,2022-07-21 12:00:00,-1740.89,381691.9000000009,384058.8400000011,-2366.940000000177
21757,2022-07-21 12:05:00,-709.51,380982.3900000009,384058.8400000011,-3076.4500000001863
21758,2022-07-21 12:10:00,-761.01,380221.3800000009,384058.8400000011,-3837.4600000001956
21759,2022-07-21 12:15:00,1748.85,381970.23000000085,384058.8400000011,-2088.610000000219
21760,2022-07-21 12:20:00,722.75,382692.98000000085,384058.8400000011,-1365.8600000002189
21761,2022-07-21 12:25:00,-1718.51,380974.47000000085,384058.8400000011,-3084.370000000228
21762,2022-07-21 12:30:00,-1349.88,379624.59000000084,384058.8400000011,-4434.250000000233
21763,2022-07-21 12:35:00,-737.41,378887.18000000087,384058.8400000011,-5171.660000000207
21764,2022-07-21 12:40:00,-501.33,378385.85000000085,384058.8400000011,-5672.9900000002235
21765,2022-07-21 12:45:00,-267.51,378118.34000000084,384058.8400000011,-5940.500000000233
21766,2022-07-21 12:50:00,598.73,378717.0700000008,384058.8400000011,-5341.7700000002515
21767,2022-07-21 12:55:00,316.84,379033.91000000085,384058.8400000011,-5024.930000000226
21768,2022-07-21 13:00:00,1679.61,380713.52000000083,384058.8400000011,-3345.32000000024
21769,2022-07-21 13:05:00,-1757.48,378956.04000000085,384058.8400000011,-5102.800000000221
21770,2022-07-21 13:10:00,710.48,379666.52000000083,384058.8400000011,-4392.32000000024
21771,2022-07-21 13:15:00,-1115.68,378550.84000000084,384058.8400000011,-5508.000000000233
21772,2022-07-21 13:20:00,70.6,378621.4400000008,384058.8400000011,-5437.400000000256
21773,2022-07-21 13:25:00,182.71,378804.15000000084,384058.8400000011,-5254.690000000235
21774,2022-07-21 13:30:00,1045.5,379849.65000000084,384058.8400000011,-4209.190000000235
21775,2022-07-21 13:35:00,-331.5,379518.15000000084,384058.8400000011,-4540.690000000235
21776,2022-07-21 13:40:00,1576.39,381094.54000000085,384058.8400000011,-2964.300000000221
21777,2022-07-21 13:45:00,1527.69,382622.23000000085,384058.8400000011,-1436.6100000002189
21778,2022-07-21 13:50:00,630.7,383252.93000000087,384058.8400000011,-805.9100000002072
21779,2022-07-21 13:55:00,1248.2,384501.1300000009,384058.8400000011,442.2899999998044
21780,2022-07-21 14:00:00,1676.0,386177.1300000009,384058.8400000011,2118.2899999998044
21781,2022-07-21 14:05:00,-401.5,385775.6300000009,384058.8400000011,1716.7899999998044
21782,2022-07-21 14:10:00,1584.87,387360.5000000009,384058.8400000011,3301.6599999997998
21783,2022-07-21 14:15:00,1455.01,388815.5100000009,384058.8400000011,4756.669999999809
21784,2022-07-21 14:20:00,-1838.27,386977.24000000086,384058.8400000011,2918.3999999997905
21785,2022-07-21 14:25:00,-1872.14,385105.10000000085,384058.8400000011,1046.2599999997765
21786,2022-07-21 14:30:00,-1891.86,383213.24000000086,384058.8400000011,-845.6000000002095
21787,2022-07-21 14:35:00,844.3,384057.54000000085,384058.8400000011,-1.3000000002211891
21788,2022-07-21 14:40:00,1892.41,385949.9500000008,384058.8400000011,1891.1099999997532
21789,2022-07-21 14:45:00,811.82,386761.77000000083,384058.8400000011,2702.92999999976
21790,2022-07-21 14:50:00,1160.24,387922.0100000008,384058.8400000011,3863.169999999751
21791,2022-07-21 14:55:00,-1184.51,386737.5000000008,384058.8400000011,2678.6599999997416
21792,2022-07-21 15:00:00,-1191.89,385545.6100000008,384058.8400000011,1486.7699999997276
21793,2022-07-21 15:05:00,1730.08,387275.6900000008,384058.8400000011,3216.849999999744
21794,2022-07-21 15:10:00,167.58,387443.27000000083,384058.8400000011,3384.42999999976
21795,2022-07-21 15:15:00,1783.68,389226.9500000008,384058.8400000011,5168.109999999753
21796,2022-07-21 15:20:00,-373.22,388853.73000000085,384058.8400000011,4794.889999999781
21797,2022-07-21 15:25:00,1901.91,390755.6400000008,384058.8400000011,6696.7999999997555
21798,2022-07-21 15:30:00,504.23,391259.8700000008,384058.8400000011,7201.029999999737
21799,2022-07-21 15:35:00,-1555.97,389703.90000000084,384058.8400000011,5645.059999999765
21800,2022-07-21 15:40:00,-944.75,388759.15000000084,384058.8400000011,4700.309999999765
21801,2022-07-21 15:45:00,575.34,389334.49000000086,384058.8400000011,5275.64999999979
21802,2022-07-21 15:50:00,-302.14,389032.35000000085,384058.8400000011,4973.5099999997765
21803,2022-07-21 15:55:00,-789.17,388243.18000000087,384058.8400000011,4184.339999999793
21804,2022-07-21 16:00:00,604.34,388847.5200000009,384058.8400000011,4788.679999999818
21805,2022-07-21 16:05:00,1402.67,390250.1900000009,384058.8400000011,6191.349999999802
21806,2022-07-21 16:10:00,-733.4,389516.79000000085,384058.8400000011,5457.949999999779
21807,2022-07-21 16:15:00,-173.32,389343.47000000085,384058.8400000011,5284.629999999772
21808,2022-07-21 16:20:00,-451.03,388892.4400000008,384058.8400000011,4833.599999999744
21809,2022-07-21 16:25:00,-1525.62,387366.8200000008,384058.8400000011,3307.9799999997485
21810,2022-07-21 16:30:00,-1874.17,385492.65000000084,384058.8400000011,1433.8099999997648
21811,2022-07-21 16:35:00,-784.9,384707.7500000008,384058.8400000011,648.9099999997416
21812,2022-07-21 16:40:00,-625.44,384082.3100000008,384058.8400000011,23.46999999973923
21813,2022-07-21 16:45:00,-1767.7,382314.6100000008,384058.8400000011,-1744.2300000002724
21814,2022-07-21 16:50:00,-1626.96,380687.6500000008,384058.8400000011,-3371.1900000002934
21815,2022-07-21 16:55:00,228.13,380915.7800000008,384058.8400000011,-3143.0600000002887
21816,2022-07-22 08:00:00,-1781.38,379134.4000000008,380915.7800000008,-1781.3800000000047
21817,2022-07-22 08:05:00,-1080.14,378054.26000000077,380915.7800000008,-2861.5200000000186
21818,2022-07-22 08:10:00,1572.81,379627.07000000076,380915.7800000008,-1288.710000000021
21819,2022-07-22 08:15:00,961.55,380588.62000000075,380915.7800000008,-327.1600000000326
21820,2022-07-22 08:20:00,1448.4,382037.0200000008,380915.7800000008,1121.2399999999907
21821,2022-07-22 08:25:00,1273.47,383310.49000000075,380915.7800000008,2394.7099999999627
21822,2022-07-22 08:30:00,-826.23,382484.26000000077,380915.7800000008,1568.4799999999814
21823,2022-07-22 08:35:00,-1830.28,380653.98000000074,380915.7800000008,-261.80000000004657
21824,2022-07-22 08:40:00,838.63,381492.61000000074,380915.7800000008,576.8299999999581
21825,2022-07-22 08:45:00,-912.97,380579.64000000077,380915.7800000008,-336.14000000001397
21826,2022-07-22 08:50:00,-1797.39,378782.25000000076,380915.7800000008,-2133.530000000028
21827,2022-07-22 08:55:00,1175.66,379957.91000000073,380915.7800000008,-957.8700000000536
21828,2022-07-22 09:00:00,1912.04,381869.9500000007,380915.7800000008,954.1699999999255
21829,2022-07-22 09:05:00,-88.43,381781.5200000007,380915.7800000008,865.7399999999325
21830,2022-07-22 09:10:00,1529.77,383311.29000000074,380915.7800000008,2395.509999999951
21831,2022-07-22 09:15:00,-1151.2,382160.0900000007,380915.7800000008,1244.3099999999395
21832,2022-07-22 09:20:00,-1057.6,381102.49000000075,380915.7800000008,186.70999999996275
21833,2022-07-22 09:25:00,1039.24,382141.73000000074,380915.7800000008,1225.9499999999534
21834,2022-07-22 09:30:00,-589.96,381551.7700000007,380915.7800000008,635.9899999999325
21835,2022-07-22 09:35:00,-1419.9,380131.8700000007,380915.7800000008,-783.9100000000908
21836,2022-07-22 09:40:00,-727.83,379404.0400000007,380915.7800000008,-1511.740000000107
21837,2022-07-22 09:45:00,1559.74,380963.78000000067,380915.7800000008,47.999999999883585
21838,2022-07-22 09:50:00,-1968.93,378994.8500000007,380915.7800000008,-1920.9300000001094
21839,2022-07-22 09:55:00,264.29,379259.14000000065,380915.7800000008,-1656.6400000001304
21840,2022-07-22 10:00:00,-1566.41,377692.7300000007,380915.7800000008,-3223.050000000105
21841,2022-07-22 10:05:00,1106.77,378799.5000000007,380915.7800000008,-2116.280000000086
21842,2022-07-22 10:10:00,576.27,379375.7700000007,380915.7800000008,-1540.0100000000675
21843,2022-07-22 10:15:00,-707.95,378667.8200000007,380915.7800000008,-2247.960000000079
21844,2022-07-22 10:20:00,-1429.3,377238.5200000007,380915.7800000008,-3677.2600000000675
21845,2022-07-22 10:25:00,-1687.65,375550.8700000007,380915.7800000008,-5364.910000000091
21846,2022-07-22 10:30:00,-1717.6,373833.2700000007,380915.7800000008,-7082.5100000000675
21847,2022-07-22 10:35:00,792.4,374625.67000000074,380915.7800000008,-6290.110000000044
21848,2022-07-22 10:40:00,-1307.3,373318.37000000075,380915.7800000008,-7597.410000000033
21849,2022-07-22 10:45:00,-1026.47,372291.9000000008,380915.7800000008,-8623.880000000005
21850,2022-07-22 10:50:00,-1248.67,371043.2300000008,380915.7800000008,-9872.549999999988
21851,2022-07-22 10:55:00,-1338.13,369705.1000000008,380915.7800000008,-11210.679999999993
21852,2022-07-22 11:00:00,1130.33,370835.4300000008,380915.7800000008,-10080.349999999977
21853,2022-07-22 11:05:00,1505.06,372340.4900000008,380915.7800000008,-8575.289999999979
21854,2022-07-22 11:10:00,590.65,372931.1400000008,380915.7800000008,-7984.639999999956
21855,2022-07-22 11:15:00,897.23,373828.3700000008,380915.7800000008,-7087.409999999974
21856,2022-07-22 11:20:00,626.21,374454.58000000083,380915.7800000008,-6461.199999999953
21857,2022-07-22 11:25:00,-1018.71,373435.8700000008,380915.7800000008,-7479.909999999974
21858,2022-07-22 11:30:00,-520.82,372915.0500000008,380915.7800000008,-8000.729999999981
21859,2022-07-22 11:35:00,525.7,373440.7500000008,380915.7800000008,-7475.02999999997
21860,2022-07-22 11:40:00,876.65,374317.40000000084,380915.7800000008,-6598.379999999946
21861,2022-07-22 11:45:00,89.67,374407.0700000008,380915.7800000008,-6508.709999999963
21862,2022-07-22 11:50:00,688.88,375095.9500000008,380915.7800000008,-5819.829999999958
21863,2022-07-22 11:55:00,-209.86,374886.09000000084,380915.7800000008,-6029.689999999944
21864,2022-07-22 12:00:00,-606.77,374279.3200000008,380915.7800000008,-6636.459999999963
21865,2022-07-22 12:05:00,796.97,375076.2900000008,380915.7800000008,-5839.489999999991
21866,2022-07-22 12:10:00,675.39,375751.6800000008,380915.7800000008,-5164.099999999977
21867,2022-07-22 12:15:00,-1363.68,374388.0000000008,380915.7800000008,-6527.77999999997
21868,2022-07-22 12:20:00,-623.03,373764.9700000008,380915.7800000008,-7150.809999999998
21869,2022-07-22 12:25:00,871.09,374636.0600000008,380915.7800000008,-6279.719999999972
21870,2022-07-22 12:30:00,-538.84,374097.2200000008,380915.7800000008,-6818.559999999998
21871,2022-07-22 12:35:00,-559.97,373537.2500000008,380915.7800000008,-7378.52999999997
21872,2022-07-22 12:40:00,-5.21,373532.0400000008,380915.7800000008,-7383.739999999991
21873,2022-07-22 12:45:00,-30.24,373501.8000000008,380915.7800000008,-7413.979999999981
21874,2022-07-22 12:50:00,102.19,373603.9900000008,380915.7800000008,-7311.789999999979
21875,2022-07-22 12:55:00,529.37,374133.3600000008,380915.7800000008,-6782.419999999984
21876,2022-07-22 13:00:00,-652.45,373480.9100000008,380915.7800000008,-7434.869999999995
21877,2022-07-22 13:05:00,-1159.48,372321.4300000008,380915.7800000008,-8594.349999999977
21878,2022-07-22 13:10:00,1516.77,373838.2000000008,380915.7800000008,-7077.579999999958
21879,2022-07-22 13:15:00,-1920.77,371917.4300000008,380915.7800000008,-8998.349999999977
21880,2022-07-22 13:20:00,-597.83,371319.6000000008,380915.7800000008,-9596.179999999993
21881,2022-07-22 13:25:00,-1725.81,369593.7900000008,380915.7800000008,-11321.98999999999
21882,2022-07-22 13:30:00,-62.0,369531.7900000008,380915.7800000008,-11383.98999999999
21883,2022-07-22 13:35:00,-461.67,369070.1200000008,380915.7800000008,-11845.659999999974
21884,2022-07-22 13:40:00,1108.58,370178.7000000008,380915.7800000008,-10737.079999999958
21885,2022-07-22 13:45:00,-1129.16,369049.54000000085,380915.7800000008,-11866.239999999932
21886,2022-07-22 13:50:00,-919.23,368130.31000000087,380915.7800000008,-12785.469999999914
21887,2022-07-22 13:55:00,555.99,368686.30000000086,380915.7800000008,-12229.479999999923
21888,2022-07-22 14:00:00,1575.11,370261.41000000085,380915.7800000008,-10654.369999999937
21889,2022-07-22 14:05:00,1446.55,371707.96000000084,380915.7800000008,-9207.819999999949
21890,2022-07-22 14:10:00,-107.82,371600.1400000008,380915.7800000008,-9315.639999999956
21891,2022-07-22 14:15:00,51.21,371651.35000000085,380915.7800000008,-9264.429999999935
21892,2022-07-22 14:20:00,1202.0,372853.35000000085,380915.7800000008,-8062.429999999935
21893,2022-07-22 14:25:00,-192.8,372660.55000000086,380915.7800000008,-8255.229999999923
21894,2022-07-22 14:30:00,-441.19,372219.36000000086,380915.7800000008,-8696.419999999925
21895,2022-07-22 14:35:00,967.99,373187.35000000085,380915.7800000008,-7728.429999999935
21896,2022-07-22 14:40:00,-846.46,372340.8900000008,380915.7800000008,-8574.889999999956
21897,2022-07-22 14:45:00,1859.21,374200.10000000085,380915.7800000008,-6715.679999999935
21898,2022-07-22 14:50:00,889.85,375089.9500000008,380915.7800000008,-5825.829999999958
21899,2022-07-22 14:55:00,-649.26,374440.6900000008,380915.7800000008,-6475.089999999967
21900,2022-07-22 15:00:00,713.09,375153.78000000084,380915.7800000008,-5761.999999999942
21901,2022-07-22 15:05:00,1335.98,376489.7600000008,380915.7800000008,-4426.01999999996
21902,2022-07-22 15:10:00,385.58,376875.34000000084,380915.7800000008,-4040.439999999944
21903,2022-07-22 15:15:00,-411.2,376464.1400000008,380915.7800000008,-4451.639999999956
21904,2022-07-22 15:20:00,-278.3,376185.84000000084,380915.7800000008,-4729.939999999944
21905,2022-07-22 15:25:00,1958.19,378144.03000000084,380915.7800000008,-2771.749999999942
21906,2022-07-22 15:30:00,1258.42,379402.4500000008,380915.7800000008,-1513.329999999958
21907,2022-07-22 15:35:00,71.57,379474.02000000083,380915.7800000008,-1441.759999999951
21908,2022-07-22 15:40:00,1584.56,381058.58000000083,380915.7800000008,142.80000000004657
21909,2022-07-22 15:45:00,619.11,381677.6900000008,380915.7800000008,761.9100000000326
21910,2022-07-22 15:50:00,-1857.36,379820.33000000083,380915.7800000008,-1095.4499999999534
21911,2022-07-22 15:55:00,1634.92,381455.2500000008,380915.7800000008,539.4700000000303
21912,2022-07-22 16:00:00,-1817.66,379637.59000000084,380915.7800000008,-1278.1899999999441
21913,2022-07-22 16:05:00,1363.77,381001.36000000086,380915.7800000008,85.5800000000745
21914,2022-07-22 16:10:00,1214.75,382216.11000000086,380915.7800000008,1300.3300000000745
21915,2022-07-22 16:15:00,-1882.91,380333.2000000009,380915.7800000008,-582.5799999998999
21916,2022-07-22 16:20:00,-1237.67,379095.5300000009,380915.7800000008,-1820.2499999998836
21917,2022-07-22 16:25:00,-873.78,378221.7500000009,380915.7800000008,-2694.0299999999115
21918,2022-07-22 16:30:00,-1929.48,376292.2700000009,380915.7800000008,-4623.509999999893
21919,2022-07-22 16:35:00,-25.08,376267.1900000009,380915.7800000008,-4648.589999999909
21920,2022-07-22 16:40:00,-762.69,375504.5000000009,380915.7800000008,-5411.2799999999115
21921,2022-07-22 16:45:00,351.86,375856.36000000086,380915.7800000008,-5059.4199999999255
21922,2022-07-22 16:50:00,-1176.92,374679.4400000009,380915.7800000008,-6236.339999999909
21923,2022-07-22 16:55:00,-1353.51,373325.93000000087,380915.7800000008,-7589.8499999999185
21924,2022-07-23 08:00:00,-160.59,373165.34000000084,373325.93000000087,-160.5900000000256
21925,2022-07-23 08:05:00,1218.85,374384.1900000008,373325.93000000087,1058.259999999951
21926,2022-07-23 08:10:00,-523.19,373861.0000000008,373325.93000000087,535.0699999999488
21927,2022-07-23 08:15:00,-973.05,372887.9500000008,373325.93000000087,-437.9800000000396
21928,2022-07-23 08:20:00,-900.12,371987.83000000083,373325.93000000087,-1338.100000000035
21929,2022-07-23 08:25:00,-1591.45,370396.3800000008,373325.93000000087,-2929.5500000000466
21930,2022-07-23 08:30:00,50.6,370446.9800000008,373325.93000000087,-2878.95000000007
21931,2022-07-23 08:35:00,1756.67,372203.6500000008,373325.93000000087,-1122.2800000000861
21932,2022-07-23 08:40:00,-159.02,372044.63000000076,373325.93000000087,-1281.3000000001048
21933,2022-07-23 08:45:00,954.0,372998.63000000076,373325.93000000087,-327.3000000001048
21934,2022-07-23 08:50:00,-217.92,372780.7100000008,373325.93000000087,-545.2200000000885
21935,2022-07-23 08:55:00,-736.41,372044.3000000008,373325.93000000087,-1281.6300000000629
21936,2022-07-23 09:00:00,-581.74,371462.5600000008,373325.93000000087,-1863.3700000000536
21937,2022-07-23 09:05:00,-1024.89,370437.6700000008,373325.93000000087,-2888.2600000000675
21938,2022-07-23 09:10:00,199.61,370637.2800000008,373325.93000000087,-2688.6500000000815
21939,2022-07-23 09:15:00,-256.86,370380.4200000008,373325.93000000087,-2945.5100000000675
21940,2022-07-23 09:20:00,882.59,371263.0100000008,373325.93000000087,-2062.920000000042
21941,2022-07-23 09:25:00,889.39,372152.40000000084,373325.93000000087,-1173.530000000028
21942,2022-07-23 09:30:00,1703.81,373856.21000000084,373325.93000000087,530.2799999999697
21943,2022-07-23 09:35:00,-1252.72,372603.49000000086,373325.93000000087,-722.4400000000023
21944,2022-07-23 09:40:00,968.18,373571.67000000086,373325.93000000087,245.7399999999907
21945,2022-07-23 09:45:00,-363.91,373207.7600000009,373325.93000000087,-118.1699999999837
21946,2022-07-23 09:50:00,-1359.84,371847.92000000086,373325.93000000087,-1478.0100000000093
21947,2022-07-23 09:55:00,-914.85,370933.0700000009,373325.93000000087,-2392.859999999986
21948,2022-07-23 10:00:00,336.83,371269.9000000009,373325.93000000087,-2056.0299999999697
21949,2022-07-23 10:05:00,-1461.47,369808.4300000009,373325.93000000087,-3517.499999999942
21950,2022-07-23 10:10:00,-1367.0,368441.4300000009,373325.93000000087,-4884.499999999942
21951,2022-07-23 10:15:00,1654.4,370095.83000000095,373325.93000000087,-3230.0999999999185
21952,2022-07-23 10:20:00,205.66,370301.4900000009,373325.93000000087,-3024.439999999944
21953,2022-07-23 10:25:00,-1361.03,368940.4600000009,373325.93000000087,-4385.469999999972
21954,2022-07-23 10:30:00,-833.61,368106.8500000009,373325.93000000087,-5219.079999999958
21955,2022-07-23 10:35:00,366.23,368473.0800000009,373325.93000000087,-4852.849999999977
21956,2022-07-23 10:40:00,1374.28,369847.3600000009,373325.93000000087,-3478.569999999949
21957,2022-07-23 10:45:00,-1483.15,368364.2100000009,373325.93000000087,-4961.719999999972
21958,2022-07-23 10:50:00,-335.57,368028.6400000009,373325.93000000087,-5297.289999999979
21959,2022-07-23 10:55:00,-303.42,367725.2200000009,373325.93000000087,-5600.709999999963
21960,2022-07-23 11:00:00,1482.48,369207.7000000009,373325.93000000087,-4118.229999999981
21961,2022-07-23 11:05:00,1756.17,370963.87000000087,373325.93000000087,-2362.0599999999977
21962,2022-07-23 11:10:00,1201.84,372165.7100000009,373325.93000000087,-1160.219999999972
21963,2022-07-23 11:15:00,67.39,372233.1000000009,373325.93000000087,-1092.829999999958
21964,2022-07-23 11:20:00,-1896.82,370336.2800000009,373325.93000000087,-2989.649999999965
21965,2022-07-23 11:25:00,-1456.82,368879.4600000009,373325.93000000087,-4446.469999999972
21966,2022-07-23 11:30:00,-884.71,367994.7500000009,373325.93000000087,-5331.179999999993
21967,2022-07-23 11:35:00,-909.76,367084.99000000086,373325.93000000087,-6240.940000000002
21968,2022-07-23 11:40:00,-1929.48,365155.5100000009,373325.93000000087,-8170.419999999984
21969,2022-07-23 11:45:00,-795.5,364360.0100000009,373325.93000000087,-8965.919999999984
21970,2022-07-23 11:50:00,114.1,364474.11000000086,373325.93000000087,-8851.820000000007
21971,2022-07-23 11:55:00,33.51,364507.62000000087,373325.93000000087,-8818.309999999998
21972,2022-07-23 12:00:00,713.73,365221.35000000085,373325.93000000087,-8104.580000000016
21973,2022-07-23 12:05:00,1778.35,366999.7000000008,373325.93000000087,-6326.23000000004
21974,2022-07-23 12:10:00,-81.18,366918.52000000083,373325.93000000087,-6407.410000000033
21975,2022-07-23 12:15:00,-889.6,366028.92000000086,373325.93000000087,-7297.010000000009
21976,2022-07-23 12:20:00,1072.91,367101.83000000083,373325.93000000087,-6224.100000000035
21977,2022-07-23 12:25:00,-1011.29,366090.54000000085,373325.93000000087,-7235.390000000014
21978,2022-07-23 12:30:00,-845.97,365244.5700000009,373325.93000000087,-8081.359999999986
21979,2022-07-23 12:35:00,-1386.87,363857.7000000009,373325.93000000087,-9468.229999999981
21980,2022-07-23 12:40:00,-186.71,363670.99000000086,373325.93000000087,-9654.940000000002
21981,2022-07-23 12:45:00,-1833.11,361837.8800000009,373325.93000000087,-11488.049999999988
21982,2022-07-23 12:50:00,-275.9,361561.98000000085,373325.93000000087,-11763.950000000012
21983,2022-07-23 12:55:00,1959.69,363521.67000000086,373325.93000000087,-9804.26000000001
21984,2022-07-23 13:00:00,-1430.76,362090.91000000085,373325.93000000087,-11235.020000000019
21985,2022-07-23 13:05:00,599.61,362690.52000000083,373325.93000000087,-10635.410000000033
21986,2022-07-23 13:10:00,764.94,363455.46000000084,373325.93000000087,-9870.47000000003
21987,2022-07-23 13:15:00,-1076.05,362379.41000000085,373325.93000000087,-10946.520000000019
21988,2022-07-23 13:20:00,-60.22,362319.1900000009,373325.93000000087,-11006.73999999999
21989,2022-07-23 13:25:00,691.67,363010.86000000086,373325.93000000087,-10315.070000000007
21990,2022-07-23 13:30:00,-1275.17,361735.6900000009,373325.93000000087,-11590.23999999999
21991,2022-07-23 13:35:00,-1181.24,360554.4500000009,373325.93000000087,-12771.479999999981
21992,2022-07-23 13:40:00,-1318.48,359235.9700000009,373325.93000000087,-14089.959999999963
21993,2022-07-23 13:45:00,-402.13,358833.8400000009,373325.93000000087,-14492.089999999967
21994,2022-07-23 13:50:00,1158.22,359992.06000000087,373325.93000000087,-13333.869999999995
21995,2022-07-23 13:55:00,-221.19,359770.87000000087,373325.93000000087,-13555.059999999998
21996,2022-07-23 14:00:00,1714.4,361485.2700000009,373325.93000000087,-11840.659999999974
21997,2022-07-23 14:05:00,1707.07,363192.3400000009,373325.93000000087,-10133.589999999967
21998,2022-07-23 14:10:00,-1932.93,361259.4100000009,373325.93000000087,-12066.51999999996
21999,2022-07-23 14:15:00,-1247.03,360012.3800000009,373325.93000000087,-13313.549999999988
22000,2022-07-23 14:20:00,344.87,360357.2500000009,373325.93000000087,-12968.679999999993
22001,2022-07-23 14:25:00,590.11,360947.36000000086,373325.93000000087,-12378.570000000007
22002,2022-07-23 14:30:00,1173.57,362120.93000000087,373325.93000000087,-11205.0
22003,2022-07-23 14:35:00,-1988.82,360132.11000000086,373325.93000000087,-13193.820000000007
22004,2022-07-23 14:40:00,764.3,360896.41000000085,373325.93000000087,-12429.520000000019
22005,2022-07-23 14:45:00,1013.84,361910.2500000009,373325.93000000087,-11415.679999999993
22006,2022-07-23 14:50:00,-22.88,361887.37000000087,373325.93000000087,-11438.559999999998
22007,2022-07-23 14:55:00,-1130.94,360756.43000000087,373325.93000000087,-12569.5
22008,2022-07-23 15:00:00,1660.83,362417.2600000009,373325.93000000087,-10908.669999999984
22009,2022-07-23 15:05:00,661.53,363078.7900000009,373325.93000000087,-10247.139999999956
22010,2022-07-23 15:10:00,707.52,363786.3100000009,373325.93000000087,-9539.619999999937
22011,2022-07-23 15:15:00,1781.51,365567.82000000094,373325.93000000087,-7758.109999999928
22012,2022-07-23 15:20:00,-1688.1,363879.72000000096,373325.93000000087,-9446.209999999905
22013,2022-07-23 15:25:00,-480.1,363399.620000001,373325.93000000087,-9926.309999999881
22014,2022-07-23 15:30:00,-1525.16,361874.460000001,373325.93000000087,-11451.469999999856
22015,2022-07-23 15:35:00,-1331.02,360543.440000001,373325.93000000087,-12782.489999999874
22016,2022-07-23 15:40:00,-971.0,359572.440000001,373325.93000000087,-13753.489999999874
22017,2022-07-23 15:45:00,1253.29,360825.730000001,373325.93000000087,-12500.199999999895
22018,2022-07-23 15:50:00,-889.83,359935.90000000095,373325.93000000087,-13390.029999999912
22019,2022-07-23 15:55:00,640.32,360576.22000000096,373325.93000000087,-12749.709999999905
22020,2022-07-23 16:00:00,-123.92,360452.300000001,373325.93000000087,-12873.629999999888
22021,2022-07-23 16:05:00,-1665.05,358787.250000001,373325.93000000087,-14538.679999999877
22022,2022-07-23 16:10:00,1104.69,359891.940000001,373325.93000000087,-13433.989999999874
22023,2022-07-23 16:15:00,-1425.94,358466.000000001,373325.93000000087,-14859.929999999877
22024,2022-07-23 16:20:00,-1917.63,356548.370000001,373325.93000000087,-16777.55999999988
22025,2022-07-23 16:25:00,1936.62,358484.990000001,373325.93000000087,-14840.939999999886
22026,2022-07-23 16:30:00,-996.27,357488.72000000096,373325.93000000087,-15837.209999999905
22027,2022-07-23 16:35:00,-621.32,356867.40000000095,373325.93000000087,-16458.52999999991
22028,2022-07-23 16:40:00,949.79,357817.19000000093,373325.93000000087,-15508.739999999932
22029,2022-07-23 16:45:00,1056.97,358874.1600000009,373325.93000000087,-14451.76999999996
22030,2022-07-23 16:50:00,50.54,358924.7000000009,373325.93000000087,-14401.229999999981
22031,2022-07-23 16:55:00,-673.35,358251.3500000009,373325.93000000087,-15074.579999999958
22032,2022-07-24 08:00:00,-1878.41,356372.94000000093,358251.3500000009,-1878.4099999999744
22033,2022-07-24 08:05:00,178.54,356551.4800000009,358251.3500000009,-1699.8699999999953
22034,2022-07-24 08:10:00,-469.79,356081.69000000093,358251.3500000009,-2169.6599999999744
22035,2022-07-24 08:15:00,697.32,356779.01000000094,358251.3500000009,-1472.3399999999674
22036,2022-07-24 08:20:00,-1903.78,354875.2300000009,358251.3500000009,-3376.1199999999953
22037,2022-07-24 08:25:00,130.09,355005.32000000094,358251.3500000009,-3246.0299999999697
22038,2022-07-24 08:30:00,-1534.36,353470.96000000095,358251.3500000009,-4780.389999999956
22039,2022-07-24 08:35:00,-1937.29,351533.670000001,358251.3500000009,-6717.679999999935
22040,2022-07-24 08:40:00,1394.93,352928.60000000097,358251.3500000009,-5322.749999999942
22041,2022-07-24 08:45:00,-75.82,352852.78000000096,358251.3500000009,-5398.569999999949
22042,2022-07-24 08:50:00,-1318.5,351534.28000000096,358251.3500000009,-6717.069999999949
22043,2022-07-24 08:55:00,290.11,351824.39000000095,358251.3500000009,-6426.959999999963
22044,2022-07-24 09:00:00,1416.9,353241.29000000097,358251.3500000009,-5010.0599999999395
22045,2022-07-24 09:05:00,-1677.12,351564.170000001,358251.3500000009,-6687.179999999935
22046,2022-07-24 09:10:00,-862.14,350702.03000000096,358251.3500000009,-7549.319999999949
22047,2022-07-24 09:15:00,-541.63,350160.40000000095,358251.3500000009,-8090.949999999953
22048,2022-07-24 09:20:00,1810.43,351970.83000000095,358251.3500000009,-6280.51999999996
22049,2022-07-24 09:25:00,1139.12,353109.95000000094,358251.3500000009,-5141.399999999965
22050,2022-07-24 09:30:00,1439.31,354549.26000000094,358251.3500000009,-3702.0899999999674
22051,2022-07-24 09:35:00,586.73,355135.9900000009,358251.3500000009,-3115.359999999986
22052,2022-07-24 09:40:00,1599.01,356735.00000000093,358251.3500000009,-1516.3499999999767
22053,2022-07-24 09:45:00,450.68,357185.6800000009,358251.3500000009,-1065.6699999999837
22054,2022-07-24 09:50:00,1198.27,358383.95000000094,358251.3500000009,132.60000000003492
22055,2022-07-24 09:55:00,1790.9,360174.85000000097,358251.3500000009,1923.5000000000582
22056,2022-07-24 10:00:00,1389.7,361564.550000001,358251.3500000009,3313.20000000007
22057,2022-07-24 10:05:00,872.06,362436.610000001,358251.3500000009,4185.2600000000675
22058,2022-07-24 10:10:00,650.93,363087.54000000097,358251.3500000009,4836.1900000000605
22059,2022-07-24 10:15:00,-967.03,362120.51000000094,358251.3500000009,3869.1600000000326
22060,2022-07-24 10:20:00,-1342.23,360778.28000000096,358251.3500000009,2526.930000000051
22061,2022-07-24 10:25:00,598.94,361377.22000000096,358251.3500000009,3125.8700000000536
22062,2022-07-24 10:30:00,1758.35,363135.57000000094,358251.3500000009,4884.22000000003
22063,2022-07-24 10:35:00,1676.75,364812.32000000094,358251.3500000009,6560.97000000003
22064,2022-07-24 10:40:00,-887.47,363924.85000000097,358251.3500000009,5673.500000000058
22065,2022-07-24 10:45:00,-75.63,363849.22000000096,358251.3500000009,5597.870000000054
22066,2022-07-24 10:50:00,459.51,364308.730000001,358251.3500000009,6057.380000000063
22067,2022-07-24 10:55:00,1137.26,365445.990000001,358251.3500000009,7194.640000000072
22068,2022-07-24 11:00:00,-270.59,365175.40000000095,358251.3500000009,6924.050000000047
22069,2022-07-24 11:05:00,1103.02,366278.420000001,358251.3500000009,8027.070000000065
22070,2022-07-24 11:10:00,444.85,366723.27000000095,358251.3500000009,8471.920000000042
22071,2022-07-24 11:15:00,-1955.16,364768.110000001,358251.3500000009,6516.7600000000675
22072,2022-07-24 11:20:00,-350.55,364417.560000001,358251.3500000009,6166.210000000079
22073,2022-07-24 11:25:00,-1334.49,363083.070000001,358251.3500000009,4831.7200000000885
22074,2022-07-24 11:30:00,-816.97,362266.100000001,358251.3500000009,4014.7500000001164
22075,2022-07-24 11:35:00,1481.14,363747.24000000104,358251.3500000009,5495.89000000013
22076,2022-07-24 11:40:00,-1542.64,362204.600000001,358251.3500000009,3953.2500000001164
22077,2022-07-24 11:45:00,-1476.46,360728.140000001,358251.3500000009,2476.7900000000955
22078,2022-07-24 11:50:00,-1229.3,359498.840000001,358251.3500000009,1247.490000000107
22079,2022-07-24 11:55:00,-1720.58,357778.260000001,358251.3500000009,-473.0899999999092
22080,2022-07-24 12:00:00,1536.36,359314.620000001,358251.3500000009,1063.2700000000768
22081,2022-07-24 12:05:00,-1139.58,358175.04000000097,358251.3500000009,-76.30999999993946
22082,2022-07-24 12:10:00,-763.97,357411.070000001,358251.3500000009,-840.2799999999115
22083,2022-07-24 12:15:00,-246.81,357164.260000001,358251.3500000009,-1087.0899999999092
22084,2022-07-24 12:20:00,1586.83,358751.090000001,358251.3500000009,499.7400000001071
22085,2022-07-24 12:25:00,-718.92,358032.17000000103,358251.3500000009,-219.1799999998766
22086,2022-07-24 12:30:00,1664.3,359696.470000001,358251.3500000009,1445.1200000001118
22087,2022-07-24 12:35:00,-1652.99,358043.48000000103,358251.3500000009,-207.86999999987893
22088,2022-07-24 12:40:00,408.76,358452.24000000104,358251.3500000009,200.89000000013039
22089,2022-07-24 12:45:00,-1462.06,356990.18000000104,358251.3500000009,-1261.1699999998673
22090,2022-07-24 12:50:00,270.06,357260.24000000104,358251.3500000009,-991.1099999998696
22091,2022-07-24 12:55:00,253.81,357514.05000000104,358251.3500000009,-737.2999999998719
22092,2022-07-24 13:00:00,1549.21,359063.26000000106,358251.3500000009,811.910000000149
22093,2022-07-24 13:05:00,-1391.33,357671.93000000104,358251.3500000009,-579.4199999998673
22094,2022-07-24 13:10:00,-496.32,357175.61000000103,358251.3500000009,-1075.7399999998743
22095,2022-07-24 13:15:00,1164.13,358339.74000000104,358251.3500000009,88.39000000013039
22096,2022-07-24 13:20:00,417.48,358757.220000001,358251.3500000009,505.87000000011176
22097,2022-07-24 13:25:00,-1617.02,357140.200000001,358251.3500000009,-1111.1499999999069
22098,2022-07-24 13:30:00,1470.43,358610.630000001,358251.3500000009,359.28000000008615
22099,2022-07-24 13:35:00,1044.63,359655.260000001,358251.3500000009,1403.9100000000908
22100,2022-07-24 13:40:00,468.66,360123.920000001,358251.3500000009,1872.5700000000652
22101,2022-07-24 13:45:00,1333.19,361457.110000001,358251.3500000009,3205.7600000000675
22102,2022-07-24 13:50:00,-608.88,360848.230000001,358251.3500000009,2596.880000000063
22103,2022-07-24 13:55:00,-1377.77,359470.46000000095,358251.3500000009,1219.1100000000442
22104,2022-07-24 14:00:00,-460.82,359009.64000000095,358251.3500000009,758.2900000000373
22105,2022-07-24 14:05:00,752.67,359762.3100000009,358251.3500000009,1510.960000000021
22106,2022-07-24 14:10:00,1706.99,361469.3000000009,358251.3500000009,3217.9500000000116
22107,2022-07-24 14:15:00,1701.03,363170.33000000095,358251.3500000009,4918.98000000004
22108,2022-07-24 14:20:00,-1114.58,362055.75000000093,358251.3500000009,3804.4000000000233
22109,2022-07-24 14:25:00,153.54,362209.2900000009,358251.3500000009,3957.9400000000023
22110,2022-07-24 14:30:00,-1203.09,361006.2000000009,358251.3500000009,2754.8499999999767
22111,2022-07-24 14:35:00,1218.46,362224.6600000009,358251.3500000009,3973.3099999999977
22112,2022-07-24 14:40:00,-1242.95,360981.7100000009,358251.3500000009,2730.359999999986
22113,2022-07-24 14:45:00,720.93,361702.6400000009,358251.3500000009,3451.289999999979
22114,2022-07-24 14:50:00,-1161.41,360541.2300000009,358251.3500000009,2289.8800000000047
22115,2022-07-24 14:55:00,1344.93,361886.1600000009,358251.3500000009,3634.8099999999977
22116,2022-07-24 15:00:00,-833.17,361052.9900000009,358251.3500000009,2801.640000000014
22117,2022-07-24 15:05:00,589.62,361642.6100000009,358251.3500000009,3391.2600000000093
22118,2022-07-24 15:10:00,-125.41,361517.20000000094,358251.3500000009,3265.850000000035
22119,2022-07-24 15:15:00,1407.79,362924.9900000009,358251.3500000009,4673.640000000014
22120,2022-07-24 15:20:00,-1038.44,361886.5500000009,358251.3500000009,3635.2000000000116
22121,2022-07-24 15:25:00,975.46,362862.01000000094,358251.3500000009,4610.660000000033
22122,2022-07-24 15:30:00,1398.24,364260.25000000093,358251.3500000009,6008.900000000023
22123,2022-07-24 15:35:00,-1243.5,363016.75000000093,358251.3500000009,4765.400000000023
22124,2022-07-24 15:40:00,-1088.24,361928.51000000094,358251.3500000009,3677.1600000000326
22125,2022-07-24 15:45:00,-974.41,360954.10000000097,358251.3500000009,2702.750000000058
22126,2022-07-24 15:50:00,1045.37,361999.47000000096,358251.3500000009,3748.1200000000536
22127,2022-07-24 15:55:00,-66.17,361933.300000001,358251.3500000009,3681.95000000007
22128,2022-07-24 16:00:00,624.56,362557.860000001,358251.3500000009,4306.5100000000675
22129,2022-07-24 16:05:00,-54.42,362503.440000001,358251.3500000009,4252.090000000084
22130,2022-07-24 16:10:00,-1688.41,360815.030000001,358251.3500000009,2563.6800000001094
22131,2022-07-24 16:15:00,-1194.32,359620.710000001,358251.3500000009,1369.3600000001024
22132,2022-07-24 16:20:00,-626.15,358994.560000001,358251.3500000009,743.2100000000792
22133,2022-07-24 16:25:00,-1970.39,357024.170000001,358251.3500000009,-1227.1799999999348
22134,2022-07-24 16:30:00,-250.69,356773.480000001,358251.3500000009,-1477.8699999999371
22135,2022-07-24 16:35:00,-71.62,356701.860000001,358251.3500000009,-1549.4899999999325
22136,2022-07-24 16:40:00,463.94,357165.800000001,358251.3500000009,-1085.5499999999302
22137,2022-07-24 16:45:00,1597.64,358763.440000001,358251.3500000009,512.0900000000838
22138,2022-07-24 16:50:00,-156.85,358606.590000001,358251.3500000009,355.2400000001071
22139,2022-07-24 16:55:00,-849.93,357756.660000001,358251.3500000009,-494.6899999998859
22140,2022-07-25 08:00:00,-1025.26,356731.400000001,357756.660000001,-1025.2600000000093
22141,2022-07-25 08:05:00,-1232.56,355498.840000001,357756.660000001,-2257.820000000007
22142,2022-07-25 08:10:00,-199.12,355299.720000001,357756.660000001,-2456.9400000000023
22143,2022-07-25 08:15:00,-921.06,354378.660000001,357756.660000001,-3378.0
22144,2022-07-25 08:20:00,1516.84,355895.50000000105,357756.660000001,-1861.1599999999744
22145,2022-07-25 08:25:00,1322.94,357218.44000000105,357756.660000001,-538.2199999999721
22146,2022-07-25 08:30:00,-938.69,356279.75000000105,357756.660000001,-1476.9099999999744
22147,2022-07-25 08:35:00,-1514.71,354765.040000001,357756.660000001,-2991.6199999999953
22148,2022-07-25 08:40:00,183.55,354948.590000001,357756.660000001,-2808.070000000007
22149,2022-07-25 08:45:00,-1962.21,352986.380000001,357756.660000001,-4770.280000000028
22150,2022-07-25 08:50:00,59.84,353046.220000001,357756.660000001,-4710.440000000002
22151,2022-07-25 08:55:00,166.08,353212.30000000104,357756.660000001,-4544.359999999986
22152,2022-07-25 09:00:00,222.43,353434.73000000103,357756.660000001,-4321.929999999993
22153,2022-07-25 09:05:00,7.39,353442.12000000104,357756.660000001,-4314.539999999979
22154,2022-07-25 09:10:00,843.84,354285.96000000107,357756.660000001,-3470.6999999999534
22155,2022-07-25 09:15:00,1434.72,355720.68000000104,357756.660000001,-2035.9799999999814
22156,2022-07-25 09:20:00,1772.92,357493.600000001,357756.660000001,-263.0599999999977
22157,2022-07-25 09:25:00,-1536.66,355956.94000000105,357756.660000001,-1799.719999999972
22158,2022-07-25 09:30:00,1478.91,357435.850000001,357756.660000001,-320.8099999999977
22159,2022-07-25 09:35:00,-1877.77,355558.080000001,357756.660000001,-2198.5800000000163
22160,2022-07-25 09:40:00,1846.53,357404.61000000103,357756.660000001,-352.04999999998836
22161,2022-07-25 09:45:00,1350.73,358755.340000001,357756.660000001,998.679999999993
22162,2022-07-25 09:50:00,1189.86,359945.200000001,357756.660000001,2188.539999999979
22163,2022-07-25 09:55:00,-1450.59,358494.610000001,357756.660000001,737.9499999999534
22164,2022-07-25 10:00:00,-1562.65,356931.96000000095,357756.660000001,-824.7000000000698
22165,2022-07-25 10:05:00,1380.14,358312.10000000097,357756.660000001,555.4399999999441
22166,2022-07-25 10:10:00,258.21,358570.310000001,357756.660000001,813.6499999999651
22167,2022-07-25 10:15:00,205.68,358775.990000001,357756.660000001,1019.3299999999581
22168,2022-07-25 10:20:00,-711.52,358064.47000000096,357756.660000001,307.80999999993946
22169,2022-07-25 10:25:00,-1030.51,357033.96000000095,357756.660000001,-722.7000000000698
22170,2022-07-25 10:30:00,-716.42,356317.54000000097,357756.660000001,-1439.1200000000536
22171,2022-07-25 10:35:00,36.2,356353.740000001,357756.660000001,-1402.920000000042
22172,2022-07-25 10:40:00,-1411.62,354942.120000001,357756.660000001,-2814.5400000000373
22173,2022-07-25 10:45:00,-347.73,354594.390000001,357756.660000001,-3162.2700000000186
22174,2022-07-25 10:50:00,1357.01,355951.400000001,357756.660000001,-1805.2600000000093
22175,2022-07-25 10:55:00,847.31,356798.710000001,357756.660000001,-957.9500000000116
22176,2022-07-25 11:00:00,-1141.92,355656.790000001,357756.660000001,-2099.8699999999953
22177,2022-07-25 11:05:00,1369.22,357026.010000001,357756.660000001,-730.6500000000233
22178,2022-07-25 11:10:00,-1327.69,355698.320000001,357756.660000001,-2058.3400000000256
22179,2022-07-25 11:15:00,-138.35,355559.970000001,357756.660000001,-2196.6900000000023
22180,2022-07-25 11:20:00,1489.27,357049.24000000104,357756.660000001,-707.4199999999837
22181,2022-07-25 11:25:00,-1821.54,355227.70000000106,357756.660000001,-2528.9599999999627
22182,2022-07-25 11:30:00,-1331.99,353895.71000000107,357756.660000001,-3860.9499999999534
22183,2022-07-25 11:35:00,1899.84,355795.5500000011,357756.660000001,-1961.1099999999278
22184,2022-07-25 11:40:00,1948.29,357743.8400000011,357756.660000001,-12.819999999948777
22185,2022-07-25 11:45:00,-1515.25,356228.5900000011,357756.660000001,-1528.0699999999488
22186,2022-07-25 11:50:00,-1462.06,354766.5300000011,357756.660000001,-2990.1299999999464
22187,2022-07-25 11:55:00,1959.02,356725.5500000011,357756.660000001,-1031.1099999999278
22188,2022-07-25 12:00:00,1125.97,357851.52000000107,357756.660000001,94.86000000004424
22189,2022-07-25 12:05:00,-1831.75,356019.77000000107,357756.660000001,-1736.8899999999558
22190,2022-07-25 12:10:00,-785.97,355233.8000000011,357756.660000001,-2522.859999999928
22191,2022-07-25 12:15:00,-342.57,354891.2300000011,357756.660000001,-2865.429999999935
22192,2022-07-25 12:20:00,-141.43,354749.8000000011,357756.660000001,-3006.859999999928
22193,2022-07-25 12:25:00,1962.33,356712.1300000011,357756.660000001,-1044.5299999999115
22194,2022-07-25 12:30:00,1257.55,357969.6800000011,357756.660000001,213.02000000007683
22195,2022-07-25 12:35:00,1483.01,359452.6900000011,357756.660000001,1696.0300000000861
22196,2022-07-25 12:40:00,1180.39,360633.0800000011,357756.660000001,2876.4200000001
22197,2022-07-25 12:45:00,-403.02,360230.0600000011,357756.660000001,2473.4000000000815
22198,2022-07-25 12:50:00,-1260.2,358969.8600000011,357756.660000001,1213.2000000000698
22199,2022-07-25 12:55:00,844.29,359814.1500000011,357756.660000001,2057.490000000049
22200,2022-07-25 13:00:00,885.47,360699.62000000104,357756.660000001,2942.960000000021
22201,2022-07-25 13:05:00,-1787.77,358911.850000001,357756.660000001,1155.1900000000023
22202,2022-07-25 13:10:00,-481.65,358430.200000001,357756.660000001,673.539999999979
22203,2022-07-25 13:15:00,530.26,358960.460000001,357756.660000001,1203.7999999999884
22204,2022-07-25 13:20:00,-1471.47,357488.99000000104,357756.660000001,-267.6699999999837
22205,2022-07-25 13:25:00,-218.52,357270.470000001,357756.660000001,-486.1900000000023
22206,2022-07-25 13:30:00,-323.68,356946.790000001,357756.660000001,-809.8699999999953
22207,2022-07-25 13:35:00,-1161.53,355785.260000001,357756.660000001,-1971.4000000000233
22208,2022-07-25 13:40:00,-170.42,355614.840000001,357756.660000001,-2141.820000000007
22209,2022-07-25 13:45:00,-1979.69,353635.150000001,357756.660000001,-4121.510000000009
22210,2022-07-25 13:50:00,952.22,354587.370000001,357756.660000001,-3169.2900000000373
22211,2022-07-25 13:55:00,-133.95,354453.420000001,357756.660000001,-3303.240000000049
22212,2022-07-25 14:00:00,-1234.34,353219.08000000095,357756.660000001,-4537.5800000000745
22213,2022-07-25 14:05:00,728.53,353947.610000001,357756.660000001,-3809.0500000000466
22214,2022-07-25 14:10:00,-273.08,353674.53000000096,357756.660000001,-4082.130000000063
22215,2022-07-25 14:15:00,-395.54,353278.990000001,357756.660000001,-4477.670000000042
22216,2022-07-25 14:20:00,-1642.36,351636.630000001,357756.660000001,-6120.030000000028
22217,2022-07-25 14:25:00,1138.18,352774.810000001,357756.660000001,-4981.850000000035
22218,2022-07-25 14:30:00,1606.51,354381.320000001,357756.660000001,-3375.3400000000256
22219,2022-07-25 14:35:00,1667.2,356048.520000001,357756.660000001,-1708.140000000014
22220,2022-07-25 14:40:00,-277.97,355770.55000000104,357756.660000001,-1986.109999999986
22221,2022-07-25 14:45:00,1727.23,357497.780000001,357756.660000001,-258.88000000000466
22222,2022-07-25 14:50:00,-1674.07,355823.710000001,357756.660000001,-1932.9500000000116
22223,2022-07-25 14:55:00,-1624.43,354199.280000001,357756.660000001,-3557.3800000000047
22224,2022-07-25 15:00:00,252.94,354452.220000001,357756.660000001,-3304.4400000000023
22225,2022-07-25 15:05:00,-1103.95,353348.270000001,357756.660000001,-4408.390000000014
22226,2022-07-25 15:10:00,-816.24,352532.030000001,357756.660000001,-5224.630000000005
22227,2022-07-25 15:15:00,-1627.43,350904.600000001,357756.660000001,-6852.059999999998
22228,2022-07-25 15:20:00,777.62,351682.220000001,357756.660000001,-6074.440000000002
22229,2022-07-25 15:25:00,1280.31,352962.530000001,357756.660000001,-4794.130000000005
22230,2022-07-25 15:30:00,-480.27,352482.260000001,357756.660000001,-5274.400000000023
22231,2022-07-25 15:35:00,-1828.75,350653.510000001,357756.660000001,-7103.150000000023
22232,2022-07-25 15:40:00,-821.65,349831.860000001,357756.660000001,-7924.800000000047
22233,2022-07-25 15:45:00,-803.49,349028.370000001,357756.660000001,-8728.290000000037
22234,2022-07-25 15:50:00,246.57,349274.940000001,357756.660000001,-8481.72000000003
22235,2022-07-25 15:55:00,1591.42,350866.360000001,357756.660000001,-6890.300000000047
22236,2022-07-25 16:00:00,-333.23,350533.130000001,357756.660000001,-7223.530000000028
22237,2022-07-25 16:05:00,-1934.32,348598.810000001,357756.660000001,-9157.850000000035
22238,2022-07-25 16:10:00,-1626.29,346972.520000001,357756.660000001,-10784.140000000014
22239,2022-07-25 16:15:00,1630.86,348603.380000001,357756.660000001,-9153.280000000028
22240,2022-07-25 16:20:00,-1483.98,347119.400000001,357756.660000001,-10637.26000000001
22241,2022-07-25 16:25:00,316.03,347435.43000000104,357756.660000001,-10321.229999999981
22242,2022-07-25 16:30:00,1086.15,348521.58000000106,357756.660000001,-9235.079999999958
22243,2022-07-25 16:35:00,354.6,348876.18000000104,357756.660000001,-8880.479999999981
22244,2022-07-25 16:40:00,-1160.16,347716.02000000107,357756.660000001,-10040.639999999956
22245,2022-07-25 16:45:00,125.65,347841.6700000011,357756.660000001,-9914.989999999932
22246,2022-07-25 16:50:00,-651.57,347190.1000000011,357756.660000001,-10566.55999999994
22247,2022-07-25 16:55:00,1597.44,348787.5400000011,357756.660000001,-8969.119999999937
22248,2022-07-26 08:00:00,1801.29,350588.83000000106,348787.5400000011,1801.289999999979
22249,2022-07-26 08:05:00,-1936.63,348652.20000000106,348787.5400000011,-135.3400000000256
22250,2022-07-26 08:10:00,-820.92,347831.2800000011,348787.5400000011,-956.2600000000093
22251,2022-07-26 08:15:00,1078.88,348910.1600000011,348787.5400000011,122.61999999999534
22252,2022-07-26 08:20:00,-344.79,348565.3700000011,348787.5400000011,-222.1699999999837
22253,2022-07-26 08:25:00,-1018.57,347546.8000000011,348787.5400000011,-1240.7399999999907
22254,2022-07-26 08:30:00,-1967.46,345579.3400000011,348787.5400000011,-3208.2000000000116
22255,2022-07-26 08:35:00,1183.91,346763.25000000105,348787.5400000011,-2024.2900000000373
22256,2022-07-26 08:40:00,1288.11,348051.36000000103,348787.5400000011,-736.1800000000512
22257,2022-07-26 08:45:00,-1732.35,346319.01000000106,348787.5400000011,-2468.530000000028
22258,2022-07-26 08:50:00,1328.1,347647.11000000103,348787.5400000011,-1140.4300000000512
22259,2022-07-26 08:55:00,1990.83,349637.94000000105,348787.5400000011,850.3999999999651
22260,2022-07-26 09:00:00,-1139.7,348498.24000000104,348787.5400000011,-289.30000000004657
22261,2022-07-26 09:05:00,1238.42,349736.660000001,348787.5400000011,949.1199999999371
22262,2022-07-26 09:10:00,805.11,350541.770000001,348787.5400000011,1754.2299999999232
22263,2022-07-26 09:15:00,643.11,351184.880000001,348787.5400000011,2397.339999999909
22264,2022-07-26 09:20:00,108.5,351293.380000001,348787.5400000011,2505.839999999909
22265,2022-07-26 09:25:00,-1543.64,349749.740000001,348787.5400000011,962.1999999998952
22266,2022-07-26 09:30:00,-38.35,349711.390000001,348787.5400000011,923.8499999999185
22267,2022-07-26 09:35:00,459.75,350171.140000001,348787.5400000011,1383.5999999999185
22268,2022-07-26 09:40:00,869.9,351041.040000001,348787.5400000011,2253.499999999942
22269,2022-07-26 09:45:00,1697.11,352738.150000001,348787.5400000011,3950.609999999928
22270,2022-07-26 09:50:00,36.19,352774.340000001,348787.5400000011,3986.79999999993
22271,2022-07-26 09:55:00,538.73,353313.070000001,348787.5400000011,4525.5299999999115
22272,2022-07-26 10:00:00,-199.67,353113.400000001,348787.5400000011,4325.859999999928
22273,2022-07-26 10:05:00,238.51,353351.910000001,348787.5400000011,4564.369999999937
22274,2022-07-26 10:10:00,-1143.37,352208.540000001,348787.5400000011,3420.999999999942
22275,2022-07-26 10:15:00,-1052.3,351156.24000000104,348787.5400000011,2368.6999999999534
22276,2022-07-26 10:20:00,622.8,351779.040000001,348787.5400000011,2991.499999999942
22277,2022-07-26 10:25:00,587.98,352367.020000001,348787.5400000011,3579.479999999923
22278,2022-07-26 10:30:00,663.91,353030.930000001,348787.5400000011,4243.389999999898
22279,2022-07-26 10:35:00,386.26,353417.190000001,348787.5400000011,4629.649999999907
22280,2022-07-26 10:40:00,1738.09,355155.280000001,348787.5400000011,6367.7399999999325
22281,2022-07-26 10:45:00,664.96,355820.24000000104,348787.5400000011,7032.699999999953
22282,2022-07-26 10:50:00,511.43,356331.67000000103,348787.5400000011,7544.129999999946
22283,2022-07-26 10:55:00,379.55,356711.220000001,348787.5400000011,7923.679999999935
22284,2022-07-26 11:00:00,359.23,357070.450000001,348787.5400000011,8282.909999999916
22285,2022-07-26 11:05:00,704.22,357774.670000001,348787.5400000011,8987.129999999888
22286,2022-07-26 11:10:00,1974.83,359749.500000001,348787.5400000011,10961.959999999905
22287,2022-07-26 11:15:00,-1664.34,358085.16000000096,348787.5400000011,9297.619999999879
22288,2022-07-26 11:20:00,-1037.33,357047.83000000095,348787.5400000011,8260.289999999863
22289,2022-07-26 11:25:00,-292.2,356755.63000000094,348787.5400000011,7968.089999999851
22290,2022-07-26 11:30:00,-393.28,356362.3500000009,348787.5400000011,7574.809999999823
22291,2022-07-26 11:35:00,-1124.43,355237.9200000009,348787.5400000011,6450.37999999983
22292,2022-07-26 11:40:00,844.7,356082.6200000009,348787.5400000011,7295.079999999842
22293,2022-07-26 11:45:00,-160.93,355921.69000000093,348787.5400000011,7134.149999999849
22294,2022-07-26 11:50:00,-92.47,355829.22000000096,348787.5400000011,7041.679999999877
22295,2022-07-26 11:55:00,-1683.81,354145.41000000096,348787.5400000011,5357.869999999879
22296,2022-07-26 12:00:00,1653.21,355798.620000001,348787.5400000011,7011.0799999999
22297,2022-07-26 12:05:00,-1586.97,354211.650000001,348787.5400000011,5424.109999999928
22298,2022-07-26 12:10:00,-1714.1,352497.55000000104,348787.5400000011,3710.009999999951
22299,2022-07-26 12:15:00,-1865.87,350631.68000000104,348787.5400000011,1844.1399999999558
22300,2022-07-26 12:20:00,505.07,351136.75000000105,348787.5400000011,2349.2099999999627
22301,2022-07-26 12:25:00,-249.88,350886.87000000104,348787.5400000011,2099.329999999958
22302,2022-07-26 12:30:00,1603.24,352490.11000000103,348787.5400000011,3702.569999999949
22303,2022-07-26 12:35:00,-1417.16,351072.95000000106,348787.5400000011,2285.4099999999744
22304,2022-07-26 12:40:00,-686.54,350386.4100000011,348787.5400000011,1598.8699999999953
22305,2022-07-26 12:45:00,143.71,350530.1200000011,348787.5400000011,1742.5800000000163
22306,2022-07-26 12:50:00,1557.86,352087.9800000011,348787.5400000011,3300.4400000000023
22307,2022-07-26 12:55:00,548.76,352636.7400000011,348787.5400000011,3849.2000000000116
22308,2022-07-26 13:00:00,260.45,352897.1900000011,348787.5400000011,4109.650000000023
22309,2022-07-26 13:05:00,538.47,353435.6600000011,348787.5400000011,4648.119999999995
22310,2022-07-26 13:10:00,1506.08,354941.7400000011,348787.5400000011,6154.200000000012
22311,2022-07-26 13:15:00,-1382.89,353558.8500000011,348787.5400000011,4771.309999999998
22312,2022-07-26 13:20:00,-32.75,353526.1000000011,348787.5400000011,4738.559999999998
22313,2022-07-26 13:25:00,-1962.87,351563.2300000011,348787.5400000011,2775.6900000000023
22314,2022-07-26 13:30:00,-24.18,351539.0500000011,348787.5400000011,2751.5100000000093
22315,2022-07-26 13:35:00,942.41,352481.46000000107,348787.5400000011,3693.9199999999837
22316,2022-07-26 13:40:00,-575.11,351906.3500000011,348787.5400000011,3118.8099999999977
22317,2022-07-26 13:45:00,332.87,352239.2200000011,348787.5400000011,3451.679999999993
22318,2022-07-26 13:50:00,-1017.26,351221.96000000107,348787.5400000011,2434.4199999999837
22319,2022-07-26 13:55:00,-1086.91,350135.0500000011,348787.5400000011,1347.5100000000093
22320,2022-07-26 14:00:00,338.75,350473.8000000011,348787.5400000011,1686.2600000000093
22321,2022-07-26 14:05:00,-1622.69,348851.1100000011,348787.5400000011,63.570000000006985
22322,2022-07-26 14:10:00,-1476.55,347374.5600000011,348787.5400000011,-1412.9799999999814
22323,2022-07-26 14:15:00,-1275.38,346099.1800000011,348787.5400000011,-2688.359999999986
22324,2022-07-26 14:20:00,-1429.82,344669.3600000011,348787.5400000011,-4118.179999999993
22325,2022-07-26 14:25:00,1236.6,345905.96000000107,348787.5400000011,-2881.5800000000163
22326,2022-07-26 14:30:00,-794.39,345111.57000000105,348787.5400000011,-3675.9700000000303
22327,2022-07-26 14:35:00,-1893.56,343218.01000000106,348787.5400000011,-5569.530000000028
22328,2022-07-26 14:40:00,-1282.62,341935.39000000106,348787.5400000011,-6852.150000000023
22329,2022-07-26 14:45:00,-727.56,341207.83000000106,348787.5400000011,-7579.710000000021
22330,2022-07-26 14:50:00,962.52,342170.3500000011,348787.5400000011,-6617.190000000002
22331,2022-07-26 14:55:00,938.5,343108.8500000011,348787.5400000011,-5678.690000000002
22332,2022-07-26 15:00:00,-247.05,342861.8000000011,348787.5400000011,-5925.739999999991
22333,2022-07-26 15:05:00,-1606.0,341255.8000000011,348787.5400000011,-7531.739999999991
22334,2022-07-26 15:10:00,119.45,341375.2500000011,348787.5400000011,-7412.289999999979
22335,2022-07-26 15:15:00,-1788.93,339586.3200000011,348787.5400000011,-9201.219999999972
22336,2022-07-26 15:20:00,1014.64,340600.9600000011,348787.5400000011,-8186.579999999958
22337,2022-07-26 15:25:00,1806.91,342407.8700000011,348787.5400000011,-6379.669999999984
22338,2022-07-26 15:30:00,204.54,342612.4100000011,348787.5400000011,-6175.130000000005
22339,2022-07-26 15:35:00,-655.08,341957.33000000106,348787.5400000011,-6830.210000000021
22340,2022-07-26 15:40:00,783.44,342740.77000000107,348787.5400000011,-6046.770000000019
22341,2022-07-26 15:45:00,-66.95,342673.82000000105,348787.5400000011,-6113.72000000003
22342,2022-07-26 15:50:00,1980.62,344654.44000000105,348787.5400000011,-4133.100000000035
22343,2022-07-26 15:55:00,-1889.85,342764.5900000011,348787.5400000011,-6022.950000000012
22344,2022-07-26 16:00:00,401.94,343166.5300000011,348787.5400000011,-5621.010000000009
22345,2022-07-26 16:05:00,-338.65,342827.88000000105,348787.5400000011,-5959.660000000033
22346,2022-07-26 16:10:00,-36.51,342791.37000000104,348787.5400000011,-5996.170000000042
22347,2022-07-26 16:15:00,-933.04,341858.33000000106,348787.5400000011,-6929.210000000021
22348,2022-07-26 16:20:00,-236.56,341621.77000000107,348787.5400000011,-7165.770000000019
22349,2022-07-26 16:25:00,-1654.83,339966.94000000105,348787.5400000011,-8820.600000000035
22350,2022-07-26 16:30:00,-441.4,339525.540000001,348787.5400000011,-9262.000000000058
22351,2022-07-26 16:35:00,-544.64,338980.900000001,348787.5400000011,-9806.640000000072
22352,2022-07-26 16:40:00,-291.17,338689.73000000103,348787.5400000011,-10097.810000000056
22353,2022-07-26 16:45:00,-216.27,338473.460000001,348787.5400000011,-10314.080000000075
22354,2022-07-26 16:50:00,-1779.62,336693.840000001,348787.5400000011,-12093.70000000007
22355,2022-07-26 16:55:00,865.83,337559.67000000103,348787.5400000011,-11227.870000000054
22356,2022-07-27 08:00:00,-1643.72,335915.95000000106,337559.67000000103,-1643.719999999972
22357,2022-07-27 08:05:00,336.78,336252.7300000011,337559.67000000103,-1306.9399999999441
22358,2022-07-27 08:10:00,-911.59,335341.14000000106,337559.67000000103,-2218.5299999999697
22359,2022-07-27 08:15:00,-899.04,334442.1000000011,337559.67000000103,-3117.569999999949
22360,2022-07-27 08:20:00,1318.84,335760.9400000011,337559.67000000103,-1798.7299999999232
22361,2022-07-27 08:25:00,1269.72,337030.6600000011,337559.67000000103,-529.0099999999511
22362,2022-07-27 08:30:00,-1504.27,335526.39000000106,337559.67000000103,-2033.2799999999697
22363,2022-07-27 08:35:00,223.14,335749.5300000011,337559.67000000103,-1810.1399999999558
22364,2022-07-27 08:40:00,212.67,335962.20000000106,337559.67000000103,-1597.469999999972
22365,2022-07-27 08:45:00,-590.49,335371.71000000107,337559.67000000103,-2187.9599999999627
22366,2022-07-27 08:50:00,-1468.32,333903.39000000106,337559.67000000103,-3656.2799999999697
22367,2022-07-27 08:55:00,1685.0,335588.39000000106,337559.67000000103,-1971.2799999999697
22368,2022-07-27 09:00:00,-288.4,335299.99000000104,337559.67000000103,-2259.679999999993
22369,2022-07-27 09:05:00,-862.62,334437.37000000104,337559.67000000103,-3122.2999999999884
22370,2022-07-27 09:10:00,1871.56,336308.93000000104,337559.67000000103,-1250.7399999999907
22371,2022-07-27 09:15:00,876.18,337185.11000000103,337559.67000000103,-374.5599999999977
22372,2022-07-27 09:20:00,1762.68,338947.790000001,337559.67000000103,1388.1199999999953
22373,2022-07-27 09:25:00,-802.25,338145.540000001,337559.67000000103,585.8699999999953
22374,2022-07-27 09:30:00,-140.12,338005.42000000103,337559.67000000103,445.75
22375,2022-07-27 09:35:00,-892.86,337112.56000000105,337559.67000000103,-447.10999999998603
22376,2022-07-27 09:40:00,1381.91,338494.470000001,337559.67000000103,934.7999999999884
22377,2022-07-27 09:45:00,1641.83,340136.30000000104,337559.67000000103,2576.6300000000047
22378,2022-07-27 09:50:00,-1206.61,338929.69000000105,337559.67000000103,1370.0200000000186
22379,2022-07-27 09:55:00,-1059.47,337870.2200000011,337559.67000000103,310.55000000004657
22380,2022-07-27 10:00:00,795.63,338665.8500000011,337559.67000000103,1106.1800000000512
22381,2022-07-27 10:05:00,409.52,339075.3700000011,337559.67000000103,1515.7000000000698
22382,2022-07-27 10:10:00,604.7,339680.0700000011,337559.67000000103,2120.4000000000815
22383,2022-07-27 10:15:00,-1364.39,338315.6800000011,337559.67000000103,756.0100000000675
22384,2022-07-27 10:20:00,1198.79,339514.4700000011,337559.67000000103,1954.8000000000466
22385,2022-07-27 10:25:00,1649.71,341164.1800000011,337559.67000000103,3604.5100000000675
22386,2022-07-27 10:30:00,973.55,342137.7300000011,337559.67000000103,4578.060000000056
22387,2022-07-27 10:35:00,1744.31,343882.0400000011,337559.67000000103,6322.370000000054
22388,2022-07-27 10:40:00,215.83,344097.8700000011,337559.67000000103,6538.20000000007
22389,2022-07-27 10:45:00,1184.26,345282.1300000011,337559.67000000103,7722.460000000079
22390,2022-07-27 10:50:00,294.08,345576.2100000011,337559.67000000103,8016.5400000000955
22391,2022-07-27 10:55:00,-516.13,345060.0800000011,337559.67000000103,7500.410000000091
22392,2022-07-27 11:00:00,127.27,345187.35000000114,337559.67000000103,7627.680000000109
22393,2022-07-27 11:05:00,705.93,345893.28000000113,337559.67000000103,8333.610000000102
22394,2022-07-27 11:10:00,927.0,346820.28000000113,337559.67000000103,9260.610000000102
22395,2022-07-27 11:15:00,-1717.76,345102.5200000011,337559.67000000103,7542.850000000093
22396,2022-07-27 11:20:00,-1062.94,344039.5800000011,337559.67000000103,6479.910000000091
22397,2022-07-27 11:25:00,-1913.07,342126.5100000011,337559.67000000103,4566.840000000084
22398,2022-07-27 11:30:00,1036.99,343163.5000000011,337559.67000000103,5603.8300000000745
22399,2022-07-27 11:35:00,-381.12,342782.3800000011,337559.67000000103,5222.710000000079
22400,2022-07-27 11:40:00,-1041.31,341741.0700000011,337559.67000000103,4181.4000000000815
22401,2022-07-27 11:45:00,-1848.23,339892.84000000113,337559.67000000103,2333.1700000001
22402,2022-07-27 11:50:00,-1278.93,338613.91000000114,337559.67000000103,1054.240000000107
22403,2022-07-27 11:55:00,260.08,338873.99000000115,337559.67000000103,1314.3200000001234
22404,2022-07-27 12:00:00,-1643.87,337230.12000000116,337559.67000000103,-329.54999999987194
22405,2022-07-27 12:05:00,-74.27,337155.85000000114,337559.67000000103,-403.81999999989057
22406,2022-07-27 12:10:00,849.62,338005.47000000114,337559.67000000103,445.8000000001048
22407,2022-07-27 12:15:00,1721.41,339726.8800000011,337559.67000000103,2167.210000000079
22408,2022-07-27 12:20:00,-690.2,339036.6800000011,337559.67000000103,1477.0100000000675
22409,2022-07-27 12:25:00,-1067.45,337969.2300000011,337559.67000000103,409.5600000000559
22410,2022-07-27 12:30:00,-1331.45,336637.7800000011,337559.67000000103,-921.8899999999558
22411,2022-07-27 12:35:00,-32.74,336605.0400000011,337559.67000000103,-954.6299999999464
22412,2022-07-27 12:40:00,344.05,336949.0900000011,337559.67000000103,-610.5799999999581
22413,2022-07-27 12:45:00,-1009.43,335939.6600000011,337559.67000000103,-1620.009999999951
22414,2022-07-27 12:50:00,1743.32,337682.9800000011,337559.67000000103,123.31000000005588
22415,2022-07-27 12:55:00,77.02,337760.0000000011,337559.67000000103,200.3300000000745
22416,2022-07-27 13:00:00,-552.54,337207.4600000011,337559.67000000103,-352.20999999990454
22417,2022-07-27 13:05:00,-5.23,337202.23000000115,337559.67000000103,-357.4399999998859
22418,2022-07-27 13:10:00,-1943.2,335259.03000000113,337559.67000000103,-2300.6399999998976
22419,2022-07-27 13:15:00,-1280.43,333978.60000000114,337559.67000000103,-3581.0699999998906
22420,2022-07-27 13:20:00,386.85,334365.4500000011,337559.67000000103,-3194.219999999914
22421,2022-07-27 13:25:00,547.57,334913.0200000011,337559.67000000103,-2646.649999999907
22422,2022-07-27 13:30:00,1912.86,336825.8800000011,337559.67000000103,-733.7899999999208
22423,2022-07-27 13:35:00,-1177.28,335648.6000000011,337559.67000000103,-1911.0699999999488
22424,2022-07-27 13:40:00,189.09,335837.6900000011,337559.67000000103,-1721.9799999999232
22425,2022-07-27 13:45:00,-1389.82,334447.8700000011,337559.67000000103,-3111.79999999993
22426,2022-07-27 13:50:00,1014.62,335462.4900000011,337559.67000000103,-2097.179999999935
22427,2022-07-27 13:55:00,-156.11,335306.3800000011,337559.67000000103,-2253.289999999921
22428,2022-07-27 14:00:00,587.66,335894.0400000011,337559.67000000103,-1665.6299999999464
22429,2022-07-27 14:05:00,483.08,336377.1200000011,337559.67000000103,-1182.5499999999302
22430,2022-07-27 14:10:00,-154.16,336222.9600000011,337559.67000000103,-1336.7099999999045
22431,2022-07-27 14:15:00,-46.66,336176.30000000115,337559.67000000103,-1383.369999999879
22432,2022-07-27 14:20:00,-1581.35,334594.9500000012,337559.67000000103,-2964.7199999998556
22433,2022-07-27 14:25:00,1649.88,336244.8300000012,337559.67000000103,-1314.839999999851
22434,2022-07-27 14:30:00,1609.38,337854.2100000012,337559.67000000103,294.54000000015367
22435,2022-07-27 14:35:00,-712.82,337141.3900000012,337559.67000000103,-418.2799999998533
22436,2022-07-27 14:40:00,1704.12,338845.5100000012,337559.67000000103,1285.840000000142
22437,2022-07-27 14:45:00,-1739.46,337106.05000000115,337559.67000000103,-453.6199999998789
22438,2022-07-27 14:50:00,1209.28,338315.3300000012,337559.67000000103,755.660000000149
22439,2022-07-27 14:55:00,1425.64,339740.9700000012,337559.67000000103,2181.300000000163
22440,2022-07-27 15:00:00,1943.71,341684.6800000012,337559.67000000103,4125.010000000184
22441,2022-07-27 15:05:00,867.79,342552.4700000012,337559.67000000103,4992.800000000163
22442,2022-07-27 15:10:00,1970.34,344522.8100000012,337559.67000000103,6963.140000000189
22443,2022-07-27 15:15:00,194.8,344717.6100000012,337559.67000000103,7157.940000000177
22444,2022-07-27 15:20:00,-1789.38,342928.2300000012,337559.67000000103,5368.560000000172
22445,2022-07-27 15:25:00,-1120.09,341808.1400000012,337559.67000000103,4248.470000000147
22446,2022-07-27 15:30:00,-703.23,341104.9100000012,337559.67000000103,3545.2400000001653
22447,2022-07-27 15:35:00,870.96,341975.8700000012,337559.67000000103,4416.200000000186
22448,2022-07-27 15:40:00,-295.69,341680.1800000012,337559.67000000103,4120.510000000184
22449,2022-07-27 15:45:00,-1785.83,339894.3500000012,337559.67000000103,2334.6800000001676
22450,2022-07-27 15:50:00,1333.39,341227.7400000012,337559.67000000103,3668.0700000001816
22451,2022-07-27 15:55:00,-1348.19,339879.5500000012,337559.67000000103,2319.8800000001793
22452,2022-07-27 16:00:00,-1042.44,338837.1100000012,337559.67000000103,1277.440000000177
22453,2022-07-27 16:05:00,788.55,339625.6600000012,337559.67000000103,2065.9900000001653
22454,2022-07-27 16:10:00,1962.57,341588.2300000012,337559.67000000103,4028.5600000001723
22455,2022-07-27 16:15:00,-1324.33,340263.9000000012,337559.67000000103,2704.230000000156
22456,2022-07-27 16:20:00,515.4,340779.3000000012,337559.67000000103,3219.6300000001793
22457,2022-07-27 16:25:00,-1491.21,339288.0900000012,337559.67000000103,1728.4200000001583
22458,2022-07-27 16:30:00,1365.09,340653.1800000012,337559.67000000103,3093.510000000184
22459,2022-07-27 16:35:00,-382.02,340271.1600000012,337559.67000000103,2711.4900000001653
22460,2022-07-27 16:40:00,-1350.47,338920.6900000012,337559.67000000103,1361.0200000001932
22461,2022-07-27 16:45:00,-322.31,338598.3800000012,337559.67000000103,1038.7100000001956
22462,2022-07-27 16:50:00,-359.2,338239.1800000012,337559.67000000103,679.5100000001839
22463,2022-07-27 16:55:00,1989.35,340228.5300000012,337559.67000000103,2668.8600000001607
22464,2022-07-28 08:00:00,1515.38,341743.9100000012,340228.5300000012,1515.3800000000047
22465,2022-07-28 08:05:00,-1063.76,340680.1500000012,340228.5300000012,451.61999999999534
22466,2022-07-28 08:10:00,1911.75,342591.9000000012,340228.5300000012,2363.3699999999953
22467,2022-07-28 08:15:00,-893.0,341698.9000000012,340228.5300000012,1470.3699999999953
22468,2022-07-28 08:20:00,915.73,342614.63000000117,340228.5300000012,2386.0999999999767
22469,2022-07-28 08:25:00,-479.97,342134.6600000012,340228.5300000012,1906.1300000000047
22470,2022-07-28 08:30:00,-1147.93,340986.7300000012,340228.5300000012,758.2000000000116
22471,2022-07-28 08:35:00,651.51,341638.2400000012,340228.5300000012,1409.710000000021
22472,2022-07-28 08:40:00,-1158.08,340480.1600000012,340228.5300000012,251.63000000000466
22473,2022-07-28 08:45:00,-1973.51,338506.6500000012,340228.5300000012,-1721.8800000000047
22474,2022-07-28 08:50:00,-1807.63,336699.0200000012,340228.5300000012,-3529.5100000000093
22475,2022-07-28 08:55:00,-183.1,336515.9200000012,340228.5300000012,-3712.609999999986
22476,2022-07-28 09:00:00,1047.48,337563.4000000012,340228.5300000012,-2665.1300000000047
22477,2022-07-28 09:05:00,-1254.84,336308.56000000116,340228.5300000012,-3919.9700000000303
22478,2022-07-28 09:10:00,1257.25,337565.81000000116,340228.5300000012,-2662.7200000000303
22479,2022-07-28 09:15:00,-1354.67,336211.1400000012,340228.5300000012,-4017.390000000014
22480,2022-07-28 09:20:00,-442.62,335768.5200000012,340228.5300000012,-4460.010000000009
22481,2022-07-28 09:25:00,-173.13,335595.3900000012,340228.5300000012,-4633.140000000014
22482,2022-07-28 09:30:00,-417.97,335177.4200000012,340228.5300000012,-5051.109999999986
22483,2022-07-28 09:35:00,1478.39,336655.8100000012,340228.5300000012,-3572.719999999972
22484,2022-07-28 09:40:00,210.52,336866.33000000124,340228.5300000012,-3362.1999999999534
22485,2022-07-28 09:45:00,1987.28,338853.61000000127,340228.5300000012,-1374.9199999999255
22486,2022-07-28 09:50:00,-1488.96,337364.65000000125,340228.5300000012,-2863.8799999999464
22487,2022-07-28 09:55:00,-585.52,336779.1300000012,340228.5300000012,-3449.399999999965
22488,2022-07-28 10:00:00,-1892.73,334886.40000000125,340228.5300000012,-5342.129999999946
22489,2022-07-28 10:05:00,1643.99,336530.39000000124,340228.5300000012,-3698.1399999999558
22490,2022-07-28 10:10:00,1632.28,338162.67000000126,340228.5300000012,-2065.859999999928
22491,2022-07-28 10:15:00,-1493.83,336668.84000000125,340228.5300000012,-3559.689999999944
22492,2022-07-28 10:20:00,1558.02,338226.86000000127,340228.5300000012,-2001.6699999999255
22493,2022-07-28 10:25:00,-1520.49,336706.3700000013,340228.5300000012,-3522.159999999916
22494,2022-07-28 10:30:00,-1566.85,335139.5200000013,340228.5300000012,-5089.009999999893
22495,2022-07-28 10:35:00,-346.66,334792.8600000013,340228.5300000012,-5435.669999999867
22496,2022-07-28 10:40:00,-1268.54,333524.32000000135,340228.5300000012,-6704.209999999846
22497,2022-07-28 10:45:00,1933.39,335457.71000000136,340228.5300000012,-4770.819999999832
22498,2022-07-28 10:50:00,1775.71,337233.4200000014,340228.5300000012,-2995.1099999998114
22499,2022-07-28 10:55:00,1410.41,338643.83000000136,340228.5300000012,-1584.699999999837
22500,2022-07-28 11:00:00,1066.13,339709.96000000136,340228.5300000012,-518.5699999998324
22501,2022-07-28 11:05:00,-799.06,338910.90000000136,340228.5300000012,-1317.62999999983
22502,2022-07-28 11:10:00,-1272.82,337638.08000000136,340228.5300000012,-2590.449999999837
22503,2022-07-28 11:15:00,79.24,337717.32000000135,340228.5300000012,-2511.2099999998463
22504,2022-07-28 11:20:00,-1680.47,336036.8500000014,340228.5300000012,-4191.679999999818
22505,2022-07-28 11:25:00,1546.6,337583.45000000135,340228.5300000012,-2645.0799999998417
22506,2022-07-28 11:30:00,-1025.98,336557.47000000137,340228.5300000012,-3671.059999999823
22507,2022-07-28 11:35:00,943.57,337501.0400000014,340228.5300000012,-2727.489999999816
22508,2022-07-28 11:40:00,-1761.11,335739.9300000014,340228.5300000012,-4488.599999999802
22509,2022-07-28 11:45:00,746.86,336486.7900000014,340228.5300000012,-3741.739999999816
22510,2022-07-28 11:50:00,1956.53,338443.3200000014,340228.5300000012,-1785.2099999997881
22511,2022-07-28 11:55:00,769.4,339212.7200000014,340228.5300000012,-1015.8099999997648
22512,2022-07-28 12:00:00,-362.37,338850.35000000143,340228.5300000012,-1378.1799999997602
22513,2022-07-28 12:05:00,518.71,339369.06000000145,340228.5300000012,-859.4699999997392
22514,2022-07-28 12:10:00,1609.48,340978.54000000143,340228.5300000012,750.0100000002421
22515,2022-07-28 12:15:00,-37.06,340941.48000000144,340228.5300000012,712.9500000002445
22516,2022-07-28 12:20:00,-524.19,340417.29000000143,340228.5300000012,188.76000000024214
22517,2022-07-28 12:25:00,-252.31,340164.98000000144,340228.5300000012,-63.54999999975553
22518,2022-07-28 12:30:00,747.27,340912.25000000146,340228.5300000012,683.7200000002631
22519,2022-07-28 12:35:00,92.83,341005.0800000015,340228.5300000012,776.5500000002794
22520,2022-07-28 12:40:00,1400.45,342405.5300000015,340228.5300000012,2177.000000000291
22521,2022-07-28 12:45:00,67.9,342473.4300000015,340228.5300000012,2244.9000000003143
22522,2022-07-28 12:50:00,-433.07,342040.3600000015,340228.5300000012,1811.8300000003073
22523,2022-07-28 12:55:00,566.29,342606.6500000015,340228.5300000012,2378.1200000002864
22524,2022-07-28 13:00:00,-1549.86,341056.7900000015,340228.5300000012,828.2600000003004
22525,2022-07-28 13:05:00,1161.74,342218.5300000015,340228.5300000012,1990.000000000291
22526,2022-07-28 13:10:00,-1327.43,340891.1000000015,340228.5300000012,662.570000000298
22527,2022-07-28 13:15:00,325.11,341216.2100000015,340228.5300000012,987.680000000284
22528,2022-07-28 13:20:00,-638.28,340577.93000000145,340228.5300000012,349.4000000002561
22529,2022-07-28 13:25:00,-1263.41,339314.5200000015,340228.5300000012,-914.0099999997183
22530,2022-07-28 13:30:00,174.71,339489.2300000015,340228.5300000012,-739.2999999996973
22531,2022-07-28 13:35:00,1067.75,340556.9800000015,340228.5300000012,328.4500000003027
22532,2022-07-28 13:40:00,-548.71,340008.2700000015,340228.5300000012,-220.25999999971827
22533,2022-07-28 13:45:00,-904.11,339104.1600000015,340228.5300000012,-1124.3699999997043
22534,2022-07-28 13:50:00,-51.64,339052.5200000015,340228.5300000012,-1176.0099999997183
22535,2022-07-28 13:55:00,-134.51,338918.01000000146,340228.5300000012,-1310.5199999997276
22536,2022-07-28 14:00:00,81.09,338999.1000000015,340228.5300000012,-1229.429999999702
22537,2022-07-28 14:05:00,594.46,339593.5600000015,340228.5300000012,-634.969999999681
22538,2022-07-28 14:10:00,1635.75,341229.3100000015,340228.5300000012,1000.780000000319
22539,2022-07-28 14:15:00,-1605.4,339623.9100000015,340228.5300000012,-604.6199999997043
22540,2022-07-28 14:20:00,201.15,339825.0600000015,340228.5300000012,-403.469999999681
22541,2022-07-28 14:25:00,783.75,340608.8100000015,340228.5300000012,380.280000000319
22542,2022-07-28 14:30:00,-765.79,339843.02000000153,340228.5300000012,-385.50999999966007
22543,2022-07-28 14:35:00,328.84,340171.86000000156,340228.5300000012,-56.669999999634456
22544,2022-07-28 14:40:00,-501.5,339670.36000000156,340228.5300000012,-558.1699999996345
22545,2022-07-28 14:45:00,-1111.11,338559.2500000016,340228.5300000012,-1669.2799999996205
22546,2022-07-28 14:50:00,-1464.26,337094.99000000156,340228.5300000012,-3133.53999999963
22547,2022-07-28 14:55:00,1649.83,338744.8200000016,340228.5300000012,-1483.7099999996135
22548,2022-07-28 15:00:00,1700.11,340444.93000000156,340228.5300000012,216.40000000037253
22549,2022-07-28 15:05:00,1813.95,342258.8800000016,340228.5300000012,2030.3500000003842
22550,2022-07-28 15:10:00,-1183.53,341075.35000000155,340228.5300000012,846.8200000003562
22551,2022-07-28 15:15:00,-1318.29,339757.06000000157,340228.5300000012,-471.4699999996228
22552,2022-07-28 15:20:00,1266.51,341023.5700000016,340228.5300000012,795.0400000003865
22553,2022-07-28 15:25:00,-844.67,340178.9000000016,340228.5300000012,-49.6299999995972
22554,2022-07-28 15:30:00,787.03,340965.9300000016,340228.5300000012,737.4000000004307
22555,2022-07-28 15:35:00,-359.76,340606.1700000016,340228.5300000012,377.6400000004214
22556,2022-07-28 15:40:00,-370.61,340235.5600000016,340228.5300000012,7.030000000435393
22557,2022-07-28 15:45:00,-18.96,340216.6000000016,340228.5300000012,-11.929999999585561
22558,2022-07-28 15:50:00,420.29,340636.8900000016,340228.5300000012,408.3600000003935
22559,2022-07-28 15:55:00,525.07,341161.9600000016,340228.5300000012,933.4300000004005
22560,2022-07-28 16:00:00,-990.36,340171.6000000016,340228.5300000012,-56.92999999958556
22561,2022-07-28 16:05:00,235.67,340407.2700000016,340228.5300000012,178.74000000039814
22562,2022-07-28 16:10:00,486.08,340893.3500000016,340228.5300000012,664.8200000004144
22563,2022-07-28 16:15:00,-1570.9,339322.4500000016,340228.5300000012,-906.0799999996088
22564,2022-07-28 16:20:00,1173.58,340496.0300000016,340228.5300000012,267.50000000040745
22565,2022-07-28 16:25:00,-1532.27,338963.7600000016,340228.5300000012,-1264.7699999996112
22566,2022-07-28 16:30:00,1721.86,340685.62000000157,340228.5300000012,457.09000000037486
22567,2022-07-28 16:35:00,472.17,341157.79000000155,340228.5300000012,929.2600000003586
22568,2022-07-28 16:40:00,1650.3,342808.09000000154,340228.5300000012,2579.560000000347
22569,2022-07-28 16:45:00,1836.78,344644.87000000157,340228.5300000012,4416.340000000375
22570,2022-07-28 16:50:00,-369.99,344274.8800000016,340228.5300000012,4046.350000000384
22571,2022-07-28 16:55:00,-28.58,344246.30000000156,340228.5300000012,4017.770000000368
22572,2022-07-29 08:00:00,1827.27,346073.5700000016,344246.30000000156,1827.2700000000186
22573,2022-07-29 08:05:00,1226.19,347299.7600000016,344246.30000000156,3053.460000000021
22574,2022-07-29 08:10:00,1901.54,349201.30000000156,344246.30000000156,4955.0
22575,2022-07-29 08:15:00,51.79,349253.09000000154,344246.30000000156,5006.789999999979
22576,2022-07-29 08:20:00,1927.8,351180.8900000015,344246.30000000156,6934.589999999967
22577,2022-07-29 08:25:00,-136.82,351044.0700000015,344246.30000000156,6797.76999999996
22578,2022-07-29 08:30:00,852.6,351896.6700000015,344246.30000000156,7650.369999999937
22579,2022-07-29 08:35:00,-278.3,351618.3700000015,344246.30000000156,7372.069999999949
22580,2022-07-29 08:40:00,-1865.06,349753.3100000015,344246.30000000156,5507.009999999951
22581,2022-07-29 08:45:00,-97.2,349656.1100000015,344246.30000000156,5409.8099999999395
22582,2022-07-29 08:50:00,-1249.48,348406.6300000015,344246.30000000156,4160.329999999958
22583,2022-07-29 08:55:00,-736.55,347670.08000000153,344246.30000000156,3423.7799999999697
22584,2022-07-29 09:00:00,1209.75,348879.83000000153,344246.30000000156,4633.52999999997
22585,2022-07-29 09:05:00,-1927.81,346952.02000000153,344246.30000000156,2705.719999999972
22586,2022-07-29 09:10:00,1769.74,348721.7600000015,344246.30000000156,4475.459999999963
22587,2022-07-29 09:15:00,324.76,349046.52000000153,344246.30000000156,4800.219999999972
22588,2022-07-29 09:20:00,1913.29,350959.8100000015,344246.30000000156,6713.509999999951
22589,2022-07-29 09:25:00,-1880.03,349079.7800000015,344246.30000000156,4833.479999999923
22590,2022-07-29 09:30:00,-303.1,348776.6800000015,344246.30000000156,4530.379999999946
22591,2022-07-29 09:35:00,-552.59,348224.0900000015,344246.30000000156,3977.789999999921
22592,2022-07-29 09:40:00,1901.09,350125.1800000015,344246.30000000156,5878.879999999946
22593,2022-07-29 09:45:00,-339.16,349786.02000000153,344246.30000000156,5539.719999999972
22594,2022-07-29 09:50:00,985.71,350771.73000000155,344246.30000000156,6525.429999999993
22595,2022-07-29 09:55:00,-692.33,350079.40000000154,344246.30000000156,5833.099999999977
22596,2022-07-29 10:00:00,1455.55,351534.9500000015,344246.30000000156,7288.649999999965
22597,2022-07-29 10:05:00,1427.89,352962.84000000154,344246.30000000156,8716.539999999979
22598,2022-07-29 10:10:00,853.3,353816.1400000015,344246.30000000156,9569.839999999967
22599,2022-07-29 10:15:00,1799.43,355615.5700000015,344246.30000000156,11369.26999999996
22600,2022-07-29 10:20:00,-835.17,354780.40000000154,344246.30000000156,10534.099999999977
22601,2022-07-29 10:25:00,1767.8,356548.2000000015,344246.30000000156,12301.899999999965
22602,2022-07-29 10:30:00,399.55,356947.7500000015,344246.30000000156,12701.449999999953
22603,2022-07-29 10:35:00,-1593.77,355353.9800000015,344246.30000000156,11107.679999999935
22604,2022-07-29 10:40:00,642.22,355996.20000000147,344246.30000000156,11749.899999999907
22605,2022-07-29 10:45:00,560.0,356556.20000000147,344246.30000000156,12309.899999999907
22606,2022-07-29 10:50:00,1943.54,358499.74000000145,344246.30000000156,14253.439999999886
22607,2022-07-29 10:55:00,-1518.71,356981.0300000014,344246.30000000156,12734.729999999865
22608,2022-07-29 11:00:00,-1280.36,355700.67000000144,344246.30000000156,11454.369999999879
22609,2022-07-29 11:05:00,-1802.83,353897.8400000014,344246.30000000156,9651.539999999863
22610,2022-07-29 11:10:00,1680.77,355578.61000000144,344246.30000000156,11332.309999999881
22611,2022-07-29 11:15:00,607.46,356186.07000000146,344246.30000000156,11939.769999999902
22612,2022-07-29 11:20:00,329.17,356515.24000000145,344246.30000000156,12268.939999999886
22613,2022-07-29 11:25:00,-680.2,355835.04000000143,344246.30000000156,11588.739999999874
22614,2022-07-29 11:30:00,-1239.17,354595.87000000145,344246.30000000156,10349.56999999989
22615,2022-07-29 11:35:00,1424.3,356020.17000000144,344246.30000000156,11773.869999999879
22616,2022-07-29 11:40:00,213.41,356233.5800000014,344246.30000000156,11987.279999999853
22617,2022-07-29 11:45:00,-324.35,355909.23000000144,344246.30000000156,11662.929999999877
22618,2022-07-29 11:50:00,-1505.83,354403.4000000014,344246.30000000156,10157.09999999986
22619,2022-07-29 11:55:00,22.74,354426.1400000014,344246.30000000156,10179.839999999851
22620,2022-07-29 12:00:00,82.1,354508.2400000014,344246.30000000156,10261.939999999828
22621,2022-07-29 12:05:00,1825.36,356333.6000000014,344246.30000000156,12087.299999999814
22622,2022-07-29 12:10:00,-1820.41,354513.1900000014,344246.30000000156,10266.88999999984
22623,2022-07-29 12:15:00,-446.06,354067.1300000014,344246.30000000156,9820.829999999842
22624,2022-07-29 12:20:00,562.81,354629.9400000014,344246.30000000156,10383.63999999984
22625,2022-07-29 12:25:00,962.55,355592.4900000014,344246.30000000156,11346.189999999828
22626,2022-07-29 12:30:00,793.94,356386.4300000014,344246.30000000156,12140.12999999983
22627,2022-07-29 12:35:00,110.58,356497.0100000014,344246.30000000156,12250.709999999846
22628,2022-07-29 12:40:00,1395.85,357892.8600000014,344246.30000000156,13646.559999999823
22629,2022-07-29 12:45:00,-826.31,357066.5500000014,344246.30000000156,12820.249999999825
22630,2022-07-29 12:50:00,3.66,357070.21000000136,344246.30000000156,12823.9099999998
22631,2022-07-29 12:55:00,542.04,357612.25000000134,344246.30000000156,13365.949999999779
22632,2022-07-29 13:00:00,-861.93,356750.32000000135,344246.30000000156,12504.019999999786
22633,2022-07-29 13:05:00,53.69,356804.01000000135,344246.30000000156,12557.709999999788
22634,2022-07-29 13:10:00,-686.49,356117.52000000136,344246.30000000156,11871.219999999797
22635,2022-07-29 13:15:00,-1839.54,354277.9800000014,344246.30000000156,10031.679999999818
22636,2022-07-29 13:20:00,-1806.93,352471.0500000014,344246.30000000156,8224.749999999825
22637,2022-07-29 13:25:00,-1633.73,350837.3200000014,344246.30000000156,6591.019999999844
22638,2022-07-29 13:30:00,1265.12,352102.4400000014,344246.30000000156,7856.139999999839
22639,2022-07-29 13:35:00,312.87,352415.3100000014,344246.30000000156,8169.009999999835
22640,2022-07-29 13:40:00,-454.75,351960.5600000014,344246.30000000156,7714.259999999835
22641,2022-07-29 13:45:00,403.97,352364.53000000137,344246.30000000156,8118.229999999807
22642,2022-07-29 13:50:00,-732.33,351632.20000000135,344246.30000000156,7385.89999999979
22643,2022-07-29 13:55:00,-736.11,350896.09000000136,344246.30000000156,6649.789999999804
22644,2022-07-29 14:00:00,113.17,351009.26000000135,344246.30000000156,6762.959999999788
22645,2022-07-29 14:05:00,759.74,351769.00000000134,344246.30000000156,7522.699999999779
22646,2022-07-29 14:10:00,-616.03,351152.9700000013,344246.30000000156,6906.669999999751
22647,2022-07-29 14:15:00,-1726.29,349426.68000000133,344246.30000000156,5180.379999999772
22648,2022-07-29 14:20:00,1746.33,351173.01000000135,344246.30000000156,6926.709999999788
22649,2022-07-29 14:25:00,-1538.12,349634.89000000135,344246.30000000156,5388.589999999793
22650,2022-07-29 14:30:00,-310.94,349323.95000000135,344246.30000000156,5077.64999999979
22651,2022-07-29 14:35:00,-727.38,348596.57000000135,344246.30000000156,4350.269999999786
22652,2022-07-29 14:40:00,-817.39,347779.18000000133,344246.30000000156,3532.879999999772
22653,2022-07-29 14:45:00,-1249.14,346530.0400000013,344246.30000000156,2283.739999999758
22654,2022-07-29 14:50:00,-521.69,346008.3500000013,344246.30000000156,1762.0499999997555
22655,2022-07-29 14:55:00,-1138.17,344870.18000000133,344246.30000000156,623.8799999997718
22656,2022-07-29 15:00:00,1846.8,346716.9800000013,344246.30000000156,2470.67999999976
22657,2022-07-29 15:05:00,-1382.66,345334.32000000135,344246.30000000156,1088.0199999997858
22658,2022-07-29 15:10:00,1046.33,346380.65000000136,344246.30000000156,2134.349999999802
22659,2022-07-29 15:15:00,-1271.88,345108.77000000136,344246.30000000156,862.4699999997974
22660,2022-07-29 15:20:00,-151.79,344956.9800000014,344246.30000000156,710.6799999998184
22661,2022-07-29 15:25:00,1422.27,346379.2500000014,344246.30000000156,2132.949999999837
22662,2022-07-29 15:30:00,1675.87,348055.1200000014,344246.30000000156,3808.8199999998324
22663,2022-07-29 15:35:00,-1982.05,346073.0700000014,344246.30000000156,1826.769999999844
22664,2022-07-29 15:40:00,-711.47,345361.60000000143,344246.30000000156,1115.299999999872
22665,2022-07-29 15:45:00,965.78,346327.38000000146,344246.30000000156,2081.0799999999
22666,2022-07-29 15:50:00,-137.67,346189.7100000015,344246.30000000156,1943.4099999999162
22667,2022-07-29 15:55:00,1269.23,347458.94000000146,344246.30000000156,3212.6399999998976
22668,2022-07-29 16:00:00,689.93,348148.87000000145,344246.30000000156,3902.5699999998906
22669,2022-07-29 16:05:00,1584.58,349733.45000000147,344246.30000000156,5487.149999999907
22670,2022-07-29 16:10:00,-1786.18,347947.2700000015,344246.30000000156,3700.969999999914
22671,2022-07-29 16:15:00,-549.79,347397.4800000015,344246.30000000156,3151.179999999935
22672,2022-07-29 16:20:00,70.97,347468.45000000147,344246.30000000156,3222.149999999907
22673,2022-07-29 16:25:00,1114.46,348582.9100000015,344246.30000000156,4336.609999999928
22674,2022-07-29 16:30:00,-1299.68,347283.2300000015,344246.30000000156,3036.929999999935
22675,2022-07-29 16:35:00,531.41,347814.64000000147,344246.30000000156,3568.339999999909
22676,2022-07-29 16:40:00,-1088.47,346726.1700000015,344246.30000000156,2479.869999999937
22677,2022-07-29 16:45:00,837.75,347563.9200000015,344246.30000000156,3317.619999999937
22678,2022-07-29 16:50:00,256.86,347820.7800000015,344246.30000000156,3574.479999999923
22679,2022-07-29 16:55:00,-1899.67,345921.1100000015,344246.30000000156,1674.8099999999395
22680,2022-07-30 08:00:00,1431.98,347353.0900000015,345921.1100000015,1431.9799999999814
22681,2022-07-30 08:05:00,-1518.61,345834.4800000015,345921.1100000015,-86.63000000000466
22682,2022-07-30 08:10:00,1940.21,347774.6900000015,345921.1100000015,1853.5800000000163
22683,2022-07-30 08:15:00,-352.56,347422.1300000015,345921.1100000015,1501.0200000000186
22684,2022-07-30 08:20:00,-1647.09,345775.0400000015,345921.1100000015,-146.07000000000698
22685,2022-07-30 08:25:00,863.28,346638.3200000015,345921.1100000015,717.210000000021
22686,2022-07-30 08:30:00,-1861.1,344777.22000000154,345921.1100000015,-1143.8899999999558
22687,2022-07-30 08:35:00,-1177.78,343599.4400000015,345921.1100000015,-2321.6699999999837
22688,2022-07-30 08:40:00,-1385.77,342213.6700000015,345921.1100000015,-3707.4400000000023
22689,2022-07-30 08:45:00,-1754.09,340459.5800000015,345921.1100000015,-5461.530000000028
22690,2022-07-30 08:50:00,-1604.6,338854.9800000015,345921.1100000015,-7066.130000000005
22691,2022-07-30 08:55:00,-1208.22,337646.7600000015,345921.1100000015,-8274.349999999977
22692,2022-07-30 09:00:00,-842.86,336803.90000000154,345921.1100000015,-9117.209999999963
22693,2022-07-30 09:05:00,1950.9,338754.80000000156,345921.1100000015,-7166.3099999999395
22694,2022-07-30 09:10:00,-597.66,338157.1400000016,345921.1100000015,-7763.969999999914
22695,2022-07-30 09:15:00,1873.77,340030.9100000016,345921.1100000015,-5890.199999999895
22696,2022-07-30 09:20:00,-21.32,340009.5900000016,345921.1100000015,-5911.519999999902
22697,2022-07-30 09:25:00,1972.34,341981.9300000016,345921.1100000015,-3939.1799999998766
22698,2022-07-30 09:30:00,1663.71,343645.64000000164,345921.1100000015,-2275.4699999998556
22699,2022-07-30 09:35:00,1879.84,345525.48000000167,345921.1100000015,-395.62999999983003
22700,2022-07-30 09:40:00,-78.93,345446.5500000017,345921.1100000015,-474.55999999982305
22701,2022-07-30 09:45:00,983.75,346430.3000000017,345921.1100000015,509.19000000017695
22702,2022-07-30 09:50:00,-813.14,345617.16000000166,345921.1100000015,-303.949999999837
22703,2022-07-30 09:55:00,1936.53,347553.6900000017,345921.1100000015,1632.580000000191
22704,2022-07-30 10:00:00,1434.97,348988.66000000166,345921.1100000015,3067.550000000163
22705,2022-07-30 10:05:00,1899.77,350888.4300000017,345921.1100000015,4967.320000000182
22706,2022-07-30 10:10:00,-1036.87,349851.5600000017,345921.1100000015,3930.4500000001863
22707,2022-07-30 10:15:00,-1102.31,348749.2500000017,345921.1100000015,2828.1400000001886
22708,2022-07-30 10:20:00,-1039.57,347709.6800000017,345921.1100000015,1788.5700000001816
22709,2022-07-30 10:25:00,-21.04,347688.6400000017,345921.1100000015,1767.5300000002026
22710,2022-07-30 10:30:00,-217.86,347470.7800000017,345921.1100000015,1549.6700000002165
22711,2022-07-30 10:35:00,211.55,347682.3300000017,345921.1100000015,1761.220000000205
22712,2022-07-30 10:40:00,763.29,348445.6200000017,345921.1100000015,2524.510000000184
22713,2022-07-30 10:45:00,1377.56,349823.1800000017,345921.1100000015,3902.0700000001816
22714,2022-07-30 10:50:00,-275.48,349547.7000000017,345921.1100000015,3626.5900000002002
22715,2022-07-30 10:55:00,-1016.75,348530.9500000017,345921.1100000015,2609.8400000002002
22716,2022-07-30 11:00:00,553.62,349084.5700000017,345921.1100000015,3163.4600000001956
22717,2022-07-30 11:05:00,1842.33,350926.9000000017,345921.1100000015,5005.790000000212
22718,2022-07-30 11:10:00,-192.67,350734.2300000017,345921.1100000015,4813.120000000228
22719,2022-07-30 11:15:00,285.58,351019.81000000174,345921.1100000015,5098.7000000002445
22720,2022-07-30 11:20:00,1035.4,352055.21000000177,345921.1100000015,6134.100000000268
22721,2022-07-30 11:25:00,-1074.02,350981.19000000175,345921.1100000015,5060.080000000249
22722,2022-07-30 11:30:00,413.82,351395.01000000176,345921.1100000015,5473.900000000256
22723,2022-07-30 11:35:00,576.87,351971.88000000175,345921.1100000015,6050.7700000002515
22724,2022-07-30 11:40:00,-235.07,351736.81000000174,345921.1100000015,5815.7000000002445
22725,2022-07-30 11:45:00,-889.52,350847.2900000017,345921.1100000015,4926.180000000226
22726,2022-07-30 11:50:00,-558.45,350288.8400000017,345921.1100000015,4367.730000000214
22727,2022-07-30 11:55:00,-259.92,350028.92000000173,345921.1100000015,4107.8100000002305
22728,2022-07-30 12:00:00,1825.22,351854.1400000017,345921.1100000015,5933.030000000203
22729,2022-07-30 12:05:00,-573.35,351280.7900000017,345921.1100000015,5359.680000000226
22730,2022-07-30 12:10:00,398.18,351678.9700000017,345921.1100000015,5757.860000000219
22731,2022-07-30 12:15:00,1354.39,353033.36000000173,345921.1100000015,7112.250000000233
22732,2022-07-30 12:20:00,939.4,353972.76000000176,345921.1100000015,8051.650000000256
22733,2022-07-30 12:25:00,-726.47,353246.2900000018,345921.1100000015,7325.180000000284
22734,2022-07-30 12:30:00,-666.52,352579.77000000176,345921.1100000015,6658.660000000265
22735,2022-07-30 12:35:00,-1399.66,351180.1100000018,345921.1100000015,5259.000000000291
22736,2022-07-30 12:40:00,1840.45,353020.5600000018,345921.1100000015,7099.450000000303
22737,2022-07-30 12:45:00,-448.89,352571.6700000018,345921.1100000015,6650.560000000289
22738,2022-07-30 12:50:00,863.13,353434.8000000018,345921.1100000015,7513.690000000293
22739,2022-07-30 12:55:00,1514.18,354948.9800000018,345921.1100000015,9027.870000000286
22740,2022-07-30 13:00:00,-1150.33,353798.65000000177,345921.1100000015,7877.54000000027
22741,2022-07-30 13:05:00,1451.29,355249.94000000175,345921.1100000015,9328.83000000025
22742,2022-07-30 13:10:00,227.14,355477.08000000176,345921.1100000015,9555.970000000263
22743,2022-07-30 13:15:00,1832.63,357309.71000000177,345921.1100000015,11388.600000000268
22744,2022-07-30 13:20:00,-1037.42,356272.2900000018,345921.1100000015,10351.180000000284
22745,2022-07-30 13:25:00,-1900.69,354371.6000000018,345921.1100000015,8450.490000000282
22746,2022-07-30 13:30:00,1426.62,355798.2200000018,345921.1100000015,9877.110000000277
22747,2022-07-30 13:35:00,1058.14,356856.3600000018,345921.1100000015,10935.250000000291
22748,2022-07-30 13:40:00,-1135.19,355721.1700000018,345921.1100000015,9800.060000000289
22749,2022-07-30 13:45:00,-317.85,355403.3200000018,345921.1100000015,9482.210000000312
22750,2022-07-30 13:50:00,398.82,355802.1400000018,345921.1100000015,9881.030000000319
22751,2022-07-30 13:55:00,530.37,356332.5100000018,345921.1100000015,10411.400000000314
22752,2022-07-30 14:00:00,87.96,356420.47000000183,345921.1100000015,10499.360000000335
22753,2022-07-30 14:05:00,-1136.69,355283.78000000183,345921.1100000015,9362.670000000333
22754,2022-07-30 14:10:00,501.76,355785.54000000184,345921.1100000015,9864.430000000342
22755,2022-07-30 14:15:00,1237.38,357022.92000000185,345921.1100000015,11101.810000000347
22756,2022-07-30 14:20:00,589.42,357612.34000000183,345921.1100000015,11691.23000000033
22757,2022-07-30 14:25:00,-260.15,357352.1900000018,345921.1100000015,11431.080000000307
22758,2022-07-30 14:30:00,867.58,358219.7700000018,345921.1100000015,12298.660000000324
22759,2022-07-30 14:35:00,1036.1,359255.8700000018,345921.1100000015,13334.7600000003
22760,2022-07-30 14:40:00,63.3,359319.1700000018,345921.1100000015,13398.060000000289
22761,2022-07-30 14:45:00,-1285.98,358033.1900000018,345921.1100000015,12112.080000000307
22762,2022-07-30 14:50:00,-1819.41,356213.78000000183,345921.1100000015,10292.670000000333
22763,2022-07-30 14:55:00,-63.73,356150.05000000185,345921.1100000015,10228.940000000352
22764,2022-07-30 15:00:00,-845.75,355304.30000000185,345921.1100000015,9383.190000000352
22765,2022-07-30 15:05:00,-1914.56,353389.74000000185,345921.1100000015,7468.630000000354
22766,2022-07-30 15:10:00,1178.42,354568.16000000184,345921.1100000015,8647.050000000338
22767,2022-07-30 15:15:00,-1874.91,352693.25000000186,345921.1100000015,6772.140000000363
22768,2022-07-30 15:20:00,-1198.7,351494.55000000185,345921.1100000015,5573.440000000352
22769,2022-07-30 15:25:00,-454.36,351040.19000000186,345921.1100000015,5119.0800000003655
22770,2022-07-30 15:30:00,1102.89,352143.0800000019,345921.1100000015,6221.9700000003795
22771,2022-07-30 15:35:00,1960.03,354103.1100000019,345921.1100000015,8182.000000000407
22772,2022-07-30 15:40:00,-1034.82,353068.2900000019,345921.1100000015,7147.1800000004005
22773,2022-07-30 15:45:00,-875.19,352193.1000000019,345921.1100000015,6271.990000000398
22774,2022-07-30 15:50:00,-198.87,351994.2300000019,345921.1100000015,6073.120000000403
22775,2022-07-30 15:55:00,-1333.46,350660.7700000019,345921.1100000015,4739.660000000382
22776,2022-07-30 16:00:00,1812.58,352473.3500000019,345921.1100000015,6552.240000000398
22777,2022-07-30 16:05:00,-1475.46,350997.8900000019,345921.1100000015,5076.780000000377
22778,2022-07-30 16:10:00,-261.85,350736.0400000019,345921.1100000015,4814.9300000004005
22779,2022-07-30 16:15:00,-1652.09,349083.9500000019,345921.1100000015,3162.840000000375
22780,2022-07-30 16:20:00,422.36,349506.31000000186,345921.1100000015,3585.200000000361
22781,2022-07-30 16:25:00,1910.23,351416.54000000184,345921.1100000015,5495.430000000342
22782,2022-07-30 16:30:00,-1455.39,349961.1500000018,345921.1100000015,4040.0400000003283
22783,2022-07-30 16:35:00,-1534.98,348426.17000000185,345921.1100000015,2505.060000000347
22784,2022-07-30 16:40:00,625.13,349051.30000000185,345921.1100000015,3130.1900000003516
22785,2022-07-30 16:45:00,1770.17,350821.47000000183,345921.1100000015,4900.360000000335
22786,2022-07-30 16:50:00,111.17,350932.6400000018,345921.1100000015,5011.530000000319
22787,2022-07-30 16:55:00,-351.66,350580.98000000184,345921.1100000015,4659.870000000345
22788,2022-07-31 08:00:00,-1570.96,349010.0200000018,350580.98000000184,-1570.960000000021
22789,2022-07-31 08:05:00,1453.08,350463.10000000184,350580.98000000184,-117.88000000000466
22790,2022-07-31 08:10:00,1196.15,351659.25000000186,350580.98000000184,1078.2700000000186
22791,2022-07-31 08:15:00,-507.48,351151.7700000019,350580.98000000184,570.7900000000373
22792,2022-07-31 08:20:00,314.62,351466.3900000019,350580.98000000184,885.4100000000326
22793,2022-07-31 08:25:00,-628.61,350837.7800000019,350580.98000000184,256.80000000004657
22794,2022-07-31 08:30:00,114.34,350952.1200000019,350580.98000000184,371.1400000000722
22795,2022-07-31 08:35:00,704.76,351656.8800000019,350580.98000000184,1075.9000000000815
22796,2022-07-31 08:40:00,-1463.13,350193.7500000019,350580.98000000184,-387.22999999992317
22797,2022-07-31 08:45:00,-131.39,350062.3600000019,350580.98000000184,-518.6199999999371
22798,2022-07-31 08:50:00,-697.87,349364.4900000019,350580.98000000184,-1216.4899999999325
22799,2022-07-31 08:55:00,-192.52,349171.9700000019,350580.98000000184,-1409.009999999951
22800,2022-07-31 09:00:00,227.78,349399.7500000019,350580.98000000184,-1181.2299999999232
22801,2022-07-31 09:05:00,-1255.47,348144.28000000195,350580.98000000184,-2436.699999999895
22802,2022-07-31 09:10:00,1299.38,349443.66000000195,350580.98000000184,-1137.3199999998906
22803,2022-07-31 09:15:00,-478.47,348965.190000002,350580.98000000184,-1615.7899999998626
22804,2022-07-31 09:20:00,661.12,349626.310000002,350580.98000000184,-954.6699999998673
22805,2022-07-31 09:25:00,1993.02,351619.330000002,350580.98000000184,1038.3500000001513
22806,2022-07-31 09:30:00,-680.11,350939.220000002,350580.98000000184,358.2400000001653
22807,2022-07-31 09:35:00,-1960.45,348978.770000002,350580.98000000184,-1602.2099999998463
22808,2022-07-31 09:40:00,20.41,348999.180000002,350580.98000000184,-1581.799999999872
22809,2022-07-31 09:45:00,1954.43,350953.61000000197,350580.98000000184,372.6300000001211
22810,2022-07-31 09:50:00,451.77,351405.380000002,350580.98000000184,824.4000000001397
22811,2022-07-31 09:55:00,213.62,351619.000000002,350580.98000000184,1038.020000000135
22812,2022-07-31 10:00:00,-1090.3,350528.700000002,350580.98000000184,-52.27999999985332
22813,2022-07-31 10:05:00,239.09,350767.790000002,350580.98000000184,186.8100000001723
22814,2022-07-31 10:10:00,-1862.93,348904.860000002,350580.98000000184,-1676.1199999998207
22815,2022-07-31 10:15:00,-1197.22,347707.64000000205,350580.98000000184,-2873.339999999793
22816,2022-07-31 10:20:00,1905.76,349613.40000000206,350580.98000000184,-967.5799999997835
22817,2022-07-31 10:25:00,750.77,350364.1700000021,350580.98000000184,-216.80999999976484
22818,2022-07-31 10:30:00,-1232.42,349131.7500000021,350580.98000000184,-1449.2299999997485
22819,2022-07-31 10:35:00,-266.76,348864.9900000021,350580.98000000184,-1715.9899999997579
22820,2022-07-31 10:40:00,-1124.27,347740.72000000207,350580.98000000184,-2840.2599999997765
22821,2022-07-31 10:45:00,665.01,348405.7300000021,350580.98000000184,-2175.249999999767
22822,2022-07-31 10:50:00,-1385.42,347020.3100000021,350580.98000000184,-3560.669999999751
22823,2022-07-31 10:55:00,-234.08,346786.2300000021,350580.98000000184,-3794.749999999767
22824,2022-07-31 11:00:00,523.95,347310.1800000021,350580.98000000184,-3270.7999999997555
22825,2022-07-31 11:05:00,-526.35,346783.8300000021,350580.98000000184,-3797.1499999997322
22826,2022-07-31 11:10:00,1543.38,348327.2100000021,350580.98000000184,-2253.7699999997276
22827,2022-07-31 11:15:00,636.8,348964.0100000021,350580.98000000184,-1616.9699999997392
22828,2022-07-31 11:20:00,1449.97,350413.9800000021,350580.98000000184,-166.99999999976717
22829,2022-07-31 11:25:00,-973.7,349440.28000000207,350580.98000000184,-1140.6999999997788
22830,2022-07-31 11:30:00,1151.89,350592.1700000021,350580.98000000184,11.190000000235159
22831,2022-07-31 11:35:00,1642.91,352235.08000000205,350580.98000000184,1654.1000000002095
22832,2022-07-31 11:40:00,1982.06,354217.14000000205,350580.98000000184,3636.160000000207
22833,2022-07-31 11:45:00,-981.15,353235.990000002,350580.98000000184,2655.010000000184
22834,2022-07-31 11:50:00,728.36,353964.350000002,350580.98000000184,3383.37000000017
22835,2022-07-31 11:55:00,-944.41,353019.94000000204,350580.98000000184,2438.9600000001956
22836,2022-07-31 12:00:00,656.29,353676.230000002,350580.98000000184,3095.2500000001746
22837,2022-07-31 12:05:00,1830.44,355506.670000002,350580.98000000184,4925.690000000177
22838,2022-07-31 12:10:00,847.73,356354.400000002,350580.98000000184,5773.420000000158
22839,2022-07-31 12:15:00,1816.47,358170.870000002,350580.98000000184,7589.89000000013
22840,2022-07-31 12:20:00,222.09,358392.960000002,350580.98000000184,7811.980000000156
22841,2022-07-31 12:25:00,16.69,358409.650000002,350580.98000000184,7828.670000000158
22842,2022-07-31 12:30:00,-1309.1,357100.550000002,350580.98000000184,6519.570000000182
22843,2022-07-31 12:35:00,-752.12,356348.43000000203,350580.98000000184,5767.450000000186
22844,2022-07-31 12:40:00,-1910.12,354438.31000000203,350580.98000000184,3857.330000000191
22845,2022-07-31 12:45:00,-483.17,353955.14000000205,350580.98000000184,3374.160000000207
22846,2022-07-31 12:50:00,-508.1,353447.0400000021,350580.98000000184,2866.0600000002305
22847,2022-07-31 12:55:00,-633.78,352813.26000000205,350580.98000000184,2232.2800000002026
22848,2022-07-31 13:00:00,1207.07,354020.33000000205,350580.98000000184,3439.3500000002095
22849,2022-07-31 13:05:00,-1011.16,353009.1700000021,350580.98000000184,2428.190000000235
22850,2022-07-31 13:10:00,-1292.15,351717.02000000206,350580.98000000184,1136.0400000002119
22851,2022-07-31 13:15:00,-1304.82,350412.20000000205,350580.98000000184,-168.7799999997951
22852,2022-07-31 13:20:00,821.27,351233.47000000207,350580.98000000184,652.4900000002235
22853,2022-07-31 13:25:00,-1102.13,350131.34000000206,350580.98000000184,-449.63999999978114
22854,2022-07-31 13:30:00,584.43,350715.77000000206,350580.98000000184,134.79000000021188
22855,2022-07-31 13:35:00,-1309.47,349406.3000000021,350580.98000000184,-1174.6799999997602
22856,2022-07-31 13:40:00,1186.17,350592.47000000207,350580.98000000184,11.490000000223517
22857,2022-07-31 13:45:00,-1805.96,348786.51000000205,350580.98000000184,-1794.4699999997974
22858,2022-07-31 13:50:00,-1474.25,347312.26000000205,350580.98000000184,-3268.7199999997974
22859,2022-07-31 13:55:00,-803.45,346508.81000000203,350580.98000000184,-4072.169999999809
22860,2022-07-31 14:00:00,-682.09,345826.720000002,350580.98000000184,-4754.259999999835
22861,2022-07-31 14:05:00,71.56,345898.280000002,350580.98000000184,-4682.699999999837
22862,2022-07-31 14:10:00,933.44,346831.720000002,350580.98000000184,-3749.2599999998347
22863,2022-07-31 14:15:00,1563.86,348395.580000002,350580.98000000184,-2185.3999999998487
22864,2022-07-31 14:20:00,304.51,348700.090000002,350580.98000000184,-1880.8899999998393
22865,2022-07-31 14:25:00,962.42,349662.510000002,350580.98000000184,-918.4699999998556
22866,2022-07-31 14:30:00,410.82,350073.330000002,350580.98000000184,-507.64999999984866
22867,2022-07-31 14:35:00,-546.12,349527.210000002,350580.98000000184,-1053.769999999844
22868,2022-07-31 14:40:00,1475.77,351002.980000002,350580.98000000184,422.0000000001746
22869,2022-07-31 14:45:00,-94.44,350908.540000002,350580.98000000184,327.5600000001723
22870,2022-07-31 14:50:00,1668.39,352576.93000000203,350580.98000000184,1995.9500000001863
22871,2022-07-31 14:55:00,-1506.39,351070.540000002,350580.98000000184,489.5600000001723
22872,2022-07-31 15:00:00,-343.99,350726.550000002,350580.98000000184,145.5700000001816
22873,2022-07-31 15:05:00,1914.79,352641.340000002,350580.98000000184,2060.3600000001607
22874,2022-07-31 15:10:00,-1106.06,351535.280000002,350580.98000000184,954.300000000163
22875,2022-07-31 15:15:00,-801.42,350733.860000002,350580.98000000184,152.88000000017928
22876,2022-07-31 15:20:00,911.98,351645.840000002,350580.98000000184,1064.8600000001607
22877,2022-07-31 15:25:00,-225.3,351420.540000002,350580.98000000184,839.5600000001723
22878,2022-07-31 15:30:00,317.44,351737.980000002,350580.98000000184,1157.0000000001746
22879,2022-07-31 15:35:00,-222.97,351515.01000000205,350580.98000000184,934.0300000002026
22880,2022-07-31 15:40:00,-595.95,350919.06000000203,350580.98000000184,338.0800000001909
22881,2022-07-31 15:45:00,1707.85,352626.910000002,350580.98000000184,2045.9300000001676
22882,2022-07-31 15:50:00,1975.17,354602.080000002,350580.98000000184,4021.1000000001513
22883,2022-07-31 15:55:00,-1026.45,353575.630000002,350580.98000000184,2994.6500000001397
22884,2022-07-31 16:00:00,460.92,354036.55000000197,350580.98000000184,3455.5700000001234
22885,2022-07-31 16:05:00,-698.55,353338.000000002,350580.98000000184,2757.020000000135
22886,2022-07-31 16:10:00,-454.13,352883.870000002,350580.98000000184,2302.8900000001304
22887,2022-07-31 16:15:00,1840.91,354724.78000000195,350580.98000000184,4143.800000000105
22888,2022-07-31 16:20:00,-1936.86,352787.92000000196,350580.98000000184,2206.9400000001187
22889,2022-07-31 16:25:00,399.98,353187.90000000194,350580.98000000184,2606.9200000001
22890,2022-07-31 16:30:00,-547.71,352640.1900000019,350580.98000000184,2059.210000000079
22891,2022-07-31 16:35:00,1761.56,354401.7500000019,350580.98000000184,3820.770000000077
22892,2022-07-31 16:40:00,-195.61,354206.14000000193,350580.98000000184,3625.160000000091
22893,2022-07-31 16:45:00,1501.47,355707.6100000019,350580.98000000184,5126.630000000063
22894,2022-07-31 16:50:00,-1481.96,354225.6500000019,350580.98000000184,3644.670000000042
22895,2022-07-31 16:55:00,-1910.91,352314.7400000019,350580.98000000184,1733.7600000000675
22896,2022-08-01 08:00:00,-645.47,351669.27000000194,352314.7400000019,-645.4699999999721
22897,2022-08-01 08:05:00,1819.57,353488.84000000195,352314.7400000019,1174.100000000035
22898,2022-08-01 08:10:00,-1432.02,352056.8200000019,352314.7400000019,-257.9199999999837
22899,2022-08-01 08:15:00,-1292.61,350764.21000000194,352314.7400000019,-1550.5299999999697
22900,2022-08-01 08:20:00,-886.94,349877.27000000194,352314.7400000019,-2437.469999999972
22901,2022-08-01 08:25:00,-1913.42,347963.85000000196,352314.7400000019,-4350.889999999956
22902,2022-08-01 08:30:00,518.78,348482.630000002,352314.7400000019,-3832.109999999928
22903,2022-08-01 08:35:00,-1125.96,347356.67000000196,352314.7400000019,-4958.069999999949
22904,2022-08-01 08:40:00,-1327.88,346028.79000000196,352314.7400000019,-6285.949999999953
22905,2022-08-01 08:45:00,1091.12,347119.91000000195,352314.7400000019,-5194.829999999958
22906,2022-08-01 08:50:00,-1203.13,345916.78000000195,352314.7400000019,-6397.959999999963
22907,2022-08-01 08:55:00,-127.18,345789.60000000196,352314.7400000019,-6525.139999999956
22908,2022-08-01 09:00:00,255.28,346044.880000002,352314.7400000019,-6269.859999999928
22909,2022-08-01 09:05:00,-1740.13,344304.750000002,352314.7400000019,-8009.9899999999325
22910,2022-08-01 09:10:00,-1216.31,343088.440000002,352314.7400000019,-9226.29999999993
22911,2022-08-01 09:15:00,-1853.51,341234.930000002,352314.7400000019,-11079.80999999994
22912,2022-08-01 09:20:00,-1150.79,340084.140000002,352314.7400000019,-12230.599999999919
22913,2022-08-01 09:25:00,1788.71,341872.850000002,352314.7400000019,-10441.889999999898
22914,2022-08-01 09:30:00,-144.29,341728.56000000203,352314.7400000019,-10586.179999999877
22915,2022-08-01 09:35:00,-213.57,341514.990000002,352314.7400000019,-10799.749999999884
22916,2022-08-01 09:40:00,-232.07,341282.920000002,352314.7400000019,-11031.81999999989
22917,2022-08-01 09:45:00,1809.82,343092.740000002,352314.7400000019,-9221.999999999884
22918,2022-08-01 09:50:00,1667.03,344759.77000000206,352314.7400000019,-7554.969999999856
22919,2022-08-01 09:55:00,-103.96,344655.81000000203,352314.7400000019,-7658.929999999877
22920,2022-08-01 10:00:00,-1030.81,343625.00000000204,352314.7400000019,-8689.739999999874
22921,2022-08-01 10:05:00,-436.34,343188.660000002,352314.7400000019,-9126.0799999999
22922,2022-08-01 10:10:00,1850.69,345039.350000002,352314.7400000019,-7275.389999999898
22923,2022-08-01 10:15:00,694.95,345734.300000002,352314.7400000019,-6580.439999999886
22924,2022-08-01 10:20:00,11.76,345746.06000000203,352314.7400000019,-6568.679999999877
22925,2022-08-01 10:25:00,-1727.16,344018.90000000206,352314.7400000019,-8295.839999999851
22926,2022-08-01 10:30:00,1762.94,345781.84000000206,352314.7400000019,-6532.899999999849
22927,2022-08-01 10:35:00,880.4,346662.2400000021,352314.7400000019,-5652.499999999825
22928,2022-08-01 10:40:00,810.53,347472.7700000021,352314.7400000019,-4841.969999999797
22929,2022-08-01 10:45:00,-82.92,347389.85000000213,352314.7400000019,-4924.889999999781
22930,2022-08-01 10:50:00,-6.87,347382.98000000214,352314.7400000019,-4931.7599999997765
22931,2022-08-01 10:55:00,130.5,347513.48000000214,352314.7400000019,-4801.2599999997765
22932,2022-08-01 11:00:00,401.13,347914.61000000214,352314.7400000019,-4400.129999999772
22933,2022-08-01 11:05:00,767.79,348682.4000000021,352314.7400000019,-3632.339999999793
22934,2022-08-01 11:10:00,1872.76,350555.1600000021,352314.7400000019,-1759.5799999997835
22935,2022-08-01 11:15:00,-7.39,350547.7700000021,352314.7400000019,-1766.9699999997974
22936,2022-08-01 11:20:00,-1630.91,348916.86000000214,352314.7400000019,-3397.879999999772
22937,2022-08-01 11:25:00,1360.64,350277.50000000215,352314.7400000019,-2037.2399999997579
22938,2022-08-01 11:30:00,-1704.1,348573.4000000022,352314.7400000019,-3741.3399999997346
22939,2022-08-01 11:35:00,1224.46,349797.8600000022,352314.7400000019,-2516.8799999997136
22940,2022-08-01 11:40:00,-311.59,349486.2700000022,352314.7400000019,-2828.4699999997392
22941,2022-08-01 11:45:00,1680.27,351166.5400000022,352314.7400000019,-1148.1999999997206
22942,2022-08-01 11:50:00,788.33,351954.8700000022,352314.7400000019,-359.8699999997043
22943,2022-08-01 11:55:00,-1427.8,350527.0700000022,352314.7400000019,-1787.6699999996927
22944,2022-08-01 12:00:00,-939.61,349587.46000000223,352314.7400000019,-2727.2799999996787
22945,2022-08-01 12:05:00,-830.84,348756.6200000022,352314.7400000019,-3558.1199999997043
22946,2022-08-01 12:10:00,1990.62,350747.2400000022,352314.7400000019,-1567.499999999709
22947,2022-08-01 12:15:00,292.27,351039.5100000022,352314.7400000019,-1275.2299999996903
22948,2022-08-01 12:20:00,603.23,351642.7400000022,352314.7400000019,-671.999999999709
22949,2022-08-01 12:25:00,-1388.79,350253.9500000022,352314.7400000019,-2060.789999999688
22950,2022-08-01 12:30:00,-76.5,350177.4500000022,352314.7400000019,-2137.289999999688
22951,2022-08-01 12:35:00,-1070.53,349106.9200000022,352314.7400000019,-3207.819999999716
22952,2022-08-01 12:40:00,936.31,350043.2300000022,352314.7400000019,-2271.5099999997183
22953,2022-08-01 12:45:00,-1763.05,348280.1800000022,352314.7400000019,-4034.5599999997066
22954,2022-08-01 12:50:00,1198.32,349478.5000000022,352314.7400000019,-2836.2399999996996
22955,2022-08-01 12:55:00,-44.64,349433.8600000022,352314.7400000019,-2880.8799999997136
22956,2022-08-01 13:00:00,474.96,349908.8200000022,352314.7400000019,-2405.9199999996927
22957,2022-08-01 13:05:00,-1294.7,348614.1200000022,352314.7400000019,-3700.6199999997043
22958,2022-08-01 13:10:00,298.27,348912.3900000022,352314.7400000019,-3402.3499999996857
22959,2022-08-01 13:15:00,-205.9,348706.4900000022,352314.7400000019,-3608.249999999709
22960,2022-08-01 13:20:00,-759.58,347946.9100000022,352314.7400000019,-4367.829999999725
22961,2022-08-01 13:25:00,-970.71,346976.20000000217,352314.7400000019,-5338.539999999746
22962,2022-08-01 13:30:00,-1994.94,344981.26000000216,352314.7400000019,-7333.4799999997485
22963,2022-08-01 13:35:00,-1264.27,343716.99000000214,352314.7400000019,-8597.749999999767
22964,2022-08-01 13:40:00,243.68,343960.67000000214,352314.7400000019,-8354.069999999774
22965,2022-08-01 13:45:00,-1245.66,342715.01000000216,352314.7400000019,-9599.729999999749
22966,2022-08-01 13:50:00,532.31,343247.32000000216,352314.7400000019,-9067.41999999975
22967,2022-08-01 13:55:00,1956.85,345204.17000000214,352314.7400000019,-7110.569999999774
22968,2022-08-01 14:00:00,480.67,345684.8400000021,352314.7400000019,-6629.89999999979
22969,2022-08-01 14:05:00,-623.61,345061.23000000214,352314.7400000019,-7253.5099999997765
22970,2022-08-01 14:10:00,-5.77,345055.4600000021,352314.7400000019,-7259.279999999795
22971,2022-08-01 14:15:00,1778.3,346833.7600000021,352314.7400000019,-5480.979999999807
22972,2022-08-01 14:20:00,-1136.22,345697.54000000213,352314.7400000019,-6617.199999999779
22973,2022-08-01 14:25:00,1106.12,346803.6600000021,352314.7400000019,-5511.0799999997835
22974,2022-08-01 14:30:00,-1147.24,345656.42000000214,352314.7400000019,-6658.319999999774
22975,2022-08-01 14:35:00,868.49,346524.9100000021,352314.7400000019,-5789.8299999997835
22976,2022-08-01 14:40:00,-1663.44,344861.4700000021,352314.7400000019,-7453.269999999786
22977,2022-08-01 14:45:00,-1225.1,343636.37000000215,352314.7400000019,-8678.369999999763
22978,2022-08-01 14:50:00,-1367.6,342268.7700000022,352314.7400000019,-10045.96999999974
22979,2022-08-01 14:55:00,938.93,343207.70000000217,352314.7400000019,-9107.039999999746
22980,2022-08-01 15:00:00,-1463.79,341743.9100000022,352314.7400000019,-10570.829999999725
22981,2022-08-01 15:05:00,535.17,342279.08000000217,352314.7400000019,-10035.659999999742
22982,2022-08-01 15:10:00,-747.57,341531.51000000216,352314.7400000019,-10783.229999999749
22983,2022-08-01 15:15:00,494.18,342025.69000000216,352314.7400000019,-10289.049999999756
22984,2022-08-01 15:20:00,1412.85,343438.54000000213,352314.7400000019,-8876.199999999779
22985,2022-08-01 15:25:00,-1209.81,342228.73000000214,352314.7400000019,-10086.009999999776
22986,2022-08-01 15:30:00,860.93,343089.6600000021,352314.7400000019,-9225.079999999783
22987,2022-08-01 15:35:00,-426.06,342663.60000000213,352314.7400000019,-9651.139999999781
22988,2022-08-01 15:40:00,-1011.66,341651.94000000216,352314.7400000019,-10662.799999999756
22989,2022-08-01 15:45:00,-1831.06,339820.88000000216,352314.7400000019,-12493.859999999753
22990,2022-08-01 15:50:00,-755.76,339065.12000000215,352314.7400000019,-13249.619999999763
22991,2022-08-01 15:55:00,-738.16,338326.9600000022,352314.7400000019,-13987.779999999737
22992,2022-08-01 16:00:00,1477.35,339804.31000000215,352314.7400000019,-12510.42999999976
22993,2022-08-01 16:05:00,1260.03,341064.3400000022,352314.7400000019,-11250.399999999732
22994,2022-08-01 16:10:00,1039.69,342104.0300000022,352314.7400000019,-10210.70999999973
22995,2022-08-01 16:15:00,1196.01,343300.0400000022,352314.7400000019,-9014.69999999972
22996,2022-08-01 16:20:00,1611.11,344911.1500000022,352314.7400000019,-7403.589999999735
22997,2022-08-01 16:25:00,1195.83,346106.9800000022,352314.7400000019,-6207.759999999718
22998,2022-08-01 16:30:00,207.53,346314.5100000022,352314.7400000019,-6000.22999999969
22999,2022-08-01 16:35:00,1980.49,348295.0000000022,352314.7400000019,-4019.7399999996996
23000,2022-08-01 16:40:00,1151.33,349446.3300000022,352314.7400000019,-2868.4099999996834
23001,2022-08-01 16:45:00,1184.68,350631.0100000022,352314.7400000019,-1683.7299999996903
23002,2022-08-01 16:50:00,269.01,350900.02000000223,352314.7400000019,-1414.719999999681
23003,2022-08-01 16:55:00,-1374.81,349525.21000000223,352314.7400000019,-2789.5299999996787
23004,2022-08-02 08:00:00,861.47,350386.6800000022,349525.21000000223,861.4699999999721
23005,2022-08-02 08:05:00,-105.53,350281.1500000022,349525.21000000223,755.9399999999441
23006,2022-08-02 08:10:00,-1215.72,349065.4300000022,349525.21000000223,-459.78000000002794
23007,2022-08-02 08:15:00,1412.0,350477.4300000022,349525.21000000223,952.2199999999721
23008,2022-08-02 08:20:00,1237.43,351714.8600000022,349525.21000000223,2189.649999999965
23009,2022-08-02 08:25:00,293.91,352008.7700000022,349525.21000000223,2483.5599999999395
23010,2022-08-02 08:30:00,-658.21,351350.56000000215,349525.21000000223,1825.3499999999185
23011,2022-08-02 08:35:00,1553.44,352904.00000000215,349525.21000000223,3378.789999999921
23012,2022-08-02 08:40:00,1254.83,354158.83000000217,349525.21000000223,4633.619999999937
23013,2022-08-02 08:45:00,1036.3,355195.13000000216,349525.21000000223,5669.9199999999255
23014,2022-08-02 08:50:00,-1758.41,353436.7200000022,349525.21000000223,3911.509999999951
23015,2022-08-02 08:55:00,1000.24,354436.9600000022,349525.21000000223,4911.749999999942
23016,2022-08-02 09:00:00,-1825.46,352611.50000000215,349525.21000000223,3086.289999999921
23017,2022-08-02 09:05:00,-556.4,352055.10000000213,349525.21000000223,2529.8899999998976
23018,2022-08-02 09:10:00,330.94,352386.04000000213,349525.21000000223,2860.8299999999
23019,2022-08-02 09:15:00,377.38,352763.42000000214,349525.21000000223,3238.2099999999045
23020,2022-08-02 09:20:00,-1115.36,351648.06000000215,349525.21000000223,2122.8499999999185
23021,2022-08-02 09:25:00,452.03,352100.0900000022,349525.21000000223,2574.8799999999464
23022,2022-08-02 09:30:00,1276.59,353376.6800000022,349525.21000000223,3851.469999999972
23023,2022-08-02 09:35:00,-1902.9,351473.7800000022,349525.21000000223,1948.5699999999488
23024,2022-08-02 09:40:00,1854.62,353328.4000000022,349525.21000000223,3803.189999999944
23025,2022-08-02 09:45:00,296.1,353624.50000000215,349525.21000000223,4099.289999999921
23026,2022-08-02 09:50:00,-846.31,352778.19000000216,349525.21000000223,3252.979999999923
23027,2022-08-02 09:55:00,1135.54,353913.73000000214,349525.21000000223,4388.519999999902
23028,2022-08-02 10:00:00,1091.6,355005.3300000021,349525.21000000223,5480.119999999879
23029,2022-08-02 10:05:00,1920.36,356925.6900000021,349525.21000000223,7400.479999999865
23030,2022-08-02 10:10:00,908.32,357834.0100000021,349525.21000000223,8308.799999999872
23031,2022-08-02 10:15:00,-434.44,357399.5700000021,349525.21000000223,7874.35999999987
23032,2022-08-02 10:20:00,1953.88,359353.4500000021,349525.21000000223,9828.239999999874
23033,2022-08-02 10:25:00,-947.47,358405.98000000214,349525.21000000223,8880.769999999902
23034,2022-08-02 10:30:00,-1840.71,356565.2700000021,349525.21000000223,7040.059999999881
23035,2022-08-02 10:35:00,-1254.7,355310.5700000021,349525.21000000223,5785.35999999987
23036,2022-08-02 10:40:00,126.41,355436.9800000021,349525.21000000223,5911.769999999844
23037,2022-08-02 10:45:00,405.45,355842.4300000021,349525.21000000223,6317.219999999856
23038,2022-08-02 10:50:00,1500.61,357343.0400000021,349525.21000000223,7817.829999999842
23039,2022-08-02 10:55:00,-1189.17,356153.8700000021,349525.21000000223,6628.659999999858
23040,2022-08-02 11:00:00,-304.93,355848.9400000021,349525.21000000223,6323.729999999865
23041,2022-08-02 11:05:00,-60.29,355788.6500000021,349525.21000000223,6263.439999999886
23042,2022-08-02 11:10:00,-246.75,355541.9000000021,349525.21000000223,6016.689999999886
23043,2022-08-02 11:15:00,1052.35,356594.2500000021,349525.21000000223,7069.039999999863
23044,2022-08-02 11:20:00,-959.79,355634.4600000021,349525.21000000223,6109.249999999884
23045,2022-08-02 11:25:00,1335.88,356970.3400000021,349525.21000000223,7445.129999999888
23046,2022-08-02 11:30:00,-477.0,356493.3400000021,349525.21000000223,6968.129999999888
23047,2022-08-02 11:35:00,388.08,356881.42000000214,349525.21000000223,7356.2099999999045
23048,2022-08-02 11:40:00,443.81,357325.23000000214,349525.21000000223,7800.019999999902
23049,2022-08-02 11:45:00,908.76,358233.99000000214,349525.21000000223,8708.779999999912
23050,2022-08-02 11:50:00,1397.92,359631.9100000021,349525.21000000223,10106.699999999895
23051,2022-08-02 11:55:00,-352.82,359279.0900000021,349525.21000000223,9753.879999999888
23052,2022-08-02 12:00:00,-1180.32,358098.7700000021,349525.21000000223,8573.559999999881
23053,2022-08-02 12:05:00,-1992.52,356106.2500000021,349525.21000000223,6581.039999999863
23054,2022-08-02 12:10:00,358.19,356464.4400000021,349525.21000000223,6939.229999999865
23055,2022-08-02 12:15:00,1243.79,357708.2300000021,349525.21000000223,8183.019999999844
23056,2022-08-02 12:20:00,1156.16,358864.39000000205,349525.21000000223,9339.179999999818
23057,2022-08-02 12:25:00,1444.39,360308.78000000207,349525.21000000223,10783.569999999832
23058,2022-08-02 12:30:00,726.03,361034.8100000021,349525.21000000223,11509.59999999986
23059,2022-08-02 12:35:00,1420.75,362455.5600000021,349525.21000000223,12930.34999999986
23060,2022-08-02 12:40:00,551.81,363007.3700000021,349525.21000000223,13482.159999999858
23061,2022-08-02 12:45:00,-1622.37,361385.0000000021,349525.21000000223,11859.789999999863
23062,2022-08-02 12:50:00,-325.72,361059.2800000021,349525.21000000223,11534.06999999989
23063,2022-08-02 12:55:00,-339.71,360719.5700000021,349525.21000000223,11194.35999999987
23064,2022-08-02 13:00:00,759.35,361478.9200000021,349525.21000000223,11953.709999999846
23065,2022-08-02 13:05:00,1591.27,363070.1900000021,349525.21000000223,13544.979999999865
23066,2022-08-02 13:10:00,1953.21,365023.4000000021,349525.21000000223,15498.189999999886
23067,2022-08-02 13:15:00,-1656.84,363366.5600000021,349525.21000000223,13841.34999999986
23068,2022-08-02 13:20:00,-973.39,362393.1700000021,349525.21000000223,12867.959999999846
23069,2022-08-02 13:25:00,-1532.37,360860.8000000021,349525.21000000223,11335.589999999851
23070,2022-08-02 13:30:00,1684.57,362545.3700000021,349525.21000000223,13020.159999999858
23071,2022-08-02 13:35:00,1407.95,363953.3200000021,349525.21000000223,14428.10999999987
23072,2022-08-02 13:40:00,709.78,364663.10000000213,349525.21000000223,15137.889999999898
23073,2022-08-02 13:45:00,-3.68,364659.42000000214,349525.21000000223,15134.209999999905
23074,2022-08-02 13:50:00,-1070.17,363589.25000000215,349525.21000000223,14064.03999999992
23075,2022-08-02 13:55:00,-1652.02,361937.23000000214,349525.21000000223,12412.019999999902
23076,2022-08-02 14:00:00,-56.06,361881.17000000214,349525.21000000223,12355.959999999905
23077,2022-08-02 14:05:00,762.44,362643.61000000214,349525.21000000223,13118.399999999907
23078,2022-08-02 14:10:00,-1264.9,361378.7100000021,349525.21000000223,11853.499999999884
23079,2022-08-02 14:15:00,729.54,362108.2500000021,349525.21000000223,12583.039999999863
23080,2022-08-02 14:20:00,-1630.16,360478.0900000021,349525.21000000223,10952.879999999888
23081,2022-08-02 14:25:00,1880.58,362358.67000000214,349525.21000000223,12833.459999999905
23082,2022-08-02 14:30:00,-1220.19,361138.48000000214,349525.21000000223,11613.269999999902
23083,2022-08-02 14:35:00,459.34,361597.82000000216,349525.21000000223,12072.609999999928
23084,2022-08-02 14:40:00,-534.89,361062.93000000215,349525.21000000223,11537.719999999914
23085,2022-08-02 14:45:00,-1784.2,359278.73000000214,349525.21000000223,9753.519999999902
23086,2022-08-02 14:50:00,365.64,359644.37000000215,349525.21000000223,10119.159999999916
23087,2022-08-02 14:55:00,756.44,360400.81000000215,349525.21000000223,10875.599999999919
23088,2022-08-02 15:00:00,-915.87,359484.94000000216,349525.21000000223,9959.729999999923
23089,2022-08-02 15:05:00,637.6,360122.54000000213,349525.21000000223,10597.3299999999
23090,2022-08-02 15:10:00,-1522.64,358599.9000000021,349525.21000000223,9074.689999999886
23091,2022-08-02 15:15:00,9.51,358609.4100000021,349525.21000000223,9084.199999999895
23092,2022-08-02 15:20:00,406.38,359015.79000000213,349525.21000000223,9490.5799999999
23093,2022-08-02 15:25:00,-1424.25,357591.54000000213,349525.21000000223,8066.3299999999
23094,2022-08-02 15:30:00,-834.97,356756.57000000216,349525.21000000223,7231.359999999928
23095,2022-08-02 15:35:00,769.52,357526.0900000022,349525.21000000223,8000.879999999946
23096,2022-08-02 15:40:00,1504.91,359031.00000000215,349525.21000000223,9505.78999999992
23097,2022-08-02 15:45:00,-1569.34,357461.6600000021,349525.21000000223,7936.449999999895
23098,2022-08-02 15:50:00,-1691.89,355769.7700000021,349525.21000000223,6244.559999999881
23099,2022-08-02 15:55:00,-789.87,354979.9000000021,349525.21000000223,5454.689999999886
23100,2022-08-02 16:00:00,-1227.01,353752.8900000021,349525.21000000223,4227.679999999877
23101,2022-08-02 16:05:00,1379.85,355132.7400000021,349525.21000000223,5607.529999999853
23102,2022-08-02 16:10:00,-137.73,354995.0100000021,349525.21000000223,5469.799999999872
23103,2022-08-02 16:15:00,1747.66,356742.6700000021,349525.21000000223,7217.459999999846
23104,2022-08-02 16:20:00,1495.4,358238.0700000021,349525.21000000223,8712.85999999987
23105,2022-08-02 16:25:00,-1326.22,356911.85000000213,349525.21000000223,7386.639999999898
23106,2022-08-02 16:30:00,-1314.48,355597.37000000215,349525.21000000223,6072.159999999916
23107,2022-08-02 16:35:00,-1214.77,354382.60000000213,349525.21000000223,4857.389999999898
23108,2022-08-02 16:40:00,924.18,355306.7800000021,349525.21000000223,5781.569999999891
23109,2022-08-02 16:45:00,-924.1,354382.68000000215,349525.21000000223,4857.469999999914
23110,2022-08-02 16:50:00,1650.56,356033.24000000214,349525.21000000223,6508.0299999999115
23111,2022-08-02 16:55:00,1190.02,357223.26000000216,349525.21000000223,7698.04999999993
23112,2022-08-03 08:00:00,1520.48,358743.74000000214,357223.26000000216,1520.4799999999814
23113,2022-08-03 08:05:00,-705.77,358037.9700000021,357223.26000000216,814.7099999999627
23114,2022-08-03 08:10:00,-230.08,357807.8900000021,357223.26000000216,584.6299999999464
23115,2022-08-03 08:15:00,1130.41,358938.3000000021,357223.26000000216,1715.0399999999208
23116,2022-08-03 08:20:00,-1121.04,357817.2600000021,357223.26000000216,593.9999999999418
23117,2022-08-03 08:25:00,-801.23,357016.0300000021,357223.26000000216,-207.23000000003958
23118,2022-08-03 08:30:00,1556.99,358573.0200000021,357223.26000000216,1349.759999999951
23119,2022-08-03 08:35:00,361.9,358934.92000000214,357223.26000000216,1711.6599999999744
23120,2022-08-03 08:40:00,-521.33,358413.5900000021,357223.26000000216,1190.329999999958
23121,2022-08-03 08:45:00,-646.05,357767.54000000213,357223.26000000216,544.2799999999697
23122,2022-08-03 08:50:00,1393.52,359161.06000000215,357223.26000000216,1937.7999999999884
23123,2022-08-03 08:55:00,1674.27,360835.33000000217,357223.26000000216,3612.070000000007
23124,2022-08-03 09:00:00,1160.03,361995.3600000022,357223.26000000216,4772.100000000035
23125,2022-08-03 09:05:00,1192.81,363188.1700000022,357223.26000000216,5964.910000000033
23126,2022-08-03 09:10:00,-913.81,362274.3600000022,357223.26000000216,5051.100000000035
23127,2022-08-03 09:15:00,1532.36,363806.7200000022,357223.26000000216,6583.460000000021
23128,2022-08-03 09:20:00,-345.55,363461.1700000022,357223.26000000216,6237.910000000033
23129,2022-08-03 09:25:00,-1637.57,361823.6000000022,357223.26000000216,4600.340000000026
23130,2022-08-03 09:30:00,-1521.97,360301.6300000022,357223.26000000216,3078.3700000000536
23131,2022-08-03 09:35:00,-1645.85,358655.78000000224,357223.26000000216,1432.5200000000768
23132,2022-08-03 09:40:00,1561.68,360217.46000000223,357223.26000000216,2994.20000000007
23133,2022-08-03 09:45:00,239.12,360456.5800000022,357223.26000000216,3233.320000000065
23134,2022-08-03 09:50:00,-225.63,360230.9500000022,357223.26000000216,3007.6900000000605
23135,2022-08-03 09:55:00,473.21,360704.16000000224,357223.26000000216,3480.9000000000815
23136,2022-08-03 10:00:00,48.91,360753.0700000022,357223.26000000216,3529.810000000056
23137,2022-08-03 10:05:00,1736.76,362489.8300000022,357223.26000000216,5266.570000000065
23138,2022-08-03 10:10:00,-762.96,361726.8700000022,357223.26000000216,4503.610000000044
23139,2022-08-03 10:15:00,1548.86,363275.7300000022,357223.26000000216,6052.47000000003
23140,2022-08-03 10:20:00,-287.36,362988.3700000022,357223.26000000216,5765.110000000044
23141,2022-08-03 10:25:00,-386.67,362601.7000000022,357223.26000000216,5378.4400000000605
23142,2022-08-03 10:30:00,1887.85,364489.5500000022,357223.26000000216,7266.290000000037
23143,2022-08-03 10:35:00,1498.81,365988.3600000022,357223.26000000216,8765.100000000035
23144,2022-08-03 10:40:00,-497.94,365490.4200000022,357223.26000000216,8267.160000000033
23145,2022-08-03 10:45:00,472.25,365962.6700000022,357223.26000000216,8739.410000000033
23146,2022-08-03 10:50:00,154.11,366116.7800000022,357223.26000000216,8893.520000000019
23147,2022-08-03 10:55:00,1046.9,367163.6800000022,357223.26000000216,9940.420000000042
23148,2022-08-03 11:00:00,-165.97,366997.71000000223,357223.26000000216,9774.45000000007
23149,2022-08-03 11:05:00,-1812.23,365185.48000000225,357223.26000000216,7962.2200000000885
23150,2022-08-03 11:10:00,-205.06,364980.42000000225,357223.26000000216,7757.160000000091
23151,2022-08-03 11:15:00,-1178.43,363801.99000000226,357223.26000000216,6578.730000000098
23152,2022-08-03 11:20:00,970.62,364772.61000000226,357223.26000000216,7549.350000000093
23153,2022-08-03 11:25:00,-820.1,363952.5100000023,357223.26000000216,6729.250000000116
23154,2022-08-03 11:30:00,947.9,364900.4100000023,357223.26000000216,7677.15000000014
23155,2022-08-03 11:35:00,-1797.96,363102.4500000023,357223.26000000216,5879.190000000119
23156,2022-08-03 11:40:00,-943.16,362159.2900000023,357223.26000000216,4936.030000000144
23157,2022-08-03 11:45:00,-841.3,361317.9900000023,357223.26000000216,4094.730000000156
23158,2022-08-03 11:50:00,218.59,361536.58000000234,357223.26000000216,4313.320000000182
23159,2022-08-03 11:55:00,279.89,361816.47000000236,357223.26000000216,4593.210000000196
23160,2022-08-03 12:00:00,905.01,362721.48000000237,357223.26000000216,5498.220000000205
23161,2022-08-03 12:05:00,222.34,362943.8200000024,357223.26000000216,5720.5600000002305
23162,2022-08-03 12:10:00,1467.5,364411.3200000024,357223.26000000216,7188.0600000002305
23163,2022-08-03 12:15:00,1402.56,365813.8800000024,357223.26000000216,8590.620000000228
23164,2022-08-03 12:20:00,1308.67,367122.5500000024,357223.26000000216,9899.290000000212
23165,2022-08-03 12:25:00,-727.69,366394.8600000024,357223.26000000216,9171.60000000021
23166,2022-08-03 12:30:00,808.49,367203.35000000236,357223.26000000216,9980.0900000002
23167,2022-08-03 12:35:00,148.79,367352.14000000234,357223.26000000216,10128.88000000018
23168,2022-08-03 12:40:00,-854.67,366497.47000000236,357223.26000000216,9274.210000000196
23169,2022-08-03 12:45:00,-297.59,366199.88000000233,357223.26000000216,8976.62000000017
23170,2022-08-03 12:50:00,306.31,366506.19000000233,357223.26000000216,9282.930000000168
23171,2022-08-03 12:55:00,1531.63,368037.82000000234,357223.26000000216,10814.560000000172
23172,2022-08-03 13:00:00,-1758.6,366279.22000000236,357223.26000000216,9055.960000000196
23173,2022-08-03 13:05:00,84.27,366363.4900000024,357223.26000000216,9140.230000000214
23174,2022-08-03 13:10:00,1694.74,368058.23000000237,357223.26000000216,10834.970000000205
23175,2022-08-03 13:15:00,866.7,368924.9300000024,357223.26000000216,11701.670000000217
23176,2022-08-03 13:20:00,1995.43,370920.3600000024,357223.26000000216,13697.10000000021
23177,2022-08-03 13:25:00,1711.36,372631.72000000236,357223.26000000216,15408.460000000196
23178,2022-08-03 13:30:00,299.78,372931.5000000024,357223.26000000216,15708.240000000224
23179,2022-08-03 13:35:00,1841.88,374773.3800000024,357223.26000000216,17550.120000000228
23180,2022-08-03 13:40:00,-1136.25,373637.1300000024,357223.26000000216,16413.870000000228
23181,2022-08-03 13:45:00,-1446.52,372190.6100000024,357223.26000000216,14967.35000000021
23182,2022-08-03 13:50:00,-1620.93,370569.6800000024,357223.26000000216,13346.420000000217
23183,2022-08-03 13:55:00,1809.5,372379.1800000024,357223.26000000216,15155.920000000217
23184,2022-08-03 14:00:00,887.82,373267.0000000024,357223.26000000216,16043.740000000224
23185,2022-08-03 14:05:00,1021.14,374288.1400000024,357223.26000000216,17064.880000000237
23186,2022-08-03 14:10:00,-511.08,373777.0600000024,357223.26000000216,16553.80000000022
23187,2022-08-03 14:15:00,1678.1,375455.16000000236,357223.26000000216,18231.900000000198
23188,2022-08-03 14:20:00,-1100.4,374354.76000000234,357223.26000000216,17131.500000000175
23189,2022-08-03 14:25:00,51.77,374406.53000000236,357223.26000000216,17183.270000000193
23190,2022-08-03 14:30:00,-1515.62,372890.91000000236,357223.26000000216,15667.650000000198
23191,2022-08-03 14:35:00,-1762.95,371127.96000000235,357223.26000000216,13904.700000000186
23192,2022-08-03 14:40:00,277.46,371405.42000000237,357223.26000000216,14182.160000000207
23193,2022-08-03 14:45:00,1789.14,373194.5600000024,357223.26000000216,15971.300000000221
23194,2022-08-03 14:50:00,-990.05,372204.5100000024,357223.26000000216,14981.250000000233
23195,2022-08-03 14:55:00,562.87,372767.3800000024,357223.26000000216,15544.120000000228
23196,2022-08-03 15:00:00,-397.6,372369.7800000024,357223.26000000216,15146.520000000251
23197,2022-08-03 15:05:00,-221.22,372148.56000000244,357223.26000000216,14925.30000000028
23198,2022-08-03 15:10:00,-1775.9,370372.6600000024,357223.26000000216,13149.400000000256
23199,2022-08-03 15:15:00,1121.2,371493.86000000243,357223.26000000216,14270.600000000268
23200,2022-08-03 15:20:00,-1027.15,370466.7100000024,357223.26000000216,13243.450000000244
23201,2022-08-03 15:25:00,1394.54,371861.2500000024,357223.26000000216,14637.990000000224
23202,2022-08-03 15:30:00,-1885.32,369975.9300000024,357223.26000000216,12752.670000000217
23203,2022-08-03 15:35:00,332.42,370308.35000000236,357223.26000000216,13085.0900000002
23204,2022-08-03 15:40:00,702.35,371010.70000000234,357223.26000000216,13787.440000000177
23205,2022-08-03 15:45:00,-871.81,370138.89000000234,357223.26000000216,12915.63000000018
23206,2022-08-03 15:50:00,-1680.7,368458.19000000233,357223.26000000216,11234.930000000168
23207,2022-08-03 15:55:00,1610.93,370069.1200000023,357223.26000000216,12845.86000000016
23208,2022-08-03 16:00:00,-1851.01,368218.1100000023,357223.26000000216,10994.850000000151
23209,2022-08-03 16:05:00,-722.13,367495.9800000023,357223.26000000216,10272.720000000147
23210,2022-08-03 16:10:00,1910.84,369406.82000000234,357223.26000000216,12183.560000000172
23211,2022-08-03 16:15:00,1936.19,371343.01000000234,357223.26000000216,14119.750000000175
23212,2022-08-03 16:20:00,1025.6,372368.6100000023,357223.26000000216,15145.350000000151
23213,2022-08-03 16:25:00,-274.25,372094.3600000023,357223.26000000216,14871.100000000151
23214,2022-08-03 16:30:00,-311.09,371783.2700000023,357223.26000000216,14560.010000000126
23215,2022-08-03 16:35:00,-1758.23,370025.0400000023,357223.26000000216,12801.780000000144
23216,2022-08-03 16:40:00,569.55,370594.5900000023,357223.26000000216,13371.330000000133
23217,2022-08-03 16:45:00,-1662.54,368932.0500000023,357223.26000000216,11708.790000000154
23218,2022-08-03 16:50:00,1963.5,370895.5500000023,357223.26000000216,13672.290000000154
23219,2022-08-03 16:55:00,1632.42,372527.9700000023,357223.26000000216,15304.710000000137
23220,2022-08-04 08:00:00,-694.49,371833.4800000023,372527.9700000023,-694.4899999999907
23221,2022-08-04 08:05:00,-207.98,371625.5000000023,372527.9700000023,-902.4699999999721
23222,2022-08-04 08:10:00,-362.17,371263.33000000234,372527.9700000023,-1264.6399999999558
23223,2022-08-04 08:15:00,407.05,371670.38000000233,372527.9700000023,-857.5899999999674
23224,2022-08-04 08:20:00,-1887.49,369782.89000000234,372527.9700000023,-2745.079999999958
23225,2022-08-04 08:25:00,1457.96,371240.85000000236,372527.9700000023,-1287.1199999999371
23226,2022-08-04 08:30:00,-1899.88,369340.97000000236,372527.9700000023,-3186.999999999942
23227,2022-08-04 08:35:00,1571.79,370912.76000000234,372527.9700000023,-1615.2099999999627
23228,2022-08-04 08:40:00,294.83,371207.59000000235,372527.9700000023,-1320.3799999999464
23229,2022-08-04 08:45:00,45.73,371253.32000000234,372527.9700000023,-1274.649999999965
23230,2022-08-04 08:50:00,-1763.06,369490.26000000234,372527.9700000023,-3037.7099999999627
23231,2022-08-04 08:55:00,-1009.97,368480.29000000237,372527.9700000023,-4047.679999999935
23232,2022-08-04 09:00:00,-1767.05,366713.2400000024,372527.9700000023,-5814.729999999923
23233,2022-08-04 09:05:00,-1224.97,365488.2700000024,372527.9700000023,-7039.699999999895
23234,2022-08-04 09:10:00,-1016.08,364472.1900000024,372527.9700000023,-8055.7799999999115
23235,2022-08-04 09:15:00,-832.68,363639.5100000024,372527.9700000023,-8888.459999999905
23236,2022-08-04 09:20:00,1047.73,364687.2400000024,372527.9700000023,-7840.729999999923
23237,2022-08-04 09:25:00,-1053.58,363633.66000000236,372527.9700000023,-8894.30999999994
23238,2022-08-04 09:30:00,-215.88,363417.78000000236,372527.9700000023,-9110.189999999944
23239,2022-08-04 09:35:00,-1486.93,361930.85000000236,372527.9700000023,-10597.119999999937
23240,2022-08-04 09:40:00,691.93,362622.78000000236,372527.9700000023,-9905.189999999944
23241,2022-08-04 09:45:00,466.86,363089.64000000234,372527.9700000023,-9438.329999999958
23242,2022-08-04 09:50:00,1834.98,364924.6200000023,372527.9700000023,-7603.349999999977
23243,2022-08-04 09:55:00,1877.44,366802.0600000023,372527.9700000023,-5725.909999999974
23244,2022-08-04 10:00:00,-682.34,366119.7200000023,372527.9700000023,-6408.25
23245,2022-08-04 10:05:00,1571.09,367690.8100000023,372527.9700000023,-4837.159999999974
23246,2022-08-04 10:10:00,-1852.13,365838.6800000023,372527.9700000023,-6689.289999999979
23247,2022-08-04 10:15:00,-908.89,364929.7900000023,372527.9700000023,-7598.179999999993
23248,2022-08-04 10:20:00,1081.15,366010.94000000233,372527.9700000023,-6517.02999999997
23249,2022-08-04 10:25:00,-771.79,365239.15000000235,372527.9700000023,-7288.819999999949
23250,2022-08-04 10:30:00,27.87,365267.02000000235,372527.9700000023,-7260.949999999953
23251,2022-08-04 10:35:00,1364.49,366631.51000000234,372527.9700000023,-5896.459999999963
23252,2022-08-04 10:40:00,1180.85,367812.3600000023,372527.9700000023,-4715.609999999986
23253,2022-08-04 10:45:00,1005.6,368817.9600000023,372527.9700000023,-3710.0100000000093
23254,2022-08-04 10:50:00,808.34,369626.3000000023,372527.9700000023,-2901.6699999999837
23255,2022-08-04 10:55:00,1904.27,371530.57000000234,372527.9700000023,-997.3999999999651
23256,2022-08-04 11:00:00,-255.07,371275.5000000023,372527.9700000023,-1252.469999999972
23257,2022-08-04 11:05:00,1736.38,373011.88000000233,372527.9700000023,483.9100000000326
23258,2022-08-04 11:10:00,1807.69,374819.57000000234,372527.9700000023,2291.600000000035
23259,2022-08-04 11:15:00,-1929.65,372889.9200000023,372527.9700000023,361.95000000001164
23260,2022-08-04 11:20:00,-629.15,372260.7700000023,372527.9700000023,-267.20000000001164
23261,2022-08-04 11:25:00,1195.59,373456.3600000023,372527.9700000023,928.390000000014
23262,2022-08-04 11:30:00,-1645.74,371810.6200000023,372527.9700000023,-717.3499999999767
23263,2022-08-04 11:35:00,-1357.75,370452.8700000023,372527.9700000023,-2075.0999999999767
23264,2022-08-04 11:40:00,-1404.88,369047.9900000023,372527.9700000023,-3479.9799999999814
23265,2022-08-04 11:45:00,-169.1,368878.89000000234,372527.9700000023,-3649.079999999958
23266,2022-08-04 11:50:00,-1341.3,367537.59000000235,372527.9700000023,-4990.379999999946
23267,2022-08-04 11:55:00,1132.93,368670.52000000235,372527.9700000023,-3857.4499999999534
23268,2022-08-04 12:00:00,1195.78,369866.3000000024,372527.9700000023,-2661.6699999999255
23269,2022-08-04 12:05:00,132.9,369999.2000000024,372527.9700000023,-2528.769999999902
23270,2022-08-04 12:10:00,-326.27,369672.9300000024,372527.9700000023,-2855.039999999921
23271,2022-08-04 12:15:00,-679.82,368993.1100000024,372527.9700000023,-3534.859999999928
23272,2022-08-04 12:20:00,1412.03,370405.1400000024,372527.9700000023,-2122.8299999999
23273,2022-08-04 12:25:00,-1150.85,369254.2900000024,372527.9700000023,-3273.6799999998766
23274,2022-08-04 12:30:00,-772.26,368482.0300000024,372527.9700000023,-4045.939999999886
23275,2022-08-04 12:35:00,-1900.94,366581.0900000024,372527.9700000023,-5946.879999999888
23276,2022-08-04 12:40:00,1881.64,368462.7300000024,372527.9700000023,-4065.2399999998743
23277,2022-08-04 12:45:00,1712.8,370175.5300000024,372527.9700000023,-2352.439999999886
23278,2022-08-04 12:50:00,-399.48,369776.05000000243,372527.9700000023,-2751.9199999998673
23279,2022-08-04 12:55:00,1704.92,371480.9700000024,372527.9700000023,-1046.9999999998836
23280,2022-08-04 13:00:00,463.7,371944.6700000024,372527.9700000023,-583.2999999998719
23281,2022-08-04 13:05:00,450.61,372395.2800000024,372527.9700000023,-132.6899999998859
23282,2022-08-04 13:10:00,1296.44,373691.7200000024,372527.9700000023,1163.7500000001164
23283,2022-08-04 13:15:00,407.84,374099.56000000244,372527.9700000023,1571.590000000142
23284,2022-08-04 13:20:00,-1987.78,372111.7800000024,372527.9700000023,-416.1899999998859
23285,2022-08-04 13:25:00,-1488.3,370623.4800000024,372527.9700000023,-1904.4899999998743
23286,2022-08-04 13:30:00,1117.29,371740.7700000024,372527.9700000023,-787.1999999998952
23287,2022-08-04 13:35:00,1206.6,372947.3700000024,372527.9700000023,419.4000000000815
23288,2022-08-04 13:40:00,-1786.19,371161.1800000024,372527.9700000023,-1366.7899999999208
23289,2022-08-04 13:45:00,-1422.9,369738.28000000236,372527.9700000023,-2789.689999999944
23290,2022-08-04 13:50:00,440.29,370178.57000000234,372527.9700000023,-2349.399999999965
23291,2022-08-04 13:55:00,1289.25,371467.82000000234,372527.9700000023,-1060.149999999965
23292,2022-08-04 14:00:00,946.55,372414.3700000023,372527.9700000023,-113.59999999997672
23293,2022-08-04 14:05:00,-640.04,371774.33000000234,372527.9700000023,-753.6399999999558
23294,2022-08-04 14:10:00,1811.8,373586.13000000233,372527.9700000023,1058.1600000000326
23295,2022-08-04 14:15:00,-1608.98,371977.15000000235,372527.9700000023,-550.8199999999488
23296,2022-08-04 14:20:00,303.16,372280.3100000023,372527.9700000023,-247.6599999999744
23297,2022-08-04 14:25:00,-204.0,372076.3100000023,372527.9700000023,-451.6599999999744
23298,2022-08-04 14:30:00,1073.9,373150.21000000235,372527.9700000023,622.2400000000489
23299,2022-08-04 14:35:00,-1746.16,371404.0500000024,372527.9700000023,-1123.9199999999255
23300,2022-08-04 14:40:00,727.83,372131.8800000024,372527.9700000023,-396.0899999999092
23301,2022-08-04 14:45:00,-607.87,371524.0100000024,372527.9700000023,-1003.9599999999045
23302,2022-08-04 14:50:00,1620.91,373144.92000000237,372527.9700000023,616.9500000000698
23303,2022-08-04 14:55:00,-973.78,372171.14000000234,372527.9700000023,-356.8299999999581
23304,2022-08-04 15:00:00,-1752.21,370418.9300000023,372527.9700000023,-2109.039999999979
23305,2022-08-04 15:05:00,-822.76,369596.1700000023,372527.9700000023,-2931.7999999999884
23306,2022-08-04 15:10:00,1779.2,371375.3700000023,372527.9700000023,-1152.5999999999767
23307,2022-08-04 15:15:00,1997.05,373372.4200000023,372527.9700000023,844.4500000000116
23308,2022-08-04 15:20:00,-963.57,372408.8500000023,372527.9700000023,-119.11999999999534
23309,2022-08-04 15:25:00,-613.01,371795.8400000023,372527.9700000023,-732.1300000000047
23310,2022-08-04 15:30:00,-1825.93,369969.9100000023,372527.9700000023,-2558.0599999999977
23311,2022-08-04 15:35:00,1773.74,371743.6500000023,372527.9700000023,-784.320000000007
23312,2022-08-04 15:40:00,-402.25,371341.4000000023,372527.9700000023,-1186.570000000007
23313,2022-08-04 15:45:00,-1649.98,369691.4200000023,372527.9700000023,-2836.5499999999884
23314,2022-08-04 15:50:00,-402.29,369289.13000000233,372527.9700000023,-3238.8399999999674
23315,2022-08-04 15:55:00,-799.96,368489.1700000023,372527.9700000023,-4038.7999999999884
23316,2022-08-04 16:00:00,1186.53,369675.70000000234,372527.9700000023,-2852.2699999999604
23317,2022-08-04 16:05:00,1198.16,370873.8600000023,372527.9700000023,-1654.109999999986
23318,2022-08-04 16:10:00,-754.57,370119.2900000023,372527.9700000023,-2408.679999999993
23319,2022-08-04 16:15:00,-162.94,369956.3500000023,372527.9700000023,-2571.6199999999953
23320,2022-08-04 16:20:00,1313.56,371269.9100000023,372527.9700000023,-1258.0599999999977
23321,2022-08-04 16:25:00,-1131.82,370138.0900000023,372527.9700000023,-2389.8800000000047
23322,2022-08-04 16:30:00,1250.11,371388.2000000023,372527.9700000023,-1139.7700000000186
23323,2022-08-04 16:35:00,-948.15,370440.05000000226,372527.9700000023,-2087.920000000042
23324,2022-08-04 16:40:00,189.07,370629.12000000227,372527.9700000023,-1898.850000000035
23325,2022-08-04 16:45:00,-677.54,369951.5800000023,372527.9700000023,-2576.390000000014
23326,2022-08-04 16:50:00,-546.01,369405.5700000023,372527.9700000023,-3122.4000000000233
23327,2022-08-04 16:55:00,-56.78,369348.79000000225,372527.9700000023,-3179.180000000051
23328,2022-08-05 08:00:00,-1671.29,367677.50000000227,369348.79000000225,-1671.289999999979
23329,2022-08-05 08:05:00,-912.89,366764.61000000226,369348.79000000225,-2584.179999999993
23330,2022-08-05 08:10:00,1833.24,368597.85000000225,369348.79000000225,-750.9400000000023
23331,2022-08-05 08:15:00,-1383.44,367214.41000000224,369348.79000000225,-2134.3800000000047
23332,2022-08-05 08:20:00,-1142.15,366072.2600000022,369348.79000000225,-3276.530000000028
23333,2022-08-05 08:25:00,788.11,366860.3700000022,369348.79000000225,-2488.420000000042
23334,2022-08-05 08:30:00,-1113.73,365746.6400000022,369348.79000000225,-3602.1500000000233
23335,2022-08-05 08:35:00,1499.62,367246.2600000022,369348.79000000225,-2102.530000000028
23336,2022-08-05 08:40:00,1348.74,368595.0000000022,369348.79000000225,-753.7900000000373
23337,2022-08-05 08:45:00,-1353.12,367241.8800000022,369348.79000000225,-2106.9100000000326
23338,2022-08-05 08:50:00,142.75,367384.6300000022,369348.79000000225,-1964.1600000000326
23339,2022-08-05 08:55:00,-271.43,367113.2000000022,369348.79000000225,-2235.5900000000256
23340,2022-08-05 09:00:00,883.02,367996.22000000224,369348.79000000225,-1352.570000000007
23341,2022-08-05 09:05:00,-1203.49,366792.73000000225,369348.79000000225,-2556.0599999999977
23342,2022-08-05 09:10:00,826.8,367619.53000000224,369348.79000000225,-1729.2600000000093
23343,2022-08-05 09:15:00,-1019.95,366599.5800000022,369348.79000000225,-2749.210000000021
23344,2022-08-05 09:20:00,938.84,367538.42000000225,369348.79000000225,-1810.3699999999953
23345,2022-08-05 09:25:00,1085.7,368624.12000000227,369348.79000000225,-724.6699999999837
23346,2022-08-05 09:30:00,-1753.67,366870.4500000023,369348.79000000225,-2478.3399999999674
23347,2022-08-05 09:35:00,1498.87,368369.3200000023,369348.79000000225,-979.4699999999721
23348,2022-08-05 09:40:00,-504.56,367864.7600000023,369348.79000000225,-1484.0299999999697
23349,2022-08-05 09:45:00,1403.63,369268.3900000023,369348.79000000225,-80.39999999996508
23350,2022-08-05 09:50:00,-1669.83,367598.56000000227,369348.79000000225,-1750.2299999999814
23351,2022-08-05 09:55:00,1006.75,368605.31000000227,369348.79000000225,-743.4799999999814
23352,2022-08-05 10:00:00,799.33,369404.6400000023,369348.79000000225,55.850000000034925
23353,2022-08-05 10:05:00,1995.88,371400.5200000023,369348.79000000225,2051.7300000000396
23354,2022-08-05 10:10:00,-565.36,370835.1600000023,369348.79000000225,1486.3700000000536
23355,2022-08-05 10:15:00,1224.26,372059.4200000023,369348.79000000225,2710.630000000063
23356,2022-08-05 10:20:00,-1436.95,370622.4700000023,369348.79000000225,1273.6800000000512
23357,2022-08-05 10:25:00,409.13,371031.6000000023,369348.79000000225,1682.8100000000559
23358,2022-08-05 10:30:00,1181.41,372213.0100000023,369348.79000000225,2864.2200000000303
23359,2022-08-05 10:35:00,956.29,373169.30000000226,369348.79000000225,3820.5100000000093
23360,2022-08-05 10:40:00,-1113.75,372055.55000000226,369348.79000000225,2706.7600000000093
23361,2022-08-05 10:45:00,973.61,373029.16000000224,369348.79000000225,3680.3699999999953
23362,2022-08-05 10:50:00,-767.34,372261.8200000022,369348.79000000225,2913.0299999999697
23363,2022-08-05 10:55:00,-1498.13,370763.6900000022,369348.79000000225,1414.899999999965
23364,2022-08-05 11:00:00,-770.81,369992.8800000022,369348.79000000225,644.0899999999674
23365,2022-08-05 11:05:00,156.56,370149.4400000022,369348.79000000225,800.6499999999651
23366,2022-08-05 11:10:00,1165.99,371315.4300000022,369348.79000000225,1966.6399999999558
23367,2022-08-05 11:15:00,-1081.01,370234.4200000022,369348.79000000225,885.6299999999464
23368,2022-08-05 11:20:00,1486.25,371720.6700000022,369348.79000000225,2371.8799999999464
23369,2022-08-05 11:25:00,282.13,372002.8000000022,369348.79000000225,2654.009999999951
23370,2022-08-05 11:30:00,-1207.76,370795.0400000022,369348.79000000225,1446.2499999999418
23371,2022-08-05 11:35:00,-851.52,369943.5200000022,369348.79000000225,594.7299999999232
23372,2022-08-05 11:40:00,-1365.4,368578.12000000215,369348.79000000225,-770.6700000001001
23373,2022-08-05 11:45:00,-630.99,367947.13000000216,369348.79000000225,-1401.6600000000908
23374,2022-08-05 11:50:00,-1315.2,366631.93000000215,369348.79000000225,-2716.8600000001024
23375,2022-08-05 11:55:00,555.37,367187.30000000214,369348.79000000225,-2161.490000000107
23376,2022-08-05 12:00:00,-1337.73,365849.57000000216,369348.79000000225,-3499.2200000000885
23377,2022-08-05 12:05:00,1042.44,366892.01000000216,369348.79000000225,-2456.780000000086
23378,2022-08-05 12:10:00,999.87,367891.88000000216,369348.79000000225,-1456.9100000000908
23379,2022-08-05 12:15:00,1065.69,368957.57000000216,369348.79000000225,-391.2200000000885
23380,2022-08-05 12:20:00,-454.41,368503.1600000022,369348.79000000225,-845.6300000000629
23381,2022-08-05 12:25:00,-1634.79,366868.3700000022,369348.79000000225,-2480.420000000042
23382,2022-08-05 12:30:00,337.67,367206.0400000022,369348.79000000225,-2142.750000000058
23383,2022-08-05 12:35:00,-230.9,366975.14000000217,369348.79000000225,-2373.6500000000815
23384,2022-08-05 12:40:00,1070.85,368045.99000000214,369348.79000000225,-1302.8000000001048
23385,2022-08-05 12:45:00,-700.64,367345.35000000213,369348.79000000225,-2003.4400000001187
23386,2022-08-05 12:50:00,-1963.99,365381.36000000214,369348.79000000225,-3967.4300000001094
23387,2022-08-05 12:55:00,-1688.22,363693.14000000217,369348.79000000225,-5655.6500000000815
23388,2022-08-05 13:00:00,858.15,364551.2900000022,369348.79000000225,-4797.500000000058
23389,2022-08-05 13:05:00,402.62,364953.9100000022,369348.79000000225,-4394.880000000063
23390,2022-08-05 13:10:00,231.78,365185.6900000022,369348.79000000225,-4163.100000000035
23391,2022-08-05 13:15:00,-918.86,364266.8300000022,369348.79000000225,-5081.960000000021
23392,2022-08-05 13:20:00,-1990.73,362276.10000000225,369348.79000000225,-7072.690000000002
23393,2022-08-05 13:25:00,1056.87,363332.97000000224,369348.79000000225,-6015.820000000007
23394,2022-08-05 13:30:00,1538.78,364871.75000000227,369348.79000000225,-4477.039999999979
23395,2022-08-05 13:35:00,1205.77,366077.5200000023,369348.79000000225,-3271.2699999999604
23396,2022-08-05 13:40:00,467.57,366545.0900000023,369348.79000000225,-2803.6999999999534
23397,2022-08-05 13:45:00,1536.15,368081.2400000023,369348.79000000225,-1267.5499999999302
23398,2022-08-05 13:50:00,-1339.08,366742.1600000023,369348.79000000225,-2606.6299999999464
23399,2022-08-05 13:55:00,-1142.09,365600.0700000023,369348.79000000225,-3748.719999999972
23400,2022-08-05 14:00:00,-1968.41,363631.6600000023,369348.79000000225,-5717.129999999946
23401,2022-08-05 14:05:00,1812.27,365443.9300000023,369348.79000000225,-3904.859999999928
23402,2022-08-05 14:10:00,-1775.66,363668.27000000235,369348.79000000225,-5680.519999999902
23403,2022-08-05 14:15:00,-788.84,362879.4300000023,369348.79000000225,-6469.359999999928
23404,2022-08-05 14:20:00,614.23,363493.6600000023,369348.79000000225,-5855.129999999946
23405,2022-08-05 14:25:00,888.04,364381.7000000023,369348.79000000225,-4967.089999999967
23406,2022-08-05 14:30:00,-655.77,363725.93000000226,369348.79000000225,-5622.859999999986
23407,2022-08-05 14:35:00,199.94,363925.87000000227,369348.79000000225,-5422.919999999984
23408,2022-08-05 14:40:00,-1176.77,362749.10000000225,369348.79000000225,-6599.690000000002
23409,2022-08-05 14:45:00,-450.39,362298.71000000223,369348.79000000225,-7050.080000000016
23410,2022-08-05 14:50:00,-823.4,361475.3100000022,369348.79000000225,-7873.48000000004
23411,2022-08-05 14:55:00,517.07,361992.3800000022,369348.79000000225,-7356.410000000033
23412,2022-08-05 15:00:00,1803.8,363796.1800000022,369348.79000000225,-5552.610000000044
23413,2022-08-05 15:05:00,1412.65,365208.8300000022,369348.79000000225,-4139.960000000021
23414,2022-08-05 15:10:00,-799.93,364408.90000000224,369348.79000000225,-4939.890000000014
23415,2022-08-05 15:15:00,-991.48,363417.42000000225,369348.79000000225,-5931.369999999995
23416,2022-08-05 15:20:00,1457.45,364874.87000000227,369348.79000000225,-4473.919999999984
23417,2022-08-05 15:25:00,-1997.67,362877.2000000023,369348.79000000225,-6471.589999999967
23418,2022-08-05 15:30:00,934.04,363811.24000000226,369348.79000000225,-5537.549999999988
23419,2022-08-05 15:35:00,1488.68,365299.92000000225,369348.79000000225,-4048.8699999999953
23420,2022-08-05 15:40:00,1490.91,366790.8300000022,369348.79000000225,-2557.960000000021
23421,2022-08-05 15:45:00,1981.13,368771.96000000223,369348.79000000225,-576.8300000000163
23422,2022-08-05 15:50:00,245.29,369017.2500000022,369348.79000000225,-331.54000000003725
23423,2022-08-05 15:55:00,-935.47,368081.78000000224,369348.79000000225,-1267.0100000000093
23424,2022-08-05 16:00:00,-737.87,367343.91000000224,369348.79000000225,-2004.8800000000047
23425,2022-08-05 16:05:00,-1031.11,366312.80000000226,369348.79000000225,-3035.9899999999907
23426,2022-08-05 16:10:00,1889.85,368202.65000000224,369348.79000000225,-1146.140000000014
23427,2022-08-05 16:15:00,187.11,368389.7600000022,369348.79000000225,-959.0300000000279
23428,2022-08-05 16:20:00,-1313.42,367076.34000000224,369348.79000000225,-2272.4500000000116
23429,2022-08-05 16:25:00,1057.11,368133.4500000022,369348.79000000225,-1215.3400000000256
23430,2022-08-05 16:30:00,-34.73,368098.72000000224,369348.79000000225,-1250.070000000007
23431,2022-08-05 16:35:00,-207.92,367890.80000000226,369348.79000000225,-1457.9899999999907
23432,2022-08-05 16:40:00,-904.41,366986.3900000023,369348.79000000225,-2362.399999999965
23433,2022-08-05 16:45:00,198.18,367184.5700000023,369348.79000000225,-2164.219999999972
23434,2022-08-05 16:50:00,-604.9,366579.67000000225,369348.79000000225,-2769.1199999999953
23435,2022-08-05 16:55:00,1489.35,368069.02000000223,369348.79000000225,-1279.7700000000186
23436,2022-08-06 08:00:00,-652.34,367416.6800000022,368069.02000000223,-652.3400000000256
23437,2022-08-06 08:05:00,1607.44,369024.1200000022,368069.02000000223,955.0999999999767
23438,2022-08-06 08:10:00,-855.49,368168.6300000022,368069.02000000223,99.60999999998603
23439,2022-08-06 08:15:00,-1593.88,366574.7500000022,368069.02000000223,-1494.2700000000186
23440,2022-08-06 08:20:00,-1851.49,364723.2600000022,368069.02000000223,-3345.7600000000093
23441,2022-08-06 08:25:00,815.65,365538.91000000224,368069.02000000223,-2530.109999999986
23442,2022-08-06 08:30:00,-856.75,364682.16000000224,368069.02000000223,-3386.859999999986
23443,2022-08-06 08:35:00,-1896.14,362786.02000000223,368069.02000000223,-5283.0
23444,2022-08-06 08:40:00,21.5,362807.52000000223,368069.02000000223,-5261.5
23445,2022-08-06 08:45:00,712.94,363520.46000000223,368069.02000000223,-4548.559999999998
23446,2022-08-06 08:50:00,-1188.57,362331.8900000022,368069.02000000223,-5737.130000000005
23447,2022-08-06 08:55:00,-1603.98,360727.91000000224,368069.02000000223,-7341.109999999986
23448,2022-08-06 09:00:00,-955.9,359772.0100000022,368069.02000000223,-8297.01000000001
23449,2022-08-06 09:05:00,-1241.97,358530.04000000225,368069.02000000223,-9538.979999999981
23450,2022-08-06 09:10:00,1190.83,359720.87000000227,368069.02000000223,-8348.149999999965
23451,2022-08-06 09:15:00,30.06,359750.93000000226,368069.02000000223,-8318.089999999967
23452,2022-08-06 09:20:00,-1888.17,357862.7600000023,368069.02000000223,-10206.259999999951
23453,2022-08-06 09:25:00,216.09,358078.8500000023,368069.02000000223,-9990.169999999925
23454,2022-08-06 09:30:00,714.25,358793.1000000023,368069.02000000223,-9275.919999999925
23455,2022-08-06 09:35:00,-1037.72,357755.38000000233,368069.02000000223,-10313.639999999898
23456,2022-08-06 09:40:00,-1604.47,356150.91000000236,368069.02000000223,-11918.10999999987
23457,2022-08-06 09:45:00,506.41,356657.32000000234,368069.02000000223,-11411.699999999895
23458,2022-08-06 09:50:00,645.06,357302.38000000233,368069.02000000223,-10766.639999999898
23459,2022-08-06 09:55:00,-442.22,356860.16000000236,368069.02000000223,-11208.85999999987
23460,2022-08-06 10:00:00,-873.42,355986.7400000024,368069.02000000223,-12082.279999999853
23461,2022-08-06 10:05:00,-152.49,355834.2500000024,368069.02000000223,-12234.769999999844
23462,2022-08-06 10:10:00,-1560.97,354273.2800000024,368069.02000000223,-13795.739999999816
23463,2022-08-06 10:15:00,-747.61,353525.6700000024,368069.02000000223,-14543.349999999802
23464,2022-08-06 10:20:00,1950.38,355476.05000000243,368069.02000000223,-12592.969999999797
23465,2022-08-06 10:25:00,1523.4,356999.45000000246,368069.02000000223,-11069.569999999774
23466,2022-08-06 10:30:00,-1709.4,355290.05000000243,368069.02000000223,-12778.969999999797
23467,2022-08-06 10:35:00,893.76,356183.81000000244,368069.02000000223,-11885.209999999788
23468,2022-08-06 10:40:00,-1952.82,354230.99000000244,368069.02000000223,-13838.029999999795
23469,2022-08-06 10:45:00,607.49,354838.4800000024,368069.02000000223,-13230.539999999804
23470,2022-08-06 10:50:00,-1064.29,353774.19000000245,368069.02000000223,-14294.829999999783
23471,2022-08-06 10:55:00,-1945.24,351828.95000000246,368069.02000000223,-16240.069999999774
23472,2022-08-06 11:00:00,876.49,352705.44000000245,368069.02000000223,-15363.579999999783
23473,2022-08-06 11:05:00,1707.08,354412.52000000246,368069.02000000223,-13656.499999999767
23474,2022-08-06 11:10:00,-1587.85,352824.6700000025,368069.02000000223,-15244.349999999744
23475,2022-08-06 11:15:00,617.1,353441.77000000246,368069.02000000223,-14627.249999999767
23476,2022-08-06 11:20:00,1580.89,355022.6600000025,368069.02000000223,-13046.359999999753
23477,2022-08-06 11:25:00,-639.55,354383.1100000025,368069.02000000223,-13685.909999999742
23478,2022-08-06 11:30:00,1693.99,356077.1000000025,368069.02000000223,-11991.91999999975
23479,2022-08-06 11:35:00,1845.06,357922.1600000025,368069.02000000223,-10146.859999999753
23480,2022-08-06 11:40:00,-898.35,357023.8100000025,368069.02000000223,-11045.20999999973
23481,2022-08-06 11:45:00,485.87,357509.6800000025,368069.02000000223,-10559.339999999735
23482,2022-08-06 11:50:00,974.21,358483.8900000025,368069.02000000223,-9585.129999999714
23483,2022-08-06 11:55:00,1721.28,360205.17000000254,368069.02000000223,-7863.849999999686
23484,2022-08-06 12:00:00,-1947.53,358257.6400000025,368069.02000000223,-9811.379999999714
23485,2022-08-06 12:05:00,-121.95,358135.6900000025,368069.02000000223,-9933.329999999725
23486,2022-08-06 12:10:00,-1582.55,356553.1400000025,368069.02000000223,-11515.879999999714
23487,2022-08-06 12:15:00,-1622.9,354930.2400000025,368069.02000000223,-13138.779999999737
23488,2022-08-06 12:20:00,-1051.66,353878.5800000025,368069.02000000223,-14190.439999999711
23489,2022-08-06 12:25:00,588.85,354467.4300000025,368069.02000000223,-13601.589999999735
23490,2022-08-06 12:30:00,1542.96,356010.3900000025,368069.02000000223,-12058.629999999714
23491,2022-08-06 12:35:00,826.8,356837.1900000025,368069.02000000223,-11231.829999999725
23492,2022-08-06 12:40:00,-377.97,356459.22000000253,368069.02000000223,-11609.799999999697
23493,2022-08-06 12:45:00,-403.16,356056.06000000256,368069.02000000223,-12012.959999999672
23494,2022-08-06 12:50:00,1310.45,357366.51000000257,368069.02000000223,-10702.50999999966
23495,2022-08-06 12:55:00,-1930.48,355436.0300000026,368069.02000000223,-12632.989999999641
23496,2022-08-06 13:00:00,-1583.89,353852.1400000026,368069.02000000223,-14216.879999999655
23497,2022-08-06 13:05:00,579.86,354432.00000000256,368069.02000000223,-13637.01999999967
23498,2022-08-06 13:10:00,37.98,354469.98000000254,368069.02000000223,-13599.039999999688
23499,2022-08-06 13:15:00,1113.97,355583.9500000025,368069.02000000223,-12485.069999999716
23500,2022-08-06 13:20:00,1625.9,357209.85000000254,368069.02000000223,-10859.169999999693
23501,2022-08-06 13:25:00,-1809.04,355400.81000000256,368069.02000000223,-12668.209999999672
23502,2022-08-06 13:30:00,-1325.88,354074.93000000255,368069.02000000223,-13994.089999999676
23503,2022-08-06 13:35:00,-1668.74,352406.19000000256,368069.02000000223,-15662.829999999667
23504,2022-08-06 13:40:00,-43.37,352362.82000000257,368069.02000000223,-15706.199999999662
23505,2022-08-06 13:45:00,-165.83,352196.99000000255,368069.02000000223,-15872.029999999679
23506,2022-08-06 13:50:00,681.22,352878.2100000025,368069.02000000223,-15190.809999999707
23507,2022-08-06 13:55:00,1725.48,354603.6900000025,368069.02000000223,-13465.329999999725
23508,2022-08-06 14:00:00,-221.27,354382.4200000025,368069.02000000223,-13686.599999999744
23509,2022-08-06 14:05:00,-1978.56,352403.8600000025,368069.02000000223,-15665.159999999742
23510,2022-08-06 14:10:00,-1149.46,351254.40000000247,368069.02000000223,-16814.619999999763
23511,2022-08-06 14:15:00,-278.14,350976.26000000245,368069.02000000223,-17092.759999999776
23512,2022-08-06 14:20:00,-1644.67,349331.59000000247,368069.02000000223,-18737.42999999976
23513,2022-08-06 14:25:00,-567.55,348764.0400000025,368069.02000000223,-19304.97999999975
23514,2022-08-06 14:30:00,-1756.25,347007.7900000025,368069.02000000223,-21061.22999999975
23515,2022-08-06 14:35:00,-1607.77,345400.02000000246,368069.02000000223,-22668.999999999767
23516,2022-08-06 14:40:00,-449.53,344950.49000000244,368069.02000000223,-23118.529999999795
23517,2022-08-06 14:45:00,1882.45,346832.94000000245,368069.02000000223,-21236.079999999783
23518,2022-08-06 14:50:00,-1361.41,345471.5300000025,368069.02000000223,-22597.489999999758
23519,2022-08-06 14:55:00,-1589.69,343881.84000000247,368069.02000000223,-24187.17999999976
23520,2022-08-06 15:00:00,-1629.93,342251.9100000025,368069.02000000223,-25817.109999999753
23521,2022-08-06 15:05:00,1978.31,344230.2200000025,368069.02000000223,-23838.799999999756
23522,2022-08-06 15:10:00,539.08,344769.3000000025,368069.02000000223,-23299.71999999974
23523,2022-08-06 15:15:00,1123.88,345893.1800000025,368069.02000000223,-22175.839999999735
23524,2022-08-06 15:20:00,660.43,346553.6100000025,368069.02000000223,-21515.40999999974
23525,2022-08-06 15:25:00,1084.22,347637.83000000246,368069.02000000223,-20431.18999999977
23526,2022-08-06 15:30:00,-772.41,346865.4200000025,368069.02000000223,-21203.599999999744
23527,2022-08-06 15:35:00,-102.26,346763.1600000025,368069.02000000223,-21305.859999999753
23528,2022-08-06 15:40:00,-694.79,346068.3700000025,368069.02000000223,-22000.649999999732
23529,2022-08-06 15:45:00,-1055.59,345012.7800000025,368069.02000000223,-23056.239999999758
23530,2022-08-06 15:50:00,-178.4,344834.38000000245,368069.02000000223,-23234.63999999978
23531,2022-08-06 15:55:00,-284.29,344550.09000000247,368069.02000000223,-23518.92999999976
23532,2022-08-06 16:00:00,-1351.79,343198.3000000025,368069.02000000223,-24870.71999999974
23533,2022-08-06 16:05:00,-287.51,342910.7900000025,368069.02000000223,-25158.22999999975
23534,2022-08-06 16:10:00,-1955.17,340955.6200000025,368069.02000000223,-27113.399999999732
23535,2022-08-06 16:15:00,-136.9,340818.7200000025,368069.02000000223,-27250.299999999756
23536,2022-08-06 16:20:00,852.6,341671.32000000245,368069.02000000223,-26397.69999999978
23537,2022-08-06 16:25:00,154.08,341825.40000000247,368069.02000000223,-26243.619999999763
23538,2022-08-06 16:30:00,-450.9,341374.50000000244,368069.02000000223,-26694.519999999786
23539,2022-08-06 16:35:00,356.1,341730.6000000024,368069.02000000223,-26338.41999999981
23540,2022-08-06 16:40:00,-1478.56,340252.0400000024,368069.02000000223,-27816.979999999807
23541,2022-08-06 16:45:00,-634.05,339617.99000000244,368069.02000000223,-28451.029999999795
23542,2022-08-06 16:50:00,274.59,339892.58000000246,368069.02000000223,-28176.43999999977
23543,2022-08-06 16:55:00,1257.24,341149.82000000245,368069.02000000223,-26919.19999999978
23544,2022-08-07 08:00:00,784.93,341934.75000000244,341149.82000000245,784.929999999993
23545,2022-08-07 08:05:00,-554.22,341380.5300000025,341149.82000000245,230.71000000002095
23546,2022-08-07 08:10:00,-247.53,341133.00000000244,341149.82000000245,-16.820000000006985
23547,2022-08-07 08:15:00,-1054.78,340078.2200000024,341149.82000000245,-1071.600000000035
23548,2022-08-07 08:20:00,-319.25,339758.9700000024,341149.82000000245,-1390.850000000035
23549,2022-08-07 08:25:00,-57.28,339701.6900000024,341149.82000000245,-1448.1300000000629
23550,2022-08-07 08:30:00,-1277.11,338424.5800000024,341149.82000000245,-2725.240000000049
23551,2022-08-07 08:35:00,-1753.49,336671.0900000024,341149.82000000245,-4478.73000000004
23552,2022-08-07 08:40:00,6.12,336677.2100000024,341149.82000000245,-4472.610000000044
23553,2022-08-07 08:45:00,874.21,337551.4200000024,341149.82000000245,-3598.4000000000233
23554,2022-08-07 08:50:00,-1469.26,336082.1600000024,341149.82000000245,-5067.660000000033
23555,2022-08-07 08:55:00,-989.95,335092.2100000024,341149.82000000245,-6057.610000000044
23556,2022-08-07 09:00:00,1900.92,336993.1300000024,341149.82000000245,-4156.6900000000605
23557,2022-08-07 09:05:00,1024.53,338017.6600000024,341149.82000000245,-3132.1600000000326
23558,2022-08-07 09:10:00,1445.64,339463.30000000243,341149.82000000245,-1686.5200000000186
23559,2022-08-07 09:15:00,644.09,340107.39000000246,341149.82000000245,-1042.429999999993
23560,2022-08-07 09:20:00,-492.93,339614.46000000247,341149.82000000245,-1535.359999999986
23561,2022-08-07 09:25:00,-1284.44,338330.02000000246,341149.82000000245,-2819.7999999999884
23562,2022-08-07 09:30:00,-1838.95,336491.07000000245,341149.82000000245,-4658.75
23563,2022-08-07 09:35:00,1747.06,338238.13000000245,341149.82000000245,-2911.6900000000023
23564,2022-08-07 09:40:00,897.87,339136.00000000244,341149.82000000245,-2013.820000000007
23565,2022-08-07 09:45:00,-681.04,338454.96000000247,341149.82000000245,-2694.859999999986
23566,2022-08-07 09:50:00,-138.15,338316.81000000244,341149.82000000245,-2833.0100000000093
23567,2022-08-07 09:55:00,-1265.53,337051.2800000024,341149.82000000245,-4098.540000000037
23568,2022-08-07 10:00:00,1087.3,338138.5800000024,341149.82000000245,-3011.240000000049
23569,2022-08-07 10:05:00,1494.78,339633.36000000243,341149.82000000245,-1516.460000000021
23570,2022-08-07 10:10:00,-1712.17,337921.19000000245,341149.82000000245,-3228.6300000000047
23571,2022-08-07 10:15:00,-659.36,337261.83000000246,341149.82000000245,-3887.9899999999907
23572,2022-08-07 10:20:00,1167.51,338429.34000000247,341149.82000000245,-2720.4799999999814
23573,2022-08-07 10:25:00,1210.1,339639.44000000245,341149.82000000245,-1510.3800000000047
23574,2022-08-07 10:30:00,1445.28,341084.7200000025,341149.82000000245,-65.09999999997672
23575,2022-08-07 10:35:00,-901.71,340183.01000000245,341149.82000000245,-966.8099999999977
23576,2022-08-07 10:40:00,1991.51,342174.52000000246,341149.82000000245,1024.7000000000116
23577,2022-08-07 10:45:00,1828.92,344003.44000000245,341149.82000000245,2853.6199999999953
23578,2022-08-07 10:50:00,-889.04,343114.40000000247,341149.82000000245,1964.5800000000163
23579,2022-08-07 10:55:00,-931.48,342182.9200000025,341149.82000000245,1033.100000000035
23580,2022-08-07 11:00:00,726.43,342909.3500000025,341149.82000000245,1759.530000000028
23581,2022-08-07 11:05:00,1367.18,344276.5300000025,341149.82000000245,3126.710000000021
23582,2022-08-07 11:10:00,-475.57,343800.96000000247,341149.82000000245,2651.140000000014
23583,2022-08-07 11:15:00,1960.63,345761.59000000247,341149.82000000245,4611.770000000019
23584,2022-08-07 11:20:00,-727.75,345033.84000000247,341149.82000000245,3884.0200000000186
23585,2022-08-07 11:25:00,-1033.77,344000.07000000245,341149.82000000245,2850.25
23586,2022-08-07 11:30:00,-1303.32,342696.75000000244,341149.82000000245,1546.929999999993
23587,2022-08-07 11:35:00,-714.52,341982.2300000024,341149.82000000245,832.4099999999744
23588,2022-08-07 11:40:00,-1273.06,340709.1700000024,341149.82000000245,-440.6500000000233
23589,2022-08-07 11:45:00,-737.1,339972.07000000245,341149.82000000245,-1177.75
23590,2022-08-07 11:50:00,-101.99,339870.08000000246,341149.82000000245,-1279.7399999999907
23591,2022-08-07 11:55:00,1553.34,341423.4200000025,341149.82000000245,273.6000000000349
23592,2022-08-07 12:00:00,-365.27,341058.15000000247,341149.82000000245,-91.6699999999837
23593,2022-08-07 12:05:00,1425.12,342483.27000000246,341149.82000000245,1333.4500000000116
23594,2022-08-07 12:10:00,-1355.19,341128.08000000246,341149.82000000245,-21.739999999990687
23595,2022-08-07 12:15:00,-1937.07,339191.01000000245,341149.82000000245,-1958.8099999999977
23596,2022-08-07 12:20:00,1091.7,340282.71000000247,341149.82000000245,-867.109999999986
23597,2022-08-07 12:25:00,1850.95,342133.6600000025,341149.82000000245,983.8400000000256
23598,2022-08-07 12:30:00,1331.74,343465.40000000247,341149.82000000245,2315.5800000000163
23599,2022-08-07 12:35:00,-294.81,343170.59000000247,341149.82000000245,2020.7700000000186
23600,2022-08-07 12:40:00,1838.77,345009.3600000025,341149.82000000245,3859.5400000000373
23601,2022-08-07 12:45:00,1209.33,346218.6900000025,341149.82000000245,5068.870000000054
23602,2022-08-07 12:50:00,355.49,346574.1800000025,341149.82000000245,5424.360000000044
23603,2022-08-07 12:55:00,-780.44,345793.7400000025,341149.82000000245,4643.920000000042
23604,2022-08-07 13:00:00,-293.55,345500.1900000025,341149.82000000245,4350.370000000054
23605,2022-08-07 13:05:00,-457.89,345042.3000000025,341149.82000000245,3892.4800000000396
23606,2022-08-07 13:10:00,1112.05,346154.3500000025,341149.82000000245,5004.530000000028
23607,2022-08-07 13:15:00,635.6,346789.95000000246,341149.82000000245,5640.130000000005
23608,2022-08-07 13:20:00,144.79,346934.74000000244,341149.82000000245,5784.919999999984
23609,2022-08-07 13:25:00,358.97,347293.7100000024,341149.82000000245,6143.889999999956
23610,2022-08-07 13:30:00,1264.57,348558.2800000024,341149.82000000245,7408.459999999963
23611,2022-08-07 13:35:00,689.81,349248.0900000024,341149.82000000245,8098.26999999996
23612,2022-08-07 13:40:00,1242.63,350490.7200000024,341149.82000000245,9340.899999999965
23613,2022-08-07 13:45:00,429.9,350920.62000000244,341149.82000000245,9770.799999999988
23614,2022-08-07 13:50:00,576.88,351497.50000000244,341149.82000000245,10347.679999999993
23615,2022-08-07 13:55:00,-1188.79,350308.71000000247,341149.82000000245,9158.890000000014
23616,2022-08-07 14:00:00,-698.39,349610.32000000245,341149.82000000245,8460.5
23617,2022-08-07 14:05:00,-1254.03,348356.2900000024,341149.82000000245,7206.469999999972
23618,2022-08-07 14:10:00,-1459.78,346896.5100000024,341149.82000000245,5746.689999999944
23619,2022-08-07 14:15:00,-1590.59,345305.92000000237,341149.82000000245,4156.0999999999185
23620,2022-08-07 14:20:00,227.96,345533.8800000024,341149.82000000245,4384.0599999999395
23621,2022-08-07 14:25:00,-292.18,345241.7000000024,341149.82000000245,4091.8799999999464
23622,2022-08-07 14:30:00,-1154.7,344087.0000000024,341149.82000000245,2937.179999999935
23623,2022-08-07 14:35:00,1046.23,345133.23000000237,341149.82000000245,3983.409999999916
23624,2022-08-07 14:40:00,-1397.72,343735.5100000024,341149.82000000245,2585.689999999944
23625,2022-08-07 14:45:00,287.04,344022.5500000024,341149.82000000245,2872.729999999923
23626,2022-08-07 14:50:00,1920.35,345942.90000000235,341149.82000000245,4793.0799999999
23627,2022-08-07 14:55:00,497.38,346440.28000000236,341149.82000000245,5290.4599999999045
23628,2022-08-07 15:00:00,-942.23,345498.0500000024,341149.82000000245,4348.229999999923
23629,2022-08-07 15:05:00,1804.96,347303.0100000024,341149.82000000245,6153.189999999944
23630,2022-08-07 15:10:00,-659.33,346643.6800000024,341149.82000000245,5493.859999999928
23631,2022-08-07 15:15:00,-1500.64,345143.04000000237,341149.82000000245,3993.219999999914
23632,2022-08-07 15:20:00,-19.38,345123.66000000236,341149.82000000245,3973.839999999909
23633,2022-08-07 15:25:00,-1790.93,343332.73000000237,341149.82000000245,2182.909999999916
23634,2022-08-07 15:30:00,6.15,343338.8800000024,341149.82000000245,2189.0599999999395
23635,2022-08-07 15:35:00,1551.22,344890.10000000236,341149.82000000245,3740.2799999999115
23636,2022-08-07 15:40:00,-75.96,344814.14000000234,341149.82000000245,3664.3199999998906
23637,2022-08-07 15:45:00,-1017.91,343796.23000000237,341149.82000000245,2646.409999999916
23638,2022-08-07 15:50:00,647.62,344443.85000000236,341149.82000000245,3294.0299999999115
23639,2022-08-07 15:55:00,-708.77,343735.08000000234,341149.82000000245,2585.259999999893
23640,2022-08-07 16:00:00,1791.88,345526.96000000235,341149.82000000245,4377.139999999898
23641,2022-08-07 16:05:00,674.62,346201.58000000234,341149.82000000245,5051.759999999893
23642,2022-08-07 16:10:00,-637.44,345564.14000000234,341149.82000000245,4414.319999999891
23643,2022-08-07 16:15:00,-185.78,345378.3600000023,341149.82000000245,4228.539999999863
23644,2022-08-07 16:20:00,-813.65,344564.7100000023,341149.82000000245,3414.8899999998393
23645,2022-08-07 16:25:00,933.28,345497.9900000023,341149.82000000245,4348.169999999867
23646,2022-08-07 16:30:00,-1569.57,343928.4200000023,341149.82000000245,2778.5999999998603
23647,2022-08-07 16:35:00,1714.79,345643.2100000023,341149.82000000245,4493.389999999839
23648,2022-08-07 16:40:00,-1461.16,344182.0500000023,341149.82000000245,3032.229999999865
23649,2022-08-07 16:45:00,350.28,344532.33000000234,341149.82000000245,3382.509999999893
23650,2022-08-07 16:50:00,1354.12,345886.45000000234,341149.82000000245,4736.629999999888
23651,2022-08-07 16:55:00,64.51,345950.96000000235,341149.82000000245,4801.139999999898
23652,2022-08-08 08:00:00,-402.58,345548.38000000233,345950.96000000235,-402.5800000000163
23653,2022-08-08 08:05:00,1579.37,347127.7500000023,345950.96000000235,1176.789999999979
23654,2022-08-08 08:10:00,397.27,347525.02000000235,345950.96000000235,1574.0599999999977
23655,2022-08-08 08:15:00,-235.52,347289.5000000023,345950.96000000235,1338.539999999979
23656,2022-08-08 08:20:00,836.44,348125.94000000233,345950.96000000235,2174.9799999999814
23657,2022-08-08 08:25:00,1269.46,349395.40000000235,345950.96000000235,3444.4400000000023
23658,2022-08-08 08:30:00,-1401.82,347993.58000000234,345950.96000000235,2042.6199999999953
23659,2022-08-08 08:35:00,-1883.36,346110.22000000236,345950.96000000235,159.2600000000093
23660,2022-08-08 08:40:00,335.32,346445.54000000237,345950.96000000235,494.5800000000163
23661,2022-08-08 08:45:00,885.03,347330.5700000024,345950.96000000235,1379.6100000000442
23662,2022-08-08 08:50:00,-13.05,347317.5200000024,345950.96000000235,1366.5600000000559
23663,2022-08-08 08:55:00,-1196.29,346121.2300000024,345950.96000000235,170.27000000007683
23664,2022-08-08 09:00:00,-1089.62,345031.61000000243,345950.96000000235,-919.3499999999185
23665,2022-08-08 09:05:00,1688.86,346720.4700000024,345950.96000000235,769.5100000000675
23666,2022-08-08 09:10:00,259.95,346980.4200000024,345950.96000000235,1029.4600000000792
23667,2022-08-08 09:15:00,-1060.09,345920.3300000024,345950.96000000235,-30.62999999994645
23668,2022-08-08 09:20:00,1294.11,347214.4400000024,345950.96000000235,1263.4800000000396
23669,2022-08-08 09:25:00,643.01,347857.4500000024,345950.96000000235,1906.490000000049
23670,2022-08-08 09:30:00,-277.17,347580.2800000024,345950.96000000235,1629.3200000000652
23671,2022-08-08 09:35:00,-1909.32,345670.9600000024,345950.96000000235,-279.9999999999418
23672,2022-08-08 09:40:00,-1319.93,344351.0300000024,345950.96000000235,-1599.9299999999348
23673,2022-08-08 09:45:00,1150.82,345501.8500000024,345950.96000000235,-449.1099999999278
23674,2022-08-08 09:50:00,1581.29,347083.1400000024,345950.96000000235,1132.1800000000512
23675,2022-08-08 09:55:00,-1718.96,345364.1800000024,345950.96000000235,-586.7799999999697
23676,2022-08-08 10:00:00,-463.81,344900.3700000024,345950.96000000235,-1050.5899999999674
23677,2022-08-08 10:05:00,-1832.38,343067.9900000024,345950.96000000235,-2882.969999999972
23678,2022-08-08 10:10:00,1931.86,344999.85000000236,345950.96000000235,-951.109999999986
23679,2022-08-08 10:15:00,-1605.99,343393.8600000024,345950.96000000235,-2557.0999999999767
23680,2022-08-08 10:20:00,1829.93,345223.79000000237,345950.96000000235,-727.1699999999837
23681,2022-08-08 10:25:00,-1093.41,344130.3800000024,345950.96000000235,-1820.579999999958
23682,2022-08-08 10:30:00,1348.22,345478.60000000236,345950.96000000235,-472.35999999998603
23683,2022-08-08 10:35:00,1858.12,347336.72000000236,345950.96000000235,1385.7600000000093
23684,2022-08-08 10:40:00,1366.36,348703.08000000234,345950.96000000235,2752.1199999999953
23685,2022-08-08 10:45:00,1475.65,350178.73000000237,345950.96000000235,4227.770000000019
23686,2022-08-08 10:50:00,1123.11,351301.84000000235,345950.96000000235,5350.880000000005
23687,2022-08-08 10:55:00,-1556.86,349744.98000000237,345950.96000000235,3794.0200000000186
23688,2022-08-08 11:00:00,-1689.9,348055.08000000234,345950.96000000235,2104.1199999999953
23689,2022-08-08 11:05:00,-452.44,347602.64000000234,345950.96000000235,1651.679999999993
23690,2022-08-08 11:10:00,1270.39,348873.03000000236,345950.96000000235,2922.070000000007
23691,2022-08-08 11:15:00,1625.68,350498.71000000235,345950.96000000235,4547.75
23692,2022-08-08 11:20:00,-256.07,350242.64000000234,345950.96000000235,4291.679999999993
23693,2022-08-08 11:25:00,960.64,351203.28000000236,345950.96000000235,5252.320000000007
23694,2022-08-08 11:30:00,-1667.72,349535.5600000024,345950.96000000235,3584.600000000035
23695,2022-08-08 11:35:00,805.78,350341.3400000024,345950.96000000235,4390.380000000063
23696,2022-08-08 11:40:00,1511.51,351852.8500000024,345950.96000000235,5901.890000000072
23697,2022-08-08 11:45:00,200.62,352053.4700000024,345950.96000000235,6102.5100000000675
23698,2022-08-08 11:50:00,708.93,352762.4000000024,345950.96000000235,6811.4400000000605
23699,2022-08-08 11:55:00,-676.01,352086.3900000024,345950.96000000235,6135.430000000051
23700,2022-08-08 12:00:00,605.17,352691.5600000024,345950.96000000235,6740.600000000035
23701,2022-08-08 12:05:00,-76.84,352614.72000000236,345950.96000000235,6663.760000000009
23702,2022-08-08 12:10:00,-1690.72,350924.0000000024,345950.96000000235,4973.040000000037
23703,2022-08-08 12:15:00,-1658.38,349265.6200000024,345950.96000000235,3314.6600000000326
23704,2022-08-08 12:20:00,946.3,350211.92000000237,345950.96000000235,4260.960000000021
23705,2022-08-08 12:25:00,-1165.35,349046.5700000024,345950.96000000235,3095.6100000000442
23706,2022-08-08 12:30:00,-1781.15,347265.42000000237,345950.96000000235,1314.460000000021
23707,2022-08-08 12:35:00,817.03,348082.4500000024,345950.96000000235,2131.490000000049
23708,2022-08-08 12:40:00,123.06,348205.5100000024,345950.96000000235,2254.5500000000466
23709,2022-08-08 12:45:00,1446.24,349651.7500000024,345950.96000000235,3700.7900000000373
23710,2022-08-08 12:50:00,-1862.28,347789.47000000236,345950.96000000235,1838.5100000000093
23711,2022-08-08 12:55:00,-351.96,347437.51000000234,345950.96000000235,1486.5499999999884
23712,2022-08-08 13:00:00,380.69,347818.20000000234,345950.96000000235,1867.2399999999907
23713,2022-08-08 13:05:00,-1714.33,346103.8700000023,345950.96000000235,152.9099999999744
23714,2022-08-08 13:10:00,1393.92,347497.7900000023,345950.96000000235,1546.829999999958
23715,2022-08-08 13:15:00,-1322.97,346174.82000000234,345950.96000000235,223.85999999998603
23716,2022-08-08 13:20:00,827.82,347002.64000000234,345950.96000000235,1051.679999999993
23717,2022-08-08 13:25:00,-5.13,346997.51000000234,345950.96000000235,1046.5499999999884
23718,2022-08-08 13:30:00,-59.26,346938.2500000023,345950.96000000235,987.289999999979
23719,2022-08-08 13:35:00,1632.55,348570.8000000023,345950.96000000235,2619.8399999999674
23720,2022-08-08 13:40:00,-1774.59,346796.2100000023,345950.96000000235,845.2499999999418
23721,2022-08-08 13:45:00,373.59,347169.8000000023,345950.96000000235,1218.8399999999674
23722,2022-08-08 13:50:00,-1017.51,346152.2900000023,345950.96000000235,201.3299999999581
23723,2022-08-08 13:55:00,-1011.81,345140.4800000023,345950.96000000235,-810.4800000000396
23724,2022-08-08 14:00:00,1613.61,346754.0900000023,345950.96000000235,803.1299999999464
23725,2022-08-08 14:05:00,737.72,347491.81000000227,345950.96000000235,1540.8499999999185
23726,2022-08-08 14:10:00,-897.05,346594.7600000023,345950.96000000235,643.7999999999302
23727,2022-08-08 14:15:00,-1402.01,345192.75000000227,345950.96000000235,-758.2100000000792
23728,2022-08-08 14:20:00,-286.68,344906.0700000023,345950.96000000235,-1044.8900000000722
23729,2022-08-08 14:25:00,-1599.31,343306.7600000023,345950.96000000235,-2644.20000000007
23730,2022-08-08 14:30:00,-1645.36,341661.4000000023,345950.96000000235,-4289.560000000056
23731,2022-08-08 14:35:00,1810.04,343471.4400000023,345950.96000000235,-2479.520000000077
23732,2022-08-08 14:40:00,1638.78,345110.2200000023,345950.96000000235,-840.7400000000489
23733,2022-08-08 14:45:00,-1272.03,343838.1900000023,345950.96000000235,-2112.770000000077
23734,2022-08-08 14:50:00,-872.27,342965.92000000225,345950.96000000235,-2985.0400000000955
23735,2022-08-08 14:55:00,-906.48,342059.4400000023,345950.96000000235,-3891.520000000077
23736,2022-08-08 15:00:00,281.58,342341.0200000023,345950.96000000235,-3609.9400000000605
23737,2022-08-08 15:05:00,1459.48,343800.50000000227,345950.96000000235,-2150.460000000079
23738,2022-08-08 15:10:00,1533.03,345333.5300000023,345950.96000000235,-617.4300000000512
23739,2022-08-08 15:15:00,186.01,345519.5400000023,345950.96000000235,-431.4200000000419
23740,2022-08-08 15:20:00,1013.82,346533.3600000023,345950.96000000235,582.3999999999651
23741,2022-08-08 15:25:00,530.69,347064.0500000023,345950.96000000235,1113.0899999999674
23742,2022-08-08 15:30:00,479.97,347544.0200000023,345950.96000000235,1593.0599999999395
23743,2022-08-08 15:35:00,-881.36,346662.6600000023,345950.96000000235,711.6999999999534
23744,2022-08-08 15:40:00,1725.92,348388.5800000023,345950.96000000235,2437.619999999937
23745,2022-08-08 15:45:00,-911.67,347476.9100000023,345950.96000000235,1525.9499999999534
23746,2022-08-08 15:50:00,187.0,347663.9100000023,345950.96000000235,1712.9499999999534
23747,2022-08-08 15:55:00,1354.35,349018.2600000023,345950.96000000235,3067.29999999993
23748,2022-08-08 16:00:00,-1204.73,347813.5300000023,345950.96000000235,1862.5699999999488
23749,2022-08-08 16:05:00,1074.14,348887.6700000023,345950.96000000235,2936.7099999999627
23750,2022-08-08 16:10:00,560.74,349448.4100000023,345950.96000000235,3497.4499999999534
23751,2022-08-08 16:15:00,1428.84,350877.2500000023,345950.96000000235,4926.289999999979
23752,2022-08-08 16:20:00,801.13,351678.38000000233,345950.96000000235,5727.419999999984
23753,2022-08-08 16:25:00,-1793.25,349885.13000000233,345950.96000000235,3934.1699999999837
23754,2022-08-08 16:30:00,-1810.89,348074.2400000023,345950.96000000235,2123.2799999999697
23755,2022-08-08 16:35:00,-143.03,347931.2100000023,345950.96000000235,1980.2499999999418
23756,2022-08-08 16:40:00,1567.22,349498.43000000226,345950.96000000235,3547.469999999914
23757,2022-08-08 16:45:00,-467.13,349031.30000000226,345950.96000000235,3080.339999999909
23758,2022-08-08 16:50:00,-943.86,348087.4400000023,345950.96000000235,2136.479999999923
23759,2022-08-08 16:55:00,1360.73,349448.17000000225,345950.96000000235,3497.2099999999045
23760,2022-08-09 08:00:00,-1323.11,348125.06000000227,349448.17000000225,-1323.109999999986
23761,2022-08-09 08:05:00,1693.0,349818.06000000227,349448.17000000225,369.89000000001397
23762,2022-08-09 08:10:00,453.16,350271.22000000224,349448.17000000225,823.0499999999884
23763,2022-08-09 08:15:00,-56.77,350214.4500000022,349448.17000000225,766.2799999999697
23764,2022-08-09 08:20:00,-550.78,349663.6700000022,349448.17000000225,215.4999999999418
23765,2022-08-09 08:25:00,1091.98,350755.6500000022,349448.17000000225,1307.4799999999232
23766,2022-08-09 08:30:00,382.53,351138.1800000022,349448.17000000225,1690.009999999951
23767,2022-08-09 08:35:00,-785.74,350352.4400000022,349448.17000000225,904.2699999999604
23768,2022-08-09 08:40:00,-1303.9,349048.5400000022,349448.17000000225,-399.63000000006286
23769,2022-08-09 08:45:00,-352.0,348696.5400000022,349448.17000000225,-751.6300000000629
23770,2022-08-09 08:50:00,1031.33,349727.8700000022,349448.17000000225,279.69999999995343
23771,2022-08-09 08:55:00,1404.69,351132.5600000022,349448.17000000225,1684.3899999999558
23772,2022-08-09 09:00:00,-1099.19,350033.3700000022,349448.17000000225,585.1999999999534
23773,2022-08-09 09:05:00,-607.04,349426.3300000022,349448.17000000225,-21.84000000002561
23774,2022-08-09 09:10:00,418.81,349845.1400000022,349448.17000000225,396.96999999997206
23775,2022-08-09 09:15:00,-1180.84,348664.3000000022,349448.17000000225,-783.8700000000536
23776,2022-08-09 09:20:00,1397.49,350061.7900000022,349448.17000000225,613.6199999999371
23777,2022-08-09 09:25:00,972.74,351034.5300000022,349448.17000000225,1586.3599999999278
23778,2022-08-09 09:30:00,935.3,351969.83000000217,349448.17000000225,2521.659999999916
23779,2022-08-09 09:35:00,-1826.44,350143.39000000217,349448.17000000225,695.2199999999139
23780,2022-08-09 09:40:00,1270.07,351413.4600000022,349448.17000000225,1965.2899999999208
23781,2022-08-09 09:45:00,-1891.06,349522.4000000022,349448.17000000225,74.22999999992317
23782,2022-08-09 09:50:00,-1413.96,348108.44000000216,349448.17000000225,-1339.7300000000978
23783,2022-08-09 09:55:00,-1224.09,346884.35000000213,349448.17000000225,-2563.8200000001234
23784,2022-08-09 10:00:00,1988.09,348872.44000000216,349448.17000000225,-575.7300000000978
23785,2022-08-09 10:05:00,-1305.77,347566.67000000214,349448.17000000225,-1881.5000000001164
23786,2022-08-09 10:10:00,-312.53,347254.1400000021,349448.17000000225,-2194.0300000001444
23787,2022-08-09 10:15:00,-1716.75,345537.3900000021,349448.17000000225,-3910.7800000001444
23788,2022-08-09 10:20:00,-1041.17,344496.2200000021,349448.17000000225,-4951.950000000128
23789,2022-08-09 10:25:00,271.77,344767.99000000214,349448.17000000225,-4680.180000000109
23790,2022-08-09 10:30:00,-1003.56,343764.43000000215,349448.17000000225,-5683.740000000107
23791,2022-08-09 10:35:00,-588.82,343175.61000000214,349448.17000000225,-6272.560000000114
23792,2022-08-09 10:40:00,1289.25,344464.86000000214,349448.17000000225,-4983.310000000114
23793,2022-08-09 10:45:00,-1510.03,342954.8300000021,349448.17000000225,-6493.340000000142
23794,2022-08-09 10:50:00,1733.45,344688.2800000021,349448.17000000225,-4759.89000000013
23795,2022-08-09 10:55:00,-1351.73,343336.55000000214,349448.17000000225,-6111.620000000112
23796,2022-08-09 11:00:00,-625.14,342711.4100000021,349448.17000000225,-6736.760000000126
23797,2022-08-09 11:05:00,-769.41,341942.00000000215,349448.17000000225,-7506.1700000001
23798,2022-08-09 11:10:00,-462.77,341479.23000000214,349448.17000000225,-7968.940000000119
23799,2022-08-09 11:15:00,928.65,342407.88000000216,349448.17000000225,-7040.2900000000955
23800,2022-08-09 11:20:00,966.11,343373.99000000214,349448.17000000225,-6074.180000000109
23801,2022-08-09 11:25:00,-177.34,343196.6500000021,349448.17000000225,-6251.520000000135
23802,2022-08-09 11:30:00,-899.34,342297.3100000021,349448.17000000225,-7150.860000000161
23803,2022-08-09 11:35:00,501.54,342798.8500000021,349448.17000000225,-6649.320000000182
23804,2022-08-09 11:40:00,1358.37,344157.22000000207,349448.17000000225,-5290.950000000186
23805,2022-08-09 11:45:00,-1988.51,342168.71000000206,349448.17000000225,-7279.460000000196
23806,2022-08-09 11:50:00,1756.64,343925.3500000021,349448.17000000225,-5522.820000000182
23807,2022-08-09 11:55:00,-718.62,343206.7300000021,349448.17000000225,-6241.440000000177
23808,2022-08-09 12:00:00,1665.12,344871.8500000021,349448.17000000225,-4576.320000000182
23809,2022-08-09 12:05:00,1752.74,346624.59000000206,349448.17000000225,-2823.580000000191
23810,2022-08-09 12:10:00,349.82,346974.41000000207,349448.17000000225,-2473.760000000184
23811,2022-08-09 12:15:00,-1042.89,345931.52000000206,349448.17000000225,-3516.650000000198
23812,2022-08-09 12:20:00,-1684.15,344247.37000000203,349448.17000000225,-5200.800000000221
23813,2022-08-09 12:25:00,-1075.04,343172.33000000205,349448.17000000225,-6275.8400000002
23814,2022-08-09 12:30:00,-5.48,343166.8500000021,349448.17000000225,-6281.320000000182
23815,2022-08-09 12:35:00,-264.36,342902.4900000021,349448.17000000225,-6545.680000000168
23816,2022-08-09 12:40:00,442.39,343344.8800000021,349448.17000000225,-6103.290000000154
23817,2022-08-09 12:45:00,1615.5,344960.3800000021,349448.17000000225,-4487.790000000154
23818,2022-08-09 12:50:00,-1925.57,343034.8100000021,349448.17000000225,-6413.360000000161
23819,2022-08-09 12:55:00,1796.75,344831.5600000021,349448.17000000225,-4616.610000000161
23820,2022-08-09 13:00:00,-1947.66,342883.9000000021,349448.17000000225,-6564.270000000135
23821,2022-08-09 13:05:00,314.86,343198.7600000021,349448.17000000225,-6249.410000000149
23822,2022-08-09 13:10:00,-1918.52,341280.2400000021,349448.17000000225,-8167.930000000168
23823,2022-08-09 13:15:00,540.24,341820.4800000021,349448.17000000225,-7627.690000000177
23824,2022-08-09 13:20:00,-1220.11,340600.3700000021,349448.17000000225,-8847.800000000163
23825,2022-08-09 13:25:00,-433.22,340167.1500000021,349448.17000000225,-9281.020000000135
23826,2022-08-09 13:30:00,1619.71,341786.86000000214,349448.17000000225,-7661.310000000114
23827,2022-08-09 13:35:00,-1391.88,340394.98000000214,349448.17000000225,-9053.190000000119
23828,2022-08-09 13:40:00,768.84,341163.82000000216,349448.17000000225,-8284.350000000093
23829,2022-08-09 13:45:00,-716.26,340447.56000000215,349448.17000000225,-9000.610000000102
23830,2022-08-09 13:50:00,-592.81,339854.75000000215,349448.17000000225,-9593.4200000001
23831,2022-08-09 13:55:00,1944.01,341798.76000000216,349448.17000000225,-7649.410000000091
23832,2022-08-09 14:00:00,757.49,342556.25000000215,349448.17000000225,-6891.9200000001
23833,2022-08-09 14:05:00,920.49,343476.74000000214,349448.17000000225,-5971.430000000109
23834,2022-08-09 14:10:00,1021.08,344497.82000000216,349448.17000000225,-4950.350000000093
23835,2022-08-09 14:15:00,-1290.91,343206.9100000022,349448.17000000225,-6241.2600000000675
23836,2022-08-09 14:20:00,1239.58,344446.4900000022,349448.17000000225,-5001.680000000051
23837,2022-08-09 14:25:00,-660.6,343785.8900000022,349448.17000000225,-5662.280000000028
23838,2022-08-09 14:30:00,-1007.79,342778.10000000225,349448.17000000225,-6670.070000000007
23839,2022-08-09 14:35:00,-419.94,342358.16000000224,349448.17000000225,-7090.010000000009
23840,2022-08-09 14:40:00,1240.79,343598.9500000022,349448.17000000225,-5849.22000000003
23841,2022-08-09 14:45:00,-324.09,343274.8600000022,349448.17000000225,-6173.310000000056
23842,2022-08-09 14:50:00,-1924.92,341349.9400000022,349448.17000000225,-8098.23000000004
23843,2022-08-09 14:55:00,-1259.35,340090.59000000224,349448.17000000225,-9357.580000000016
23844,2022-08-09 15:00:00,629.08,340719.67000000225,349448.17000000225,-8728.5
23845,2022-08-09 15:05:00,1228.42,341948.09000000224,349448.17000000225,-7500.080000000016
23846,2022-08-09 15:10:00,-1508.85,340439.24000000226,349448.17000000225,-9008.929999999993
23847,2022-08-09 15:15:00,-1317.8,339121.4400000023,349448.17000000225,-10326.729999999981
23848,2022-08-09 15:20:00,-1355.46,337765.98000000225,349448.17000000225,-11682.190000000002
23849,2022-08-09 15:25:00,-1705.71,336060.27000000223,349448.17000000225,-13387.900000000023
23850,2022-08-09 15:30:00,153.39,336213.66000000224,349448.17000000225,-13234.51000000001
23851,2022-08-09 15:35:00,1999.22,338212.8800000022,349448.17000000225,-11235.290000000037
23852,2022-08-09 15:40:00,519.84,338732.72000000224,349448.17000000225,-10715.450000000012
23853,2022-08-09 15:45:00,1035.87,339768.59000000224,349448.17000000225,-9679.580000000016
23854,2022-08-09 15:50:00,-701.88,339066.71000000223,349448.17000000225,-10381.460000000021
23855,2022-08-09 15:55:00,-306.47,338760.24000000226,349448.17000000225,-10687.929999999993
23856,2022-08-09 16:00:00,-461.11,338299.1300000023,349448.17000000225,-11149.039999999979
23857,2022-08-09 16:05:00,-1006.2,337292.93000000226,349448.17000000225,-12155.23999999999
23858,2022-08-09 16:10:00,1088.17,338381.10000000225,349448.17000000225,-11067.070000000007
23859,2022-08-09 16:15:00,1958.56,340339.66000000224,349448.17000000225,-9108.51000000001
23860,2022-08-09 16:20:00,1054.32,341393.98000000225,349448.17000000225,-8054.190000000002
23861,2022-08-09 16:25:00,-789.06,340604.92000000225,349448.17000000225,-8843.25
23862,2022-08-09 16:30:00,1667.3,342272.22000000224,349448.17000000225,-7175.950000000012
23863,2022-08-09 16:35:00,-1870.76,340401.46000000223,349448.17000000225,-9046.710000000021
23864,2022-08-09 16:40:00,554.39,340955.85000000225,349448.17000000225,-8492.320000000007
23865,2022-08-09 16:45:00,-136.75,340819.10000000225,349448.17000000225,-8629.070000000007
23866,2022-08-09 16:50:00,-1191.83,339627.27000000223,349448.17000000225,-9820.900000000023
23867,2022-08-09 16:55:00,-1528.04,338099.23000000225,349448.17000000225,-11348.940000000002
23868,2022-08-10 08:00:00,-512.9,337586.3300000022,338099.23000000225,-512.9000000000233
23869,2022-08-10 08:05:00,-154.35,337431.98000000225,338099.23000000225,-667.25
23870,2022-08-10 08:10:00,481.59,337913.5700000023,338099.23000000225,-185.6599999999744
23871,2022-08-10 08:15:00,306.1,338219.67000000225,338099.23000000225,120.44000000000233
23872,2022-08-10 08:20:00,1384.71,339604.3800000023,338099.23000000225,1505.1500000000233
23873,2022-08-10 08:25:00,-1543.98,338060.4000000023,338099.23000000225,-38.82999999995809
23874,2022-08-10 08:30:00,-1416.92,336643.4800000023,338099.23000000225,-1455.7499999999418
23875,2022-08-10 08:35:00,1422.6,338066.0800000023,338099.23000000225,-33.149999999965075
23876,2022-08-10 08:40:00,1747.13,339813.2100000023,338099.23000000225,1713.9800000000396
23877,2022-08-10 08:45:00,-782.46,339030.75000000227,338099.23000000225,931.5200000000186
23878,2022-08-10 08:50:00,-1435.34,337595.41000000224,338099.23000000225,-503.820000000007
23879,2022-08-10 08:55:00,-99.29,337496.12000000227,338099.23000000225,-603.109999999986
23880,2022-08-10 09:00:00,-1890.59,335605.53000000224,338099.23000000225,-2493.7000000000116
23881,2022-08-10 09:05:00,609.98,336215.5100000022,338099.23000000225,-1883.7200000000303
23882,2022-08-10 09:10:00,-1485.57,334729.9400000022,338099.23000000225,-3369.2900000000373
23883,2022-08-10 09:15:00,1246.07,335976.0100000022,338099.23000000225,-2123.2200000000303
23884,2022-08-10 09:20:00,-433.85,335542.16000000224,338099.23000000225,-2557.070000000007
23885,2022-08-10 09:25:00,187.79,335729.9500000022,338099.23000000225,-2369.280000000028
23886,2022-08-10 09:30:00,770.33,336500.28000000224,338099.23000000225,-1598.9500000000116
23887,2022-08-10 09:35:00,131.68,336631.96000000223,338099.23000000225,-1467.2700000000186
23888,2022-08-10 09:40:00,1068.23,337700.1900000022,338099.23000000225,-399.04000000003725
23889,2022-08-10 09:45:00,-805.46,336894.7300000022,338099.23000000225,-1204.5000000000582
23890,2022-08-10 09:50:00,-1039.15,335855.58000000217,338099.23000000225,-2243.6500000000815
23891,2022-08-10 09:55:00,119.1,335974.68000000215,338099.23000000225,-2124.550000000105
23892,2022-08-10 10:00:00,-1897.68,334077.00000000215,338099.23000000225,-4022.230000000098
23893,2022-08-10 10:05:00,-1141.86,332935.14000000217,338099.23000000225,-5164.090000000084
23894,2022-08-10 10:10:00,1652.01,334587.1500000022,338099.23000000225,-3512.0800000000745
23895,2022-08-10 10:15:00,166.88,334754.0300000022,338099.23000000225,-3345.20000000007
23896,2022-08-10 10:20:00,-1762.19,332991.8400000022,338099.23000000225,-5107.390000000072
23897,2022-08-10 10:25:00,-537.39,332454.45000000217,338099.23000000225,-5644.780000000086
23898,2022-08-10 10:30:00,1598.37,334052.82000000216,338099.23000000225,-4046.410000000091
23899,2022-08-10 10:35:00,-1821.0,332231.82000000216,338099.23000000225,-5867.410000000091
23900,2022-08-10 10:40:00,804.95,333036.7700000022,338099.23000000225,-5062.460000000079
23901,2022-08-10 10:45:00,-89.22,332947.5500000022,338099.23000000225,-5151.680000000051
23902,2022-08-10 10:50:00,1186.7,334134.2500000022,338099.23000000225,-3964.9800000000396
23903,2022-08-10 10:55:00,1597.4,335731.65000000224,338099.23000000225,-2367.5800000000163
23904,2022-08-10 11:00:00,601.62,336333.27000000223,338099.23000000225,-1765.960000000021
23905,2022-08-10 11:05:00,1280.69,337613.96000000223,338099.23000000225,-485.2700000000186
23906,2022-08-10 11:10:00,-872.13,336741.8300000022,338099.23000000225,-1357.4000000000233
23907,2022-08-10 11:15:00,-1355.49,335386.34000000224,338099.23000000225,-2712.890000000014
23908,2022-08-10 11:20:00,-1040.36,334345.98000000225,338099.23000000225,-3753.25
23909,2022-08-10 11:25:00,317.1,334663.0800000022,338099.23000000225,-3436.1500000000233
23910,2022-08-10 11:30:00,303.35,334966.4300000022,338099.23000000225,-3132.8000000000466
23911,2022-08-10 11:35:00,1744.33,336710.7600000022,338099.23000000225,-1388.4700000000303
23912,2022-08-10 11:40:00,-395.7,336315.0600000022,338099.23000000225,-1784.170000000042
23913,2022-08-10 11:45:00,1118.88,337433.9400000022,338099.23000000225,-665.2900000000373
23914,2022-08-10 11:50:00,-1483.2,335950.7400000022,338099.23000000225,-2148.490000000049
23915,2022-08-10 11:55:00,-1800.99,334149.7500000022,338099.23000000225,-3949.4800000000396
23916,2022-08-10 12:00:00,-1485.43,332664.3200000022,338099.23000000225,-5434.910000000033
23917,2022-08-10 12:05:00,-726.11,331938.21000000223,338099.23000000225,-6161.020000000019
23918,2022-08-10 12:10:00,401.71,332339.92000000225,338099.23000000225,-5759.309999999998
23919,2022-08-10 12:15:00,1131.35,333471.27000000223,338099.23000000225,-4627.960000000021
23920,2022-08-10 12:20:00,-344.72,333126.55000000226,338099.23000000225,-4972.679999999993
23921,2022-08-10 12:25:00,-1.01,333125.54000000225,338099.23000000225,-4973.690000000002
23922,2022-08-10 12:30:00,-322.23,332803.31000000227,338099.23000000225,-5295.919999999984
23923,2022-08-10 12:35:00,1678.49,334481.80000000226,338099.23000000225,-3617.429999999993
23924,2022-08-10 12:40:00,-605.35,333876.4500000023,338099.23000000225,-4222.77999999997
23925,2022-08-10 12:45:00,-96.42,333780.0300000023,338099.23000000225,-4319.199999999953
23926,2022-08-10 12:50:00,58.86,333838.8900000023,338099.23000000225,-4260.339999999967
23927,2022-08-10 12:55:00,22.83,333861.7200000023,338099.23000000225,-4237.509999999951
23928,2022-08-10 13:00:00,-1000.66,332861.0600000023,338099.23000000225,-5238.1699999999255
23929,2022-08-10 13:05:00,893.65,333754.71000000235,338099.23000000225,-4344.519999999902
23930,2022-08-10 13:10:00,-74.26,333680.45000000234,338099.23000000225,-4418.7799999999115
23931,2022-08-10 13:15:00,-179.43,333501.02000000235,338099.23000000225,-4598.2099999999045
23932,2022-08-10 13:20:00,1746.22,335247.2400000023,338099.23000000225,-2851.9899999999325
23933,2022-08-10 13:25:00,-1037.55,334209.69000000233,338099.23000000225,-3889.539999999921
23934,2022-08-10 13:30:00,-57.99,334151.70000000234,338099.23000000225,-3947.5299999999115
23935,2022-08-10 13:35:00,-1964.59,332187.1100000023,338099.23000000225,-5912.119999999937
23936,2022-08-10 13:40:00,-1537.54,330649.57000000234,338099.23000000225,-7449.659999999916
23937,2022-08-10 13:45:00,-34.11,330615.46000000235,338099.23000000225,-7483.769999999902
23938,2022-08-10 13:50:00,-730.53,329884.9300000023,338099.23000000225,-8214.29999999993
23939,2022-08-10 13:55:00,-1255.49,328629.44000000233,338099.23000000225,-9469.78999999992
23940,2022-08-10 14:00:00,-1514.54,327114.90000000235,338099.23000000225,-10984.3299999999
23941,2022-08-10 14:05:00,-1667.1,325447.8000000024,338099.23000000225,-12651.429999999877
23942,2022-08-10 14:10:00,172.46,325620.2600000024,338099.23000000225,-12478.969999999856
23943,2022-08-10 14:15:00,88.9,325709.1600000024,338099.23000000225,-12390.069999999832
23944,2022-08-10 14:20:00,1756.21,327465.37000000244,338099.23000000225,-10633.859999999811
23945,2022-08-10 14:25:00,191.52,327656.89000000246,338099.23000000225,-10442.339999999793
23946,2022-08-10 14:30:00,-1598.67,326058.2200000025,338099.23000000225,-12041.009999999776
23947,2022-08-10 14:35:00,1136.01,327194.2300000025,338099.23000000225,-10904.999999999767
23948,2022-08-10 14:40:00,-251.1,326943.1300000025,338099.23000000225,-11156.099999999744
23949,2022-08-10 14:45:00,932.7,327875.8300000025,338099.23000000225,-10223.399999999732
23950,2022-08-10 14:50:00,-1013.07,326862.7600000025,338099.23000000225,-11236.46999999974
23951,2022-08-10 14:55:00,-265.89,326596.8700000025,338099.23000000225,-11502.359999999753
23952,2022-08-10 15:00:00,1188.2,327785.0700000025,338099.23000000225,-10314.159999999742
23953,2022-08-10 15:05:00,-543.96,327241.1100000025,338099.23000000225,-10858.119999999763
23954,2022-08-10 15:10:00,55.36,327296.4700000025,338099.23000000225,-10802.759999999776
23955,2022-08-10 15:15:00,-478.65,326817.82000000245,338099.23000000225,-11281.4099999998
23956,2022-08-10 15:20:00,-136.47,326681.3500000025,338099.23000000225,-11417.879999999772
23957,2022-08-10 15:25:00,86.98,326768.33000000246,338099.23000000225,-11330.89999999979
23958,2022-08-10 15:30:00,1087.4,327855.7300000025,338099.23000000225,-10243.499999999767
23959,2022-08-10 15:35:00,983.4,328839.1300000025,338099.23000000225,-9260.099999999744
23960,2022-08-10 15:40:00,1978.66,330817.7900000025,338099.23000000225,-7281.4399999997695
23961,2022-08-10 15:45:00,1853.7,332671.4900000025,338099.23000000225,-5427.739999999758
23962,2022-08-10 15:50:00,-510.09,332161.40000000247,338099.23000000225,-5937.8299999997835
23963,2022-08-10 15:55:00,-1422.93,330738.4700000025,338099.23000000225,-7360.7599999997765
23964,2022-08-10 16:00:00,-1374.03,329364.44000000245,338099.23000000225,-8734.789999999804
23965,2022-08-10 16:05:00,-308.74,329055.70000000246,338099.23000000225,-9043.529999999795
23966,2022-08-10 16:10:00,-1681.85,327373.8500000025,338099.23000000225,-10725.379999999772
23967,2022-08-10 16:15:00,-551.66,326822.1900000025,338099.23000000225,-11277.039999999746
23968,2022-08-10 16:20:00,-119.53,326702.6600000025,338099.23000000225,-11396.569999999774
23969,2022-08-10 16:25:00,-1351.55,325351.1100000025,338099.23000000225,-12748.119999999763
23970,2022-08-10 16:30:00,1420.94,326772.0500000025,338099.23000000225,-11327.17999999976
23971,2022-08-10 16:35:00,-14.16,326757.8900000025,338099.23000000225,-11341.339999999735
23972,2022-08-10 16:40:00,-593.78,326164.1100000025,338099.23000000225,-11935.119999999763
23973,2022-08-10 16:45:00,1830.39,327994.5000000025,338099.23000000225,-10104.729999999749
23974,2022-08-10 16:50:00,-1806.41,326188.0900000025,338099.23000000225,-11911.139999999723
23975,2022-08-10 16:55:00,1408.06,327596.1500000025,338099.23000000225,-10503.079999999725
23976,2022-08-11 08:00:00,559.46,328155.61000000255,327596.1500000025,559.460000000021
23977,2022-08-11 08:05:00,-1382.6,326773.01000000257,327596.1500000025,-823.1399999999558
23978,2022-08-11 08:10:00,-433.44,326339.57000000257,327596.1500000025,-1256.579999999958
23979,2022-08-11 08:15:00,1060.96,327400.5300000026,327596.1500000025,-195.61999999993714
23980,2022-08-11 08:20:00,-1710.39,325690.1400000026,327596.1500000025,-1906.009999999951
23981,2022-08-11 08:25:00,755.11,326445.25000000256,327596.1500000025,-1150.899999999965
23982,2022-08-11 08:30:00,-129.86,326315.3900000026,327596.1500000025,-1280.759999999951
23983,2022-08-11 08:35:00,-1635.49,324679.9000000026,327596.1500000025,-2916.249999999942
23984,2022-08-11 08:40:00,-1609.44,323070.4600000026,327596.1500000025,-4525.689999999944
23985,2022-08-11 08:45:00,293.26,323363.7200000026,327596.1500000025,-4232.429999999935
23986,2022-08-11 08:50:00,393.37,323757.0900000026,327596.1500000025,-3839.0599999999395
23987,2022-08-11 08:55:00,-262.54,323494.5500000026,327596.1500000025,-4101.5999999999185
23988,2022-08-11 09:00:00,403.1,323897.6500000026,327596.1500000025,-3698.499999999942
23989,2022-08-11 09:05:00,-1029.61,322868.0400000026,327596.1500000025,-4728.109999999928
23990,2022-08-11 09:10:00,-1371.66,321496.3800000026,327596.1500000025,-6099.769999999902
23991,2022-08-11 09:15:00,662.0,322158.3800000026,327596.1500000025,-5437.769999999902
23992,2022-08-11 09:20:00,-690.88,321467.5000000026,327596.1500000025,-6128.649999999907
23993,2022-08-11 09:25:00,1932.65,323400.15000000264,327596.1500000025,-4195.999999999884
23994,2022-08-11 09:30:00,249.38,323649.53000000265,327596.1500000025,-3946.619999999879
23995,2022-08-11 09:35:00,-733.11,322916.42000000266,327596.1500000025,-4679.729999999865
23996,2022-08-11 09:40:00,1057.86,323974.28000000265,327596.1500000025,-3621.869999999879
23997,2022-08-11 09:45:00,-1893.67,322080.61000000266,327596.1500000025,-5515.539999999863
23998,2022-08-11 09:50:00,-1168.52,320912.09000000264,327596.1500000025,-6684.059999999881
23999,2022-08-11 09:55:00,545.17,321457.2600000026,327596.1500000025,-6138.889999999898
24000,2022-08-11 10:00:00,691.86,322149.1200000026,327596.1500000025,-5447.0299999999115
24001,2022-08-11 10:05:00,1592.03,323741.15000000264,327596.1500000025,-3854.9999999998836
24002,2022-08-11 10:10:00,-565.95,323175.20000000263,327596.1500000025,-4420.949999999895
24003,2022-08-11 10:15:00,1578.01,324753.21000000264,327596.1500000025,-2842.939999999886
24004,2022-08-11 10:20:00,-932.75,323820.46000000264,327596.1500000025,-3775.689999999886
24005,2022-08-11 10:25:00,1294.68,325115.14000000263,327596.1500000025,-2481.009999999893
24006,2022-08-11 10:30:00,-1086.02,324029.1200000026,327596.1500000025,-3567.0299999999115
24007,2022-08-11 10:35:00,-834.84,323194.2800000026,327596.1500000025,-4401.869999999937
24008,2022-08-11 10:40:00,-978.59,322215.69000000256,327596.1500000025,-5380.459999999963
24009,2022-08-11 10:45:00,-987.06,321228.63000000257,327596.1500000025,-6367.51999999996
24010,2022-08-11 10:50:00,-607.05,320621.5800000026,327596.1500000025,-6974.569999999949
24011,2022-08-11 10:55:00,1501.56,322123.1400000026,327596.1500000025,-5473.009999999951
24012,2022-08-11 11:00:00,1844.76,323967.9000000026,327596.1500000025,-3628.249999999942
24013,2022-08-11 11:05:00,781.98,324749.88000000257,327596.1500000025,-2846.2699999999604
24014,2022-08-11 11:10:00,1456.34,326206.2200000026,327596.1500000025,-1389.9299999999348
24015,2022-08-11 11:15:00,-1985.85,324220.3700000026,327596.1500000025,-3375.7799999999115
24016,2022-08-11 11:20:00,1751.55,325971.9200000026,327596.1500000025,-1624.2299999999232
24017,2022-08-11 11:25:00,1933.03,327904.95000000263,327596.1500000025,308.8000000001048
24018,2022-08-11 11:30:00,1892.95,329797.90000000264,327596.1500000025,2201.7500000001164
24019,2022-08-11 11:35:00,1063.32,330861.22000000265,327596.1500000025,3265.0700000001234
24020,2022-08-11 11:40:00,1152.79,332014.0100000026,327596.1500000025,4417.860000000102
24021,2022-08-11 11:45:00,-216.1,331797.91000000265,327596.1500000025,4201.760000000126
24022,2022-08-11 11:50:00,-712.68,331085.23000000266,327596.1500000025,3489.0800000001327
24023,2022-08-11 11:55:00,1641.7,332726.93000000267,327596.1500000025,5130.780000000144
24024,2022-08-11 12:00:00,1885.03,334611.9600000027,327596.1500000025,7015.810000000172
24025,2022-08-11 12:05:00,373.58,334985.5400000027,327596.1500000025,7389.390000000189
24026,2022-08-11 12:10:00,311.07,335296.6100000027,327596.1500000025,7700.460000000196
24027,2022-08-11 12:15:00,-286.66,335009.95000000275,327596.1500000025,7413.800000000221
24028,2022-08-11 12:20:00,1904.45,336914.40000000276,327596.1500000025,9318.250000000233
24029,2022-08-11 12:25:00,415.63,337330.03000000276,327596.1500000025,9733.880000000237
24030,2022-08-11 12:30:00,1973.42,339303.45000000275,327596.1500000025,11707.300000000221
24031,2022-08-11 12:35:00,-144.93,339158.52000000275,327596.1500000025,11562.370000000228
24032,2022-08-11 12:40:00,-143.27,339015.25000000274,327596.1500000025,11419.10000000021
24033,2022-08-11 12:45:00,1217.0,340232.25000000274,327596.1500000025,12636.10000000021
24034,2022-08-11 12:50:00,747.87,340980.12000000273,327596.1500000025,13383.970000000205
24035,2022-08-11 12:55:00,744.51,341724.63000000274,327596.1500000025,14128.480000000214
24036,2022-08-11 13:00:00,-1879.21,339845.4200000027,327596.1500000025,12249.270000000193
24037,2022-08-11 13:05:00,-1336.29,338509.13000000274,327596.1500000025,10912.980000000214
24038,2022-08-11 13:10:00,1138.1,339647.2300000027,327596.1500000025,12051.080000000191
24039,2022-08-11 13:15:00,1079.03,340726.26000000275,327596.1500000025,13130.110000000219
24040,2022-08-11 13:20:00,-1304.87,339421.39000000275,327596.1500000025,11825.240000000224
24041,2022-08-11 13:25:00,-1825.55,337595.84000000276,327596.1500000025,9999.690000000235
24042,2022-08-11 13:30:00,-1182.82,336413.02000000275,327596.1500000025,8816.870000000228
24043,2022-08-11 13:35:00,-1944.56,334468.46000000276,327596.1500000025,6872.3100000002305
24044,2022-08-11 13:40:00,111.79,334580.25000000274,327596.1500000025,6984.10000000021
24045,2022-08-11 13:45:00,1494.37,336074.62000000273,327596.1500000025,8478.470000000205
24046,2022-08-11 13:50:00,-178.77,335895.8500000027,327596.1500000025,8299.700000000186
24047,2022-08-11 13:55:00,-238.78,335657.0700000027,327596.1500000025,8060.920000000158
24048,2022-08-11 14:00:00,1833.53,337490.6000000027,327596.1500000025,9894.450000000186
24049,2022-08-11 14:05:00,-1893.37,335597.2300000027,327596.1500000025,8001.080000000191
24050,2022-08-11 14:10:00,1316.51,336913.7400000027,327596.1500000025,9317.5900000002
24051,2022-08-11 14:15:00,1190.71,338104.45000000275,327596.1500000025,10508.300000000221
24052,2022-08-11 14:20:00,1342.98,339447.4300000027,327596.1500000025,11851.280000000203
24053,2022-08-11 14:25:00,1180.37,340627.8000000027,327596.1500000025,13031.650000000198
24054,2022-08-11 14:30:00,1756.59,342384.39000000275,327596.1500000025,14788.240000000224
24055,2022-08-11 14:35:00,595.91,342980.3000000027,327596.1500000025,15384.150000000198
24056,2022-08-11 14:40:00,-861.86,342118.44000000274,327596.1500000025,14522.290000000212
24057,2022-08-11 14:45:00,942.16,343060.6000000027,327596.1500000025,15464.450000000186
24058,2022-08-11 14:50:00,252.99,343313.5900000027,327596.1500000025,15717.440000000177
24059,2022-08-11 14:55:00,67.98,343381.5700000027,327596.1500000025,15785.420000000158
24060,2022-08-11 15:00:00,279.93,343661.5000000027,327596.1500000025,16065.350000000151
24061,2022-08-11 15:05:00,-1849.7,341811.80000000267,327596.1500000025,14215.65000000014
24062,2022-08-11 15:10:00,1283.91,343095.71000000264,327596.1500000025,15499.560000000114
24063,2022-08-11 15:15:00,328.88,343424.59000000264,327596.1500000025,15828.440000000119
24064,2022-08-11 15:20:00,1487.07,344911.66000000265,327596.1500000025,17315.510000000126
24065,2022-08-11 15:25:00,-1644.52,343267.14000000263,327596.1500000025,15670.990000000107
24066,2022-08-11 15:30:00,-982.16,342284.98000000266,327596.1500000025,14688.830000000133
24067,2022-08-11 15:35:00,720.33,343005.3100000027,327596.1500000025,15409.160000000149
24068,2022-08-11 15:40:00,-1478.58,341526.73000000266,327596.1500000025,13930.580000000133
24069,2022-08-11 15:45:00,-58.18,341468.55000000267,327596.1500000025,13872.40000000014
24070,2022-08-11 15:50:00,-718.95,340749.60000000265,327596.1500000025,13153.450000000128
24071,2022-08-11 15:55:00,-1153.75,339595.85000000265,327596.1500000025,11999.700000000128
24072,2022-08-11 16:00:00,-206.64,339389.21000000264,327596.1500000025,11793.060000000114
24073,2022-08-11 16:05:00,1788.99,341178.20000000263,327596.1500000025,13582.050000000105
24074,2022-08-11 16:10:00,308.63,341486.83000000264,327596.1500000025,13890.68000000011
24075,2022-08-11 16:15:00,1215.48,342702.3100000026,327596.1500000025,15106.16000000009
24076,2022-08-11 16:20:00,1691.52,344393.83000000264,327596.1500000025,16797.68000000011
24077,2022-08-11 16:25:00,1214.43,345608.2600000026,327596.1500000025,18012.110000000102
24078,2022-08-11 16:30:00,573.32,346181.58000000264,327596.1500000025,18585.43000000011
24079,2022-08-11 16:35:00,-9.12,346172.46000000264,327596.1500000025,18576.310000000114
24080,2022-08-11 16:40:00,-214.63,345957.83000000264,327596.1500000025,18361.68000000011
24081,2022-08-11 16:45:00,1204.21,347162.04000000266,327596.1500000025,19565.89000000013
24082,2022-08-11 16:50:00,1023.57,348185.61000000266,327596.1500000025,20589.460000000137
24083,2022-08-11 16:55:00,1690.22,349875.83000000264,327596.1500000025,22279.68000000011
24084,2022-08-12 08:00:00,1363.04,351238.8700000026,349875.83000000264,1363.039999999979
24085,2022-08-12 08:05:00,-313.94,350924.9300000026,349875.83000000264,1049.0999999999767
24086,2022-08-12 08:10:00,934.07,351859.0000000026,349875.83000000264,1983.1699999999837
24087,2022-08-12 08:15:00,1091.75,352950.7500000026,349875.83000000264,3074.9199999999837
24088,2022-08-12 08:20:00,488.49,353439.2400000026,349875.83000000264,3563.4099999999744
24089,2022-08-12 08:25:00,1793.92,355233.1600000026,349875.83000000264,5357.329999999958
24090,2022-08-12 08:30:00,-280.66,354952.5000000026,349875.83000000264,5076.669999999984
24091,2022-08-12 08:35:00,-725.23,354227.27000000264,349875.83000000264,4351.440000000002
24092,2022-08-12 08:40:00,-946.98,353280.29000000266,349875.83000000264,3404.460000000021
24093,2022-08-12 08:45:00,165.29,353445.58000000264,349875.83000000264,3569.75
24094,2022-08-12 08:50:00,1789.81,355235.39000000263,349875.83000000264,5359.559999999998
24095,2022-08-12 08:55:00,-1495.37,353740.02000000264,349875.83000000264,3864.1900000000023
24096,2022-08-12 09:00:00,163.38,353903.40000000264,349875.83000000264,4027.570000000007
24097,2022-08-12 09:05:00,-950.22,352953.18000000267,349875.83000000264,3077.350000000035
24098,2022-08-12 09:10:00,-1241.99,351711.1900000027,349875.83000000264,1835.3600000000442
24099,2022-08-12 09:15:00,1375.97,353087.16000000265,349875.83000000264,3211.3300000000163
24100,2022-08-12 09:20:00,1441.3,354528.46000000264,349875.83000000264,4652.630000000005
24101,2022-08-12 09:25:00,-1517.03,353011.4300000026,349875.83000000264,3135.5999999999767
24102,2022-08-12 09:30:00,-273.03,352738.4000000026,349875.83000000264,2862.569999999949
24103,2022-08-12 09:35:00,161.67,352900.07000000257,349875.83000000264,3024.2399999999325
24104,2022-08-12 09:40:00,-178.29,352721.7800000026,349875.83000000264,2845.9499999999534
24105,2022-08-12 09:45:00,-1435.51,351286.2700000026,349875.83000000264,1410.4399999999441
24106,2022-08-12 09:50:00,-1635.43,349650.8400000026,349875.83000000264,-224.9900000000489
24107,2022-08-12 09:55:00,-1182.07,348468.7700000026,349875.83000000264,-1407.0600000000559
24108,2022-08-12 10:00:00,1596.03,350064.8000000026,349875.83000000264,188.96999999997206
24109,2022-08-12 10:05:00,-1967.24,348097.5600000026,349875.83000000264,-1778.2700000000186
24110,2022-08-12 10:10:00,1136.54,349234.1000000026,349875.83000000264,-641.7300000000396
24111,2022-08-12 10:15:00,-582.11,348651.9900000026,349875.83000000264,-1223.8400000000256
24112,2022-08-12 10:20:00,956.25,349608.2400000026,349875.83000000264,-267.5900000000256
24113,2022-08-12 10:25:00,137.63,349745.8700000026,349875.83000000264,-129.96000000002095
24114,2022-08-12 10:30:00,1996.77,351742.64000000263,349875.83000000264,1866.8099999999977
24115,2022-08-12 10:35:00,1734.24,353476.8800000026,349875.83000000264,3601.0499999999884
24116,2022-08-12 10:40:00,-1200.58,352276.3000000026,349875.83000000264,2400.469999999972
24117,2022-08-12 10:45:00,-1445.75,350830.5500000026,349875.83000000264,954.7199999999721
24118,2022-08-12 10:50:00,-1675.01,349155.5400000026,349875.83000000264,-720.2900000000373
24119,2022-08-12 10:55:00,-637.67,348517.8700000026,349875.83000000264,-1357.960000000021
24120,2022-08-12 11:00:00,108.59,348626.46000000264,349875.83000000264,-1249.3699999999953
24121,2022-08-12 11:05:00,-1323.47,347302.99000000267,349875.83000000264,-2572.8399999999674
24122,2022-08-12 11:10:00,1885.84,349188.8300000027,349875.83000000264,-686.9999999999418
24123,2022-08-12 11:15:00,421.17,349610.0000000027,349875.83000000264,-265.8299999999581
24124,2022-08-12 11:20:00,-788.38,348821.6200000027,349875.83000000264,-1054.2099999999627
24125,2022-08-12 11:25:00,-1433.64,347387.98000000266,349875.83000000264,-2487.8499999999767
24126,2022-08-12 11:30:00,-693.87,346694.11000000266,349875.83000000264,-3181.719999999972
24127,2022-08-12 11:35:00,-177.35,346516.7600000027,349875.83000000264,-3359.069999999949
24128,2022-08-12 11:40:00,-1765.91,344750.8500000027,349875.83000000264,-5124.979999999923
24129,2022-08-12 11:45:00,-617.52,344133.3300000027,349875.83000000264,-5742.499999999942
24130,2022-08-12 11:50:00,410.67,344544.0000000027,349875.83000000264,-5331.829999999958
24131,2022-08-12 11:55:00,1615.37,346159.3700000027,349875.83000000264,-3716.4599999999627
24132,2022-08-12 12:00:00,1708.9,347868.2700000027,349875.83000000264,-2007.5599999999395
24133,2022-08-12 12:05:00,-1723.18,346145.0900000027,349875.83000000264,-3730.7399999999325
24134,2022-08-12 12:10:00,-219.65,345925.4400000027,349875.83000000264,-3950.3899999999558
24135,2022-08-12 12:15:00,248.47,346173.91000000265,349875.83000000264,-3701.9199999999837
24136,2022-08-12 12:20:00,1012.55,347186.46000000264,349875.83000000264,-2689.3699999999953
24137,2022-08-12 12:25:00,-162.56,347023.90000000264,349875.83000000264,-2851.929999999993
24138,2022-08-12 12:30:00,-978.34,346045.5600000026,349875.83000000264,-3830.2700000000186
24139,2022-08-12 12:35:00,1572.02,347617.58000000264,349875.83000000264,-2258.25
24140,2022-08-12 12:40:00,951.32,348568.90000000264,349875.83000000264,-1306.929999999993
24141,2022-08-12 12:45:00,452.36,349021.2600000026,349875.83000000264,-854.570000000007
24142,2022-08-12 12:50:00,-1040.73,347980.53000000265,349875.83000000264,-1895.2999999999884
24143,2022-08-12 12:55:00,1611.01,349591.54000000266,349875.83000000264,-284.28999999997905
24144,2022-08-12 13:00:00,1186.37,350777.91000000265,349875.83000000264,902.0800000000163
24145,2022-08-12 13:05:00,-838.0,349939.91000000265,349875.83000000264,64.0800000000163
24146,2022-08-12 13:10:00,-1356.24,348583.67000000266,349875.83000000264,-1292.1599999999744
24147,2022-08-12 13:15:00,1693.15,350276.8200000027,349875.83000000264,400.9900000000489
24148,2022-08-12 13:20:00,-353.06,349923.7600000027,349875.83000000264,47.93000000005122
24149,2022-08-12 13:25:00,-1000.54,348923.2200000027,349875.83000000264,-952.6099999999278
24150,2022-08-12 13:30:00,-775.42,348147.8000000027,349875.83000000264,-1728.0299999999115
24151,2022-08-12 13:35:00,-1107.84,347039.9600000027,349875.83000000264,-2835.869999999937
24152,2022-08-12 13:40:00,-1733.25,345306.7100000027,349875.83000000264,-4569.119999999937
24153,2022-08-12 13:45:00,888.24,346194.9500000027,349875.83000000264,-3680.8799999999464
24154,2022-08-12 13:50:00,1114.46,347309.4100000027,349875.83000000264,-2566.4199999999255
24155,2022-08-12 13:55:00,-250.75,347058.6600000027,349875.83000000264,-2817.1699999999255
24156,2022-08-12 14:00:00,-515.21,346543.4500000027,349875.83000000264,-3332.3799999999464
24157,2022-08-12 14:05:00,-1283.05,345260.4000000027,349875.83000000264,-4615.429999999935
24158,2022-08-12 14:10:00,1825.77,347086.1700000027,349875.83000000264,-2789.659999999916
24159,2022-08-12 14:15:00,1592.97,348679.1400000027,349875.83000000264,-1196.6899999999441
24160,2022-08-12 14:20:00,1445.06,350124.2000000027,349875.83000000264,248.37000000005355
24161,2022-08-12 14:25:00,-1587.39,348536.8100000027,349875.83000000264,-1339.0199999999604
24162,2022-08-12 14:30:00,114.3,348651.11000000266,349875.83000000264,-1224.719999999972
24163,2022-08-12 14:35:00,-739.55,347911.5600000027,349875.83000000264,-1964.2699999999604
24164,2022-08-12 14:40:00,823.28,348734.8400000027,349875.83000000264,-1140.9899999999325
24165,2022-08-12 14:45:00,1372.73,350107.5700000027,349875.83000000264,231.7400000000489
24166,2022-08-12 14:50:00,-1361.17,348746.4000000027,349875.83000000264,-1129.4299999999348
24167,2022-08-12 14:55:00,-1845.19,346901.2100000027,349875.83000000264,-2974.619999999937
24168,2022-08-12 15:00:00,-1114.41,345786.8000000027,349875.83000000264,-4089.0299999999115
24169,2022-08-12 15:05:00,-221.19,345565.6100000027,349875.83000000264,-4310.219999999914
24170,2022-08-12 15:10:00,-1005.35,344560.26000000275,349875.83000000264,-5315.569999999891
24171,2022-08-12 15:15:00,400.59,344960.85000000277,349875.83000000264,-4914.979999999865
24172,2022-08-12 15:20:00,1423.85,346384.70000000275,349875.83000000264,-3491.1299999998882
24173,2022-08-12 15:25:00,1246.17,347630.87000000273,349875.83000000264,-2244.9599999999045
24174,2022-08-12 15:30:00,-1454.27,346176.6000000027,349875.83000000264,-3699.229999999923
24175,2022-08-12 15:35:00,1572.01,347748.6100000027,349875.83000000264,-2127.219999999914
24176,2022-08-12 15:40:00,656.12,348404.7300000027,349875.83000000264,-1471.0999999999185
24177,2022-08-12 15:45:00,1783.39,350188.12000000273,349875.83000000264,312.29000000009546
24178,2022-08-12 15:50:00,-946.33,349241.7900000027,349875.83000000264,-634.0399999999208
24179,2022-08-12 15:55:00,81.9,349323.69000000274,349875.83000000264,-552.1399999998976
24180,2022-08-12 16:00:00,1942.67,351266.3600000027,349875.83000000264,1390.5300000000861
24181,2022-08-12 16:05:00,300.51,351566.87000000273,349875.83000000264,1691.0400000000955
24182,2022-08-12 16:10:00,733.15,352300.02000000275,349875.83000000264,2424.1900000001187
24183,2022-08-12 16:15:00,1633.76,353933.78000000276,349875.83000000264,4057.950000000128
24184,2022-08-12 16:20:00,-713.54,353220.2400000028,349875.83000000264,3344.410000000149
24185,2022-08-12 16:25:00,-686.3,352533.9400000028,349875.83000000264,2658.1100000001607
24186,2022-08-12 16:30:00,-1812.81,350721.1300000028,349875.83000000264,845.300000000163
24187,2022-08-12 16:35:00,1616.49,352337.6200000028,349875.83000000264,2461.7900000001537
24188,2022-08-12 16:40:00,890.6,353228.22000000277,349875.83000000264,3352.3900000001304
24189,2022-08-12 16:45:00,-1033.64,352194.58000000275,349875.83000000264,2318.7500000001164
24190,2022-08-12 16:50:00,584.18,352778.76000000275,349875.83000000264,2902.9300000001094
24191,2022-08-12 16:55:00,-1961.13,350817.63000000274,349875.83000000264,941.8000000001048
24192,2022-08-13 08:00:00,-385.81,350431.82000000274,350817.63000000274,-385.8099999999977
24193,2022-08-13 08:05:00,-1540.29,348891.53000000276,350817.63000000274,-1926.0999999999767
24194,2022-08-13 08:10:00,1326.16,350217.69000000274,350817.63000000274,-599.9400000000023
24195,2022-08-13 08:15:00,409.42,350627.1100000027,350817.63000000274,-190.52000000001863
24196,2022-08-13 08:20:00,-1693.52,348933.5900000027,350817.63000000274,-1884.0400000000373
24197,2022-08-13 08:25:00,1316.8,350250.3900000027,350817.63000000274,-567.2400000000489
24198,2022-08-13 08:30:00,379.5,350629.8900000027,350817.63000000274,-187.7400000000489
24199,2022-08-13 08:35:00,-671.36,349958.5300000027,350817.63000000274,-859.1000000000349
24200,2022-08-13 08:40:00,-1943.27,348015.2600000027,350817.63000000274,-2802.3700000000536
24201,2022-08-13 08:45:00,-1455.92,346559.3400000027,350817.63000000274,-4258.290000000037
24202,2022-08-13 08:50:00,1905.63,348464.9700000027,350817.63000000274,-2352.6600000000326
24203,2022-08-13 08:55:00,-1890.36,346574.6100000027,350817.63000000274,-4243.020000000019
24204,2022-08-13 09:00:00,-1582.23,344992.38000000274,350817.63000000274,-5825.25
24205,2022-08-13 09:05:00,645.04,345637.4200000027,350817.63000000274,-5180.210000000021
24206,2022-08-13 09:10:00,106.26,345743.6800000027,350817.63000000274,-5073.950000000012
24207,2022-08-13 09:15:00,-1052.79,344690.89000000275,350817.63000000274,-6126.739999999991
24208,2022-08-13 09:20:00,1691.32,346382.21000000276,350817.63000000274,-4435.419999999984
24209,2022-08-13 09:25:00,-402.14,345980.07000000274,350817.63000000274,-4837.559999999998
24210,2022-08-13 09:30:00,-1628.7,344351.37000000273,350817.63000000274,-6466.260000000009
24211,2022-08-13 09:35:00,-173.27,344178.1000000027,350817.63000000274,-6639.530000000028
24212,2022-08-13 09:40:00,425.24,344603.3400000027,350817.63000000274,-6214.290000000037
24213,2022-08-13 09:45:00,-901.59,343701.7500000027,350817.63000000274,-7115.880000000063
24214,2022-08-13 09:50:00,-1641.62,342060.1300000027,350817.63000000274,-8757.500000000058
24215,2022-08-13 09:55:00,974.61,343034.74000000267,350817.63000000274,-7782.890000000072
24216,2022-08-13 10:00:00,-1711.99,341322.7500000027,350817.63000000274,-9494.880000000063
24217,2022-08-13 10:05:00,-1152.57,340170.18000000267,350817.63000000274,-10647.45000000007
24218,2022-08-13 10:10:00,-934.42,339235.7600000027,350817.63000000274,-11581.870000000054
24219,2022-08-13 10:15:00,710.64,339946.4000000027,350817.63000000274,-10871.23000000004
24220,2022-08-13 10:20:00,-513.14,339433.2600000027,350817.63000000274,-11384.370000000054
24221,2022-08-13 10:25:00,-988.88,338444.3800000027,350817.63000000274,-12373.250000000058
24222,2022-08-13 10:30:00,23.35,338467.73000000266,350817.63000000274,-12349.900000000081
24223,2022-08-13 10:35:00,1872.21,340339.9400000027,350817.63000000274,-10477.69000000006
24224,2022-08-13 10:40:00,-1561.66,338778.2800000027,350817.63000000274,-12039.350000000035
24225,2022-08-13 10:45:00,722.36,339500.6400000027,350817.63000000274,-11316.990000000049
24226,2022-08-13 10:50:00,-173.04,339327.6000000027,350817.63000000274,-11490.030000000028
24227,2022-08-13 10:55:00,777.7,340105.3000000027,350817.63000000274,-10712.330000000016
24228,2022-08-13 11:00:00,153.21,340258.51000000275,350817.63000000274,-10559.119999999995
24229,2022-08-13 11:05:00,-674.85,339583.66000000277,350817.63000000274,-11233.969999999972
24230,2022-08-13 11:10:00,1931.15,341514.8100000028,350817.63000000274,-9302.819999999949
24231,2022-08-13 11:15:00,159.44,341674.2500000028,350817.63000000274,-9143.379999999946
24232,2022-08-13 11:20:00,-1868.78,339805.47000000277,350817.63000000274,-11012.159999999974
24233,2022-08-13 11:25:00,1481.44,341286.91000000277,350817.63000000274,-9530.719999999972
24234,2022-08-13 11:30:00,-906.44,340380.47000000277,350817.63000000274,-10437.159999999974
24235,2022-08-13 11:35:00,-1520.84,338859.63000000274,350817.63000000274,-11958.0
24236,2022-08-13 11:40:00,-1812.77,337046.8600000027,350817.63000000274,-13770.770000000019
24237,2022-08-13 11:45:00,-425.13,336621.7300000027,350817.63000000274,-14195.900000000023
24238,2022-08-13 11:50:00,1342.17,337963.9000000027,350817.63000000274,-12853.73000000004
24239,2022-08-13 11:55:00,-372.94,337590.9600000027,350817.63000000274,-13226.670000000042
24240,2022-08-13 12:00:00,626.34,338217.3000000027,350817.63000000274,-12600.330000000016
24241,2022-08-13 12:05:00,-1555.1,336662.20000000275,350817.63000000274,-14155.429999999993
24242,2022-08-13 12:10:00,471.2,337133.40000000276,350817.63000000274,-13684.229999999981
24243,2022-08-13 12:15:00,314.51,337447.91000000277,350817.63000000274,-13369.719999999972
24244,2022-08-13 12:20:00,-1589.44,335858.47000000277,350817.63000000274,-14959.159999999974
24245,2022-08-13 12:25:00,-1540.47,334318.0000000028,350817.63000000274,-16499.629999999946
24246,2022-08-13 12:30:00,580.86,334898.8600000028,350817.63000000274,-15918.76999999996
24247,2022-08-13 12:35:00,-188.82,334710.0400000028,350817.63000000274,-16107.589999999967
24248,2022-08-13 12:40:00,-1082.09,333627.95000000275,350817.63000000274,-17189.679999999993
24249,2022-08-13 12:45:00,625.69,334253.64000000275,350817.63000000274,-16563.98999999999
24250,2022-08-13 12:50:00,-1840.15,332413.4900000027,350817.63000000274,-18404.140000000014
24251,2022-08-13 12:55:00,-1342.43,331071.06000000273,350817.63000000274,-19746.570000000007
24252,2022-08-13 13:00:00,1182.13,332253.19000000274,350817.63000000274,-18564.440000000002
24253,2022-08-13 13:05:00,333.28,332586.47000000277,350817.63000000274,-18231.159999999974
24254,2022-08-13 13:10:00,-1896.47,330690.0000000028,350817.63000000274,-20127.629999999946
24255,2022-08-13 13:15:00,-1681.59,329008.41000000277,350817.63000000274,-21809.219999999972
24256,2022-08-13 13:20:00,1993.16,331001.57000000274,350817.63000000274,-19816.059999999998
24257,2022-08-13 13:25:00,1196.65,332198.22000000277,350817.63000000274,-18619.409999999974
24258,2022-08-13 13:30:00,-970.27,331227.95000000275,350817.63000000274,-19589.679999999993
24259,2022-08-13 13:35:00,1738.82,332966.77000000275,350817.63000000274,-17850.859999999986
24260,2022-08-13 13:40:00,232.21,333198.9800000028,350817.63000000274,-17618.649999999965
24261,2022-08-13 13:45:00,-1346.18,331852.8000000028,350817.63000000274,-18964.829999999958
24262,2022-08-13 13:50:00,277.59,332130.3900000028,350817.63000000274,-18687.239999999932
24263,2022-08-13 13:55:00,-999.43,331130.9600000028,350817.63000000274,-19686.669999999925
24264,2022-08-13 14:00:00,-1529.32,329601.6400000028,350817.63000000274,-21215.989999999932
24265,2022-08-13 14:05:00,784.59,330386.23000000283,350817.63000000274,-20431.399999999907
24266,2022-08-13 14:10:00,-1356.26,329029.9700000028,350817.63000000274,-21787.659999999916
24267,2022-08-13 14:15:00,-691.13,328338.8400000028,350817.63000000274,-22478.78999999992
24268,2022-08-13 14:20:00,-404.47,327934.37000000285,350817.63000000274,-22883.259999999893
24269,2022-08-13 14:25:00,1758.52,329692.89000000287,350817.63000000274,-21124.739999999874
24270,2022-08-13 14:30:00,-1648.85,328044.0400000029,350817.63000000274,-22773.58999999985
24271,2022-08-13 14:35:00,600.27,328644.3100000029,350817.63000000274,-22173.319999999832
24272,2022-08-13 14:40:00,-933.15,327711.1600000029,350817.63000000274,-23106.469999999856
24273,2022-08-13 14:45:00,-1845.03,325866.13000000286,350817.63000000274,-24951.499999999884
24274,2022-08-13 14:50:00,-990.73,324875.4000000029,350817.63000000274,-25942.229999999865
24275,2022-08-13 14:55:00,806.56,325681.9600000029,350817.63000000274,-25135.669999999867
24276,2022-08-13 15:00:00,-1276.19,324405.77000000287,350817.63000000274,-26411.85999999987
24277,2022-08-13 15:05:00,139.89,324545.6600000029,350817.63000000274,-26271.969999999856
24278,2022-08-13 15:10:00,1660.96,326206.6200000029,350817.63000000274,-24611.009999999835
24279,2022-08-13 15:15:00,-706.5,325500.1200000029,350817.63000000274,-25317.509999999835
24280,2022-08-13 15:20:00,-1192.79,324307.3300000029,350817.63000000274,-26510.299999999814
24281,2022-08-13 15:25:00,496.93,324804.2600000029,350817.63000000274,-26013.36999999982
24282,2022-08-13 15:30:00,-697.29,324106.97000000294,350817.63000000274,-26710.6599999998
24283,2022-08-13 15:35:00,1324.89,325431.86000000295,350817.63000000274,-25385.769999999786
24284,2022-08-13 15:40:00,1169.1,326600.96000000293,350817.63000000274,-24216.66999999981
24285,2022-08-13 15:45:00,-1673.7,324927.2600000029,350817.63000000274,-25890.36999999982
24286,2022-08-13 15:50:00,913.7,325840.96000000293,350817.63000000274,-24976.66999999981
24287,2022-08-13 15:55:00,1141.76,326982.72000000294,350817.63000000274,-23834.9099999998
24288,2022-08-13 16:00:00,1869.92,328852.6400000029,350817.63000000274,-21964.989999999816
24289,2022-08-13 16:05:00,-1595.23,327257.41000000294,350817.63000000274,-23560.219999999797
24290,2022-08-13 16:10:00,-391.93,326865.48000000295,350817.63000000274,-23952.14999999979
24291,2022-08-13 16:15:00,-420.73,326444.75000000297,350817.63000000274,-24372.879999999772
24292,2022-08-13 16:20:00,1297.0,327741.75000000297,350817.63000000274,-23075.879999999772
24293,2022-08-13 16:25:00,-1651.08,326090.67000000295,350817.63000000274,-24726.959999999788
24294,2022-08-13 16:30:00,79.58,326170.25000000297,350817.63000000274,-24647.379999999772
24295,2022-08-13 16:35:00,1656.09,327826.340000003,350817.63000000274,-22991.289999999746
24296,2022-08-13 16:40:00,-236.03,327590.31000000297,350817.63000000274,-23227.319999999774
24297,2022-08-13 16:45:00,98.5,327688.81000000297,350817.63000000274,-23128.819999999774
24298,2022-08-13 16:50:00,1702.91,329391.72000000294,350817.63000000274,-21425.9099999998
24299,2022-08-13 16:55:00,-1667.93,327723.79000000295,350817.63000000274,-23093.839999999793
24300,2022-08-14 08:00:00,-50.72,327673.070000003,327723.79000000295,-50.71999999997206
24301,2022-08-14 08:05:00,656.54,328329.61000000295,327723.79000000295,605.820000000007
24302,2022-08-14 08:10:00,-1385.18,326944.43000000296,327723.79000000295,-779.359999999986
24303,2022-08-14 08:15:00,-819.45,326124.98000000295,327723.79000000295,-1598.8099999999977
24304,2022-08-14 08:20:00,-1865.12,324259.86000000295,327723.79000000295,-3463.929999999993
24305,2022-08-14 08:25:00,1675.49,325935.35000000295,327723.79000000295,-1788.4400000000023
24306,2022-08-14 08:30:00,741.21,326676.56000000297,327723.79000000295,-1047.2299999999814
24307,2022-08-14 08:35:00,78.46,326755.020000003,327723.79000000295,-968.7699999999604
24308,2022-08-14 08:40:00,424.89,327179.910000003,327723.79000000295,-543.8799999999464
24309,2022-08-14 08:45:00,1440.79,328620.700000003,327723.79000000295,896.9100000000326
24310,2022-08-14 08:50:00,-121.72,328498.980000003,327723.79000000295,775.1900000000605
24311,2022-08-14 08:55:00,-1130.91,327368.07000000303,327723.79000000295,-355.71999999991385
24312,2022-08-14 09:00:00,-1331.26,326036.810000003,327723.79000000295,-1686.9799999999232
24313,2022-08-14 09:05:00,1608.31,327645.120000003,327723.79000000295,-78.6699999999255
24314,2022-08-14 09:10:00,1953.16,329598.280000003,327723.79000000295,1874.490000000049
24315,2022-08-14 09:15:00,837.1,330435.380000003,327723.79000000295,2711.5900000000256
24316,2022-08-14 09:20:00,1730.9,332166.280000003,327723.79000000295,4442.490000000049
24317,2022-08-14 09:25:00,-52.4,332113.880000003,327723.79000000295,4390.090000000026
24318,2022-08-14 09:30:00,604.42,332718.30000000296,327723.79000000295,4994.510000000009
24319,2022-08-14 09:35:00,-818.54,331899.760000003,327723.79000000295,4175.97000000003
24320,2022-08-14 09:40:00,1171.69,333071.450000003,327723.79000000295,5347.660000000033
24321,2022-08-14 09:45:00,-935.36,332136.090000003,327723.79000000295,4412.300000000047
24322,2022-08-14 09:50:00,-1123.08,331013.010000003,327723.79000000295,3289.2200000000303
24323,2022-08-14 09:55:00,-73.2,330939.81000000297,327723.79000000295,3216.0200000000186
24324,2022-08-14 10:00:00,1770.55,332710.36000000295,327723.79000000295,4986.570000000007
24325,2022-08-14 10:05:00,-1979.6,330730.760000003,327723.79000000295,3006.9700000000303
24326,2022-08-14 10:10:00,-586.25,330144.510000003,327723.79000000295,2420.7200000000303
24327,2022-08-14 10:15:00,-25.92,330118.590000003,327723.79000000295,2394.8000000000466
24328,2022-08-14 10:20:00,-1301.2,328817.390000003,327723.79000000295,1093.600000000035
24329,2022-08-14 10:25:00,-2.96,328814.43000000296,327723.79000000295,1090.640000000014
24330,2022-08-14 10:30:00,295.65,329110.080000003,327723.79000000295,1386.2900000000373
24331,2022-08-14 10:35:00,-567.68,328542.400000003,327723.79000000295,818.6100000000442
24332,2022-08-14 10:40:00,-1902.06,326640.340000003,327723.79000000295,-1083.4499999999534
24333,2022-08-14 10:45:00,913.41,327553.75000000297,327723.79000000295,-170.03999999997905
24334,2022-08-14 10:50:00,-18.27,327535.48000000295,327723.79000000295,-188.30999999999767
24335,2022-08-14 10:55:00,1242.87,328778.35000000295,327723.79000000295,1054.5599999999977
24336,2022-08-14 11:00:00,-162.02,328616.3300000029,327723.79000000295,892.539999999979
24337,2022-08-14 11:05:00,1245.15,329861.48000000295,327723.79000000295,2137.6900000000023
24338,2022-08-14 11:10:00,835.14,330696.62000000296,327723.79000000295,2972.8300000000163
24339,2022-08-14 11:15:00,1141.85,331838.47000000294,327723.79000000295,4114.679999999993
24340,2022-08-14 11:20:00,-1250.24,330588.23000000295,327723.79000000295,2864.4400000000023
24341,2022-08-14 11:25:00,669.73,331257.96000000293,327723.79000000295,3534.1699999999837
24342,2022-08-14 11:30:00,1710.23,332968.1900000029,327723.79000000295,5244.399999999965
24343,2022-08-14 11:35:00,-1306.81,331661.3800000029,327723.79000000295,3937.5899999999674
24344,2022-08-14 11:40:00,1204.43,332865.8100000029,327723.79000000295,5142.01999999996
24345,2022-08-14 11:45:00,906.91,333772.7200000029,327723.79000000295,6048.929999999935
24346,2022-08-14 11:50:00,-1988.65,331784.07000000286,327723.79000000295,4060.2799999999115
24347,2022-08-14 11:55:00,-1950.44,329833.63000000286,327723.79000000295,2109.839999999909
24348,2022-08-14 12:00:00,833.51,330667.14000000287,327723.79000000295,2943.3499999999185
24349,2022-08-14 12:05:00,1735.87,332403.01000000286,327723.79000000295,4679.219999999914
24350,2022-08-14 12:10:00,-146.2,332256.81000000285,327723.79000000295,4533.019999999902
24351,2022-08-14 12:15:00,-1159.03,331097.7800000028,327723.79000000295,3373.9899999998743
24352,2022-08-14 12:20:00,986.42,332084.2000000028,327723.79000000295,4360.409999999858
24353,2022-08-14 12:25:00,-858.85,331225.3500000028,327723.79000000295,3501.5599999998813
24354,2022-08-14 12:30:00,296.2,331521.55000000284,327723.79000000295,3797.759999999893
24355,2022-08-14 12:35:00,1757.39,333278.94000000285,327723.79000000295,5555.149999999907
24356,2022-08-14 12:40:00,-864.51,332414.43000000285,327723.79000000295,4690.639999999898
24357,2022-08-14 12:45:00,656.49,333070.92000000284,327723.79000000295,5347.129999999888
24358,2022-08-14 12:50:00,-1133.51,331937.4100000028,327723.79000000295,4213.619999999879
24359,2022-08-14 12:55:00,85.17,332022.5800000028,327723.79000000295,4298.789999999863
24360,2022-08-14 13:00:00,768.15,332790.73000000283,327723.79000000295,5066.939999999886
24361,2022-08-14 13:05:00,400.14,333190.87000000285,327723.79000000295,5467.0799999999
24362,2022-08-14 13:10:00,1279.79,334470.6600000028,327723.79000000295,6746.869999999879
24363,2022-08-14 13:15:00,555.0,335025.6600000028,327723.79000000295,7301.869999999879
24364,2022-08-14 13:20:00,69.78,335095.44000000285,327723.79000000295,7371.649999999907
24365,2022-08-14 13:25:00,882.83,335978.27000000287,327723.79000000295,8254.479999999923
24366,2022-08-14 13:30:00,-1799.62,334178.6500000029,327723.79000000295,6454.859999999928
24367,2022-08-14 13:35:00,-1383.35,332795.3000000029,327723.79000000295,5071.509999999951
24368,2022-08-14 13:40:00,-496.99,332298.3100000029,327723.79000000295,4574.51999999996
24369,2022-08-14 13:45:00,-13.35,332284.96000000293,327723.79000000295,4561.169999999984
24370,2022-08-14 13:50:00,-1946.69,330338.2700000029,327723.79000000295,2614.4799999999814
24371,2022-08-14 13:55:00,-714.41,329623.86000000295,327723.79000000295,1900.070000000007
24372,2022-08-14 14:00:00,-1502.01,328121.85000000295,327723.79000000295,398.0599999999977
24373,2022-08-14 14:05:00,1460.42,329582.2700000029,327723.79000000295,1858.4799999999814
24374,2022-08-14 14:10:00,-874.84,328707.4300000029,327723.79000000295,983.6399999999558
24375,2022-08-14 14:15:00,-983.01,327724.4200000029,327723.79000000295,0.629999999946449
24376,2022-08-14 14:20:00,610.67,328335.0900000029,327723.79000000295,611.2999999999302
24377,2022-08-14 14:25:00,-1648.73,326686.3600000029,327723.79000000295,-1037.4300000000512
24378,2022-08-14 14:30:00,1643.93,328330.2900000029,327723.79000000295,606.4999999999418
24379,2022-08-14 14:35:00,-582.64,327747.6500000029,327723.79000000295,23.859999999927823
24380,2022-08-14 14:40:00,1343.28,329090.9300000029,327723.79000000295,1367.1399999999558
24381,2022-08-14 14:45:00,-1136.99,327953.9400000029,327723.79000000295,230.14999999996508
24382,2022-08-14 14:50:00,-785.36,327168.5800000029,327723.79000000295,-555.210000000021
24383,2022-08-14 14:55:00,42.06,327210.6400000029,327723.79000000295,-513.1500000000233
24384,2022-08-14 15:00:00,1981.97,329192.6100000029,327723.79000000295,1468.8199999999488
24385,2022-08-14 15:05:00,1274.59,330467.2000000029,327723.79000000295,2743.4099999999744
24386,2022-08-14 15:10:00,506.61,330973.8100000029,327723.79000000295,3250.0199999999604
24387,2022-08-14 15:15:00,-279.01,330694.8000000029,327723.79000000295,2971.009999999951
24388,2022-08-14 15:20:00,-1638.39,329056.4100000029,327723.79000000295,1332.6199999999371
24389,2022-08-14 15:25:00,482.31,329538.7200000029,327723.79000000295,1814.9299999999348
24390,2022-08-14 15:30:00,990.41,330529.13000000286,327723.79000000295,2805.339999999909
24391,2022-08-14 15:35:00,720.17,331249.30000000284,327723.79000000295,3525.509999999893
24392,2022-08-14 15:40:00,77.6,331326.9000000028,327723.79000000295,3603.1099999998696
24393,2022-08-14 15:45:00,-155.23,331171.67000000284,327723.79000000295,3447.8799999998882
24394,2022-08-14 15:50:00,-1924.61,329247.06000000285,327723.79000000295,1523.2699999999022
24395,2022-08-14 15:55:00,-332.41,328914.6500000029,327723.79000000295,1190.8599999999278
24396,2022-08-14 16:00:00,-613.88,328300.77000000287,327723.79000000295,576.9799999999232
24397,2022-08-14 16:05:00,764.08,329064.8500000029,327723.79000000295,1341.0599999999395
24398,2022-08-14 16:10:00,654.89,329719.7400000029,327723.79000000295,1995.9499999999534
24399,2022-08-14 16:15:00,520.93,330240.6700000029,327723.79000000295,2516.8799999999464
24400,2022-08-14 16:20:00,1649.65,331890.3200000029,327723.79000000295,4166.52999999997
24401,2022-08-14 16:25:00,-1090.37,330799.9500000029,327723.79000000295,3076.1599999999744
24402,2022-08-14 16:30:00,1294.88,332094.8300000029,327723.79000000295,4371.039999999979
24403,2022-08-14 16:35:00,-1828.35,330266.48000000295,327723.79000000295,2542.6900000000023
24404,2022-08-14 16:40:00,-1780.45,328486.03000000294,327723.79000000295,762.2399999999907
24405,2022-08-14 16:45:00,1162.06,329648.09000000294,327723.79000000295,1924.2999999999884
24406,2022-08-14 16:50:00,-1259.81,328388.28000000294,327723.79000000295,664.4899999999907
24407,2022-08-14 16:55:00,-1120.72,327267.56000000297,327723.79000000295,-456.2299999999814
24408,2022-08-15 08:00:00,1515.95,328783.510000003,327267.56000000297,1515.9500000000116
24409,2022-08-15 08:05:00,1046.27,329829.780000003,327267.56000000297,2562.2200000000303
24410,2022-08-15 08:10:00,1621.76,331451.540000003,327267.56000000297,4183.98000000004
24411,2022-08-15 08:15:00,1020.83,332472.370000003,327267.56000000297,5204.810000000056
24412,2022-08-15 08:20:00,-1367.55,331104.82000000303,327267.56000000297,3837.2600000000675
24413,2022-08-15 08:25:00,502.29,331607.110000003,327267.56000000297,4339.550000000047
24414,2022-08-15 08:30:00,263.21,331870.32000000303,327267.56000000297,4602.7600000000675
24415,2022-08-15 08:35:00,-1200.04,330670.28000000305,327267.56000000297,3402.7200000000885
24416,2022-08-15 08:40:00,1637.89,332308.17000000307,327267.56000000297,5040.610000000102
24417,2022-08-15 08:45:00,1564.35,333872.52000000305,327267.56000000297,6604.960000000079
24418,2022-08-15 08:50:00,484.55,334357.07000000303,327267.56000000297,7089.5100000000675
24419,2022-08-15 08:55:00,-1527.49,332829.58000000304,327267.56000000297,5562.020000000077
24420,2022-08-15 09:00:00,-281.33,332548.250000003,327267.56000000297,5280.6900000000605
24421,2022-08-15 09:05:00,-1457.25,331091.000000003,327267.56000000297,3823.4400000000605
24422,2022-08-15 09:10:00,-1831.49,329259.51000000304,327267.56000000297,1991.9500000000698
24423,2022-08-15 09:15:00,52.92,329312.430000003,327267.56000000297,2044.8700000000536
24424,2022-08-15 09:20:00,-376.93,328935.500000003,327267.56000000297,1667.9400000000605
24425,2022-08-15 09:25:00,1916.73,330852.230000003,327267.56000000297,3584.670000000042
24426,2022-08-15 09:30:00,1083.49,331935.720000003,327267.56000000297,4668.160000000033
24427,2022-08-15 09:35:00,-522.68,331413.040000003,327267.56000000297,4145.48000000004
24428,2022-08-15 09:40:00,-1509.47,329903.57000000303,327267.56000000297,2636.0100000000675
24429,2022-08-15 09:45:00,320.01,330223.58000000304,327267.56000000297,2956.020000000077
24430,2022-08-15 09:50:00,-1303.93,328919.65000000305,327267.56000000297,1652.0900000000838
24431,2022-08-15 09:55:00,-845.74,328073.91000000306,327267.56000000297,806.3500000000931
24432,2022-08-15 10:00:00,1080.7,329154.6100000031,327267.56000000297,1887.0500000001048
24433,2022-08-15 10:05:00,-1816.25,327338.3600000031,327267.56000000297,70.80000000010477
24434,2022-08-15 10:10:00,307.88,327646.2400000031,327267.56000000297,378.68000000010943
24435,2022-08-15 10:15:00,728.75,328374.9900000031,327267.56000000297,1107.4300000001094
24436,2022-08-15 10:20:00,624.5,328999.4900000031,327267.56000000297,1731.9300000001094
24437,2022-08-15 10:25:00,934.36,329933.85000000306,327267.56000000297,2666.2900000000955
24438,2022-08-15 10:30:00,-177.52,329756.33000000304,327267.56000000297,2488.770000000077
24439,2022-08-15 10:35:00,-1989.03,327767.300000003,327267.56000000297,499.7400000000489
24440,2022-08-15 10:40:00,-1520.74,326246.560000003,327267.56000000297,-1020.9999999999418
24441,2022-08-15 10:45:00,1009.57,327256.13000000303,327267.56000000297,-11.429999999934807
24442,2022-08-15 10:50:00,-1165.44,326090.69000000303,327267.56000000297,-1176.8699999999371
24443,2022-08-15 10:55:00,1248.61,327339.300000003,327267.56000000297,71.7400000000489
24444,2022-08-15 11:00:00,1557.02,328896.32000000303,327267.56000000297,1628.7600000000675
24445,2022-08-15 11:05:00,1432.94,330329.26000000304,327267.56000000297,3061.70000000007
24446,2022-08-15 11:10:00,56.09,330385.35000000306,327267.56000000297,3117.7900000000955
24447,2022-08-15 11:15:00,1606.22,331991.57000000303,327267.56000000297,4724.0100000000675
24448,2022-08-15 11:20:00,1645.94,333637.51000000304,327267.56000000297,6369.95000000007
24449,2022-08-15 11:25:00,-494.77,333142.740000003,327267.56000000297,5875.180000000051
24450,2022-08-15 11:30:00,-820.99,332321.750000003,327267.56000000297,5054.1900000000605
24451,2022-08-15 11:35:00,-810.71,331511.040000003,327267.56000000297,4243.48000000004
24452,2022-08-15 11:40:00,-1546.06,329964.980000003,327267.56000000297,2697.420000000042
24453,2022-08-15 11:45:00,-1434.2,328530.780000003,327267.56000000297,1263.2200000000303
24454,2022-08-15 11:50:00,-335.0,328195.780000003,327267.56000000297,928.2200000000303
24455,2022-08-15 11:55:00,295.84,328491.620000003,327267.56000000297,1224.0600000000559
24456,2022-08-15 12:00:00,913.11,329404.730000003,327267.56000000297,2137.170000000042
24457,2022-08-15 12:05:00,1719.92,331124.650000003,327267.56000000297,3857.0900000000256
24458,2022-08-15 12:10:00,-1628.01,329496.640000003,327267.56000000297,2229.0800000000163
24459,2022-08-15 12:15:00,763.81,330260.450000003,327267.56000000297,2992.890000000014
24460,2022-08-15 12:20:00,-1461.14,328799.31000000297,327267.56000000297,1531.75
24461,2022-08-15 12:25:00,-1536.05,327263.260000003,327267.56000000297,-4.2999999999883585
24462,2022-08-15 12:30:00,-1425.46,325837.80000000296,327267.56000000297,-1429.7600000000093
24463,2022-08-15 12:35:00,-965.67,324872.130000003,327267.56000000297,-2395.429999999993
24464,2022-08-15 12:40:00,-857.9,324014.23000000295,327267.56000000297,-3253.3300000000163
24465,2022-08-15 12:45:00,1198.41,325212.6400000029,327267.56000000297,-2054.920000000042
24466,2022-08-15 12:50:00,242.44,325455.0800000029,327267.56000000297,-1812.4800000000396
24467,2022-08-15 12:55:00,1337.46,326792.54000000295,327267.56000000297,-475.0200000000186
24468,2022-08-15 13:00:00,1914.94,328707.48000000295,327267.56000000297,1439.9199999999837
24469,2022-08-15 13:05:00,1598.38,330305.86000000295,327267.56000000297,3038.2999999999884
24470,2022-08-15 13:10:00,-241.21,330064.65000000293,327267.56000000297,2797.0899999999674
24471,2022-08-15 13:15:00,37.29,330101.9400000029,327267.56000000297,2834.3799999999464
24472,2022-08-15 13:20:00,-61.98,330039.96000000293,327267.56000000297,2772.399999999965
24473,2022-08-15 13:25:00,305.67,330345.6300000029,327267.56000000297,3078.069999999949
24474,2022-08-15 13:30:00,-1922.5,328423.1300000029,327267.56000000297,1155.5699999999488
24475,2022-08-15 13:35:00,-698.37,327724.7600000029,327267.56000000297,457.19999999995343
24476,2022-08-15 13:40:00,-1816.43,325908.3300000029,327267.56000000297,-1359.2300000000396
24477,2022-08-15 13:45:00,-1609.24,324299.09000000294,327267.56000000297,-2968.4700000000303
24478,2022-08-15 13:50:00,1784.74,326083.8300000029,327267.56000000297,-1183.7300000000396
24479,2022-08-15 13:55:00,-331.57,325752.2600000029,327267.56000000297,-1515.3000000000466
24480,2022-08-15 14:00:00,1448.13,327200.3900000029,327267.56000000297,-67.17000000004191
24481,2022-08-15 14:05:00,-447.55,326752.84000000294,327267.56000000297,-514.7200000000303
24482,2022-08-15 14:10:00,14.66,326767.5000000029,327267.56000000297,-500.0600000000559
24483,2022-08-15 14:15:00,-1129.34,325638.1600000029,327267.56000000297,-1629.4000000000815
24484,2022-08-15 14:20:00,1504.88,327143.0400000029,327267.56000000297,-124.52000000007683
24485,2022-08-15 14:25:00,-1592.09,325550.95000000286,327267.56000000297,-1716.6100000001024
24486,2022-08-15 14:30:00,-1446.87,324104.08000000287,327267.56000000297,-3163.480000000098
24487,2022-08-15 14:35:00,1139.35,325243.43000000285,327267.56000000297,-2024.130000000121
24488,2022-08-15 14:40:00,-1322.07,323921.36000000284,327267.56000000297,-3346.200000000128
24489,2022-08-15 14:45:00,-537.71,323383.6500000028,327267.56000000297,-3883.910000000149
24490,2022-08-15 14:50:00,478.98,323862.6300000028,327267.56000000297,-3404.9300000001676
24491,2022-08-15 14:55:00,75.67,323938.3000000028,327267.56000000297,-3329.260000000184
24492,2022-08-15 15:00:00,1287.88,325226.1800000028,327267.56000000297,-2041.3800000001793
24493,2022-08-15 15:05:00,1999.69,327225.8700000028,327267.56000000297,-41.69000000017695
24494,2022-08-15 15:10:00,-169.68,327056.1900000028,327267.56000000297,-211.37000000016997
24495,2022-08-15 15:15:00,-682.37,326373.8200000028,327267.56000000297,-893.7400000001653
24496,2022-08-15 15:20:00,-321.19,326052.6300000028,327267.56000000297,-1214.9300000001676
24497,2022-08-15 15:25:00,20.15,326072.7800000028,327267.56000000297,-1194.7800000001444
24498,2022-08-15 15:30:00,722.37,326795.1500000028,327267.56000000297,-472.410000000149
24499,2022-08-15 15:35:00,-1113.16,325681.99000000284,327267.56000000297,-1585.5700000001234
24500,2022-08-15 15:40:00,-367.04,325314.95000000286,327267.56000000297,-1952.6100000001024
24501,2022-08-15 15:45:00,956.49,326271.44000000285,327267.56000000297,-996.1200000001118
24502,2022-08-15 15:50:00,1708.21,327979.6500000029,327267.56000000297,712.0899999999092
24503,2022-08-15 15:55:00,-341.97,327637.6800000029,327267.56000000297,370.11999999993714
24504,2022-08-15 16:00:00,402.39,328040.0700000029,327267.56000000297,772.5099999999511
24505,2022-08-15 16:05:00,-1564.59,326475.4800000029,327267.56000000297,-792.0800000000745
24506,2022-08-15 16:10:00,1889.47,328364.95000000286,327267.56000000297,1097.3899999998976
24507,2022-08-15 16:15:00,-1352.97,327011.9800000029,327267.56000000297,-255.5800000000745
24508,2022-08-15 16:20:00,249.44,327261.4200000029,327267.56000000297,-6.1400000000721775
24509,2022-08-15 16:25:00,-1816.34,325445.08000000287,327267.56000000297,-1822.4800000000978
24510,2022-08-15 16:30:00,-1347.42,324097.6600000029,327267.56000000297,-3169.9000000000815
24511,2022-08-15 16:35:00,132.73,324230.39000000287,327267.56000000297,-3037.1700000001
24512,2022-08-15 16:40:00,-1667.37,322563.02000000287,327267.56000000297,-4704.5400000000955
24513,2022-08-15 16:45:00,1335.46,323898.4800000029,327267.56000000297,-3369.0800000000745
24514,2022-08-15 16:50:00,1779.95,325678.4300000029,327267.56000000297,-1589.1300000000629
24515,2022-08-15 16:55:00,-1574.39,324104.0400000029,327267.56000000297,-3163.520000000077
24516,2022-08-16 08:00:00,1673.85,325777.89000000287,324104.0400000029,1673.8499999999767
24517,2022-08-16 08:05:00,-1996.03,323781.86000000284,324104.0400000029,-322.1800000000512
24518,2022-08-16 08:10:00,-475.1,323306.76000000286,324104.0400000029,-797.2800000000279
24519,2022-08-16 08:15:00,643.42,323950.18000000285,324104.0400000029,-153.86000000004424
24520,2022-08-16 08:20:00,-524.2,323425.98000000283,324104.0400000029,-678.0600000000559
24521,2022-08-16 08:25:00,2.56,323428.54000000283,324104.0400000029,-675.5000000000582
24522,2022-08-16 08:30:00,-496.09,322932.4500000028,324104.0400000029,-1171.5900000000838
24523,2022-08-16 08:35:00,-923.21,322009.2400000028,324104.0400000029,-2094.800000000105
24524,2022-08-16 08:40:00,954.18,322963.4200000028,324104.0400000029,-1140.6200000001118
24525,2022-08-16 08:45:00,1248.06,324211.4800000028,324104.0400000029,107.43999999988591
24526,2022-08-16 08:50:00,1379.98,325591.46000000276,324104.0400000029,1487.4199999998673
24527,2022-08-16 08:55:00,374.14,325965.60000000277,324104.0400000029,1861.5599999998813
24528,2022-08-16 09:00:00,-700.89,325264.71000000276,324104.0400000029,1160.6699999998673
24529,2022-08-16 09:05:00,-1061.79,324202.9200000028,324104.0400000029,98.87999999988824
24530,2022-08-16 09:10:00,343.37,324546.2900000028,324104.0400000029,442.2499999998836
24531,2022-08-16 09:15:00,-290.75,324255.5400000028,324104.0400000029,151.49999999988358
24532,2022-08-16 09:20:00,122.72,324378.26000000275,324104.0400000029,274.21999999985565
24533,2022-08-16 09:25:00,709.65,325087.91000000277,324104.0400000029,983.8699999998789
24534,2022-08-16 09:30:00,1921.59,327009.5000000028,324104.0400000029,2905.4599999999045
24535,2022-08-16 09:35:00,-430.23,326579.2700000028,324104.0400000029,2475.229999999923
24536,2022-08-16 09:40:00,-637.91,325941.36000000284,324104.0400000029,1837.3199999999488
24537,2022-08-16 09:45:00,959.54,326900.9000000028,324104.0400000029,2796.859999999928
24538,2022-08-16 09:50:00,555.01,327455.9100000028,324104.0400000029,3351.869999999937
24539,2022-08-16 09:55:00,-484.42,326971.49000000284,324104.0400000029,2867.4499999999534
24540,2022-08-16 10:00:00,1590.47,328561.9600000028,324104.0400000029,4457.9199999999255
24541,2022-08-16 10:05:00,1792.93,330354.8900000028,324104.0400000029,6250.8499999999185
24542,2022-08-16 10:10:00,-271.46,330083.4300000028,324104.0400000029,5979.389999999898
24543,2022-08-16 10:15:00,-1520.71,328562.72000000277,324104.0400000029,4458.679999999877
24544,2022-08-16 10:20:00,1889.49,330452.21000000276,324104.0400000029,6348.169999999867
24545,2022-08-16 10:25:00,1442.06,331894.27000000275,324104.0400000029,7790.229999999865
24546,2022-08-16 10:30:00,129.06,332023.33000000275,324104.0400000029,7919.289999999863
24547,2022-08-16 10:35:00,854.35,332877.6800000027,324104.0400000029,8773.63999999984
24548,2022-08-16 10:40:00,751.44,333629.12000000273,324104.0400000029,9525.079999999842
24549,2022-08-16 10:45:00,1237.69,334866.81000000273,324104.0400000029,10762.769999999844
24550,2022-08-16 10:50:00,1458.92,336325.7300000027,324104.0400000029,12221.689999999828
24551,2022-08-16 10:55:00,-1947.02,334378.7100000027,324104.0400000029,10274.669999999809
24552,2022-08-16 11:00:00,-945.79,333432.9200000027,324104.0400000029,9328.87999999983
24553,2022-08-16 11:05:00,1192.63,334625.5500000027,324104.0400000029,10521.509999999835
24554,2022-08-16 11:10:00,-1452.92,333172.63000000274,324104.0400000029,9068.589999999851
24555,2022-08-16 11:15:00,-1672.0,331500.63000000274,324104.0400000029,7396.589999999851
24556,2022-08-16 11:20:00,1813.55,333314.1800000027,324104.0400000029,9210.13999999984
24557,2022-08-16 11:25:00,-432.46,332881.7200000027,324104.0400000029,8777.679999999818
24558,2022-08-16 11:30:00,-897.83,331983.8900000027,324104.0400000029,7879.849999999802
24559,2022-08-16 11:35:00,632.02,332615.9100000027,324104.0400000029,8511.86999999982
24560,2022-08-16 11:40:00,1689.21,334305.12000000273,324104.0400000029,10201.079999999842
24561,2022-08-16 11:45:00,1707.82,336012.94000000274,324104.0400000029,11908.899999999849
24562,2022-08-16 11:50:00,158.18,336171.12000000273,324104.0400000029,12067.079999999842
24563,2022-08-16 11:55:00,-1463.53,334707.5900000027,324104.0400000029,10603.549999999814
24564,2022-08-16 12:00:00,-9.97,334697.62000000273,324104.0400000029,10593.579999999842
24565,2022-08-16 12:05:00,-1843.52,332854.1000000027,324104.0400000029,8750.059999999823
24566,2022-08-16 12:10:00,1723.67,334577.7700000027,324104.0400000029,10473.729999999807
24567,2022-08-16 12:15:00,-1145.59,333432.18000000267,324104.0400000029,9328.139999999781
24568,2022-08-16 12:20:00,-579.39,332852.79000000266,324104.0400000029,8748.749999999767
24569,2022-08-16 12:25:00,-421.28,332431.5100000026,324104.0400000029,8327.46999999974
24570,2022-08-16 12:30:00,590.82,333022.33000000264,324104.0400000029,8918.289999999746
24571,2022-08-16 12:35:00,862.99,333885.3200000026,324104.0400000029,9781.279999999737
24572,2022-08-16 12:40:00,-1801.5,332083.8200000026,324104.0400000029,7979.779999999737
24573,2022-08-16 12:45:00,1881.92,333965.7400000026,324104.0400000029,9861.69999999972
24574,2022-08-16 12:50:00,305.68,334271.4200000026,324104.0400000029,10167.379999999714
24575,2022-08-16 12:55:00,-1510.86,332760.5600000026,324104.0400000029,8656.519999999728
24576,2022-08-16 13:00:00,-786.94,331973.6200000026,324104.0400000029,7869.579999999725
24577,2022-08-16 13:05:00,-1611.16,330362.46000000264,324104.0400000029,6258.419999999751
24578,2022-08-16 13:10:00,568.41,330930.8700000026,324104.0400000029,6826.829999999725
24579,2022-08-16 13:15:00,1883.97,332814.8400000026,324104.0400000029,8710.799999999697
24580,2022-08-16 13:20:00,506.34,333321.1800000026,324104.0400000029,9217.139999999723
24581,2022-08-16 13:25:00,-1962.05,331359.1300000026,324104.0400000029,7255.089999999735
24582,2022-08-16 13:30:00,1675.12,333034.2500000026,324104.0400000029,8930.20999999973
24583,2022-08-16 13:35:00,1966.88,335001.1300000026,324104.0400000029,10897.089999999735
24584,2022-08-16 13:40:00,427.98,335429.1100000026,324104.0400000029,11325.069999999716
24585,2022-08-16 13:45:00,904.43,336333.5400000026,324104.0400000029,12229.499999999709
24586,2022-08-16 13:50:00,-1231.21,335102.3300000026,324104.0400000029,10998.289999999688
24587,2022-08-16 13:55:00,-1101.74,334000.5900000026,324104.0400000029,9896.549999999697
24588,2022-08-16 14:00:00,-1659.89,332340.7000000026,324104.0400000029,8236.659999999683
24589,2022-08-16 14:05:00,-1317.19,331023.51000000257,324104.0400000029,6919.469999999681
24590,2022-08-16 14:10:00,1831.5,332855.01000000257,324104.0400000029,8750.969999999681
24591,2022-08-16 14:15:00,-997.03,331857.98000000254,324104.0400000029,7753.939999999653
24592,2022-08-16 14:20:00,863.67,332721.6500000025,324104.0400000029,8617.609999999637
24593,2022-08-16 14:25:00,681.91,333403.5600000025,324104.0400000029,9299.519999999611
24594,2022-08-16 14:30:00,317.73,333721.2900000025,324104.0400000029,9617.249999999593
24595,2022-08-16 14:35:00,-553.08,333168.21000000247,324104.0400000029,9064.169999999576
24596,2022-08-16 14:40:00,-364.95,332803.26000000245,324104.0400000029,8699.219999999565
24597,2022-08-16 14:45:00,-68.06,332735.20000000246,324104.0400000029,8631.159999999567
24598,2022-08-16 14:50:00,1977.81,334713.01000000245,324104.0400000029,10608.969999999565
24599,2022-08-16 14:55:00,-1060.26,333652.75000000244,324104.0400000029,9548.709999999555
24600,2022-08-16 15:00:00,1520.23,335172.9800000024,324104.0400000029,11068.939999999537
24601,2022-08-16 15:05:00,574.34,335747.32000000245,324104.0400000029,11643.279999999562
24602,2022-08-16 15:10:00,-285.6,335461.7200000025,324104.0400000029,11357.679999999586
24603,2022-08-16 15:15:00,1157.36,336619.08000000246,324104.0400000029,12515.039999999572
24604,2022-08-16 15:20:00,-470.18,336148.90000000247,324104.0400000029,12044.859999999579
24605,2022-08-16 15:25:00,1015.27,337164.1700000025,324104.0400000029,13060.129999999597
24606,2022-08-16 15:30:00,1888.54,339052.71000000247,324104.0400000029,14948.669999999576
24607,2022-08-16 15:35:00,1707.91,340760.62000000244,324104.0400000029,16656.57999999955
24608,2022-08-16 15:40:00,1605.19,342365.81000000244,324104.0400000029,18261.769999999553
24609,2022-08-16 15:45:00,1420.86,343786.6700000024,324104.0400000029,19682.62999999954
24610,2022-08-16 15:50:00,1244.59,345031.26000000245,324104.0400000029,20927.219999999565
24611,2022-08-16 15:55:00,1733.1,346764.36000000243,324104.0400000029,22660.31999999954
24612,2022-08-16 16:00:00,-447.88,346316.4800000024,324104.0400000029,22212.439999999537
24613,2022-08-16 16:05:00,-1132.02,345184.4600000024,324104.0400000029,21080.419999999518
24614,2022-08-16 16:10:00,-141.81,345042.6500000024,324104.0400000029,20938.60999999952
24615,2022-08-16 16:15:00,-544.61,344498.0400000024,324104.0400000029,20393.999999999534
24616,2022-08-16 16:20:00,1554.98,346053.0200000024,324104.0400000029,21948.979999999516
24617,2022-08-16 16:25:00,822.46,346875.4800000024,324104.0400000029,22771.439999999537
24618,2022-08-16 16:30:00,368.12,347243.6000000024,324104.0400000029,23139.559999999532
24619,2022-08-16 16:35:00,-1304.21,345939.3900000024,324104.0400000029,21835.34999999951
24620,2022-08-16 16:40:00,1897.6,347836.9900000024,324104.0400000029,23732.949999999488
24621,2022-08-16 16:45:00,-1175.72,346661.2700000024,324104.0400000029,22557.229999999516
24622,2022-08-16 16:50:00,-519.61,346141.6600000024,324104.0400000029,22037.61999999953
24623,2022-08-16 16:55:00,-1662.23,344479.43000000244,324104.0400000029,20375.38999999955
24624,2022-08-17 08:00:00,1293.78,345773.21000000247,344479.43000000244,1293.780000000028
24625,2022-08-17 08:05:00,1854.92,347628.13000000245,344479.43000000244,3148.7000000000116
24626,2022-08-17 08:10:00,1336.42,348964.55000000243,344479.43000000244,4485.119999999995
24627,2022-08-17 08:15:00,-990.95,347973.6000000024,344479.43000000244,3494.1699999999837
24628,2022-08-17 08:20:00,-1758.05,346215.55000000243,344479.43000000244,1736.1199999999953
24629,2022-08-17 08:25:00,-403.6,345811.95000000246,344479.43000000244,1332.5200000000186
24630,2022-08-17 08:30:00,1279.65,347091.6000000025,344479.43000000244,2612.170000000042
24631,2022-08-17 08:35:00,-611.91,346479.6900000025,344479.43000000244,2000.2600000000675
24632,2022-08-17 08:40:00,-731.9,345747.7900000025,344479.43000000244,1268.3600000000442
24633,2022-08-17 08:45:00,108.68,345856.4700000025,344479.43000000244,1377.0400000000373
24634,2022-08-17 08:50:00,1485.04,347341.51000000245,344479.43000000244,2862.0800000000163
24635,2022-08-17 08:55:00,-1900.93,345440.58000000246,344479.43000000244,961.1500000000233
24636,2022-08-17 09:00:00,-1484.92,343955.6600000025,344479.43000000244,-523.7699999999604
24637,2022-08-17 09:05:00,-1588.89,342366.77000000246,344479.43000000244,-2112.6599999999744
24638,2022-08-17 09:10:00,-16.6,342350.1700000025,344479.43000000244,-2129.259999999951
24639,2022-08-17 09:15:00,87.59,342437.7600000025,344479.43000000244,-2041.6699999999255
24640,2022-08-17 09:20:00,1439.58,343877.3400000025,344479.43000000244,-602.0899999999092
24641,2022-08-17 09:25:00,-1062.14,342815.2000000025,344479.43000000244,-1664.2299999999232
24642,2022-08-17 09:30:00,1212.19,344027.3900000025,344479.43000000244,-452.03999999992084
24643,2022-08-17 09:35:00,-555.84,343471.5500000025,344479.43000000244,-1007.8799999999464
24644,2022-08-17 09:40:00,-996.31,342475.2400000025,344479.43000000244,-2004.1899999999441
24645,2022-08-17 09:45:00,-320.51,342154.7300000025,344479.43000000244,-2324.6999999999534
24646,2022-08-17 09:50:00,-651.57,341503.1600000025,344479.43000000244,-2976.2699999999604
24647,2022-08-17 09:55:00,-722.0,340781.1600000025,344479.43000000244,-3698.2699999999604
24648,2022-08-17 10:00:00,886.82,341667.9800000025,344479.43000000244,-2811.4499999999534
24649,2022-08-17 10:05:00,1259.79,342927.77000000246,344479.43000000244,-1551.6599999999744
24650,2022-08-17 10:10:00,-1825.01,341102.76000000245,344479.43000000244,-3376.6699999999837
24651,2022-08-17 10:15:00,-721.49,340381.27000000246,344479.43000000244,-4098.159999999974
24652,2022-08-17 10:20:00,-189.85,340191.4200000025,344479.43000000244,-4288.009999999951
24653,2022-08-17 10:25:00,661.74,340853.1600000025,344479.43000000244,-3626.2699999999604
24654,2022-08-17 10:30:00,-467.41,340385.7500000025,344479.43000000244,-4093.679999999935
24655,2022-08-17 10:35:00,-6.83,340378.9200000025,344479.43000000244,-4100.509999999951
24656,2022-08-17 10:40:00,-1167.07,339211.8500000025,344479.43000000244,-5267.579999999958
24657,2022-08-17 10:45:00,164.5,339376.3500000025,344479.43000000244,-5103.079999999958
24658,2022-08-17 10:50:00,-1349.05,338027.3000000025,344479.43000000244,-6452.129999999946
24659,2022-08-17 10:55:00,861.08,338888.3800000025,344479.43000000244,-5591.04999999993
24660,2022-08-17 11:00:00,-278.03,338610.3500000025,344479.43000000244,-5869.079999999958
24661,2022-08-17 11:05:00,1411.21,340021.5600000025,344479.43000000244,-4457.869999999937
24662,2022-08-17 11:10:00,1497.9,341519.4600000025,344479.43000000244,-2959.969999999914
24663,2022-08-17 11:15:00,-1283.53,340235.9300000025,344479.43000000244,-4243.499999999942
24664,2022-08-17 11:20:00,1635.46,341871.3900000025,344479.43000000244,-2608.039999999921
24665,2022-08-17 11:25:00,-1140.29,340731.10000000254,344479.43000000244,-3748.3299999999
24666,2022-08-17 11:30:00,1350.2,342081.30000000255,344479.43000000244,-2398.1299999998882
24667,2022-08-17 11:35:00,1510.9,343592.2000000026,344479.43000000244,-887.229999999865
24668,2022-08-17 11:40:00,-1849.83,341742.37000000256,344479.43000000244,-2737.0599999998813
24669,2022-08-17 11:45:00,871.32,342613.69000000256,344479.43000000244,-1865.7399999998743
24670,2022-08-17 11:50:00,-96.04,342517.6500000026,344479.43000000244,-1961.7799999998533
24671,2022-08-17 11:55:00,-1249.07,341268.5800000026,344479.43000000244,-3210.8499999998603
24672,2022-08-17 12:00:00,1839.96,343108.5400000026,344479.43000000244,-1370.8899999998393
24673,2022-08-17 12:05:00,-342.55,342765.9900000026,344479.43000000244,-1713.4399999998277
24674,2022-08-17 12:10:00,-185.06,342580.9300000026,344479.43000000244,-1898.4999999998254
24675,2022-08-17 12:15:00,1494.88,344075.8100000026,344479.43000000244,-403.6199999998207
24676,2022-08-17 12:20:00,-1999.57,342076.2400000026,344479.43000000244,-2403.1899999998277
24677,2022-08-17 12:25:00,-958.07,341118.1700000026,344479.43000000244,-3361.2599999998347
24678,2022-08-17 12:30:00,740.48,341858.6500000026,344479.43000000244,-2620.7799999998533
24679,2022-08-17 12:35:00,-1157.48,340701.1700000026,344479.43000000244,-3778.2599999998347
24680,2022-08-17 12:40:00,301.48,341002.6500000026,344479.43000000244,-3476.7799999998533
24681,2022-08-17 12:45:00,1191.15,342193.8000000026,344479.43000000244,-2285.62999999983
24682,2022-08-17 12:50:00,-273.05,341920.7500000026,344479.43000000244,-2558.6799999998184
24683,2022-08-17 12:55:00,-1599.38,340321.3700000026,344479.43000000244,-4158.059999999823
24684,2022-08-17 13:00:00,-849.98,339471.39000000263,344479.43000000244,-5008.039999999804
24685,2022-08-17 13:05:00,465.92,339937.3100000026,344479.43000000244,-4542.119999999821
24686,2022-08-17 13:10:00,662.74,340600.0500000026,344479.43000000244,-3879.37999999983
24687,2022-08-17 13:15:00,-712.16,339887.89000000263,344479.43000000244,-4591.539999999804
24688,2022-08-17 13:20:00,323.39,340211.28000000265,344479.43000000244,-4268.14999999979
24689,2022-08-17 13:25:00,1738.59,341949.8700000027,344479.43000000244,-2529.559999999765
24690,2022-08-17 13:30:00,47.34,341997.2100000027,344479.43000000244,-2482.2199999997392
24691,2022-08-17 13:35:00,1127.47,343124.68000000267,344479.43000000244,-1354.7499999997672
24692,2022-08-17 13:40:00,1158.54,344283.22000000265,344479.43000000244,-196.20999999978812
24693,2022-08-17 13:45:00,403.29,344686.5100000026,344479.43000000244,207.08000000019092
24694,2022-08-17 13:50:00,379.94,345066.45000000263,344479.43000000244,587.0200000001932
24695,2022-08-17 13:55:00,-120.84,344945.6100000026,344479.43000000244,466.18000000016764
24696,2022-08-17 14:00:00,-540.22,344405.39000000263,344479.43000000244,-74.03999999980442
24697,2022-08-17 14:05:00,330.14,344735.53000000265,344479.43000000244,256.10000000020955
24698,2022-08-17 14:10:00,1666.36,346401.89000000263,344479.43000000244,1922.4600000001956
24699,2022-08-17 14:15:00,393.1,346794.9900000026,344479.43000000244,2315.5600000001723
24700,2022-08-17 14:20:00,-1682.45,345112.5400000026,344479.43000000244,633.1100000001607
24701,2022-08-17 14:25:00,751.75,345864.2900000026,344479.43000000244,1384.8600000001607
24702,2022-08-17 14:30:00,1549.36,347413.6500000026,344479.43000000244,2934.2200000001467
24703,2022-08-17 14:35:00,743.69,348157.3400000026,344479.43000000244,3677.910000000149
24704,2022-08-17 14:40:00,1127.76,349285.1000000026,344479.43000000244,4805.670000000158
24705,2022-08-17 14:45:00,474.79,349759.8900000026,344479.43000000244,5280.460000000137
24706,2022-08-17 14:50:00,-1306.33,348453.56000000256,344479.43000000244,3974.130000000121
24707,2022-08-17 14:55:00,-1765.94,346687.62000000256,344479.43000000244,2208.1900000001187
24708,2022-08-17 15:00:00,-1792.97,344894.6500000026,344479.43000000244,415.2200000001467
24709,2022-08-17 15:05:00,1741.76,346636.4100000026,344479.43000000244,2156.980000000156
24710,2022-08-17 15:10:00,-261.75,346374.6600000026,344479.43000000244,1895.230000000156
24711,2022-08-17 15:15:00,-788.23,345586.4300000026,344479.43000000244,1107.0000000001746
24712,2022-08-17 15:20:00,-985.72,344600.71000000264,344479.43000000244,121.28000000020256
24713,2022-08-17 15:25:00,1281.65,345882.36000000266,344479.43000000244,1402.9300000002258
24714,2022-08-17 15:30:00,-1639.66,344242.7000000027,344479.43000000244,-236.72999999974854
24715,2022-08-17 15:35:00,478.55,344721.2500000027,344479.43000000244,241.82000000023982
24716,2022-08-17 15:40:00,-839.08,343882.17000000266,344479.43000000244,-597.2599999997765
24717,2022-08-17 15:45:00,-1141.87,342740.30000000267,344479.43000000244,-1739.1299999997718
24718,2022-08-17 15:50:00,1162.62,343902.92000000266,344479.43000000244,-576.5099999997765
24719,2022-08-17 15:55:00,-285.82,343617.10000000265,344479.43000000244,-862.3299999997835
24720,2022-08-17 16:00:00,733.61,344350.71000000264,344479.43000000244,-128.71999999979744
24721,2022-08-17 16:05:00,-1684.55,342666.16000000265,344479.43000000244,-1813.2699999997858
24722,2022-08-17 16:10:00,-275.91,342390.2500000027,344479.43000000244,-2089.17999999976
24723,2022-08-17 16:15:00,985.87,343376.1200000027,344479.43000000244,-1103.3099999997648
24724,2022-08-17 16:20:00,1076.67,344452.79000000266,344479.43000000244,-26.63999999978114
24725,2022-08-17 16:25:00,1821.86,346274.65000000264,344479.43000000244,1795.220000000205
24726,2022-08-17 16:30:00,1677.73,347952.3800000026,344479.43000000244,3472.9500000001863
24727,2022-08-17 16:35:00,984.51,348936.89000000263,344479.43000000244,4457.460000000196
24728,2022-08-17 16:40:00,-1828.15,347108.7400000026,344479.43000000244,2629.3100000001723
24729,2022-08-17 16:45:00,1737.64,348846.3800000026,344479.43000000244,4366.950000000186
24730,2022-08-17 16:50:00,1927.71,350774.09000000264,344479.43000000244,6294.660000000207
24731,2022-08-17 16:55:00,773.35,351547.4400000026,344479.43000000244,7068.010000000184
24732,2022-08-18 08:00:00,1053.84,352601.28000000265,351547.4400000026,1053.8400000000256
24733,2022-08-18 08:05:00,-1026.04,351575.24000000267,351547.4400000026,27.800000000046566
24734,2022-08-18 08:10:00,-1689.9,349885.34000000264,351547.4400000026,-1662.0999999999767
24735,2022-08-18 08:15:00,1444.93,351330.27000000264,351547.4400000026,-217.1699999999837
24736,2022-08-18 08:20:00,62.95,351393.22000000265,351547.4400000026,-154.21999999997206
24737,2022-08-18 08:25:00,-159.04,351234.18000000267,351547.4400000026,-313.2599999999511
24738,2022-08-18 08:30:00,1414.46,352648.6400000027,351547.4400000026,1101.2000000000698
24739,2022-08-18 08:35:00,459.03,353107.6700000027,351547.4400000026,1560.2300000000978
24740,2022-08-18 08:40:00,-1653.87,351453.8000000027,351547.4400000026,-93.63999999989755
24741,2022-08-18 08:45:00,1388.3,352842.1000000027,351547.4400000026,1294.6600000000908
24742,2022-08-18 08:50:00,1104.39,353946.4900000027,351547.4400000026,2399.050000000105
24743,2022-08-18 08:55:00,-632.05,353314.44000000274,351547.4400000026,1767.0000000001164
24744,2022-08-18 09:00:00,1764.31,355078.75000000274,351547.4400000026,3531.310000000114
24745,2022-08-18 09:05:00,-279.25,354799.50000000274,351547.4400000026,3252.060000000114
24746,2022-08-18 09:10:00,-1076.12,353723.38000000274,351547.4400000026,2175.9400000001187
24747,2022-08-18 09:15:00,-173.99,353549.39000000275,351547.4400000026,2001.950000000128
24748,2022-08-18 09:20:00,-174.91,353374.4800000028,351547.4400000026,1827.0400000001537
24749,2022-08-18 09:25:00,-151.7,353222.78000000276,351547.4400000026,1675.340000000142
24750,2022-08-18 09:30:00,1908.64,355131.4200000028,351547.4400000026,3583.980000000156
24751,2022-08-18 09:35:00,-95.1,355036.3200000028,351547.4400000026,3488.8800000001793
24752,2022-08-18 09:40:00,-318.02,354718.3000000028,351547.4400000026,3170.8600000001607
24753,2022-08-18 09:45:00,-630.97,354087.3300000028,351547.4400000026,2539.8900000001886
24754,2022-08-18 09:50:00,539.85,354627.1800000028,351547.4400000026,3079.7400000001653
24755,2022-08-18 09:55:00,-1565.54,353061.6400000028,351547.4400000026,1514.2000000001863
24756,2022-08-18 10:00:00,1830.57,354892.2100000028,351547.4400000026,3344.7700000001932
24757,2022-08-18 10:05:00,1547.2,356439.4100000028,351547.4400000026,4891.970000000205
24758,2022-08-18 10:10:00,118.77,356558.18000000285,351547.4400000026,5010.7400000002235
24759,2022-08-18 10:15:00,-1596.06,354962.12000000285,351547.4400000026,3414.680000000226
24760,2022-08-18 10:20:00,992.85,355954.9700000028,351547.4400000026,4407.530000000203
24761,2022-08-18 10:25:00,-1520.45,354434.5200000028,351547.4400000026,2887.080000000191
24762,2022-08-18 10:30:00,1984.69,356419.2100000028,351547.4400000026,4871.770000000193
24763,2022-08-18 10:35:00,-1595.02,354824.1900000028,351547.4400000026,3276.7500000001746
24764,2022-08-18 10:40:00,27.16,354851.35000000277,351547.4400000026,3303.910000000149
24765,2022-08-18 10:45:00,-1106.74,353744.6100000028,351547.4400000026,2197.1700000001583
24766,2022-08-18 10:50:00,-1952.04,351792.5700000028,351547.4400000026,245.13000000017928
24767,2022-08-18 10:55:00,-1774.92,350017.6500000028,351547.4400000026,-1529.7899999998044
24768,2022-08-18 11:00:00,960.39,350978.04000000283,351547.4400000026,-569.3999999997905
24769,2022-08-18 11:05:00,-1039.01,349939.0300000028,351547.4400000026,-1608.4099999997998
24770,2022-08-18 11:10:00,-878.07,349060.9600000028,351547.4400000026,-2486.4799999998068
24771,2022-08-18 11:15:00,-321.83,348739.1300000028,351547.4400000026,-2808.309999999823
24772,2022-08-18 11:20:00,1576.41,350315.5400000028,351547.4400000026,-1231.8999999998487
24773,2022-08-18 11:25:00,1306.51,351622.0500000028,351547.4400000026,74.61000000016065
24774,2022-08-18 11:30:00,-45.46,351576.59000000276,351547.4400000026,29.1500000001397
24775,2022-08-18 11:35:00,-1865.22,349711.3700000028,351547.4400000026,-1836.0699999998324
24776,2022-08-18 11:40:00,187.82,349899.1900000028,351547.4400000026,-1648.2499999998254
24777,2022-08-18 11:45:00,-1808.34,348090.85000000277,351547.4400000026,-3456.589999999851
24778,2022-08-18 11:50:00,-1640.0,346450.85000000277,351547.4400000026,-5096.589999999851
24779,2022-08-18 11:55:00,1222.91,347673.76000000275,351547.4400000026,-3873.6799999998766
24780,2022-08-18 12:00:00,-1148.27,346525.4900000027,351547.4400000026,-5021.949999999895
24781,2022-08-18 12:05:00,-1978.64,344546.8500000027,351547.4400000026,-7000.589999999909
24782,2022-08-18 12:10:00,-1377.64,343169.2100000027,351547.4400000026,-8378.229999999923
24783,2022-08-18 12:15:00,-1642.64,341526.5700000027,351547.4400000026,-10020.869999999937
24784,2022-08-18 12:20:00,631.02,342157.5900000027,351547.4400000026,-9389.849999999919
24785,2022-08-18 12:25:00,-1031.0,341126.5900000027,351547.4400000026,-10420.849999999919
24786,2022-08-18 12:30:00,-1914.48,339212.1100000027,351547.4400000026,-12335.3299999999
24787,2022-08-18 12:35:00,819.11,340031.2200000027,351547.4400000026,-11516.219999999914
24788,2022-08-18 12:40:00,1802.79,341834.0100000027,351547.4400000026,-9713.429999999935
24789,2022-08-18 12:45:00,3.49,341837.5000000027,351547.4400000026,-9709.939999999944
24790,2022-08-18 12:50:00,-891.12,340946.3800000027,351547.4400000026,-10601.05999999994
24791,2022-08-18 12:55:00,-609.39,340336.99000000267,351547.4400000026,-11210.449999999953
24792,2022-08-18 13:00:00,1440.99,341777.98000000266,351547.4400000026,-9769.459999999963
24793,2022-08-18 13:05:00,1931.8,343709.78000000265,351547.4400000026,-7837.659999999974
24794,2022-08-18 13:10:00,-895.49,342814.29000000266,351547.4400000026,-8733.149999999965
24795,2022-08-18 13:15:00,-639.1,342175.1900000027,351547.4400000026,-9372.249999999942
24796,2022-08-18 13:20:00,1059.83,343235.0200000027,351547.4400000026,-8312.419999999925
24797,2022-08-18 13:25:00,300.82,343535.8400000027,351547.4400000026,-8011.5999999999185
24798,2022-08-18 13:30:00,978.38,344514.2200000027,351547.4400000026,-7033.219999999914
24799,2022-08-18 13:35:00,-1495.87,343018.3500000027,351547.4400000026,-8529.08999999991
24800,2022-08-18 13:40:00,607.71,343626.06000000273,351547.4400000026,-7921.379999999888
24801,2022-08-18 13:45:00,-750.0,342876.06000000273,351547.4400000026,-8671.379999999888
24802,2022-08-18 13:50:00,1735.85,344611.9100000027,351547.4400000026,-6935.5299999999115
24803,2022-08-18 13:55:00,-1632.34,342979.5700000027,351547.4400000026,-8567.869999999937
24804,2022-08-18 14:00:00,1904.0,344883.5700000027,351547.4400000026,-6663.869999999937
24805,2022-08-18 14:05:00,1711.99,346595.5600000027,351547.4400000026,-4951.879999999946
24806,2022-08-18 14:10:00,811.4,347406.9600000027,351547.4400000026,-4140.479999999923
24807,2022-08-18 14:15:00,-18.03,347388.93000000267,351547.4400000026,-4158.509999999951
24808,2022-08-18 14:20:00,859.07,348248.0000000027,351547.4400000026,-3299.439999999944
24809,2022-08-18 14:25:00,886.29,349134.29000000266,351547.4400000026,-2413.149999999965
24810,2022-08-18 14:30:00,-781.76,348352.53000000265,351547.4400000026,-3194.9099999999744
24811,2022-08-18 14:35:00,711.4,349063.93000000267,351547.4400000026,-2483.509999999951
24812,2022-08-18 14:40:00,-1692.52,347371.41000000265,351547.4400000026,-4176.02999999997
24813,2022-08-18 14:45:00,-628.56,346742.85000000265,351547.4400000026,-4804.589999999967
24814,2022-08-18 14:50:00,500.87,347243.72000000265,351547.4400000026,-4303.719999999972
24815,2022-08-18 14:55:00,-382.38,346861.34000000264,351547.4400000026,-4686.099999999977
24816,2022-08-18 15:00:00,1172.99,348034.33000000264,351547.4400000026,-3513.109999999986
24817,2022-08-18 15:05:00,1663.7,349698.03000000265,351547.4400000026,-1849.4099999999744
24818,2022-08-18 15:10:00,1340.84,351038.8700000027,351547.4400000026,-508.5699999999488
24819,2022-08-18 15:15:00,-1717.09,349321.78000000265,351547.4400000026,-2225.6599999999744
24820,2022-08-18 15:20:00,520.45,349842.23000000266,351547.4400000026,-1705.2099999999627
24821,2022-08-18 15:25:00,892.64,350734.8700000027,351547.4400000026,-812.5699999999488
24822,2022-08-18 15:30:00,-615.8,350119.0700000027,351547.4400000026,-1428.3699999999371
24823,2022-08-18 15:35:00,76.59,350195.6600000027,351547.4400000026,-1351.7799999999115
24824,2022-08-18 15:40:00,1648.32,351843.9800000027,351547.4400000026,296.54000000009546
24825,2022-08-18 15:45:00,1208.34,353052.32000000274,351547.4400000026,1504.880000000121
24826,2022-08-18 15:50:00,1841.23,354893.5500000027,351547.4400000026,3346.1100000001024
24827,2022-08-18 15:55:00,1411.22,356304.7700000027,351547.4400000026,4757.3300000000745
24828,2022-08-18 16:00:00,888.03,357192.8000000027,351547.4400000026,5645.360000000102
24829,2022-08-18 16:05:00,897.55,358090.3500000027,351547.4400000026,6542.910000000091
24830,2022-08-18 16:10:00,-569.42,357520.9300000027,351547.4400000026,5973.490000000107
24831,2022-08-18 16:15:00,1074.61,358595.5400000027,351547.4400000026,7048.100000000093
24832,2022-08-18 16:20:00,-1558.47,357037.07000000274,351547.4400000026,5489.630000000121
24833,2022-08-18 16:25:00,-1758.63,355278.44000000274,351547.4400000026,3731.0000000001164
24834,2022-08-18 16:30:00,-1224.3,354054.14000000275,351547.4400000026,2506.700000000128
24835,2022-08-18 16:35:00,-1292.58,352761.56000000273,351547.4400000026,1214.1200000001118
24836,2022-08-18 16:40:00,-1581.72,351179.84000000276,351547.4400000026,-367.5999999998603
24837,2022-08-18 16:45:00,593.87,351773.71000000276,351547.4400000026,226.27000000013504
24838,2022-08-18 16:50:00,1141.15,352914.8600000028,351547.4400000026,1367.4200000001583
24839,2022-08-18 16:55:00,-48.18,352866.6800000028,351547.4400000026,1319.2400000001653
24840,2022-08-19 08:00:00,939.49,353806.1700000028,352866.6800000028,939.4899999999907
24841,2022-08-19 08:05:00,-552.12,353254.0500000028,352866.6800000028,387.36999999999534
24842,2022-08-19 08:10:00,-1287.26,351966.7900000028,352866.6800000028,-899.890000000014
24843,2022-08-19 08:15:00,-1695.33,350271.46000000276,352866.6800000028,-2595.2200000000303
24844,2022-08-19 08:20:00,959.19,351230.65000000276,352866.6800000028,-1636.030000000028
24845,2022-08-19 08:25:00,1426.51,352657.16000000277,352866.6800000028,-209.52000000001863
24846,2022-08-19 08:30:00,-1006.67,351650.4900000028,352866.6800000028,-1216.1900000000023
24847,2022-08-19 08:35:00,148.94,351799.4300000028,352866.6800000028,-1067.25
24848,2022-08-19 08:40:00,1169.95,352969.3800000028,352866.6800000028,102.70000000001164
24849,2022-08-19 08:45:00,846.65,353816.0300000028,352866.6800000028,949.3500000000349
24850,2022-08-19 08:50:00,1903.09,355719.12000000285,352866.6800000028,2852.4400000000605
24851,2022-08-19 08:55:00,-168.66,355550.4600000029,352866.6800000028,2683.780000000086
24852,2022-08-19 09:00:00,-317.97,355232.4900000029,352866.6800000028,2365.810000000114
24853,2022-08-19 09:05:00,1665.83,356898.3200000029,352866.6800000028,4031.6400000001304
24854,2022-08-19 09:10:00,304.93,357203.2500000029,352866.6800000028,4336.570000000123
24855,2022-08-19 09:15:00,-1262.66,355940.59000000294,352866.6800000028,3073.910000000149
24856,2022-08-19 09:20:00,1058.33,356998.92000000295,352866.6800000028,4132.240000000165
24857,2022-08-19 09:25:00,825.27,357824.190000003,352866.6800000028,4957.510000000184
24858,2022-08-19 09:30:00,-24.68,357799.510000003,352866.6800000028,4932.830000000191
24859,2022-08-19 09:35:00,-730.37,357069.140000003,352866.6800000028,4202.460000000196
24860,2022-08-19 09:40:00,796.17,357865.31000000297,352866.6800000028,4998.630000000179
24861,2022-08-19 09:45:00,-1330.55,356534.760000003,352866.6800000028,3668.080000000191
24862,2022-08-19 09:50:00,1000.96,357535.720000003,352866.6800000028,4669.040000000212
24863,2022-08-19 09:55:00,-476.51,357059.210000003,352866.6800000028,4192.530000000203
24864,2022-08-19 10:00:00,-1246.13,355813.080000003,352866.6800000028,2946.400000000198
24865,2022-08-19 10:05:00,-1465.74,354347.340000003,352866.6800000028,1480.6600000002072
24866,2022-08-19 10:10:00,-793.15,353554.190000003,352866.6800000028,687.5100000001839
24867,2022-08-19 10:15:00,-329.21,353224.98000000295,352866.6800000028,358.300000000163
24868,2022-08-19 10:20:00,239.96,353464.940000003,352866.6800000028,598.2600000001839
24869,2022-08-19 10:25:00,1467.45,354932.390000003,352866.6800000028,2065.7100000001956
24870,2022-08-19 10:30:00,526.83,355459.220000003,352866.6800000028,2592.540000000212
24871,2022-08-19 10:35:00,-928.66,354530.560000003,352866.6800000028,1663.8800000002375
24872,2022-08-19 10:40:00,-1795.12,352735.44000000303,352866.6800000028,-131.23999999975786
24873,2022-08-19 10:45:00,-537.84,352197.600000003,352866.6800000028,-669.0799999997835
24874,2022-08-19 10:50:00,-376.45,351821.150000003,352866.6800000028,-1045.529999999795
24875,2022-08-19 10:55:00,-642.58,351178.570000003,352866.6800000028,-1688.1099999998114
24876,2022-08-19 11:00:00,-129.83,351048.74000000296,352866.6800000028,-1817.9399999998277
24877,2022-08-19 11:05:00,1801.43,352850.17000000295,352866.6800000028,-16.50999999983469
24878,2022-08-19 11:10:00,-339.02,352511.15000000293,352866.6800000028,-355.5299999998533
24879,2022-08-19 11:15:00,600.73,353111.8800000029,352866.6800000028,245.20000000012806
24880,2022-08-19 11:20:00,-1942.16,351169.72000000294,352866.6800000028,-1696.9599999998463
24881,2022-08-19 11:25:00,1960.32,353130.04000000295,352866.6800000028,263.36000000016065
24882,2022-08-19 11:30:00,72.88,353202.92000000295,352866.6800000028,336.2400000001653
24883,2022-08-19 11:35:00,-695.24,352507.68000000296,352866.6800000028,-358.9999999998254
24884,2022-08-19 11:40:00,-1537.2,350970.48000000295,352866.6800000028,-1896.199999999837
24885,2022-08-19 11:45:00,1269.61,352240.09000000294,352866.6800000028,-626.589999999851
24886,2022-08-19 11:50:00,316.19,352556.28000000294,352866.6800000028,-310.39999999984866
24887,2022-08-19 11:55:00,741.8,353298.0800000029,352866.6800000028,431.4000000001397
24888,2022-08-19 12:00:00,288.24,353586.3200000029,352866.6800000028,719.6400000001304
24889,2022-08-19 12:05:00,-1535.77,352050.5500000029,352866.6800000028,-816.1299999998882
24890,2022-08-19 12:10:00,1292.6,353343.1500000029,352866.6800000028,476.4700000000885
24891,2022-08-19 12:15:00,-941.1,352402.0500000029,352866.6800000028,-464.62999999988824
24892,2022-08-19 12:20:00,594.15,352996.2000000029,352866.6800000028,129.52000000013504
24893,2022-08-19 12:25:00,-421.06,352575.1400000029,352866.6800000028,-291.53999999986263
24894,2022-08-19 12:30:00,-580.37,351994.7700000029,352866.6800000028,-871.909999999858
24895,2022-08-19 12:35:00,-357.37,351637.40000000293,352866.6800000028,-1229.2799999998533
24896,2022-08-19 12:40:00,971.7,352609.10000000295,352866.6800000028,-257.5799999998417
24897,2022-08-19 12:45:00,1730.67,354339.7700000029,352866.6800000028,1473.090000000142
24898,2022-08-19 12:50:00,-1959.36,352380.41000000294,352866.6800000028,-486.269999999844
24899,2022-08-19 12:55:00,1412.89,353793.30000000296,352866.6800000028,926.62000000017
24900,2022-08-19 13:00:00,-1681.72,352111.580000003,352866.6800000028,-755.0999999998021
24901,2022-08-19 13:05:00,-1381.43,350730.150000003,352866.6800000028,-2136.529999999795
24902,2022-08-19 13:10:00,646.72,351376.87000000296,352866.6800000028,-1489.809999999823
24903,2022-08-19 13:15:00,555.78,351932.650000003,352866.6800000028,-934.0299999997951
24904,2022-08-19 13:20:00,1703.29,353635.940000003,352866.6800000028,769.2600000001839
24905,2022-08-19 13:25:00,-1706.1,351929.840000003,352866.6800000028,-936.8399999997928
24906,2022-08-19 13:30:00,-1696.14,350233.700000003,352866.6800000028,-2632.9799999998068
24907,2022-08-19 13:35:00,18.0,350251.700000003,352866.6800000028,-2614.9799999998068
24908,2022-08-19 13:40:00,-765.7,349486.00000000297,352866.6800000028,-3380.6799999998184
24909,2022-08-19 13:45:00,-1744.63,347741.37000000296,352866.6800000028,-5125.309999999823
24910,2022-08-19 13:50:00,918.87,348660.24000000296,352866.6800000028,-4206.439999999828
24911,2022-08-19 13:55:00,-757.67,347902.570000003,352866.6800000028,-4964.109999999811
24912,2022-08-19 14:00:00,-1985.7,345916.87000000296,352866.6800000028,-6949.809999999823
24913,2022-08-19 14:05:00,1444.12,347360.99000000296,352866.6800000028,-5505.689999999828
24914,2022-08-19 14:10:00,-1408.27,345952.72000000294,352866.6800000028,-6913.959999999846
24915,2022-08-19 14:15:00,-1105.05,344847.67000000295,352866.6800000028,-8019.009999999835
24916,2022-08-19 14:20:00,1178.22,346025.8900000029,352866.6800000028,-6840.789999999863
24917,2022-08-19 14:25:00,-1323.6,344702.29000000295,352866.6800000028,-8164.389999999839
24918,2022-08-19 14:30:00,1244.17,345946.46000000293,352866.6800000028,-6920.219999999856
24919,2022-08-19 14:35:00,-112.04,345834.42000000295,352866.6800000028,-7032.259999999835
24920,2022-08-19 14:40:00,-584.76,345249.66000000294,352866.6800000028,-7617.019999999844
24921,2022-08-19 14:45:00,-1480.84,343768.8200000029,352866.6800000028,-9097.85999999987
24922,2022-08-19 14:50:00,-287.27,343481.5500000029,352866.6800000028,-9385.129999999888
24923,2022-08-19 14:55:00,-1578.34,341903.2100000029,352866.6800000028,-10963.469999999914
24924,2022-08-19 15:00:00,1801.58,343704.7900000029,352866.6800000028,-9161.889999999898
24925,2022-08-19 15:05:00,-1892.52,341812.27000000287,352866.6800000028,-11054.409999999916
24926,2022-08-19 15:10:00,-574.84,341237.43000000285,352866.6800000028,-11629.249999999942
24927,2022-08-19 15:15:00,-1419.91,339817.52000000287,352866.6800000028,-13049.159999999916
24928,2022-08-19 15:20:00,-837.46,338980.06000000285,352866.6800000028,-13886.619999999937
24929,2022-08-19 15:25:00,-1425.96,337554.1000000028,352866.6800000028,-15312.579999999958
24930,2022-08-19 15:30:00,1406.25,338960.3500000028,352866.6800000028,-13906.329999999958
24931,2022-08-19 15:35:00,1664.6,340624.9500000028,352866.6800000028,-12241.729999999981
24932,2022-08-19 15:40:00,-240.95,340384.0000000028,352866.6800000028,-12482.679999999993
24933,2022-08-19 15:45:00,1813.64,342197.6400000028,352866.6800000028,-10669.039999999979
24934,2022-08-19 15:50:00,1839.61,344037.2500000028,352866.6800000028,-8829.429999999993
24935,2022-08-19 15:55:00,-881.89,343155.3600000028,352866.6800000028,-9711.320000000007
24936,2022-08-19 16:00:00,372.46,343527.8200000028,352866.6800000028,-9338.859999999986
24937,2022-08-19 16:05:00,1208.76,344736.5800000028,352866.6800000028,-8130.099999999977
24938,2022-08-19 16:10:00,-1770.93,342965.6500000028,352866.6800000028,-9901.02999999997
24939,2022-08-19 16:15:00,-298.42,342667.23000000283,352866.6800000028,-10199.449999999953
24940,2022-08-19 16:20:00,-724.51,341942.7200000028,352866.6800000028,-10923.959999999963
24941,2022-08-19 16:25:00,106.26,342048.98000000283,352866.6800000028,-10817.699999999953
24942,2022-08-19 16:30:00,-1247.63,340801.3500000028,352866.6800000028,-12065.329999999958
24943,2022-08-19 16:35:00,136.29,340937.6400000028,352866.6800000028,-11929.039999999979
24944,2022-08-19 16:40:00,-1074.32,339863.3200000028,352866.6800000028,-13003.359999999986
24945,2022-08-19 16:45:00,-127.82,339735.5000000028,352866.6800000028,-13131.179999999993
24946,2022-08-19 16:50:00,-1511.7,338223.8000000028,352866.6800000028,-14642.880000000005
24947,2022-08-19 16:55:00,512.93,338736.7300000028,352866.6800000028,-14129.950000000012
24948,2022-08-20 08:00:00,485.99,339222.72000000277,338736.7300000028,485.9899999999907
24949,2022-08-20 08:05:00,-73.62,339149.10000000277,338736.7300000028,412.36999999999534
24950,2022-08-20 08:10:00,1158.78,340307.8800000028,338736.7300000028,1571.1500000000233
24951,2022-08-20 08:15:00,518.95,340826.8300000028,338736.7300000028,2090.100000000035
24952,2022-08-20 08:20:00,1340.7,342167.5300000028,338736.7300000028,3430.8000000000466
24953,2022-08-20 08:25:00,601.76,342769.29000000283,338736.7300000028,4032.560000000056
24954,2022-08-20 08:30:00,-1748.3,341020.99000000284,338736.7300000028,2284.2600000000675
24955,2022-08-20 08:35:00,1596.57,342617.56000000285,338736.7300000028,3880.8300000000745
24956,2022-08-20 08:40:00,1427.59,344045.1500000029,338736.7300000028,5308.4200000001
24957,2022-08-20 08:45:00,-428.7,343616.45000000286,338736.7300000028,4879.7200000000885
24958,2022-08-20 08:50:00,-1158.89,342457.56000000285,338736.7300000028,3720.8300000000745
24959,2022-08-20 08:55:00,-1654.16,340803.4000000029,338736.7300000028,2066.6700000001
24960,2022-08-20 09:00:00,-1939.85,338863.5500000029,338736.7300000028,126.8200000001234
24961,2022-08-20 09:05:00,134.7,338998.2500000029,338736.7300000028,261.52000000013504
24962,2022-08-20 09:10:00,540.7,339538.9500000029,338736.7300000028,802.2200000001467
24963,2022-08-20 09:15:00,1836.25,341375.2000000029,338736.7300000028,2638.4700000001467
24964,2022-08-20 09:20:00,923.58,342298.78000000294,338736.7300000028,3562.050000000163
24965,2022-08-20 09:25:00,-599.28,341699.5000000029,338736.7300000028,2962.770000000135
24966,2022-08-20 09:30:00,-1078.75,340620.7500000029,338736.7300000028,1884.020000000135
24967,2022-08-20 09:35:00,-329.87,340290.8800000029,338736.7300000028,1554.1500000001397
24968,2022-08-20 09:40:00,-658.62,339632.2600000029,338736.7300000028,895.5300000001444
24969,2022-08-20 09:45:00,620.66,340252.9200000029,338736.7300000028,1516.1900000001187
24970,2022-08-20 09:50:00,1882.42,342135.3400000029,338736.7300000028,3398.6100000001024
24971,2022-08-20 09:55:00,1165.01,343300.3500000029,338736.7300000028,4563.620000000112
24972,2022-08-20 10:00:00,1949.27,345249.6200000029,338736.7300000028,6512.89000000013
24973,2022-08-20 10:05:00,-332.43,344917.1900000029,338736.7300000028,6180.460000000137
24974,2022-08-20 10:10:00,145.12,345062.3100000029,338736.7300000028,6325.580000000133
24975,2022-08-20 10:15:00,-1510.52,343551.7900000029,338736.7300000028,4815.060000000114
24976,2022-08-20 10:20:00,690.56,344242.3500000029,338736.7300000028,5505.620000000112
24977,2022-08-20 10:25:00,-715.26,343527.0900000029,338736.7300000028,4790.360000000102
24978,2022-08-20 10:30:00,-482.82,343044.27000000287,338736.7300000028,4307.5400000000955
24979,2022-08-20 10:35:00,1291.75,344336.02000000287,338736.7300000028,5599.2900000000955
24980,2022-08-20 10:40:00,-651.76,343684.26000000286,338736.7300000028,4947.530000000086
24981,2022-08-20 10:45:00,-770.92,342913.3400000029,338736.7300000028,4176.610000000102
24982,2022-08-20 10:50:00,1726.16,344639.50000000285,338736.7300000028,5902.770000000077
24983,2022-08-20 10:55:00,746.2,345385.70000000286,338736.7300000028,6648.9700000000885
24984,2022-08-20 11:00:00,-611.61,344774.0900000029,338736.7300000028,6037.360000000102
24985,2022-08-20 11:05:00,1042.67,345816.76000000286,338736.7300000028,7080.030000000086
24986,2022-08-20 11:10:00,303.75,346120.51000000286,338736.7300000028,7383.780000000086
24987,2022-08-20 11:15:00,-47.01,346073.50000000285,338736.7300000028,7336.770000000077
24988,2022-08-20 11:20:00,-729.82,345343.68000000285,338736.7300000028,6606.95000000007
24989,2022-08-20 11:25:00,-13.66,345330.02000000287,338736.7300000028,6593.2900000000955
24990,2022-08-20 11:30:00,248.16,345578.18000000285,338736.7300000028,6841.45000000007
24991,2022-08-20 11:35:00,1198.13,346776.31000000285,338736.7300000028,8039.5800000000745
24992,2022-08-20 11:40:00,-1819.18,344957.13000000286,338736.7300000028,6220.4000000000815
24993,2022-08-20 11:45:00,-1684.53,343272.6000000028,338736.7300000028,4535.870000000054
24994,2022-08-20 11:50:00,1402.78,344675.38000000286,338736.7300000028,5938.6500000000815
24995,2022-08-20 11:55:00,-555.86,344119.52000000287,338736.7300000028,5382.7900000000955
24996,2022-08-20 12:00:00,896.17,345015.69000000285,338736.7300000028,6278.960000000079
24997,2022-08-20 12:05:00,677.85,345693.54000000283,338736.7300000028,6956.810000000056
24998,2022-08-20 12:10:00,576.78,346270.32000000286,338736.7300000028,7533.590000000084
24999,2022-08-20 12:15:00,73.83,346344.1500000029,338736.7300000028,7607.4200000001
25000,2022-08-20 12:20:00,1333.83,347677.9800000029,338736.7300000028,8941.250000000116
25001,2022-08-20 12:25:00,-938.13,346739.8500000029,338736.7300000028,8003.120000000112
25002,2022-08-20 12:30:00,-1413.59,345326.26000000286,338736.7300000028,6589.530000000086
25003,2022-08-20 12:35:00,-1301.81,344024.45000000286,338736.7300000028,5287.7200000000885
25004,2022-08-20 12:40:00,-163.81,343860.64000000287,338736.7300000028,5123.910000000091
25005,2022-08-20 12:45:00,1842.16,345702.80000000284,338736.7300000028,6966.070000000065
25006,2022-08-20 12:50:00,1640.28,347343.08000000287,338736.7300000028,8606.350000000093
25007,2022-08-20 12:55:00,-953.39,346389.69000000285,338736.7300000028,7652.960000000079
25008,2022-08-20 13:00:00,1041.89,347431.58000000287,338736.7300000028,8694.850000000093
25009,2022-08-20 13:05:00,-762.24,346669.3400000029,338736.7300000028,7932.610000000102
25010,2022-08-20 13:10:00,-97.61,346571.7300000029,338736.7300000028,7835.000000000116
25011,2022-08-20 13:15:00,-1676.66,344895.0700000029,338736.7300000028,6158.340000000142
25012,2022-08-20 13:20:00,377.99,345273.0600000029,338736.7300000028,6536.330000000133
25013,2022-08-20 13:25:00,551.27,345824.3300000029,338736.7300000028,7087.600000000151
25014,2022-08-20 13:30:00,646.87,346471.2000000029,338736.7300000028,7734.470000000147
25015,2022-08-20 13:35:00,-1570.7,344900.5000000029,338736.7300000028,6163.770000000135
25016,2022-08-20 13:40:00,688.85,345589.3500000029,338736.7300000028,6852.620000000112
25017,2022-08-20 13:45:00,-893.33,344696.02000000287,338736.7300000028,5959.2900000000955
25018,2022-08-20 13:50:00,1439.86,346135.88000000286,338736.7300000028,7399.1500000000815
25019,2022-08-20 13:55:00,-1166.1,344969.7800000029,338736.7300000028,6233.050000000105
25020,2022-08-20 14:00:00,919.04,345888.82000000286,338736.7300000028,7152.090000000084
25021,2022-08-20 14:05:00,-176.55,345712.27000000287,338736.7300000028,6975.5400000000955
25022,2022-08-20 14:10:00,-1849.38,343862.89000000287,338736.7300000028,5126.160000000091
25023,2022-08-20 14:15:00,914.35,344777.24000000284,338736.7300000028,6040.5100000000675
25024,2022-08-20 14:20:00,-457.19,344320.05000000284,338736.7300000028,5583.320000000065
25025,2022-08-20 14:25:00,928.24,345248.29000000283,338736.7300000028,6511.560000000056
25026,2022-08-20 14:30:00,-1254.57,343993.7200000028,338736.7300000028,5256.990000000049
25027,2022-08-20 14:35:00,-165.92,343827.80000000284,338736.7300000028,5091.070000000065
25028,2022-08-20 14:40:00,1762.06,345589.86000000284,338736.7300000028,6853.130000000063
25029,2022-08-20 14:45:00,-1186.85,344403.01000000286,338736.7300000028,5666.280000000086
25030,2022-08-20 14:50:00,-1854.19,342548.82000000286,338736.7300000028,3812.090000000084
25031,2022-08-20 14:55:00,1927.24,344476.06000000285,338736.7300000028,5739.3300000000745
25032,2022-08-20 15:00:00,-767.42,343708.64000000287,338736.7300000028,4971.910000000091
25033,2022-08-20 15:05:00,-564.72,343143.9200000029,338736.7300000028,4407.190000000119
25034,2022-08-20 15:10:00,383.28,343527.2000000029,338736.7300000028,4790.470000000147
25035,2022-08-20 15:15:00,785.89,344313.09000000294,338736.7300000028,5576.360000000161
25036,2022-08-20 15:20:00,-1880.97,342432.12000000296,338736.7300000028,3695.3900000001886
25037,2022-08-20 15:25:00,1193.73,343625.85000000295,338736.7300000028,4889.12000000017
25038,2022-08-20 15:30:00,664.95,344290.80000000296,338736.7300000028,5554.070000000182
25039,2022-08-20 15:35:00,-1011.28,343279.5200000029,338736.7300000028,4542.790000000154
25040,2022-08-20 15:40:00,1968.57,345248.09000000294,338736.7300000028,6511.360000000161
25041,2022-08-20 15:45:00,703.19,345951.28000000294,338736.7300000028,7214.550000000163
25042,2022-08-20 15:50:00,808.82,346760.10000000295,338736.7300000028,8023.37000000017
25043,2022-08-20 15:55:00,-1969.87,344790.23000000295,338736.7300000028,6053.500000000175
25044,2022-08-20 16:00:00,-720.35,344069.880000003,338736.7300000028,5333.150000000198
25045,2022-08-20 16:05:00,141.82,344211.700000003,338736.7300000028,5474.970000000205
25046,2022-08-20 16:10:00,19.27,344230.970000003,338736.7300000028,5494.2400000002235
25047,2022-08-20 16:15:00,1329.02,345559.990000003,338736.7300000028,6823.260000000242
25048,2022-08-20 16:20:00,1585.83,347145.82000000303,338736.7300000028,8409.090000000258
25049,2022-08-20 16:25:00,1788.51,348934.33000000304,338736.7300000028,10197.600000000268
25050,2022-08-20 16:30:00,-877.16,348057.17000000307,338736.7300000028,9320.440000000293
25051,2022-08-20 16:35:00,88.91,348146.08000000304,338736.7300000028,9409.350000000268
25052,2022-08-20 16:40:00,1813.95,349960.03000000305,338736.7300000028,11223.30000000028
25053,2022-08-20 16:45:00,-1152.51,348807.52000000305,338736.7300000028,10070.79000000027
25054,2022-08-20 16:50:00,-755.0,348052.52000000305,338736.7300000028,9315.79000000027
25055,2022-08-20 16:55:00,1310.44,349362.96000000305,338736.7300000028,10626.230000000272
25056,2022-08-21 08:00:00,-413.6,348949.3600000031,349362.96000000305,-413.5999999999767
25057,2022-08-21 08:05:00,868.74,349818.10000000306,349362.96000000305,455.14000000001397
25058,2022-08-21 08:10:00,-1981.47,347836.6300000031,349362.96000000305,-1526.329999999958
25059,2022-08-21 08:15:00,745.42,348582.0500000031,349362.96000000305,-780.9099999999744
25060,2022-08-21 08:20:00,1288.94,349870.9900000031,349362.96000000305,508.03000000002794
25061,2022-08-21 08:25:00,784.16,350655.15000000305,349362.96000000305,1292.1900000000023
25062,2022-08-21 08:30:00,1697.55,352352.70000000304,349362.96000000305,2989.7399999999907
25063,2022-08-21 08:35:00,-483.65,351869.050000003,349362.96000000305,2506.0899999999674
25064,2022-08-21 08:40:00,-985.28,350883.770000003,349362.96000000305,1520.8099999999395
25065,2022-08-21 08:45:00,1411.78,352295.550000003,349362.96000000305,2932.5899999999674
25066,2022-08-21 08:50:00,-875.82,351419.730000003,349362.96000000305,2056.7699999999604
25067,2022-08-21 08:55:00,-187.14,351232.590000003,349362.96000000305,1869.6299999999464
25068,2022-08-21 09:00:00,-88.41,351144.180000003,349362.96000000305,1781.219999999972
25069,2022-08-21 09:05:00,1412.04,352556.220000003,349362.96000000305,3193.259999999951
25070,2022-08-21 09:10:00,93.65,352649.870000003,349362.96000000305,3286.9099999999744
25071,2022-08-21 09:15:00,1522.74,354172.610000003,349362.96000000305,4809.649999999965
25072,2022-08-21 09:20:00,-1046.69,353125.920000003,349362.96000000305,3762.9599999999627
25073,2022-08-21 09:25:00,306.85,353432.770000003,349362.96000000305,4069.8099999999395
25074,2022-08-21 09:30:00,-75.24,353357.530000003,349362.96000000305,3994.569999999949
25075,2022-08-21 09:35:00,-175.61,353181.920000003,349362.96000000305,3818.9599999999627
25076,2022-08-21 09:40:00,-42.97,353138.95000000304,349362.96000000305,3775.9899999999907
25077,2022-08-21 09:45:00,-1192.97,351945.98000000307,349362.96000000305,2583.0200000000186
25078,2022-08-21 09:50:00,1560.36,353506.34000000305,349362.96000000305,4143.380000000005
25079,2022-08-21 09:55:00,981.59,354487.9300000031,349362.96000000305,5124.97000000003
25080,2022-08-21 10:00:00,-1636.08,352851.85000000306,349362.96000000305,3488.890000000014
25081,2022-08-21 10:05:00,-0.3,352851.5500000031,349362.96000000305,3488.5900000000256
25082,2022-08-21 10:10:00,-564.71,352286.84000000305,349362.96000000305,2923.8800000000047
25083,2022-08-21 10:15:00,1220.12,353506.96000000305,349362.96000000305,4144.0
25084,2022-08-21 10:20:00,-479.45,353027.51000000304,349362.96000000305,3664.5499999999884
25085,2022-08-21 10:25:00,1804.57,354832.08000000304,349362.96000000305,5469.119999999995
25086,2022-08-21 10:30:00,-793.86,354038.22000000306,349362.96000000305,4675.260000000009
25087,2022-08-21 10:35:00,1783.57,355821.79000000306,349362.96000000305,6458.830000000016
25088,2022-08-21 10:40:00,-496.61,355325.1800000031,349362.96000000305,5962.22000000003
25089,2022-08-21 10:45:00,952.56,356277.7400000031,349362.96000000305,6914.780000000028
25090,2022-08-21 10:50:00,-1452.46,354825.28000000305,349362.96000000305,5462.320000000007
25091,2022-08-21 10:55:00,-191.76,354633.52000000305,349362.96000000305,5270.559999999998
25092,2022-08-21 11:00:00,1482.88,356116.40000000305,349362.96000000305,6753.440000000002
25093,2022-08-21 11:05:00,-55.55,356060.85000000306,349362.96000000305,6697.890000000014
25094,2022-08-21 11:10:00,1837.89,357898.7400000031,349362.96000000305,8535.780000000028
25095,2022-08-21 11:15:00,1229.11,359127.85000000306,349362.96000000305,9764.890000000014
25096,2022-08-21 11:20:00,-1524.32,357603.53000000305,349362.96000000305,8240.570000000007
25097,2022-08-21 11:25:00,-766.23,356837.3000000031,349362.96000000305,7474.340000000026
25098,2022-08-21 11:30:00,1818.91,358656.21000000305,349362.96000000305,9293.25
25099,2022-08-21 11:35:00,1685.46,360341.67000000307,349362.96000000305,10978.710000000021
25100,2022-08-21 11:40:00,-801.03,359540.64000000304,349362.96000000305,10177.679999999993
25101,2022-08-21 11:45:00,-476.67,359063.97000000306,349362.96000000305,9701.01000000001
25102,2022-08-21 11:50:00,167.06,359231.03000000305,349362.96000000305,9868.070000000007
25103,2022-08-21 11:55:00,1762.88,360993.91000000306,349362.96000000305,11630.950000000012
25104,2022-08-21 12:00:00,407.3,361401.21000000305,349362.96000000305,12038.25
25105,2022-08-21 12:05:00,1399.49,362800.70000000304,349362.96000000305,13437.73999999999
25106,2022-08-21 12:10:00,-1729.38,361071.32000000303,349362.96000000305,11708.359999999986
25107,2022-08-21 12:15:00,-285.9,360785.420000003,349362.96000000305,11422.459999999963
25108,2022-08-21 12:20:00,1619.96,362405.38000000303,349362.96000000305,13042.419999999984
25109,2022-08-21 12:25:00,-832.29,361573.09000000305,349362.96000000305,12210.130000000005
25110,2022-08-21 12:30:00,1311.61,362884.70000000304,349362.96000000305,13521.73999999999
25111,2022-08-21 12:35:00,102.31,362987.01000000304,349362.96000000305,13624.049999999988
25112,2022-08-21 12:40:00,-1547.2,361439.810000003,349362.96000000305,12076.849999999977
25113,2022-08-21 12:45:00,141.36,361581.170000003,349362.96000000305,12218.209999999963
25114,2022-08-21 12:50:00,-1183.48,360397.69000000303,349362.96000000305,11034.729999999981
25115,2022-08-21 12:55:00,1827.35,362225.040000003,349362.96000000305,12862.079999999958
25116,2022-08-21 13:00:00,-681.44,361543.600000003,349362.96000000305,12180.639999999956
25117,2022-08-21 13:05:00,-355.53,361188.070000003,349362.96000000305,11825.109999999928
25118,2022-08-21 13:10:00,-95.4,361092.67000000295,349362.96000000305,11729.709999999905
25119,2022-08-21 13:15:00,-1626.54,359466.130000003,349362.96000000305,10103.169999999925
25120,2022-08-21 13:20:00,-979.18,358486.950000003,349362.96000000305,9123.989999999932
25121,2022-08-21 13:25:00,1432.56,359919.510000003,349362.96000000305,10556.54999999993
25122,2022-08-21 13:30:00,-98.88,359820.630000003,349362.96000000305,10457.669999999925
25123,2022-08-21 13:35:00,-1855.6,357965.030000003,349362.96000000305,8602.069999999949
25124,2022-08-21 13:40:00,192.2,358157.230000003,349362.96000000305,8794.26999999996
25125,2022-08-21 13:45:00,1173.93,359331.160000003,349362.96000000305,9968.199999999953
25126,2022-08-21 13:50:00,1621.15,360952.310000003,349362.96000000305,11589.349999999977
25127,2022-08-21 13:55:00,385.5,361337.810000003,349362.96000000305,11974.849999999977
25128,2022-08-21 14:00:00,-200.17,361137.64000000304,349362.96000000305,11774.679999999993
25129,2022-08-21 14:05:00,253.81,361391.45000000304,349362.96000000305,12028.48999999999
25130,2022-08-21 14:10:00,-713.14,360678.310000003,349362.96000000305,11315.349999999977
25131,2022-08-21 14:15:00,1187.14,361865.45000000304,349362.96000000305,12502.48999999999
25132,2022-08-21 14:20:00,-607.92,361257.53000000305,349362.96000000305,11894.570000000007
25133,2022-08-21 14:25:00,-610.04,360647.4900000031,349362.96000000305,11284.530000000028
25134,2022-08-21 14:30:00,754.55,361402.04000000306,349362.96000000305,12039.080000000016
25135,2022-08-21 14:35:00,1521.99,362924.03000000305,349362.96000000305,13561.070000000007
25136,2022-08-21 14:40:00,-1180.86,361743.17000000307,349362.96000000305,12380.210000000021
25137,2022-08-21 14:45:00,-542.59,361200.58000000304,349362.96000000305,11837.619999999995
25138,2022-08-21 14:50:00,1466.02,362666.60000000306,349362.96000000305,13303.640000000014
25139,2022-08-21 14:55:00,1292.45,363959.0500000031,349362.96000000305,14596.090000000026
25140,2022-08-21 15:00:00,582.41,364541.46000000305,349362.96000000305,15178.5
25141,2022-08-21 15:05:00,915.67,365457.13000000303,349362.96000000305,16094.169999999984
25142,2022-08-21 15:10:00,-45.98,365411.15000000305,349362.96000000305,16048.190000000002
25143,2022-08-21 15:15:00,194.11,365605.26000000304,349362.96000000305,16242.299999999988
25144,2022-08-21 15:20:00,1759.24,367364.500000003,349362.96000000305,18001.53999999998
25145,2022-08-21 15:25:00,-1387.01,365977.490000003,349362.96000000305,16614.52999999997
25146,2022-08-21 15:30:00,1310.65,367288.14000000304,349362.96000000305,17925.179999999993
25147,2022-08-21 15:35:00,716.01,368004.15000000305,349362.96000000305,18641.190000000002
25148,2022-08-21 15:40:00,1025.81,369029.96000000305,349362.96000000305,19667.0
25149,2022-08-21 15:45:00,978.51,370008.47000000306,349362.96000000305,20645.51000000001
25150,2022-08-21 15:50:00,-1528.17,368480.3000000031,349362.96000000305,19117.340000000026
25151,2022-08-21 15:55:00,621.6,369101.90000000305,349362.96000000305,19738.940000000002
25152,2022-08-21 16:00:00,422.61,369524.51000000304,349362.96000000305,20161.54999999999
25153,2022-08-21 16:05:00,1986.2,371510.71000000305,349362.96000000305,22147.75
25154,2022-08-21 16:10:00,1061.3,372572.01000000304,349362.96000000305,23209.04999999999
25155,2022-08-21 16:15:00,1356.81,373928.82000000303,349362.96000000305,24565.859999999986
25156,2022-08-21 16:20:00,549.27,374478.09000000305,349362.96000000305,25115.130000000005
25157,2022-08-21 16:25:00,-1597.55,372880.54000000306,349362.96000000305,23517.580000000016
25158,2022-08-21 16:30:00,-1545.33,371335.21000000305,349362.96000000305,21972.25
25159,2022-08-21 16:35:00,-1277.1,370058.1100000031,349362.96000000305,20695.150000000023
25160,2022-08-21 16:40:00,-1382.56,368675.5500000031,349362.96000000305,19312.590000000026
25161,2022-08-21 16:45:00,-112.11,368563.4400000031,349362.96000000305,19200.48000000004
25162,2022-08-21 16:50:00,722.88,369286.3200000031,349362.96000000305,19923.360000000044
25163,2022-08-21 16:55:00,-873.68,368412.6400000031,349362.96000000305,19049.68000000005
25164,2022-08-22 08:00:00,659.2,369071.8400000031,368412.6400000031,659.2000000000116
25165,2022-08-22 08:05:00,-1953.71,367118.1300000031,368412.6400000031,-1294.5100000000093
25166,2022-08-22 08:10:00,-331.56,366786.5700000031,368412.6400000031,-1626.070000000007
25167,2022-08-22 08:15:00,1796.27,368582.8400000031,368412.6400000031,170.20000000001164
25168,2022-08-22 08:20:00,-955.61,367627.2300000031,368412.6400000031,-785.4099999999744
25169,2022-08-22 08:25:00,-741.54,366885.69000000315,368412.6400000031,-1526.9499999999534
25170,2022-08-22 08:30:00,1733.06,368618.75000000314,368412.6400000031,206.11000000004424
25171,2022-08-22 08:35:00,953.19,369571.94000000315,368412.6400000031,1159.3000000000466
25172,2022-08-22 08:40:00,1296.38,370868.32000000315,368412.6400000031,2455.680000000051
25173,2022-08-22 08:45:00,1012.01,371880.33000000316,368412.6400000031,3467.6900000000605
25174,2022-08-22 08:50:00,-1470.94,370409.39000000316,368412.6400000031,1996.7500000000582
25175,2022-08-22 08:55:00,1403.5,371812.89000000316,368412.6400000031,3400.250000000058
25176,2022-08-22 09:00:00,1251.45,373064.34000000317,368412.6400000031,4651.70000000007
25177,2022-08-22 09:05:00,-1881.14,371183.20000000315,368412.6400000031,2770.560000000056
25178,2022-08-22 09:10:00,1263.19,372446.39000000316,368412.6400000031,4033.750000000058
25179,2022-08-22 09:15:00,-157.45,372288.94000000315,368412.6400000031,3876.3000000000466
25180,2022-08-22 09:20:00,331.68,372620.62000000314,368412.6400000031,4207.98000000004
25181,2022-08-22 09:25:00,-1627.28,370993.3400000031,368412.6400000031,2580.7000000000116
25182,2022-08-22 09:30:00,-320.67,370672.6700000031,368412.6400000031,2260.030000000028
25183,2022-08-22 09:35:00,-343.22,370329.45000000315,368412.6400000031,1916.8100000000559
25184,2022-08-22 09:40:00,634.62,370964.07000000315,368412.6400000031,2551.430000000051
25185,2022-08-22 09:45:00,1993.74,372957.81000000314,368412.6400000031,4545.170000000042
25186,2022-08-22 09:50:00,306.53,373264.34000000317,368412.6400000031,4851.70000000007
25187,2022-08-22 09:55:00,298.98,373563.32000000315,368412.6400000031,5150.680000000051
25188,2022-08-22 10:00:00,1480.75,375044.07000000315,368412.6400000031,6631.430000000051
25189,2022-08-22 10:05:00,1628.81,376672.88000000315,368412.6400000031,8260.240000000049
25190,2022-08-22 10:10:00,-748.89,375923.99000000313,368412.6400000031,7511.350000000035
25191,2022-08-22 10:15:00,1211.39,377135.38000000315,368412.6400000031,8722.740000000049
25192,2022-08-22 10:20:00,-1990.33,375145.05000000313,368412.6400000031,6732.410000000033
25193,2022-08-22 10:25:00,1124.96,376270.01000000315,368412.6400000031,7857.370000000054
25194,2022-08-22 10:30:00,54.03,376324.0400000032,368412.6400000031,7911.4000000000815
25195,2022-08-22 10:35:00,-941.59,375382.45000000315,368412.6400000031,6969.810000000056
25196,2022-08-22 10:40:00,-1024.99,374357.46000000316,368412.6400000031,5944.820000000065
25197,2022-08-22 10:45:00,427.94,374785.40000000317,368412.6400000031,6372.7600000000675
25198,2022-08-22 10:50:00,-1783.42,373001.9800000032,368412.6400000031,4589.340000000084
25199,2022-08-22 10:55:00,-1550.68,371451.3000000032,368412.6400000031,3038.660000000091
25200,2022-08-22 11:00:00,1124.99,372576.2900000032,368412.6400000031,4163.6500000000815
25201,2022-08-22 11:05:00,828.83,373405.1200000032,368412.6400000031,4992.480000000098
25202,2022-08-22 11:10:00,-258.95,373146.1700000032,368412.6400000031,4733.530000000086
25203,2022-08-22 11:15:00,132.58,373278.7500000032,368412.6400000031,4866.110000000102
25204,2022-08-22 11:20:00,-920.11,372358.6400000032,368412.6400000031,3946.0000000001164
25205,2022-08-22 11:25:00,-1417.12,370941.5200000032,368412.6400000031,2528.880000000121
25206,2022-08-22 11:30:00,1320.96,372262.48000000324,368412.6400000031,3849.840000000142
25207,2022-08-22 11:35:00,-1467.93,370794.55000000325,368412.6400000031,2381.910000000149
25208,2022-08-22 11:40:00,-258.75,370535.80000000325,368412.6400000031,2123.160000000149
25209,2022-08-22 11:45:00,582.93,371118.73000000324,368412.6400000031,2706.090000000142
25210,2022-08-22 11:50:00,-1139.34,369979.3900000032,368412.6400000031,1566.7500000001164
25211,2022-08-22 11:55:00,1856.67,371836.0600000032,368412.6400000031,3423.4200000001
25212,2022-08-22 12:00:00,1147.28,372983.3400000032,368412.6400000031,4570.700000000128
25213,2022-08-22 12:05:00,1295.22,374278.5600000032,368412.6400000031,5865.9200000001
25214,2022-08-22 12:10:00,1340.19,375618.7500000032,368412.6400000031,7206.110000000102
25215,2022-08-22 12:15:00,1426.13,377044.8800000032,368412.6400000031,8632.240000000107
25216,2022-08-22 12:20:00,1327.9,378372.78000000323,368412.6400000031,9960.14000000013
25217,2022-08-22 12:25:00,464.74,378837.5200000032,368412.6400000031,10424.880000000121
25218,2022-08-22 12:30:00,-1060.0,377777.5200000032,368412.6400000031,9364.880000000121
25219,2022-08-22 12:35:00,-340.01,377437.5100000032,368412.6400000031,9024.870000000112
25220,2022-08-22 12:40:00,1707.73,379145.2400000032,368412.6400000031,10732.600000000093
25221,2022-08-22 12:45:00,703.16,379848.40000000317,368412.6400000031,11435.760000000068
25222,2022-08-22 12:50:00,-203.41,379644.9900000032,368412.6400000031,11232.350000000093
25223,2022-08-22 12:55:00,53.49,379698.4800000032,368412.6400000031,11285.840000000084
25224,2022-08-22 13:00:00,595.41,380293.89000000316,368412.6400000031,11881.250000000058
25225,2022-08-22 13:05:00,751.77,381045.6600000032,368412.6400000031,12633.020000000077
25226,2022-08-22 13:10:00,-613.56,380432.1000000032,368412.6400000031,12019.46000000008
25227,2022-08-22 13:15:00,-1722.03,378710.07000000315,368412.6400000031,10297.430000000051
25228,2022-08-22 13:20:00,-1852.85,376857.2200000032,368412.6400000031,8444.580000000075
25229,2022-08-22 13:25:00,-951.87,375905.3500000032,368412.6400000031,7492.710000000079
25230,2022-08-22 13:30:00,1882.9,377788.2500000032,368412.6400000031,9375.610000000102
25231,2022-08-22 13:35:00,327.47,378115.7200000032,368412.6400000031,9703.080000000075
25232,2022-08-22 13:40:00,439.25,378554.9700000032,368412.6400000031,10142.330000000075
25233,2022-08-22 13:45:00,-114.17,378440.8000000032,368412.6400000031,10028.16000000009
25234,2022-08-22 13:50:00,1456.51,379897.3100000032,368412.6400000031,11484.6700000001
25235,2022-08-22 13:55:00,-590.35,379306.9600000032,368412.6400000031,10894.320000000123
25236,2022-08-22 14:00:00,1423.8,380730.7600000032,368412.6400000031,12318.120000000112
25237,2022-08-22 14:05:00,-479.97,380250.79000000324,368412.6400000031,11838.15000000014
25238,2022-08-22 14:10:00,-664.77,379586.0200000032,368412.6400000031,11173.380000000121
25239,2022-08-22 14:15:00,-1423.42,378162.60000000324,368412.6400000031,9749.960000000137
25240,2022-08-22 14:20:00,1351.47,379514.0700000032,368412.6400000031,11101.43000000011
25241,2022-08-22 14:25:00,980.31,380494.3800000032,368412.6400000031,12081.740000000107
25242,2022-08-22 14:30:00,-1694.62,378799.7600000032,368412.6400000031,10387.120000000112
25243,2022-08-22 14:35:00,-1709.49,377090.2700000032,368412.6400000031,8677.630000000121
25244,2022-08-22 14:40:00,-39.95,377050.3200000032,368412.6400000031,8637.68000000011
25245,2022-08-22 14:45:00,-1668.57,375381.7500000032,368412.6400000031,6969.110000000102
25246,2022-08-22 14:50:00,-1732.86,373648.8900000032,368412.6400000031,5236.250000000116
25247,2022-08-22 14:55:00,1033.6,374682.4900000032,368412.6400000031,6269.850000000093
25248,2022-08-22 15:00:00,-347.52,374334.9700000032,368412.6400000031,5922.3300000000745
25249,2022-08-22 15:05:00,-1602.06,372732.9100000032,368412.6400000031,4320.270000000077
25250,2022-08-22 15:10:00,-1271.25,371461.6600000032,368412.6400000031,3049.020000000077
25251,2022-08-22 15:15:00,-1460.76,370000.90000000317,368412.6400000031,1588.2600000000675
25252,2022-08-22 15:20:00,-1309.87,368691.0300000032,368412.6400000031,278.3900000000722
25253,2022-08-22 15:25:00,1008.08,369699.1100000032,368412.6400000031,1286.4700000000885
25254,2022-08-22 15:30:00,-628.11,369071.0000000032,368412.6400000031,658.3600000001024
25255,2022-08-22 15:35:00,1740.23,370811.2300000032,368412.6400000031,2398.590000000084
25256,2022-08-22 15:40:00,-1984.33,368826.90000000317,368412.6400000031,414.2600000000675
25257,2022-08-22 15:45:00,682.56,369509.46000000316,368412.6400000031,1096.8200000000652
25258,2022-08-22 15:50:00,-1432.08,368077.38000000315,368412.6400000031,-335.2599999999511
25259,2022-08-22 15:55:00,-1112.8,366964.58000000316,368412.6400000031,-1448.0599999999395
25260,2022-08-22 16:00:00,-1007.93,365956.65000000317,368412.6400000031,-2455.9899999999325
25261,2022-08-22 16:05:00,-266.12,365690.5300000032,368412.6400000031,-2722.109999999928
25262,2022-08-22 16:10:00,-1756.32,363934.21000000316,368412.6400000031,-4478.429999999935
25263,2022-08-22 16:15:00,-193.44,363740.77000000316,368412.6400000031,-4671.869999999937
25264,2022-08-22 16:20:00,-1390.74,362350.0300000032,368412.6400000031,-6062.609999999928
25265,2022-08-22 16:25:00,416.82,362766.8500000032,368412.6400000031,-5645.789999999921
25266,2022-08-22 16:30:00,-1642.39,361124.46000000316,368412.6400000031,-7288.179999999935
25267,2022-08-22 16:35:00,288.18,361412.64000000316,368412.6400000031,-6999.999999999942
25268,2022-08-22 16:40:00,-785.5,360627.14000000316,368412.6400000031,-7785.499999999942
25269,2022-08-22 16:45:00,-819.66,359807.4800000032,368412.6400000031,-8605.159999999916
25270,2022-08-22 16:50:00,-207.89,359599.59000000317,368412.6400000031,-8813.04999999993
25271,2022-08-22 16:55:00,489.67,360089.26000000315,368412.6400000031,-8323.379999999946
25272,2022-08-23 08:00:00,-1052.36,359036.90000000317,360089.26000000315,-1052.359999999986
25273,2022-08-23 08:05:00,-629.98,358406.9200000032,360089.26000000315,-1682.3399999999674
25274,2022-08-23 08:10:00,-1914.64,356492.2800000032,360089.26000000315,-3596.9799999999814
25275,2022-08-23 08:15:00,-395.33,356096.95000000315,360089.26000000315,-3992.3099999999977
25276,2022-08-23 08:20:00,-1109.3,354987.65000000317,360089.26000000315,-5101.609999999986
25277,2022-08-23 08:25:00,1952.1,356939.75000000314,360089.26000000315,-3149.5100000000093
25278,2022-08-23 08:30:00,1964.86,358904.61000000313,360089.26000000315,-1184.6500000000233
25279,2022-08-23 08:35:00,1121.48,360026.0900000031,360089.26000000315,-63.17000000004191
25280,2022-08-23 08:40:00,1873.4,361899.49000000313,360089.26000000315,1810.2299999999814
25281,2022-08-23 08:45:00,382.94,362282.43000000314,360089.26000000315,2193.1699999999837
25282,2022-08-23 08:50:00,695.28,362977.71000000316,360089.26000000315,2888.4500000000116
25283,2022-08-23 08:55:00,1810.47,364788.18000000314,360089.26000000315,4698.919999999984
25284,2022-08-23 09:00:00,-486.54,364301.64000000316,360089.26000000315,4212.380000000005
25285,2022-08-23 09:05:00,923.02,365224.6600000032,360089.26000000315,5135.400000000023
25286,2022-08-23 09:10:00,493.83,365718.4900000032,360089.26000000315,5629.23000000004
25287,2022-08-23 09:15:00,499.99,366218.4800000032,360089.26000000315,6129.22000000003
25288,2022-08-23 09:20:00,1596.84,367815.3200000032,360089.26000000315,7726.060000000056
25289,2022-08-23 09:25:00,1885.32,369700.6400000032,360089.26000000315,9611.380000000063
25290,2022-08-23 09:30:00,845.48,370546.1200000032,360089.26000000315,10456.860000000044
25291,2022-08-23 09:35:00,718.5,371264.6200000032,360089.26000000315,11175.360000000044
25292,2022-08-23 09:40:00,-1450.24,369814.3800000032,360089.26000000315,9725.120000000054
25293,2022-08-23 09:45:00,-801.59,369012.7900000032,360089.26000000315,8923.530000000028
25294,2022-08-23 09:50:00,1000.66,370013.45000000315,360089.26000000315,9924.190000000002
25295,2022-08-23 09:55:00,-1933.72,368079.7300000032,360089.26000000315,7990.47000000003
25296,2022-08-23 10:00:00,-1665.78,366413.95000000315,360089.26000000315,6324.690000000002
25297,2022-08-23 10:05:00,290.92,366704.87000000314,360089.26000000315,6615.609999999986
25298,2022-08-23 10:10:00,-119.06,366585.81000000314,360089.26000000315,6496.549999999988
25299,2022-08-23 10:15:00,1595.04,368180.8500000031,360089.26000000315,8091.589999999967
25300,2022-08-23 10:20:00,-890.98,367289.87000000314,360089.26000000315,7200.609999999986
25301,2022-08-23 10:25:00,-1869.52,365420.3500000031,360089.26000000315,5331.089999999967
25302,2022-08-23 10:30:00,-1883.25,363537.1000000031,360089.26000000315,3447.8399999999674
25303,2022-08-23 10:35:00,488.85,364025.9500000031,360089.26000000315,3936.689999999944
25304,2022-08-23 10:40:00,-1742.88,362283.0700000031,360089.26000000315,2193.8099999999395
25305,2022-08-23 10:45:00,-848.8,361434.2700000031,360089.26000000315,1345.009999999951
25306,2022-08-23 10:50:00,1503.85,362938.1200000031,360089.26000000315,2848.859999999928
25307,2022-08-23 10:55:00,-1565.23,361372.8900000031,360089.26000000315,1283.6299999999464
25308,2022-08-23 11:00:00,1527.43,362900.3200000031,360089.26000000315,2811.0599999999395
25309,2022-08-23 11:05:00,1679.47,364579.79000000306,360089.26000000315,4490.5299999999115
25310,2022-08-23 11:10:00,928.13,365507.92000000307,360089.26000000315,5418.659999999916
25311,2022-08-23 11:15:00,1986.82,367494.7400000031,360089.26000000315,7405.479999999923
25312,2022-08-23 11:20:00,1914.36,369409.10000000306,360089.26000000315,9319.83999999991
25313,2022-08-23 11:25:00,-1302.28,368106.82000000303,360089.26000000315,8017.559999999881
25314,2022-08-23 11:30:00,-1293.61,366813.21000000305,360089.26000000315,6723.949999999895
25315,2022-08-23 11:35:00,-122.26,366690.95000000304,360089.26000000315,6601.689999999886
25316,2022-08-23 11:40:00,-983.89,365707.060000003,360089.26000000315,5617.799999999872
25317,2022-08-23 11:45:00,392.81,366099.870000003,360089.26000000315,6010.60999999987
25318,2022-08-23 11:50:00,345.92,366445.790000003,360089.26000000315,6356.529999999853
25319,2022-08-23 11:55:00,878.79,367324.580000003,360089.26000000315,7235.319999999832
25320,2022-08-23 12:00:00,111.55,367436.130000003,360089.26000000315,7346.869999999821
25321,2022-08-23 12:05:00,-1381.18,366054.950000003,360089.26000000315,5965.689999999828
25322,2022-08-23 12:10:00,912.33,366967.280000003,360089.26000000315,6878.019999999844
25323,2022-08-23 12:15:00,1711.4,368678.680000003,360089.26000000315,8589.419999999867
25324,2022-08-23 12:20:00,-1306.66,367372.02000000305,360089.26000000315,7282.759999999893
25325,2022-08-23 12:25:00,-1234.33,366137.69000000303,360089.26000000315,6048.429999999877
25326,2022-08-23 12:30:00,-1210.94,364926.750000003,360089.26000000315,4837.489999999874
25327,2022-08-23 12:35:00,-1389.97,363536.78000000305,360089.26000000315,3447.519999999902
25328,2022-08-23 12:40:00,-537.86,362998.92000000307,360089.26000000315,2909.659999999916
25329,2022-08-23 12:45:00,44.59,363043.5100000031,360089.26000000315,2954.249999999942
25330,2022-08-23 12:50:00,-527.15,362516.3600000031,360089.26000000315,2427.0999999999185
25331,2022-08-23 12:55:00,-504.92,362011.4400000031,360089.26000000315,1922.1799999999348
25332,2022-08-23 13:00:00,-797.48,361213.9600000031,360089.26000000315,1124.6999999999534
25333,2022-08-23 13:05:00,-510.84,360703.1200000031,360089.26000000315,613.8599999999278
25334,2022-08-23 13:10:00,-1524.71,359178.41000000306,360089.26000000315,-910.8500000000931
25335,2022-08-23 13:15:00,1160.71,360339.1200000031,360089.26000000315,249.85999999992782
25336,2022-08-23 13:20:00,-1780.27,358558.85000000306,360089.26000000315,-1530.4100000000908
25337,2022-08-23 13:25:00,-243.75,358315.10000000306,360089.26000000315,-1774.1600000000908
25338,2022-08-23 13:30:00,735.46,359050.5600000031,360089.26000000315,-1038.7000000000698
25339,2022-08-23 13:35:00,-665.64,358384.92000000307,360089.26000000315,-1704.3400000000838
25340,2022-08-23 13:40:00,1876.05,360260.97000000306,360089.26000000315,171.70999999990454
25341,2022-08-23 13:45:00,1869.09,362130.0600000031,360089.26000000315,2040.7999999999302
25342,2022-08-23 13:50:00,-1248.38,360881.6800000031,360089.26000000315,792.4199999999255
25343,2022-08-23 13:55:00,1479.67,362361.35000000306,360089.26000000315,2272.089999999909
25344,2022-08-23 14:00:00,1173.48,363534.83000000304,360089.26000000315,3445.5699999998906
25345,2022-08-23 14:05:00,604.05,364138.88000000303,360089.26000000315,4049.619999999879
25346,2022-08-23 14:10:00,-423.44,363715.44000000303,360089.26000000315,3626.1799999998766
25347,2022-08-23 14:15:00,1274.28,364989.72000000306,360089.26000000315,4900.4599999999045
25348,2022-08-23 14:20:00,1746.44,366736.16000000306,360089.26000000315,6646.899999999907
25349,2022-08-23 14:25:00,592.98,367329.14000000304,360089.26000000315,7239.879999999888
25350,2022-08-23 14:30:00,612.96,367942.10000000306,360089.26000000315,7852.839999999909
25351,2022-08-23 14:35:00,1491.91,369434.01000000304,360089.26000000315,9344.749999999884
25352,2022-08-23 14:40:00,1380.98,370814.990000003,360089.26000000315,10725.729999999865
25353,2022-08-23 14:45:00,-1245.85,369569.14000000304,360089.26000000315,9479.879999999888
25354,2022-08-23 14:50:00,-1236.03,368333.110000003,360089.26000000315,8243.84999999986
25355,2022-08-23 14:55:00,1934.43,370267.540000003,360089.26000000315,10178.279999999853
25356,2022-08-23 15:00:00,-494.83,369772.710000003,360089.26000000315,9683.449999999837
25357,2022-08-23 15:05:00,-1810.23,367962.480000003,360089.26000000315,7873.219999999856
25358,2022-08-23 15:10:00,-816.55,367145.930000003,360089.26000000315,7056.669999999867
25359,2022-08-23 15:15:00,537.32,367683.250000003,360089.26000000315,7593.989999999874
25360,2022-08-23 15:20:00,-854.13,366829.120000003,360089.26000000315,6739.85999999987
25361,2022-08-23 15:25:00,454.02,367283.14000000304,360089.26000000315,7193.879999999888
25362,2022-08-23 15:30:00,-439.56,366843.58000000304,360089.26000000315,6754.319999999891
25363,2022-08-23 15:35:00,134.56,366978.14000000304,360089.26000000315,6888.879999999888
25364,2022-08-23 15:40:00,226.64,367204.78000000305,360089.26000000315,7115.519999999902
25365,2022-08-23 15:45:00,698.06,367902.84000000305,360089.26000000315,7813.5799999999
25366,2022-08-23 15:50:00,1816.83,369719.67000000307,360089.26000000315,9630.409999999916
25367,2022-08-23 15:55:00,-229.57,369490.10000000306,360089.26000000315,9400.83999999991
25368,2022-08-23 16:00:00,533.68,370023.78000000305,360089.26000000315,9934.519999999902
25369,2022-08-23 16:05:00,-1872.74,368151.04000000306,360089.26000000315,8061.7799999999115
25370,2022-08-23 16:10:00,-1341.13,366809.91000000306,360089.26000000315,6720.649999999907
25371,2022-08-23 16:15:00,-1053.19,365756.72000000306,360089.26000000315,5667.4599999999045
25372,2022-08-23 16:20:00,1583.47,367340.19000000303,360089.26000000315,7250.929999999877
25373,2022-08-23 16:25:00,261.51,367601.70000000304,360089.26000000315,7512.439999999886
25374,2022-08-23 16:30:00,-897.93,366703.77000000305,360089.26000000315,6614.509999999893
25375,2022-08-23 16:35:00,-977.27,365726.500000003,360089.26000000315,5637.239999999874
25376,2022-08-23 16:40:00,19.86,365746.360000003,360089.26000000315,5657.09999999986
25377,2022-08-23 16:45:00,-672.27,365074.090000003,360089.26000000315,4984.829999999842
25378,2022-08-23 16:50:00,581.89,365655.980000003,360089.26000000315,5566.719999999856
25379,2022-08-23 16:55:00,389.73,366045.710000003,360089.26000000315,5956.449999999837
25380,2022-08-24 08:00:00,46.41,366092.12000000296,366045.710000003,46.40999999997439
25381,2022-08-24 08:05:00,402.29,366494.41000000294,366045.710000003,448.69999999995343
25382,2022-08-24 08:10:00,52.57,366546.98000000295,366045.710000003,501.2699999999604
25383,2022-08-24 08:15:00,-1328.56,365218.42000000295,366045.710000003,-827.2900000000373
25384,2022-08-24 08:20:00,245.36,365463.78000000294,366045.710000003,-581.9300000000512
25385,2022-08-24 08:25:00,1260.3,366724.0800000029,366045.710000003,678.3699999999371
25386,2022-08-24 08:30:00,1663.37,368387.4500000029,366045.710000003,2341.7399999999325
25387,2022-08-24 08:35:00,-1742.43,366645.0200000029,366045.710000003,599.3099999999395
25388,2022-08-24 08:40:00,-1220.48,365424.54000000295,366045.710000003,-621.1700000000419
25389,2022-08-24 08:45:00,-49.91,365374.630000003,366045.710000003,-671.0800000000163
25390,2022-08-24 08:50:00,894.58,366269.210000003,366045.710000003,223.5
25391,2022-08-24 08:55:00,850.21,367119.420000003,366045.710000003,1073.710000000021
25392,2022-08-24 09:00:00,1262.06,368381.480000003,366045.710000003,2335.7700000000186
25393,2022-08-24 09:05:00,-834.78,367546.700000003,366045.710000003,1500.9899999999907
25394,2022-08-24 09:10:00,-751.0,366795.700000003,366045.710000003,749.9899999999907
25395,2022-08-24 09:15:00,374.66,367170.36000000295,366045.710000003,1124.649999999965
25396,2022-08-24 09:20:00,-188.85,366981.510000003,366045.710000003,935.7999999999884
25397,2022-08-24 09:25:00,-135.14,366846.37000000296,366045.710000003,800.6599999999744
25398,2022-08-24 09:30:00,-241.48,366604.890000003,366045.710000003,559.179999999993
25399,2022-08-24 09:35:00,2.79,366607.68000000296,366045.710000003,561.9699999999721
25400,2022-08-24 09:40:00,375.15,366982.830000003,366045.710000003,937.1199999999953
25401,2022-08-24 09:45:00,803.69,367786.520000003,366045.710000003,1740.8099999999977
25402,2022-08-24 09:50:00,-196.55,367589.970000003,366045.710000003,1544.2600000000093
25403,2022-08-24 09:55:00,-1076.95,366513.020000003,366045.710000003,467.3099999999977
25404,2022-08-24 10:00:00,525.73,367038.75000000297,366045.710000003,993.039999999979
25405,2022-08-24 10:05:00,-1399.47,365639.280000003,366045.710000003,-406.429999999993
25406,2022-08-24 10:10:00,940.5,366579.780000003,366045.710000003,534.070000000007
25407,2022-08-24 10:15:00,650.05,367229.830000003,366045.710000003,1184.1199999999953
25408,2022-08-24 10:20:00,-992.25,366237.580000003,366045.710000003,191.86999999999534
25409,2022-08-24 10:25:00,-200.8,366036.780000003,366045.710000003,-8.929999999993015
25410,2022-08-24 10:30:00,257.56,366294.340000003,366045.710000003,248.63000000000466
25411,2022-08-24 10:35:00,-377.62,365916.720000003,366045.710000003,-128.9899999999907
25412,2022-08-24 10:40:00,226.55,366143.270000003,366045.710000003,97.55999999999767
25413,2022-08-24 10:45:00,552.85,366696.12000000296,366045.710000003,650.4099999999744
25414,2022-08-24 10:50:00,1198.73,367894.85000000295,366045.710000003,1849.1399999999558
25415,2022-08-24 10:55:00,-324.12,367570.73000000295,366045.710000003,1525.0199999999604
25416,2022-08-24 11:00:00,1264.19,368834.92000000295,366045.710000003,2789.2099999999627
25417,2022-08-24 11:05:00,1350.42,370185.34000000294,366045.710000003,4139.629999999946
25418,2022-08-24 11:10:00,-1728.05,368457.29000000295,366045.710000003,2411.579999999958
25419,2022-08-24 11:15:00,931.94,369389.23000000295,366045.710000003,3343.5199999999604
25420,2022-08-24 11:20:00,945.86,370335.09000000294,366045.710000003,4289.379999999946
25421,2022-08-24 11:25:00,1490.23,371825.3200000029,366045.710000003,5779.609999999928
25422,2022-08-24 11:30:00,1310.69,373136.0100000029,366045.710000003,7090.29999999993
25423,2022-08-24 11:35:00,756.15,373892.16000000294,366045.710000003,7846.449999999953
25424,2022-08-24 11:40:00,-348.21,373543.9500000029,366045.710000003,7498.2399999999325
25425,2022-08-24 11:45:00,271.05,373815.0000000029,366045.710000003,7769.289999999921
25426,2022-08-24 11:50:00,-427.24,373387.7600000029,366045.710000003,7342.04999999993
25427,2022-08-24 11:55:00,-193.22,373194.54000000295,366045.710000003,7148.829999999958
25428,2022-08-24 12:00:00,-382.6,372811.940000003,366045.710000003,6766.229999999981
25429,2022-08-24 12:05:00,-981.12,371830.820000003,366045.710000003,5785.109999999986
25430,2022-08-24 12:10:00,1148.14,372978.960000003,366045.710000003,6933.25
25431,2022-08-24 12:15:00,-1616.99,371361.970000003,366045.710000003,5316.260000000009
25432,2022-08-24 12:20:00,463.03,371825.000000003,366045.710000003,5779.290000000037
25433,2022-08-24 12:25:00,7.67,371832.670000003,366045.710000003,5786.960000000021
25434,2022-08-24 12:30:00,831.83,372664.500000003,366045.710000003,6618.790000000037
25435,2022-08-24 12:35:00,1338.57,374003.07000000303,366045.710000003,7957.360000000044
25436,2022-08-24 12:40:00,1253.66,375256.730000003,366045.710000003,9211.020000000019
25437,2022-08-24 12:45:00,1594.88,376851.610000003,366045.710000003,10805.900000000023
25438,2022-08-24 12:50:00,-392.74,376458.870000003,366045.710000003,10413.160000000033
25439,2022-08-24 12:55:00,-1238.97,375219.90000000305,366045.710000003,9174.19000000006
25440,2022-08-24 13:00:00,1283.18,376503.08000000304,366045.710000003,10457.370000000054
25441,2022-08-24 13:05:00,1793.83,378296.91000000306,366045.710000003,12251.20000000007
25442,2022-08-24 13:10:00,-602.02,377694.89000000304,366045.710000003,11649.180000000051
25443,2022-08-24 13:15:00,1356.99,379051.88000000303,366045.710000003,13006.170000000042
25444,2022-08-24 13:20:00,1374.46,380426.34000000305,366045.710000003,14380.630000000063
25445,2022-08-24 13:25:00,-1947.34,378479.000000003,366045.710000003,12433.290000000037
25446,2022-08-24 13:30:00,-570.87,377908.13000000303,366045.710000003,11862.420000000042
25447,2022-08-24 13:35:00,-1775.68,376132.45000000304,366045.710000003,10086.740000000049
25448,2022-08-24 13:40:00,-1853.95,374278.500000003,366045.710000003,8232.790000000037
25449,2022-08-24 13:45:00,-730.8,373547.70000000304,366045.710000003,7501.990000000049
25450,2022-08-24 13:50:00,4.19,373551.89000000304,366045.710000003,7506.180000000051
25451,2022-08-24 13:55:00,-316.94,373234.95000000304,366045.710000003,7189.240000000049
25452,2022-08-24 14:00:00,-1116.0,372118.95000000304,366045.710000003,6073.240000000049
25453,2022-08-24 14:05:00,1956.22,374075.170000003,366045.710000003,8029.460000000021
25454,2022-08-24 14:10:00,-369.91,373705.26000000304,366045.710000003,7659.550000000047
25455,2022-08-24 14:15:00,-903.68,372801.58000000304,366045.710000003,6755.870000000054
25456,2022-08-24 14:20:00,1964.0,374765.58000000304,366045.710000003,8719.870000000054
25457,2022-08-24 14:25:00,1356.39,376121.97000000306,366045.710000003,10076.260000000068
25458,2022-08-24 14:30:00,-1208.71,374913.26000000304,366045.710000003,8867.550000000047
25459,2022-08-24 14:35:00,396.3,375309.560000003,366045.710000003,9263.850000000035
25460,2022-08-24 14:40:00,-1886.5,373423.060000003,366045.710000003,7377.350000000035
25461,2022-08-24 14:45:00,-1269.59,372153.470000003,366045.710000003,6107.760000000009
25462,2022-08-24 14:50:00,-1642.53,370510.940000003,366045.710000003,4465.229999999981
25463,2022-08-24 14:55:00,1601.15,372112.090000003,366045.710000003,6066.380000000005
25464,2022-08-24 15:00:00,426.12,372538.210000003,366045.710000003,6492.5
25465,2022-08-24 15:05:00,1764.08,374302.290000003,366045.710000003,8256.580000000016
25466,2022-08-24 15:10:00,-1582.57,372719.720000003,366045.710000003,6674.010000000009
25467,2022-08-24 15:15:00,339.92,373059.640000003,366045.710000003,7013.929999999993
25468,2022-08-24 15:20:00,-1886.77,371172.87000000296,366045.710000003,5127.159999999974
25469,2022-08-24 15:25:00,-1969.41,369203.460000003,366045.710000003,3157.75
25470,2022-08-24 15:30:00,1000.41,370203.87000000296,366045.710000003,4158.159999999974
25471,2022-08-24 15:35:00,-557.37,369646.50000000297,366045.710000003,3600.789999999979
25472,2022-08-24 15:40:00,-1894.36,367752.140000003,366045.710000003,1706.429999999993
25473,2022-08-24 15:45:00,-161.62,367590.520000003,366045.710000003,1544.8099999999977
25474,2022-08-24 15:50:00,-564.92,367025.600000003,366045.710000003,979.890000000014
25475,2022-08-24 15:55:00,1755.73,368781.330000003,366045.710000003,2735.6199999999953
25476,2022-08-24 16:00:00,-1884.14,366897.190000003,366045.710000003,851.4799999999814
25477,2022-08-24 16:05:00,-490.4,366406.79000000295,366045.710000003,361.0799999999581
25478,2022-08-24 16:10:00,299.97,366706.7600000029,366045.710000003,661.0499999999302
25479,2022-08-24 16:15:00,-9.18,366697.5800000029,366045.710000003,651.8699999999371
25480,2022-08-24 16:20:00,-1869.17,364828.41000000294,366045.710000003,-1217.3000000000466
25481,2022-08-24 16:25:00,-404.3,364424.11000000295,366045.710000003,-1621.600000000035
25482,2022-08-24 16:30:00,-760.03,363664.0800000029,366045.710000003,-2381.630000000063
25483,2022-08-24 16:35:00,-770.87,362893.21000000293,366045.710000003,-3152.500000000058
25484,2022-08-24 16:40:00,1878.33,364771.54000000295,366045.710000003,-1274.170000000042
25485,2022-08-24 16:45:00,1372.45,366143.99000000296,366045.710000003,98.27999999996973
25486,2022-08-24 16:50:00,-1632.63,364511.36000000295,366045.710000003,-1534.350000000035
25487,2022-08-24 16:55:00,-378.68,364132.68000000296,366045.710000003,-1913.030000000028
25488,2022-08-25 08:00:00,-662.47,363470.210000003,364132.68000000296,-662.4699999999721
25489,2022-08-25 08:05:00,289.79,363760.00000000297,364132.68000000296,-372.679999999993
25490,2022-08-25 08:10:00,-802.43,362957.570000003,364132.68000000296,-1175.109999999986
25491,2022-08-25 08:15:00,149.29,363106.86000000295,364132.68000000296,-1025.820000000007
25492,2022-08-25 08:20:00,-1095.81,362011.05000000296,364132.68000000296,-2121.6300000000047
25493,2022-08-25 08:25:00,885.84,362896.890000003,364132.68000000296,-1235.789999999979
25494,2022-08-25 08:30:00,-195.32,362701.570000003,364132.68000000296,-1431.109999999986
25495,2022-08-25 08:35:00,-179.32,362522.25000000297,364132.68000000296,-1610.429999999993
25496,2022-08-25 08:40:00,-671.71,361850.54000000295,364132.68000000296,-2282.140000000014
25497,2022-08-25 08:45:00,-1352.87,360497.67000000295,364132.68000000296,-3635.0100000000093
25498,2022-08-25 08:50:00,-745.56,359752.11000000295,364132.68000000296,-4380.570000000007
25499,2022-08-25 08:55:00,632.57,360384.68000000296,364132.68000000296,-3748.0
25500,2022-08-25 09:00:00,855.18,361239.86000000295,364132.68000000296,-2892.820000000007
25501,2022-08-25 09:05:00,1206.47,362446.3300000029,364132.68000000296,-1686.350000000035
25502,2022-08-25 09:10:00,-10.63,362435.7000000029,364132.68000000296,-1696.9800000000396
25503,2022-08-25 09:15:00,-1195.5,361240.2000000029,364132.68000000296,-2892.4800000000396
25504,2022-08-25 09:20:00,23.0,361263.2000000029,364132.68000000296,-2869.4800000000396
25505,2022-08-25 09:25:00,1425.14,362688.34000000294,364132.68000000296,-1444.3400000000256
25506,2022-08-25 09:30:00,-1947.47,360740.87000000296,364132.68000000296,-3391.8099999999977
25507,2022-08-25 09:35:00,-421.87,360319.00000000297,364132.68000000296,-3813.679999999993
25508,2022-08-25 09:40:00,61.67,360380.67000000295,364132.68000000296,-3752.0100000000093
25509,2022-08-25 09:45:00,-1817.53,358563.1400000029,364132.68000000296,-5569.540000000037
25510,2022-08-25 09:50:00,-704.86,357858.28000000294,364132.68000000296,-6274.400000000023
25511,2022-08-25 09:55:00,-1541.4,356316.8800000029,364132.68000000296,-7815.800000000047
25512,2022-08-25 10:00:00,1897.07,358213.9500000029,364132.68000000296,-5918.73000000004
25513,2022-08-25 10:05:00,863.52,359077.47000000294,364132.68000000296,-5055.210000000021
25514,2022-08-25 10:10:00,-483.97,358593.50000000297,364132.68000000296,-5539.179999999993
25515,2022-08-25 10:15:00,965.37,359558.87000000296,364132.68000000296,-4573.809999999998
25516,2022-08-25 10:20:00,1213.09,360771.960000003,364132.68000000296,-3360.719999999972
25517,2022-08-25 10:25:00,396.93,361168.890000003,364132.68000000296,-2963.789999999979
25518,2022-08-25 10:30:00,-1550.1,359618.790000003,364132.68000000296,-4513.889999999956
25519,2022-08-25 10:35:00,1310.66,360929.450000003,364132.68000000296,-3203.2299999999814
25520,2022-08-25 10:40:00,1453.62,362383.070000003,364132.68000000296,-1749.609999999986
25521,2022-08-25 10:45:00,1129.42,363512.49000000296,364132.68000000296,-620.1900000000023
25522,2022-08-25 10:50:00,-207.08,363305.41000000294,364132.68000000296,-827.2700000000186
25523,2022-08-25 10:55:00,299.14,363604.55000000296,364132.68000000296,-528.1300000000047
25524,2022-08-25 11:00:00,-1654.2,361950.35000000295,364132.68000000296,-2182.3300000000163
25525,2022-08-25 11:05:00,860.94,362811.29000000295,364132.68000000296,-1321.390000000014
25526,2022-08-25 11:10:00,686.94,363498.23000000295,364132.68000000296,-634.4500000000116
25527,2022-08-25 11:15:00,1562.73,365060.96000000293,364132.68000000296,928.2799999999697
25528,2022-08-25 11:20:00,125.89,365186.85000000295,364132.68000000296,1054.1699999999837
25529,2022-08-25 11:25:00,-241.58,364945.2700000029,364132.68000000296,812.5899999999674
25530,2022-08-25 11:30:00,132.66,365077.9300000029,364132.68000000296,945.2499999999418
25531,2022-08-25 11:35:00,-1378.72,363699.21000000293,364132.68000000296,-433.47000000003027
25532,2022-08-25 11:40:00,-570.81,363128.40000000293,364132.68000000296,-1004.2800000000279
25533,2022-08-25 11:45:00,89.98,363218.3800000029,364132.68000000296,-914.3000000000466
25534,2022-08-25 11:50:00,-1105.36,362113.0200000029,364132.68000000296,-2019.6600000000326
25535,2022-08-25 11:55:00,1468.42,363581.4400000029,364132.68000000296,-551.2400000000489
25536,2022-08-25 12:00:00,-1922.58,361658.8600000029,364132.68000000296,-2473.820000000065
25537,2022-08-25 12:05:00,-1228.87,360429.9900000029,364132.68000000296,-3702.6900000000605
25538,2022-08-25 12:10:00,696.15,361126.1400000029,364132.68000000296,-3006.5400000000373
25539,2022-08-25 12:15:00,680.06,361806.2000000029,364132.68000000296,-2326.4800000000396
25540,2022-08-25 12:20:00,-1388.2,360418.0000000029,364132.68000000296,-3714.680000000051
25541,2022-08-25 12:25:00,1684.16,362102.1600000029,364132.68000000296,-2030.5200000000768
25542,2022-08-25 12:30:00,-1869.34,360232.82000000286,364132.68000000296,-3899.8600000001024
25543,2022-08-25 12:35:00,1082.68,361315.50000000285,364132.68000000296,-2817.1800000001094
25544,2022-08-25 12:40:00,1061.59,362377.0900000029,364132.68000000296,-1755.5900000000838
25545,2022-08-25 12:45:00,158.81,362535.9000000029,364132.68000000296,-1596.7800000000861
25546,2022-08-25 12:50:00,-693.32,361842.58000000287,364132.68000000296,-2290.100000000093
25547,2022-08-25 12:55:00,-1634.84,360207.74000000284,364132.68000000296,-3924.9400000001187
25548,2022-08-25 13:00:00,-1583.82,358623.92000000284,364132.68000000296,-5508.760000000126
25549,2022-08-25 13:05:00,534.53,359158.45000000286,364132.68000000296,-4974.230000000098
25550,2022-08-25 13:10:00,-1369.59,357788.86000000284,364132.68000000296,-6343.820000000123
25551,2022-08-25 13:15:00,-1573.64,356215.2200000028,364132.68000000296,-7917.460000000137
25552,2022-08-25 13:20:00,-1359.14,354856.0800000028,364132.68000000296,-9276.600000000151
25553,2022-08-25 13:25:00,-1596.64,353259.4400000028,364132.68000000296,-10873.240000000165
25554,2022-08-25 13:30:00,-1261.96,351997.4800000028,364132.68000000296,-12135.200000000186
25555,2022-08-25 13:35:00,-1162.61,350834.8700000028,364132.68000000296,-13297.810000000172
25556,2022-08-25 13:40:00,1654.44,352489.3100000028,364132.68000000296,-11643.37000000017
25557,2022-08-25 13:45:00,80.37,352569.6800000028,364132.68000000296,-11563.000000000175
25558,2022-08-25 13:50:00,-568.32,352001.3600000028,364132.68000000296,-12131.320000000182
25559,2022-08-25 13:55:00,-992.77,351008.59000000276,364132.68000000296,-13124.0900000002
25560,2022-08-25 14:00:00,316.63,351325.22000000277,364132.68000000296,-12807.460000000196
25561,2022-08-25 14:05:00,-406.41,350918.8100000028,364132.68000000296,-13213.87000000017
25562,2022-08-25 14:10:00,897.46,351816.2700000028,364132.68000000296,-12316.410000000149
25563,2022-08-25 14:15:00,1263.39,353079.6600000028,364132.68000000296,-11053.020000000135
25564,2022-08-25 14:20:00,-194.85,352884.81000000285,364132.68000000296,-11247.870000000112
25565,2022-08-25 14:25:00,98.36,352983.17000000284,364132.68000000296,-11149.510000000126
25566,2022-08-25 14:30:00,1198.5,354181.67000000284,364132.68000000296,-9951.010000000126
25567,2022-08-25 14:35:00,715.55,354897.2200000028,364132.68000000296,-9235.460000000137
25568,2022-08-25 14:40:00,-1389.43,353507.79000000283,364132.68000000296,-10624.89000000013
25569,2022-08-25 14:45:00,1552.93,355060.7200000028,364132.68000000296,-9071.960000000137
25570,2022-08-25 14:50:00,1906.52,356967.24000000284,364132.68000000296,-7165.440000000119
25571,2022-08-25 14:55:00,-78.89,356888.3500000028,364132.68000000296,-7244.330000000133
25572,2022-08-25 15:00:00,1341.67,358230.0200000028,364132.68000000296,-5902.660000000149
25573,2022-08-25 15:05:00,-803.78,357426.2400000028,364132.68000000296,-6706.440000000177
25574,2022-08-25 15:10:00,-1555.22,355871.0200000028,364132.68000000296,-8261.660000000149
25575,2022-08-25 15:15:00,1171.08,357042.1000000028,364132.68000000296,-7090.580000000133
25576,2022-08-25 15:20:00,-668.48,356373.62000000285,364132.68000000296,-7759.060000000114
25577,2022-08-25 15:25:00,251.99,356625.61000000284,364132.68000000296,-7507.070000000123
25578,2022-08-25 15:30:00,-1755.12,354870.49000000284,364132.68000000296,-9262.190000000119
25579,2022-08-25 15:35:00,925.09,355795.58000000287,364132.68000000296,-8337.100000000093
25580,2022-08-25 15:40:00,-359.21,355436.37000000285,364132.68000000296,-8696.310000000114
25581,2022-08-25 15:45:00,-651.01,354785.36000000284,364132.68000000296,-9347.320000000123
25582,2022-08-25 15:50:00,-995.98,353789.38000000286,364132.68000000296,-10343.300000000105
25583,2022-08-25 15:55:00,-674.29,353115.0900000029,364132.68000000296,-11017.590000000084
25584,2022-08-25 16:00:00,-937.09,352178.00000000285,364132.68000000296,-11954.68000000011
25585,2022-08-25 16:05:00,-1634.22,350543.7800000029,364132.68000000296,-13588.900000000081
25586,2022-08-25 16:10:00,1271.33,351815.1100000029,364132.68000000296,-12317.570000000065
25587,2022-08-25 16:15:00,-1788.84,350026.27000000287,364132.68000000296,-14106.41000000009
25588,2022-08-25 16:20:00,-63.9,349962.37000000285,364132.68000000296,-14170.310000000114
25589,2022-08-25 16:25:00,-364.94,349597.43000000285,364132.68000000296,-14535.250000000116
25590,2022-08-25 16:30:00,1981.78,351579.2100000029,364132.68000000296,-12553.470000000088
25591,2022-08-25 16:35:00,1981.89,353561.1000000029,364132.68000000296,-10571.580000000075
25592,2022-08-25 16:40:00,123.19,353684.2900000029,364132.68000000296,-10448.390000000072
25593,2022-08-25 16:45:00,-1402.81,352281.4800000029,364132.68000000296,-11851.20000000007
25594,2022-08-25 16:50:00,1889.16,354170.64000000287,364132.68000000296,-9962.040000000095
25595,2022-08-25 16:55:00,-453.64,353717.00000000285,364132.68000000296,-10415.68000000011
25596,2022-08-26 08:00:00,700.51,354417.51000000286,353717.00000000285,700.5100000000093
25597,2022-08-26 08:05:00,-1309.47,353108.0400000029,353717.00000000285,-608.9599999999627
25598,2022-08-26 08:10:00,1844.24,354952.2800000029,353717.00000000285,1235.280000000028
25599,2022-08-26 08:15:00,1981.19,356933.4700000029,353717.00000000285,3216.4700000000303
25600,2022-08-26 08:20:00,632.12,357565.5900000029,353717.00000000285,3848.5900000000256
25601,2022-08-26 08:25:00,-1518.65,356046.94000000285,353717.00000000285,2329.9400000000023
25602,2022-08-26 08:30:00,-232.35,355814.5900000029,353717.00000000285,2097.5900000000256
25603,2022-08-26 08:35:00,-1409.05,354405.5400000029,353717.00000000285,688.5400000000373
25604,2022-08-26 08:40:00,-85.75,354319.7900000029,353717.00000000285,602.7900000000373
25605,2022-08-26 08:45:00,1363.84,355683.6300000029,353717.00000000285,1966.6300000000629
25606,2022-08-26 08:50:00,472.33,356155.96000000293,353717.00000000285,2438.960000000079
25607,2022-08-26 08:55:00,-696.55,355459.41000000294,353717.00000000285,1742.4100000000908
25608,2022-08-26 09:00:00,1252.92,356712.3300000029,353717.00000000285,2995.3300000000745
25609,2022-08-26 09:05:00,-115.4,356596.9300000029,353717.00000000285,2879.930000000051
25610,2022-08-26 09:10:00,-603.54,355993.3900000029,353717.00000000285,2276.390000000072
25611,2022-08-26 09:15:00,995.81,356989.2000000029,353717.00000000285,3272.20000000007
25612,2022-08-26 09:20:00,269.95,357259.15000000293,353717.00000000285,3542.1500000000815
25613,2022-08-26 09:25:00,-912.04,356347.11000000295,353717.00000000285,2630.1100000001024
25614,2022-08-26 09:30:00,1798.51,358145.62000000296,353717.00000000285,4428.620000000112
25615,2022-08-26 09:35:00,748.95,358894.570000003,353717.00000000285,5177.570000000123
25616,2022-08-26 09:40:00,-1352.56,357542.010000003,353717.00000000285,3825.0100000001257
25617,2022-08-26 09:45:00,-1491.46,356050.55000000296,353717.00000000285,2333.550000000105
25618,2022-08-26 09:50:00,-280.1,355770.450000003,353717.00000000285,2053.450000000128
25619,2022-08-26 09:55:00,1839.76,357610.210000003,353717.00000000285,3893.2100000001374
25620,2022-08-26 10:00:00,-697.75,356912.460000003,353717.00000000285,3195.4600000001374
25621,2022-08-26 10:05:00,922.09,357834.550000003,353717.00000000285,4117.550000000163
25622,2022-08-26 10:10:00,-194.65,357639.900000003,353717.00000000285,3922.9000000001397
25623,2022-08-26 10:15:00,-871.56,356768.340000003,353717.00000000285,3051.340000000142
25624,2022-08-26 10:20:00,-840.47,355927.870000003,353717.00000000285,2210.87000000017
25625,2022-08-26 10:25:00,1420.36,357348.230000003,353717.00000000285,3631.230000000156
25626,2022-08-26 10:30:00,-959.81,356388.420000003,353717.00000000285,2671.4200000001583
25627,2022-08-26 10:35:00,696.07,357084.490000003,353717.00000000285,3367.4900000001653
25628,2022-08-26 10:40:00,-238.74,356845.750000003,353717.00000000285,3128.7500000001746
25629,2022-08-26 10:45:00,-1109.44,355736.310000003,353717.00000000285,2019.3100000001723
25630,2022-08-26 10:50:00,1195.08,356931.39000000304,353717.00000000285,3214.3900000001886
25631,2022-08-26 10:55:00,-1827.49,355103.90000000305,353717.00000000285,1386.900000000198
25632,2022-08-26 11:00:00,-731.83,354372.07000000303,353717.00000000285,655.0700000001816
25633,2022-08-26 11:05:00,1709.69,356081.76000000304,353717.00000000285,2364.760000000184
25634,2022-08-26 11:10:00,532.6,356614.360000003,353717.00000000285,2897.3600000001607
25635,2022-08-26 11:15:00,668.61,357282.970000003,353717.00000000285,3565.9700000001467
25636,2022-08-26 11:20:00,981.21,358264.180000003,353717.00000000285,4547.180000000168
25637,2022-08-26 11:25:00,651.87,358916.050000003,353717.00000000285,5199.050000000163
25638,2022-08-26 11:30:00,-1562.86,357353.19000000303,353717.00000000285,3636.190000000177
25639,2022-08-26 11:35:00,-166.86,357186.33000000304,353717.00000000285,3469.330000000191
25640,2022-08-26 11:40:00,-1038.49,356147.84000000305,353717.00000000285,2430.8400000002002
25641,2022-08-26 11:45:00,98.8,356246.64000000304,353717.00000000285,2529.6400000001886
25642,2022-08-26 11:50:00,1557.89,357804.53000000305,353717.00000000285,4087.5300000002026
25643,2022-08-26 11:55:00,231.27,358035.8000000031,353717.00000000285,4318.800000000221
25644,2022-08-26 12:00:00,1369.24,359405.04000000306,353717.00000000285,5688.040000000212
25645,2022-08-26 12:05:00,1466.78,360871.8200000031,353717.00000000285,7154.82000000024
25646,2022-08-26 12:10:00,-1768.26,359103.5600000031,353717.00000000285,5386.5600000002305
25647,2022-08-26 12:15:00,-364.01,358739.5500000031,353717.00000000285,5022.550000000221
25648,2022-08-26 12:20:00,610.73,359350.28000000305,353717.00000000285,5633.280000000203
25649,2022-08-26 12:25:00,-1233.06,358117.22000000306,353717.00000000285,4400.220000000205
25650,2022-08-26 12:30:00,1360.88,359478.10000000306,353717.00000000285,5761.10000000021
25651,2022-08-26 12:35:00,735.04,360213.14000000304,353717.00000000285,6496.140000000189
25652,2022-08-26 12:40:00,-1973.11,358240.03000000305,353717.00000000285,4523.030000000203
25653,2022-08-26 12:45:00,1344.18,359584.21000000305,353717.00000000285,5867.210000000196
25654,2022-08-26 12:50:00,815.33,360399.54000000306,353717.00000000285,6682.540000000212
25655,2022-08-26 12:55:00,-321.02,360078.52000000305,353717.00000000285,6361.520000000193
25656,2022-08-26 13:00:00,-1710.55,358367.97000000306,353717.00000000285,4650.970000000205
25657,2022-08-26 13:05:00,-1729.96,356638.01000000304,353717.00000000285,2921.010000000184
25658,2022-08-26 13:10:00,-1009.79,355628.22000000306,353717.00000000285,1911.220000000205
25659,2022-08-26 13:15:00,-331.72,355296.5000000031,353717.00000000285,1579.5000000002328
25660,2022-08-26 13:20:00,303.37,355599.8700000031,353717.00000000285,1882.8700000002282
25661,2022-08-26 13:25:00,-217.01,355382.8600000031,353717.00000000285,1665.8600000002189
25662,2022-08-26 13:30:00,-1727.34,353655.52000000305,353717.00000000285,-61.47999999980675
25663,2022-08-26 13:35:00,-1947.54,351707.98000000307,353717.00000000285,-2009.0199999997858
25664,2022-08-26 13:40:00,-1858.65,349849.33000000304,353717.00000000285,-3867.669999999809
25665,2022-08-26 13:45:00,-1726.6,348122.73000000307,353717.00000000285,-5594.269999999786
25666,2022-08-26 13:50:00,1163.28,349286.0100000031,353717.00000000285,-4430.989999999758
25667,2022-08-26 13:55:00,346.97,349632.98000000307,353717.00000000285,-4084.019999999786
25668,2022-08-26 14:00:00,260.41,349893.39000000304,353717.00000000285,-3823.6099999998114
25669,2022-08-26 14:05:00,1705.33,351598.72000000306,353717.00000000285,-2118.279999999795
25670,2022-08-26 14:10:00,-1846.5,349752.22000000306,353717.00000000285,-3964.779999999795
25671,2022-08-26 14:15:00,-720.86,349031.3600000031,353717.00000000285,-4685.639999999781
25672,2022-08-26 14:20:00,341.3,349372.66000000306,353717.00000000285,-4344.339999999793
25673,2022-08-26 14:25:00,1167.17,350539.83000000304,353717.00000000285,-3177.169999999809
25674,2022-08-26 14:30:00,-1446.25,349093.58000000304,353717.00000000285,-4623.419999999809
25675,2022-08-26 14:35:00,1274.99,350368.57000000303,353717.00000000285,-3348.4299999998184
25676,2022-08-26 14:40:00,-1780.26,348588.310000003,353717.00000000285,-5128.689999999828
25677,2022-08-26 14:45:00,1340.3,349928.610000003,353717.00000000285,-3788.3899999998393
25678,2022-08-26 14:50:00,782.89,350711.500000003,353717.00000000285,-3005.4999999998254
25679,2022-08-26 14:55:00,-1437.93,349273.57000000303,353717.00000000285,-4443.429999999818
25680,2022-08-26 15:00:00,-761.97,348511.60000000306,353717.00000000285,-5205.39999999979
25681,2022-08-26 15:05:00,-1592.96,346918.64000000304,353717.00000000285,-6798.359999999811
25682,2022-08-26 15:10:00,-1604.45,345314.19000000303,353717.00000000285,-8402.809999999823
25683,2022-08-26 15:15:00,-633.9,344680.290000003,353717.00000000285,-9036.709999999846
25684,2022-08-26 15:20:00,1111.81,345792.100000003,353717.00000000285,-7924.899999999849
25685,2022-08-26 15:25:00,-805.93,344986.170000003,353717.00000000285,-8730.829999999842
25686,2022-08-26 15:30:00,1773.82,346759.990000003,353717.00000000285,-6957.009999999835
25687,2022-08-26 15:35:00,431.33,347191.32000000303,353717.00000000285,-6525.679999999818
25688,2022-08-26 15:40:00,-566.12,346625.20000000304,353717.00000000285,-7091.799999999814
25689,2022-08-26 15:45:00,-1297.45,345327.750000003,353717.00000000285,-8389.249999999825
25690,2022-08-26 15:50:00,-280.34,345047.410000003,353717.00000000285,-8669.589999999851
25691,2022-08-26 15:55:00,1855.73,346903.140000003,353717.00000000285,-6813.85999999987
25692,2022-08-26 16:00:00,-469.48,346433.660000003,353717.00000000285,-7283.339999999851
25693,2022-08-26 16:05:00,1285.0,347718.660000003,353717.00000000285,-5998.339999999851
25694,2022-08-26 16:10:00,-0.57,347718.090000003,353717.00000000285,-5998.909999999858
25695,2022-08-26 16:15:00,383.49,348101.580000003,353717.00000000285,-5615.419999999867
25696,2022-08-26 16:20:00,-382.33,347719.25000000297,353717.00000000285,-5997.749999999884
25697,2022-08-26 16:25:00,-968.88,346750.37000000296,353717.00000000285,-6966.629999999888
25698,2022-08-26 16:30:00,1644.28,348394.650000003,353717.00000000285,-5322.34999999986
25699,2022-08-26 16:35:00,1167.36,349562.010000003,353717.00000000285,-4154.989999999874
25700,2022-08-26 16:40:00,-1371.75,348190.260000003,353717.00000000285,-5526.739999999874
25701,2022-08-26 16:45:00,546.94,348737.200000003,353717.00000000285,-4979.799999999872
25702,2022-08-26 16:50:00,1693.25,350430.450000003,353717.00000000285,-3286.549999999872
25703,2022-08-26 16:55:00,492.61,350923.06000000297,353717.00000000285,-2793.939999999886
25704,2022-08-27 08:00:00,1986.33,352909.390000003,350923.06000000297,1986.3300000000163
25705,2022-08-27 08:05:00,1536.75,354446.140000003,350923.06000000297,3523.0800000000163
25706,2022-08-27 08:10:00,-1055.34,353390.80000000296,350923.06000000297,2467.7399999999907
25707,2022-08-27 08:15:00,743.41,354134.21000000293,350923.06000000297,3211.149999999965
25708,2022-08-27 08:20:00,235.05,354369.2600000029,350923.06000000297,3446.1999999999534
25709,2022-08-27 08:25:00,-728.04,353641.22000000294,350923.06000000297,2718.1599999999744
25710,2022-08-27 08:30:00,-485.55,353155.67000000295,350923.06000000297,2232.609999999986
25711,2022-08-27 08:35:00,342.78,353498.450000003,350923.06000000297,2575.390000000014
25712,2022-08-27 08:40:00,341.36,353839.81000000297,350923.06000000297,2916.75
25713,2022-08-27 08:45:00,-866.93,352972.880000003,350923.06000000297,2049.820000000007
25714,2022-08-27 08:50:00,924.52,353897.400000003,350923.06000000297,2974.3400000000256
25715,2022-08-27 08:55:00,278.76,354176.160000003,350923.06000000297,3253.100000000035
25716,2022-08-27 09:00:00,-992.32,353183.840000003,350923.06000000297,2260.780000000028
25717,2022-08-27 09:05:00,-1622.65,351561.190000003,350923.06000000297,638.1300000000047
25718,2022-08-27 09:10:00,-1275.9,350285.29000000295,350923.06000000297,-637.7700000000186
25719,2022-08-27 09:15:00,-717.75,349567.54000000295,350923.06000000297,-1355.5200000000186
25720,2022-08-27 09:20:00,1704.77,351272.31000000297,350923.06000000297,349.25
25721,2022-08-27 09:25:00,215.09,351487.400000003,350923.06000000297,564.3400000000256
25722,2022-08-27 09:30:00,-1580.59,349906.81000000297,350923.06000000297,-1016.25
25723,2022-08-27 09:35:00,83.22,349990.03000000294,350923.06000000297,-933.0300000000279
25724,2022-08-27 09:40:00,-1708.49,348281.54000000295,350923.06000000297,-2641.5200000000186
25725,2022-08-27 09:45:00,643.19,348924.73000000295,350923.06000000297,-1998.3300000000163
25726,2022-08-27 09:50:00,296.3,349221.03000000294,350923.06000000297,-1702.030000000028
25727,2022-08-27 09:55:00,282.31,349503.34000000294,350923.06000000297,-1419.7200000000303
25728,2022-08-27 10:00:00,859.15,350362.49000000296,350923.06000000297,-560.570000000007
25729,2022-08-27 10:05:00,-1154.01,349208.48000000295,350923.06000000297,-1714.5800000000163
25730,2022-08-27 10:10:00,-1708.16,347500.320000003,350923.06000000297,-3422.7399999999907
25731,2022-08-27 10:15:00,-1534.91,345965.410000003,350923.06000000297,-4957.649999999965
25732,2022-08-27 10:20:00,-1256.06,344709.350000003,350923.06000000297,-6213.709999999963
25733,2022-08-27 10:25:00,-359.67,344349.680000003,350923.06000000297,-6573.379999999946
25734,2022-08-27 10:30:00,-452.14,343897.540000003,350923.06000000297,-7025.51999999996
25735,2022-08-27 10:35:00,-663.05,343234.490000003,350923.06000000297,-7688.569999999949
25736,2022-08-27 10:40:00,22.44,343256.930000003,350923.06000000297,-7666.129999999946
25737,2022-08-27 10:45:00,-1432.21,341824.720000003,350923.06000000297,-9098.339999999967
25738,2022-08-27 10:50:00,610.93,342435.650000003,350923.06000000297,-8487.409999999974
25739,2022-08-27 10:55:00,-777.24,341658.410000003,350923.06000000297,-9264.649999999965
25740,2022-08-27 11:00:00,-600.78,341057.630000003,350923.06000000297,-9865.429999999993
25741,2022-08-27 11:05:00,514.38,341572.010000003,350923.06000000297,-9351.049999999988
25742,2022-08-27 11:10:00,-1745.29,339826.720000003,350923.06000000297,-11096.339999999967
25743,2022-08-27 11:15:00,-784.58,339042.140000003,350923.06000000297,-11880.919999999984
25744,2022-08-27 11:20:00,-543.91,338498.230000003,350923.06000000297,-12424.829999999958
25745,2022-08-27 11:25:00,-1139.19,337359.040000003,350923.06000000297,-13564.01999999996
25746,2022-08-27 11:30:00,1450.04,338809.080000003,350923.06000000297,-12113.979999999981
25747,2022-08-27 11:35:00,-1430.19,337378.890000003,350923.06000000297,-13544.169999999984
25748,2022-08-27 11:40:00,-1721.63,335657.260000003,350923.06000000297,-15265.799999999988
25749,2022-08-27 11:45:00,-1030.08,334627.18000000296,350923.06000000297,-16295.880000000005
25750,2022-08-27 11:50:00,348.34,334975.520000003,350923.06000000297,-15947.539999999979
25751,2022-08-27 11:55:00,1637.48,336613.00000000297,350923.06000000297,-14310.059999999998
25752,2022-08-27 12:00:00,-1708.45,334904.55000000296,350923.06000000297,-16018.51000000001
25753,2022-08-27 12:05:00,-977.77,333926.78000000294,350923.06000000297,-16996.280000000028
25754,2022-08-27 12:10:00,1058.01,334984.79000000295,350923.06000000297,-15938.270000000019
25755,2022-08-27 12:15:00,1478.0,336462.79000000295,350923.06000000297,-14460.270000000019
25756,2022-08-27 12:20:00,-681.02,335781.7700000029,350923.06000000297,-15141.290000000037
25757,2022-08-27 12:25:00,-1164.38,334617.3900000029,350923.06000000297,-16305.670000000042
25758,2022-08-27 12:30:00,1893.17,336510.5600000029,350923.06000000297,-14412.500000000058
25759,2022-08-27 12:35:00,-391.46,336119.1000000029,350923.06000000297,-14803.96000000008
25760,2022-08-27 12:40:00,1927.65,338046.7500000029,350923.06000000297,-12876.310000000056
25761,2022-08-27 12:45:00,-1266.49,336780.2600000029,350923.06000000297,-14142.800000000047
25762,2022-08-27 12:50:00,-79.6,336700.66000000294,350923.06000000297,-14222.400000000023
25763,2022-08-27 12:55:00,-344.59,336356.0700000029,350923.06000000297,-14566.990000000049
25764,2022-08-27 13:00:00,946.35,337302.4200000029,350923.06000000297,-13620.640000000072
25765,2022-08-27 13:05:00,-1894.12,335408.3000000029,350923.06000000297,-15514.760000000068
25766,2022-08-27 13:10:00,218.87,335627.1700000029,350923.06000000297,-15295.890000000072
25767,2022-08-27 13:15:00,1480.86,337108.0300000029,350923.06000000297,-13815.030000000086
25768,2022-08-27 13:20:00,30.8,337138.83000000287,350923.06000000297,-13784.230000000098
25769,2022-08-27 13:25:00,926.73,338065.56000000285,350923.06000000297,-12857.500000000116
25770,2022-08-27 13:30:00,-1800.07,336265.49000000284,350923.06000000297,-14657.570000000123
25771,2022-08-27 13:35:00,-1007.54,335257.95000000286,350923.06000000297,-15665.110000000102
25772,2022-08-27 13:40:00,-1840.79,333417.1600000029,350923.06000000297,-17505.90000000008
25773,2022-08-27 13:45:00,1132.0,334549.1600000029,350923.06000000297,-16373.900000000081
25774,2022-08-27 13:50:00,-91.91,334457.2500000029,350923.06000000297,-16465.810000000056
25775,2022-08-27 13:55:00,-895.62,333561.6300000029,350923.06000000297,-17361.43000000005
25776,2022-08-27 14:00:00,-1624.46,331937.1700000029,350923.06000000297,-18985.890000000072
25777,2022-08-27 14:05:00,-1628.68,330308.4900000029,350923.06000000297,-20614.570000000065
25778,2022-08-27 14:10:00,-434.92,329873.5700000029,350923.06000000297,-21049.49000000005
25779,2022-08-27 14:15:00,-1702.14,328171.4300000029,350923.06000000297,-22751.630000000063
25780,2022-08-27 14:20:00,-643.56,327527.8700000029,350923.06000000297,-23395.19000000006
25781,2022-08-27 14:25:00,889.37,328417.2400000029,350923.06000000297,-22505.820000000065
25782,2022-08-27 14:30:00,-531.56,327885.6800000029,350923.06000000297,-23037.380000000063
25783,2022-08-27 14:35:00,1798.85,329684.5300000029,350923.06000000297,-21238.530000000086
25784,2022-08-27 14:40:00,427.16,330111.69000000285,350923.06000000297,-20811.37000000011
25785,2022-08-27 14:45:00,-1231.8,328879.89000000287,350923.06000000297,-22043.1700000001
25786,2022-08-27 14:50:00,-1985.18,326894.7100000029,350923.06000000297,-24028.350000000093
25787,2022-08-27 14:55:00,1363.93,328258.64000000287,350923.06000000297,-22664.4200000001
25788,2022-08-27 15:00:00,73.03,328331.6700000029,350923.06000000297,-22591.390000000072
25789,2022-08-27 15:05:00,627.25,328958.9200000029,350923.06000000297,-21964.140000000072
25790,2022-08-27 15:10:00,919.18,329878.1000000029,350923.06000000297,-21044.96000000008
25791,2022-08-27 15:15:00,-1522.37,328355.7300000029,350923.06000000297,-22567.330000000075
25792,2022-08-27 15:20:00,-747.19,327608.5400000029,350923.06000000297,-23314.520000000077
25793,2022-08-27 15:25:00,525.14,328133.6800000029,350923.06000000297,-22789.380000000063
25794,2022-08-27 15:30:00,874.43,329008.1100000029,350923.06000000297,-21914.95000000007
25795,2022-08-27 15:35:00,-1753.09,327255.02000000287,350923.06000000297,-23668.040000000095
25796,2022-08-27 15:40:00,967.44,328222.4600000029,350923.06000000297,-22700.600000000093
25797,2022-08-27 15:45:00,-1108.28,327114.18000000285,350923.06000000297,-23808.88000000012
25798,2022-08-27 15:50:00,1791.15,328905.33000000287,350923.06000000297,-22017.730000000098
25799,2022-08-27 15:55:00,-1208.16,327697.1700000029,350923.06000000297,-23225.890000000072
25800,2022-08-27 16:00:00,1821.73,329518.9000000029,350923.06000000297,-21404.16000000009
25801,2022-08-27 16:05:00,-1084.29,328434.6100000029,350923.06000000297,-22488.45000000007
25802,2022-08-27 16:10:00,-904.02,327530.5900000029,350923.06000000297,-23392.47000000009
25803,2022-08-27 16:15:00,1222.08,328752.6700000029,350923.06000000297,-22170.390000000072
25804,2022-08-27 16:20:00,1374.9,330127.5700000029,350923.06000000297,-20795.49000000005
25805,2022-08-27 16:25:00,1044.4,331171.97000000294,350923.06000000297,-19751.090000000026
25806,2022-08-27 16:30:00,-1512.09,329659.8800000029,350923.06000000297,-21263.18000000005
25807,2022-08-27 16:35:00,-1282.97,328376.91000000294,350923.06000000297,-22546.150000000023
25808,2022-08-27 16:40:00,-405.67,327971.24000000296,350923.06000000297,-22951.820000000007
25809,2022-08-27 16:45:00,-828.65,327142.59000000294,350923.06000000297,-23780.47000000003
25810,2022-08-27 16:50:00,37.9,327180.49000000296,350923.06000000297,-23742.570000000007
25811,2022-08-27 16:55:00,102.75,327283.24000000296,350923.06000000297,-23639.820000000007
25812,2022-08-28 08:00:00,556.02,327839.260000003,327283.24000000296,556.0200000000186
25813,2022-08-28 08:05:00,-286.96,327552.30000000296,327283.24000000296,269.0599999999977
25814,2022-08-28 08:10:00,-759.83,326792.47000000294,327283.24000000296,-490.7700000000186
25815,2022-08-28 08:15:00,-671.37,326121.10000000295,327283.24000000296,-1162.140000000014
25816,2022-08-28 08:20:00,-1130.8,324990.30000000296,327283.24000000296,-2292.9400000000023
25817,2022-08-28 08:25:00,1894.53,326884.830000003,327283.24000000296,-398.4099999999744
25818,2022-08-28 08:30:00,-645.44,326239.390000003,327283.24000000296,-1043.8499999999767
25819,2022-08-28 08:35:00,1737.76,327977.150000003,327283.24000000296,693.9100000000326
25820,2022-08-28 08:40:00,31.84,328008.990000003,327283.24000000296,725.7500000000582
25821,2022-08-28 08:45:00,215.91,328224.900000003,327283.24000000296,941.6600000000326
25822,2022-08-28 08:50:00,-1881.91,326342.990000003,327283.24000000296,-940.2499999999418
25823,2022-08-28 08:55:00,-36.46,326306.530000003,327283.24000000296,-976.7099999999627
25824,2022-08-28 09:00:00,-1233.68,325072.850000003,327283.24000000296,-2210.3899999999558
25825,2022-08-28 09:05:00,1244.77,326317.620000003,327283.24000000296,-965.6199999999371
25826,2022-08-28 09:10:00,1723.7,328041.32000000303,327283.24000000296,758.0800000000745
25827,2022-08-28 09:15:00,68.01,328109.33000000304,327283.24000000296,826.0900000000838
25828,2022-08-28 09:20:00,-1979.03,326130.300000003,327283.24000000296,-1152.9399999999441
25829,2022-08-28 09:25:00,-1049.43,325080.870000003,327283.24000000296,-2202.369999999937
25830,2022-08-28 09:30:00,385.92,325466.790000003,327283.24000000296,-1816.4499999999534
25831,2022-08-28 09:35:00,1226.16,326692.950000003,327283.24000000296,-590.289999999979
25832,2022-08-28 09:40:00,470.36,327163.31000000297,327283.24000000296,-119.92999999999302
25833,2022-08-28 09:45:00,-1240.39,325922.92000000295,327283.24000000296,-1360.320000000007
25834,2022-08-28 09:50:00,-356.52,325566.40000000293,327283.24000000296,-1716.8400000000256
25835,2022-08-28 09:55:00,163.06,325729.46000000293,327283.24000000296,-1553.780000000028
25836,2022-08-28 10:00:00,609.91,326339.3700000029,327283.24000000296,-943.8700000000536
25837,2022-08-28 10:05:00,1695.18,328034.5500000029,327283.24000000296,751.3099999999395
25838,2022-08-28 10:10:00,400.76,328435.3100000029,327283.24000000296,1152.0699999999488
25839,2022-08-28 10:15:00,-71.85,328363.46000000293,327283.24000000296,1080.219999999972
25840,2022-08-28 10:20:00,320.32,328683.78000000294,327283.24000000296,1400.539999999979
25841,2022-08-28 10:25:00,1337.82,330021.60000000295,327283.24000000296,2738.359999999986
25842,2022-08-28 10:30:00,1.52,330023.12000000296,327283.24000000296,2739.8800000000047
25843,2022-08-28 10:35:00,695.09,330718.210000003,327283.24000000296,3434.9700000000303
25844,2022-08-28 10:40:00,-511.85,330206.360000003,327283.24000000296,2923.1200000000536
25845,2022-08-28 10:45:00,572.04,330778.400000003,327283.24000000296,3495.1600000000326
25846,2022-08-28 10:50:00,566.38,331344.780000003,327283.24000000296,4061.5400000000373
25847,2022-08-28 10:55:00,-944.0,330400.780000003,327283.24000000296,3117.5400000000373
25848,2022-08-28 11:00:00,-1454.76,328946.020000003,327283.24000000296,1662.780000000028
25849,2022-08-28 11:05:00,-596.81,328349.210000003,327283.24000000296,1065.9700000000303
25850,2022-08-28 11:10:00,1367.03,329716.240000003,327283.24000000296,2433.000000000058
25851,2022-08-28 11:15:00,1421.93,331138.170000003,327283.24000000296,3854.930000000051
25852,2022-08-28 11:20:00,1746.81,332884.980000003,327283.24000000296,5601.740000000049
25853,2022-08-28 11:25:00,-1542.71,331342.270000003,327283.24000000296,4059.030000000028
25854,2022-08-28 11:30:00,-330.46,331011.81000000297,327283.24000000296,3728.570000000007
25855,2022-08-28 11:35:00,608.17,331619.98000000295,327283.24000000296,4336.739999999991
25856,2022-08-28 11:40:00,-88.38,331531.60000000295,327283.24000000296,4248.359999999986
25857,2022-08-28 11:45:00,-591.26,330940.34000000294,327283.24000000296,3657.0999999999767
25858,2022-08-28 11:50:00,-1857.21,329083.1300000029,327283.24000000296,1799.8899999999558
25859,2022-08-28 11:55:00,-552.08,328531.0500000029,327283.24000000296,1247.8099999999395
25860,2022-08-28 12:00:00,-810.11,327720.9400000029,327283.24000000296,437.69999999995343
25861,2022-08-28 12:05:00,-1826.32,325894.6200000029,327283.24000000296,-1388.6200000000536
25862,2022-08-28 12:10:00,-163.18,325731.4400000029,327283.24000000296,-1551.8000000000466
25863,2022-08-28 12:15:00,-1038.1,324693.34000000294,327283.24000000296,-2589.9000000000233
25864,2022-08-28 12:20:00,-267.24,324426.10000000295,327283.24000000296,-2857.140000000014
25865,2022-08-28 12:25:00,-1869.43,322556.67000000295,327283.24000000296,-4726.570000000007
25866,2022-08-28 12:30:00,389.13,322945.80000000296,327283.24000000296,-4337.440000000002
25867,2022-08-28 12:35:00,765.51,323711.31000000297,327283.24000000296,-3571.929999999993
25868,2022-08-28 12:40:00,752.23,324463.54000000295,327283.24000000296,-2819.7000000000116
25869,2022-08-28 12:45:00,-1866.47,322597.070000003,327283.24000000296,-4686.169999999984
25870,2022-08-28 12:50:00,-1871.55,320725.520000003,327283.24000000296,-6557.719999999972
25871,2022-08-28 12:55:00,734.93,321460.450000003,327283.24000000296,-5822.789999999979
25872,2022-08-28 13:00:00,-357.85,321102.600000003,327283.24000000296,-6180.639999999956
25873,2022-08-28 13:05:00,-1492.65,319609.950000003,327283.24000000296,-7673.289999999979
25874,2022-08-28 13:10:00,-920.53,318689.42000000295,327283.24000000296,-8593.820000000007
25875,2022-08-28 13:15:00,-889.02,317800.40000000293,327283.24000000296,-9482.840000000026
25876,2022-08-28 13:20:00,155.46,317955.86000000295,327283.24000000296,-9327.380000000005
25877,2022-08-28 13:25:00,-1983.52,315972.34000000294,327283.24000000296,-11310.900000000023
25878,2022-08-28 13:30:00,-861.47,315110.87000000296,327283.24000000296,-12172.369999999995
25879,2022-08-28 13:35:00,223.07,315333.940000003,327283.24000000296,-11949.299999999988
25880,2022-08-28 13:40:00,1636.44,316970.380000003,327283.24000000296,-10312.859999999986
25881,2022-08-28 13:45:00,927.26,317897.640000003,327283.24000000296,-9385.599999999977
25882,2022-08-28 13:50:00,-1775.18,316122.460000003,327283.24000000296,-11160.77999999997
25883,2022-08-28 13:55:00,-883.24,315239.220000003,327283.24000000296,-12044.01999999996
25884,2022-08-28 14:00:00,-1032.92,314206.300000003,327283.24000000296,-13076.939999999944
25885,2022-08-28 14:05:00,1678.29,315884.590000003,327283.24000000296,-11398.649999999965
25886,2022-08-28 14:10:00,-1934.15,313950.440000003,327283.24000000296,-13332.799999999988
25887,2022-08-28 14:15:00,-1344.3,312606.140000003,327283.24000000296,-14677.099999999977
25888,2022-08-28 14:20:00,-154.98,312451.160000003,327283.24000000296,-14832.079999999958
25889,2022-08-28 14:25:00,470.28,312921.44000000303,327283.24000000296,-14361.79999999993
25890,2022-08-28 14:30:00,-1207.43,311714.01000000304,327283.24000000296,-15569.229999999923
25891,2022-08-28 14:35:00,1180.86,312894.870000003,327283.24000000296,-14388.369999999937
25892,2022-08-28 14:40:00,727.21,313622.08000000304,327283.24000000296,-13661.159999999916
25893,2022-08-28 14:45:00,1356.7,314978.78000000305,327283.24000000296,-12304.459999999905
25894,2022-08-28 14:50:00,-713.87,314264.91000000306,327283.24000000296,-13018.3299999999
25895,2022-08-28 14:55:00,-1723.8,312541.1100000031,327283.24000000296,-14742.129999999888
25896,2022-08-28 15:00:00,1256.72,313797.83000000304,327283.24000000296,-13485.409999999916
25897,2022-08-28 15:05:00,634.8,314432.63000000303,327283.24000000296,-12850.609999999928
25898,2022-08-28 15:10:00,-795.57,313637.060000003,327283.24000000296,-13646.179999999935
25899,2022-08-28 15:15:00,588.59,314225.65000000305,327283.24000000296,-13057.58999999991
25900,2022-08-28 15:20:00,-379.71,313845.94000000303,327283.24000000296,-13437.29999999993
25901,2022-08-28 15:25:00,1486.64,315332.58000000304,327283.24000000296,-11950.659999999916
25902,2022-08-28 15:30:00,-1033.18,314299.40000000305,327283.24000000296,-12983.83999999991
25903,2022-08-28 15:35:00,-607.36,313692.04000000306,327283.24000000296,-13591.199999999895
25904,2022-08-28 15:40:00,603.43,314295.47000000306,327283.24000000296,-12987.769999999902
25905,2022-08-28 15:45:00,244.95,314540.42000000307,327283.24000000296,-12742.81999999989
25906,2022-08-28 15:50:00,717.22,315257.64000000304,327283.24000000296,-12025.599999999919
25907,2022-08-28 15:55:00,452.17,315709.810000003,327283.24000000296,-11573.429999999935
25908,2022-08-28 16:00:00,-691.4,315018.410000003,327283.24000000296,-12264.829999999958
25909,2022-08-28 16:05:00,-414.56,314603.850000003,327283.24000000296,-12679.389999999956
25910,2022-08-28 16:10:00,-50.29,314553.560000003,327283.24000000296,-12729.679999999935
25911,2022-08-28 16:15:00,-1266.99,313286.57000000303,327283.24000000296,-13996.669999999925
25912,2022-08-28 16:20:00,-665.75,312620.82000000303,327283.24000000296,-14662.419999999925
25913,2022-08-28 16:25:00,-1241.2,311379.620000003,327283.24000000296,-15903.619999999937
25914,2022-08-28 16:30:00,197.03,311576.65000000305,327283.24000000296,-15706.58999999991
25915,2022-08-28 16:35:00,345.08,311921.73000000307,327283.24000000296,-15361.509999999893
25916,2022-08-28 16:40:00,-223.63,311698.10000000306,327283.24000000296,-15585.139999999898
25917,2022-08-28 16:45:00,667.53,312365.6300000031,327283.24000000296,-14917.60999999987
25918,2022-08-28 16:50:00,-1373.1,310992.5300000031,327283.24000000296,-16290.709999999846
25919,2022-08-28 16:55:00,-1878.99,309113.5400000031,327283.24000000296,-18169.699999999837
25920,2022-08-29 08:00:00,1362.5,310476.0400000031,309113.5400000031,1362.5
25921,2022-08-29 08:05:00,1638.02,312114.06000000314,309113.5400000031,3000.5200000000186
25922,2022-08-29 08:10:00,1782.29,313896.3500000031,309113.5400000031,4782.809999999998
25923,2022-08-29 08:15:00,-1936.22,311960.13000000315,309113.5400000031,2846.5900000000256
25924,2022-08-29 08:20:00,-548.58,311411.55000000313,309113.5400000031,2298.0100000000093
25925,2022-08-29 08:25:00,1166.49,312578.0400000031,309113.5400000031,3464.5
25926,2022-08-29 08:30:00,1408.06,313986.1000000031,309113.5400000031,4872.559999999998
25927,2022-08-29 08:35:00,110.19,314096.2900000031,309113.5400000031,4982.75
25928,2022-08-29 08:40:00,-652.4,313443.8900000031,309113.5400000031,4330.349999999977
25929,2022-08-29 08:45:00,-1597.05,311846.8400000031,309113.5400000031,2733.2999999999884
25930,2022-08-29 08:50:00,-237.97,311608.87000000314,309113.5400000031,2495.3300000000163
25931,2022-08-29 08:55:00,-166.24,311442.63000000315,309113.5400000031,2329.0900000000256
25932,2022-08-29 09:00:00,527.53,311970.1600000032,309113.5400000031,2856.6200000000536
25933,2022-08-29 09:05:00,443.49,312413.65000000317,309113.5400000031,3300.1100000000442
25934,2022-08-29 09:10:00,-94.36,312319.2900000032,309113.5400000031,3205.750000000058
25935,2022-08-29 09:15:00,1436.38,313755.6700000032,309113.5400000031,4642.130000000063
25936,2022-08-29 09:20:00,1844.64,315600.3100000032,309113.5400000031,6486.770000000077
25937,2022-08-29 09:25:00,-347.06,315253.2500000032,309113.5400000031,6139.710000000079
25938,2022-08-29 09:30:00,1882.38,317135.6300000032,309113.5400000031,8022.090000000084
25939,2022-08-29 09:35:00,-1680.24,315455.3900000032,309113.5400000031,6341.850000000093
25940,2022-08-29 09:40:00,873.65,316329.04000000324,309113.5400000031,7215.500000000116
25941,2022-08-29 09:45:00,-1296.68,315032.36000000325,309113.5400000031,5918.820000000123
25942,2022-08-29 09:50:00,-1106.61,313925.75000000326,309113.5400000031,4812.210000000137
25943,2022-08-29 09:55:00,-1191.17,312734.5800000033,309113.5400000031,3621.0400000001537
25944,2022-08-29 10:00:00,-1968.62,310765.9600000033,309113.5400000031,1652.4200000001583
25945,2022-08-29 10:05:00,38.18,310804.1400000033,309113.5400000031,1690.6000000001513
25946,2022-08-29 10:10:00,1022.27,311826.4100000033,309113.5400000031,2712.87000000017
25947,2022-08-29 10:15:00,-877.79,310948.6200000033,309113.5400000031,1835.080000000191
25948,2022-08-29 10:20:00,1482.31,312430.9300000033,309113.5400000031,3317.3900000001886
25949,2022-08-29 10:25:00,-1957.22,310473.71000000334,309113.5400000031,1360.1700000002165
25950,2022-08-29 10:30:00,1006.83,311480.54000000336,309113.5400000031,2367.000000000233
25951,2022-08-29 10:35:00,-1136.88,310343.66000000335,309113.5400000031,1230.1200000002282
25952,2022-08-29 10:40:00,-1192.0,309151.66000000335,309113.5400000031,38.120000000228174
25953,2022-08-29 10:45:00,1233.82,310385.48000000336,309113.5400000031,1271.9400000002352
25954,2022-08-29 10:50:00,-1690.11,308695.3700000034,309113.5400000031,-418.16999999975087
25955,2022-08-29 10:55:00,-560.46,308134.91000000335,309113.5400000031,-978.6299999997718
25956,2022-08-29 11:00:00,-331.77,307803.14000000333,309113.5400000031,-1310.3999999997905
25957,2022-08-29 11:05:00,1800.44,309603.58000000333,309113.5400000031,490.0400000002119
25958,2022-08-29 11:10:00,-1406.94,308196.64000000333,309113.5400000031,-916.8999999997905
25959,2022-08-29 11:15:00,-1279.52,306917.1200000033,309113.5400000031,-2196.419999999809
25960,2022-08-29 11:20:00,1910.97,308828.0900000033,309113.5400000031,-285.449999999837
25961,2022-08-29 11:25:00,-1854.24,306973.8500000033,309113.5400000031,-2139.6899999998277
25962,2022-08-29 11:30:00,-292.29,306681.5600000033,309113.5400000031,-2431.9799999998068
25963,2022-08-29 11:35:00,1825.06,308506.6200000033,309113.5400000031,-606.9199999998091
25964,2022-08-29 11:40:00,-1487.98,307018.64000000333,309113.5400000031,-2094.8999999997905
25965,2022-08-29 11:45:00,-203.31,306815.33000000333,309113.5400000031,-2298.209999999788
25966,2022-08-29 11:50:00,-20.03,306795.3000000033,309113.5400000031,-2318.239999999816
25967,2022-08-29 11:55:00,1144.49,307939.7900000033,309113.5400000031,-1173.7499999998254
25968,2022-08-29 12:00:00,-1951.9,305987.8900000033,309113.5400000031,-3125.6499999998487
25969,2022-08-29 12:05:00,-1317.25,304670.6400000033,309113.5400000031,-4442.899999999849
25970,2022-08-29 12:10:00,1300.29,305970.93000000325,309113.5400000031,-3142.6099999998696
25971,2022-08-29 12:15:00,1499.57,307470.50000000326,309113.5400000031,-1643.0399999998626
25972,2022-08-29 12:20:00,712.78,308183.2800000033,309113.5400000031,-930.2599999998347
25973,2022-08-29 12:25:00,144.8,308328.0800000033,309113.5400000031,-785.4599999998463
25974,2022-08-29 12:30:00,-796.43,307531.6500000033,309113.5400000031,-1581.8899999998393
25975,2022-08-29 12:35:00,836.75,308368.4000000033,309113.5400000031,-745.1399999998393
25976,2022-08-29 12:40:00,-193.07,308175.3300000033,309113.5400000031,-938.2099999998463
25977,2022-08-29 12:45:00,-327.98,307847.3500000033,309113.5400000031,-1266.1899999998277
25978,2022-08-29 12:50:00,867.84,308715.1900000033,309113.5400000031,-398.3499999998021
25979,2022-08-29 12:55:00,376.31,309091.5000000033,309113.5400000031,-22.039999999804422
25980,2022-08-29 13:00:00,1117.38,310208.8800000033,309113.5400000031,1095.3400000002002
25981,2022-08-29 13:05:00,-596.36,309612.52000000334,309113.5400000031,498.9800000002142
25982,2022-08-29 13:10:00,-30.45,309582.0700000033,309113.5400000031,468.53000000020256
25983,2022-08-29 13:15:00,864.53,310446.60000000335,309113.5400000031,1333.0600000002305
25984,2022-08-29 13:20:00,1621.36,312067.96000000334,309113.5400000031,2954.4200000002165
25985,2022-08-29 13:25:00,-1819.27,310248.6900000033,309113.5400000031,1135.150000000198
25986,2022-08-29 13:30:00,574.89,310823.58000000333,309113.5400000031,1710.0400000002119
25987,2022-08-29 13:35:00,-598.33,310225.2500000033,309113.5400000031,1111.7100000001956
25988,2022-08-29 13:40:00,1478.87,311704.1200000033,309113.5400000031,2590.580000000191
25989,2022-08-29 13:45:00,-1699.19,310004.9300000033,309113.5400000031,891.3900000001886
25990,2022-08-29 13:50:00,-634.1,309370.83000000333,309113.5400000031,257.2900000002119
25991,2022-08-29 13:55:00,1526.33,310897.16000000335,309113.5400000031,1783.6200000002282
25992,2022-08-29 14:00:00,1128.88,312026.04000000336,309113.5400000031,2912.500000000233
25993,2022-08-29 14:05:00,-999.14,311026.90000000334,309113.5400000031,1913.3600000002189
25994,2022-08-29 14:10:00,757.32,311784.22000000335,309113.5400000031,2670.680000000226
25995,2022-08-29 14:15:00,-555.51,311228.71000000334,309113.5400000031,2115.1700000002165
25996,2022-08-29 14:20:00,368.85,311597.5600000033,309113.5400000031,2484.0200000001932
25997,2022-08-29 14:25:00,1536.87,313134.4300000033,309113.5400000031,4020.8900000001886
25998,2022-08-29 14:30:00,-1421.63,311712.8000000033,309113.5400000031,2599.260000000184
25999,2022-08-29 14:35:00,-892.64,310820.1600000033,309113.5400000031,1706.62000000017
26000,2022-08-29 14:40:00,1099.49,311919.6500000033,309113.5400000031,2806.1100000001607
26001,2022-08-29 14:45:00,-875.51,311044.1400000033,309113.5400000031,1930.6000000001513
26002,2022-08-29 14:50:00,1523.49,312567.63000000326,309113.5400000031,3454.090000000142
26003,2022-08-29 14:55:00,1367.52,313935.1500000033,309113.5400000031,4821.610000000161
26004,2022-08-29 15:00:00,693.36,314628.51000000327,309113.5400000031,5514.970000000147
26005,2022-08-29 15:05:00,-21.13,314607.38000000326,309113.5400000031,5493.840000000142
26006,2022-08-29 15:10:00,-489.52,314117.86000000325,309113.5400000031,5004.320000000123
26007,2022-08-29 15:15:00,523.74,314641.60000000324,309113.5400000031,5528.060000000114
26008,2022-08-29 15:20:00,1635.33,316276.93000000325,309113.5400000031,7163.39000000013
26009,2022-08-29 15:25:00,668.92,316945.85000000324,309113.5400000031,7832.310000000114
26010,2022-08-29 15:30:00,-1925.87,315019.98000000324,309113.5400000031,5906.440000000119
26011,2022-08-29 15:35:00,44.55,315064.53000000323,309113.5400000031,5950.990000000107
26012,2022-08-29 15:40:00,71.49,315136.0200000032,309113.5400000031,6022.480000000098
26013,2022-08-29 15:45:00,-1083.18,314052.8400000032,309113.5400000031,4939.300000000105
26014,2022-08-29 15:50:00,-1603.43,312449.41000000323,309113.5400000031,3335.8700000001118
26015,2022-08-29 15:55:00,-1588.09,310861.3200000032,309113.5400000031,1747.7800000000861
26016,2022-08-29 16:00:00,-767.42,310093.9000000032,309113.5400000031,980.3600000001024
26017,2022-08-29 16:05:00,-835.96,309257.9400000032,309113.5400000031,144.4000000000815
26018,2022-08-29 16:10:00,1843.43,311101.3700000032,309113.5400000031,1987.8300000000745
26019,2022-08-29 16:15:00,19.83,311121.2000000032,309113.5400000031,2007.6600000000908
26020,2022-08-29 16:20:00,-598.72,310522.48000000324,309113.5400000031,1408.9400000001187
26021,2022-08-29 16:25:00,1186.51,311708.99000000325,309113.5400000031,2595.450000000128
26022,2022-08-29 16:30:00,-1778.5,309930.49000000325,309113.5400000031,816.9500000001281
26023,2022-08-29 16:35:00,1741.93,311672.42000000324,309113.5400000031,2558.880000000121
26024,2022-08-29 16:40:00,1540.56,313212.98000000324,309113.5400000031,4099.440000000119
26025,2022-08-29 16:45:00,842.52,314055.50000000326,309113.5400000031,4941.960000000137
26026,2022-08-29 16:50:00,832.06,314887.56000000326,309113.5400000031,5774.020000000135
26027,2022-08-29 16:55:00,-487.18,314400.38000000326,309113.5400000031,5286.840000000142
26028,2022-08-30 08:00:00,609.05,315009.43000000325,314400.38000000326,609.0499999999884
26029,2022-08-30 08:05:00,1993.64,317003.07000000327,314400.38000000326,2602.6900000000023
26030,2022-08-30 08:10:00,523.94,317527.01000000327,314400.38000000326,3126.6300000000047
26031,2022-08-30 08:15:00,881.04,318408.05000000325,314400.38000000326,4007.6699999999837
26032,2022-08-30 08:20:00,536.92,318944.97000000323,314400.38000000326,4544.589999999967
26033,2022-08-30 08:25:00,746.12,319691.0900000032,314400.38000000326,5290.709999999963
26034,2022-08-30 08:30:00,-1196.41,318494.68000000325,314400.38000000326,4094.2999999999884
26035,2022-08-30 08:35:00,1044.32,319539.00000000326,314400.38000000326,5138.619999999995
26036,2022-08-30 08:40:00,688.84,320227.8400000033,314400.38000000326,5827.460000000021
26037,2022-08-30 08:45:00,-957.75,319270.0900000033,314400.38000000326,4869.710000000021
26038,2022-08-30 08:50:00,30.05,319300.1400000033,314400.38000000326,4899.760000000009
26039,2022-08-30 08:55:00,1259.56,320559.7000000033,314400.38000000326,6159.320000000007
26040,2022-08-30 09:00:00,-1232.67,319327.0300000033,314400.38000000326,4926.650000000023
26041,2022-08-30 09:05:00,1957.48,321284.51000000327,314400.38000000326,6884.130000000005
26042,2022-08-30 09:10:00,-1077.52,320206.99000000325,314400.38000000326,5806.609999999986
26043,2022-08-30 09:15:00,1899.14,322106.13000000326,314400.38000000326,7705.75
26044,2022-08-30 09:20:00,-362.48,321743.6500000033,314400.38000000326,7343.270000000019
26045,2022-08-30 09:25:00,424.25,322167.9000000033,314400.38000000326,7767.520000000019
26046,2022-08-30 09:30:00,1536.57,323704.4700000033,314400.38000000326,9304.090000000026
26047,2022-08-30 09:35:00,467.3,324171.7700000033,314400.38000000326,9771.390000000014
26048,2022-08-30 09:40:00,1235.64,325407.4100000033,314400.38000000326,11007.030000000028
26049,2022-08-30 09:45:00,1644.74,327052.1500000033,314400.38000000326,12651.770000000019
26050,2022-08-30 09:50:00,1575.55,328627.7000000033,314400.38000000326,14227.320000000007
26051,2022-08-30 09:55:00,-816.01,327811.69000000326,314400.38000000326,13411.309999999998
26052,2022-08-30 10:00:00,-1282.56,326529.13000000326,314400.38000000326,12128.75
26053,2022-08-30 10:05:00,516.04,327045.17000000324,314400.38000000326,12644.789999999979
26054,2022-08-30 10:10:00,-699.56,326345.61000000325,314400.38000000326,11945.229999999981
26055,2022-08-30 10:15:00,-1803.46,324542.1500000032,314400.38000000326,10141.76999999996
26056,2022-08-30 10:20:00,1523.85,326066.0000000032,314400.38000000326,11665.619999999937
26057,2022-08-30 10:25:00,161.84,326227.8400000032,314400.38000000326,11827.459999999963
26058,2022-08-30 10:30:00,-36.41,326191.43000000325,314400.38000000326,11791.049999999988
26059,2022-08-30 10:35:00,-353.93,325837.50000000326,314400.38000000326,11437.119999999995
26060,2022-08-30 10:40:00,1389.01,327226.51000000327,314400.38000000326,12826.130000000005
26061,2022-08-30 10:45:00,1267.05,328493.56000000326,314400.38000000326,14093.179999999993
26062,2022-08-30 10:50:00,-777.47,327716.0900000033,314400.38000000326,13315.710000000021
26063,2022-08-30 10:55:00,1397.01,329113.1000000033,314400.38000000326,14712.72000000003
26064,2022-08-30 11:00:00,664.01,329777.1100000033,314400.38000000326,15376.73000000004
26065,2022-08-30 11:05:00,527.7,330304.8100000033,314400.38000000326,15904.430000000051
26066,2022-08-30 11:10:00,1831.83,332136.64000000333,314400.38000000326,17736.260000000068
26067,2022-08-30 11:15:00,493.1,332629.7400000033,314400.38000000326,18229.360000000044
26068,2022-08-30 11:20:00,638.9,333268.64000000333,314400.38000000326,18868.260000000068
26069,2022-08-30 11:25:00,1377.68,334646.3200000033,314400.38000000326,20245.94000000006
26070,2022-08-30 11:30:00,532.12,335178.4400000033,314400.38000000326,20778.060000000056
26071,2022-08-30 11:35:00,1405.56,336584.0000000033,314400.38000000326,22183.620000000054
26072,2022-08-30 11:40:00,-1137.11,335446.89000000333,314400.38000000326,21046.510000000068
26073,2022-08-30 11:45:00,-1544.65,333902.2400000033,314400.38000000326,19501.860000000044
26074,2022-08-30 11:50:00,-1869.16,332033.08000000333,314400.38000000326,17632.70000000007
26075,2022-08-30 11:55:00,-809.28,331223.8000000033,314400.38000000326,16823.420000000042
26076,2022-08-30 12:00:00,-1121.39,330102.4100000033,314400.38000000326,15702.030000000028
26077,2022-08-30 12:05:00,301.04,330403.4500000033,314400.38000000326,16003.070000000007
26078,2022-08-30 12:10:00,235.79,330639.24000000325,314400.38000000326,16238.859999999986
26079,2022-08-30 12:15:00,1657.17,332296.41000000323,314400.38000000326,17896.02999999997
26080,2022-08-30 12:20:00,-1008.47,331287.94000000326,314400.38000000326,16887.559999999998
26081,2022-08-30 12:25:00,369.18,331657.12000000325,314400.38000000326,17256.73999999999
26082,2022-08-30 12:30:00,-610.39,331046.73000000324,314400.38000000326,16646.349999999977
26083,2022-08-30 12:35:00,-1968.76,329077.97000000323,314400.38000000326,14677.589999999967
26084,2022-08-30 12:40:00,1893.59,330971.56000000326,314400.38000000326,16571.179999999993
26085,2022-08-30 12:45:00,1137.98,332109.54000000324,314400.38000000326,17709.159999999974
26086,2022-08-30 12:50:00,1984.55,334094.0900000032,314400.38000000326,19693.709999999963
26087,2022-08-30 12:55:00,1071.65,335165.74000000325,314400.38000000326,20765.359999999986
26088,2022-08-30 13:00:00,1163.89,336329.63000000326,314400.38000000326,21929.25
26089,2022-08-30 13:05:00,-1511.57,334818.06000000326,314400.38000000326,20417.679999999993
26090,2022-08-30 13:10:00,-1650.21,333167.85000000324,314400.38000000326,18767.469999999972
26091,2022-08-30 13:15:00,1293.05,334460.9000000032,314400.38000000326,20060.51999999996
26092,2022-08-30 13:20:00,-139.19,334321.7100000032,314400.38000000326,19921.329999999958
26093,2022-08-30 13:25:00,1951.63,336273.3400000032,314400.38000000326,21872.959999999963
26094,2022-08-30 13:30:00,-1672.48,334600.86000000325,314400.38000000326,20200.47999999998
26095,2022-08-30 13:35:00,61.19,334662.05000000325,314400.38000000326,20261.669999999984
26096,2022-08-30 13:40:00,-69.15,334592.9000000032,314400.38000000326,20192.51999999996
26097,2022-08-30 13:45:00,322.65,334915.55000000325,314400.38000000326,20515.169999999984
26098,2022-08-30 13:50:00,-1614.49,333301.06000000326,314400.38000000326,18900.679999999993
26099,2022-08-30 13:55:00,924.06,334225.12000000325,314400.38000000326,19824.73999999999
26100,2022-08-30 14:00:00,111.51,334336.63000000326,314400.38000000326,19936.25
26101,2022-08-30 14:05:00,-1979.34,332357.29000000324,314400.38000000326,17956.909999999974
26102,2022-08-30 14:10:00,1296.86,333654.1500000032,314400.38000000326,19253.76999999996
26103,2022-08-30 14:15:00,1481.82,335135.97000000323,314400.38000000326,20735.589999999967
26104,2022-08-30 14:20:00,-466.23,334669.74000000325,314400.38000000326,20269.359999999986
26105,2022-08-30 14:25:00,1701.68,336371.42000000324,314400.38000000326,21971.03999999998
26106,2022-08-30 14:30:00,-1545.41,334826.01000000327,314400.38000000326,20425.630000000005
26107,2022-08-30 14:35:00,-1414.1,333411.9100000033,314400.38000000326,19011.530000000028
26108,2022-08-30 14:40:00,1376.29,334788.2000000033,314400.38000000326,20387.820000000007
26109,2022-08-30 14:45:00,-1748.67,333039.5300000033,314400.38000000326,18639.150000000023
26110,2022-08-30 14:50:00,-337.82,332701.7100000033,314400.38000000326,18301.330000000016
26111,2022-08-30 14:55:00,-959.56,331742.1500000033,314400.38000000326,17341.77000000002
26112,2022-08-30 15:00:00,-697.19,331044.9600000033,314400.38000000326,16644.580000000016
26113,2022-08-30 15:05:00,611.41,331656.37000000325,314400.38000000326,17255.98999999999
26114,2022-08-30 15:10:00,-1758.39,329897.98000000324,314400.38000000326,15497.599999999977
26115,2022-08-30 15:15:00,1478.65,331376.63000000326,314400.38000000326,16976.25
26116,2022-08-30 15:20:00,-607.74,330768.8900000033,314400.38000000326,16368.51000000001
26117,2022-08-30 15:25:00,397.26,331166.1500000033,314400.38000000326,16765.77000000002
26118,2022-08-30 15:30:00,-1457.11,329709.0400000033,314400.38000000326,15308.660000000033
26119,2022-08-30 15:35:00,-1709.6,327999.4400000033,314400.38000000326,13599.060000000056
26120,2022-08-30 15:40:00,-211.45,327787.9900000033,314400.38000000326,13387.610000000044
26121,2022-08-30 15:45:00,-1465.29,326322.70000000333,314400.38000000326,11922.320000000065
26122,2022-08-30 15:50:00,-283.06,326039.64000000333,314400.38000000326,11639.260000000068
26123,2022-08-30 15:55:00,-700.73,325338.91000000335,314400.38000000326,10938.530000000086
26124,2022-08-30 16:00:00,418.45,325757.36000000336,314400.38000000326,11356.980000000098
26125,2022-08-30 16:05:00,789.28,326546.6400000034,314400.38000000326,12146.260000000126
26126,2022-08-30 16:10:00,192.12,326738.7600000034,314400.38000000326,12338.380000000121
26127,2022-08-30 16:15:00,164.63,326903.3900000034,314400.38000000326,12503.010000000126
26128,2022-08-30 16:20:00,-1053.8,325849.5900000034,314400.38000000326,11449.210000000137
26129,2022-08-30 16:25:00,-1.73,325847.8600000034,314400.38000000326,11447.480000000156
26130,2022-08-30 16:30:00,-74.86,325773.00000000343,314400.38000000326,11372.62000000017
26131,2022-08-30 16:35:00,-632.15,325140.8500000034,314400.38000000326,10740.470000000147
26132,2022-08-30 16:40:00,-246.18,324894.6700000034,314400.38000000326,10494.290000000154
26133,2022-08-30 16:45:00,1576.96,326471.63000000344,314400.38000000326,12071.250000000175
26134,2022-08-30 16:50:00,1012.65,327484.28000000346,314400.38000000326,13083.900000000198
26135,2022-08-30 16:55:00,-1170.73,326313.5500000035,314400.38000000326,11913.170000000217
26136,2022-08-31 08:00:00,1010.19,327323.7400000035,326313.5500000035,1010.1900000000023
26137,2022-08-31 08:05:00,551.61,327875.35000000347,326313.5500000035,1561.7999999999884
26138,2022-08-31 08:10:00,384.78,328260.1300000035,326313.5500000035,1946.5800000000163
26139,2022-08-31 08:15:00,478.15,328738.2800000035,326313.5500000035,2424.7300000000396
26140,2022-08-31 08:20:00,-299.2,328439.0800000035,326313.5500000035,2125.530000000028
26141,2022-08-31 08:25:00,-978.6,327460.48000000353,326313.5500000035,1146.9300000000512
26142,2022-08-31 08:30:00,365.66,327826.1400000035,326313.5500000035,1512.5900000000256
26143,2022-08-31 08:35:00,1996.88,329823.0200000035,326313.5500000035,3509.4700000000303
26144,2022-08-31 08:40:00,-1077.38,328745.6400000035,326313.5500000035,2432.0900000000256
26145,2022-08-31 08:45:00,309.19,329054.8300000035,326313.5500000035,2741.280000000028
26146,2022-08-31 08:50:00,225.41,329280.2400000035,326313.5500000035,2966.6900000000023
26147,2022-08-31 08:55:00,1634.23,330914.47000000346,326313.5500000035,4600.919999999984
26148,2022-08-31 09:00:00,-1920.78,328993.69000000344,326313.5500000035,2680.1399999999558
26149,2022-08-31 09:05:00,189.22,329182.9100000034,326313.5500000035,2869.359999999928
26150,2022-08-31 09:10:00,-967.66,328215.25000000343,326313.5500000035,1901.6999999999534
26151,2022-08-31 09:15:00,1518.62,329733.87000000343,326313.5500000035,3420.319999999949
26152,2022-08-31 09:20:00,-595.75,329138.12000000343,326313.5500000035,2824.569999999949
26153,2022-08-31 09:25:00,991.3,330129.4200000034,326313.5500000035,3815.869999999937
26154,2022-08-31 09:30:00,-881.91,329247.51000000344,326313.5500000035,2933.9599999999627
26155,2022-08-31 09:35:00,-1179.54,328067.97000000346,326313.5500000035,1754.4199999999837
26156,2022-08-31 09:40:00,187.83,328255.8000000035,326313.5500000035,1942.25
26157,2022-08-31 09:45:00,-1806.24,326449.5600000035,326313.5500000035,136.0100000000093
26158,2022-08-31 09:50:00,-1556.26,324893.3000000035,326313.5500000035,-1420.25
26159,2022-08-31 09:55:00,449.85,325343.15000000346,326313.5500000035,-970.4000000000233
26160,2022-08-31 10:00:00,211.83,325554.9800000035,326313.5500000035,-758.570000000007
26161,2022-08-31 10:05:00,1501.38,327056.3600000035,326313.5500000035,742.8099999999977
26162,2022-08-31 10:10:00,-1953.51,325102.85000000347,326313.5500000035,-1210.7000000000116
26163,2022-08-31 10:15:00,1753.63,326856.4800000035,326313.5500000035,542.929999999993
26164,2022-08-31 10:20:00,-558.71,326297.77000000345,326313.5500000035,-15.78000000002794
26165,2022-08-31 10:25:00,1239.74,327537.51000000344,326313.5500000035,1223.9599999999627
26166,2022-08-31 10:30:00,-1778.33,325759.1800000034,326313.5500000035,-554.3700000000536
26167,2022-08-31 10:35:00,929.08,326688.26000000344,326313.5500000035,374.70999999996275
26168,2022-08-31 10:40:00,-1690.91,324997.35000000347,326313.5500000035,-1316.2000000000116
26169,2022-08-31 10:45:00,614.74,325612.09000000346,326313.5500000035,-701.460000000021
26170,2022-08-31 10:50:00,671.06,326283.15000000346,326313.5500000035,-30.400000000023283
26171,2022-08-31 10:55:00,-849.34,325433.81000000343,326313.5500000035,-879.7400000000489
26172,2022-08-31 11:00:00,1454.86,326888.6700000034,326313.5500000035,575.1199999999371
26173,2022-08-31 11:05:00,-1492.17,325396.50000000343,326313.5500000035,-917.0500000000466
26174,2022-08-31 11:10:00,1222.03,326618.53000000346,326313.5500000035,304.9799999999814
26175,2022-08-31 11:15:00,1775.79,328394.32000000344,326313.5500000035,2080.7699999999604
26176,2022-08-31 11:20:00,-17.98,328376.34000000346,326313.5500000035,2062.789999999979
26177,2022-08-31 11:25:00,-241.34,328135.00000000343,326313.5500000035,1821.4499999999534
26178,2022-08-31 11:30:00,1048.58,329183.58000000345,326313.5500000035,2870.0299999999697
26179,2022-08-31 11:35:00,854.14,330037.72000000346,326313.5500000035,3724.1699999999837
26180,2022-08-31 11:40:00,-758.69,329279.03000000346,326313.5500000035,2965.4799999999814
26181,2022-08-31 11:45:00,1955.89,331234.9200000035,326313.5500000035,4921.369999999995
26182,2022-08-31 11:50:00,-764.78,330470.14000000345,326313.5500000035,4156.589999999967
26183,2022-08-31 11:55:00,117.94,330588.08000000345,326313.5500000035,4274.52999999997
26184,2022-08-31 12:00:00,-476.04,330112.0400000035,326313.5500000035,3798.4899999999907
26185,2022-08-31 12:05:00,-1789.81,328322.2300000035,326313.5500000035,2008.679999999993
26186,2022-08-31 12:10:00,-454.19,327868.0400000035,326313.5500000035,1554.4899999999907
26187,2022-08-31 12:15:00,-397.87,327470.1700000035,326313.5500000035,1156.6199999999953
26188,2022-08-31 12:20:00,799.1,328269.27000000345,326313.5500000035,1955.719999999972
26189,2022-08-31 12:25:00,-843.32,327425.95000000345,326313.5500000035,1112.399999999965
26190,2022-08-31 12:30:00,605.06,328031.01000000344,326313.5500000035,1717.4599999999627
26191,2022-08-31 12:35:00,886.61,328917.62000000343,326313.5500000035,2604.069999999949
26192,2022-08-31 12:40:00,95.69,329013.31000000343,326313.5500000035,2699.759999999951
26193,2022-08-31 12:45:00,-1657.35,327355.96000000346,326313.5500000035,1042.4099999999744
26194,2022-08-31 12:50:00,-817.6,326538.3600000035,326313.5500000035,224.80999999999767
26195,2022-08-31 12:55:00,1575.67,328114.03000000346,326313.5500000035,1800.4799999999814
26196,2022-08-31 13:00:00,780.25,328894.28000000346,326313.5500000035,2580.7299999999814
26197,2022-08-31 13:05:00,-1984.19,326910.09000000346,326313.5500000035,596.539999999979
26198,2022-08-31 13:10:00,1441.05,328351.14000000345,326313.5500000035,2037.5899999999674
26199,2022-08-31 13:15:00,-74.44,328276.70000000345,326313.5500000035,1963.149999999965
26200,2022-08-31 13:20:00,1123.02,329399.72000000346,326313.5500000035,3086.1699999999837
26201,2022-08-31 13:25:00,649.67,330049.39000000345,326313.5500000035,3735.8399999999674
26202,2022-08-31 13:30:00,874.32,330923.71000000346,326313.5500000035,4610.159999999974
26203,2022-08-31 13:35:00,-573.29,330350.4200000035,326313.5500000035,4036.8699999999953
26204,2022-08-31 13:40:00,-1127.18,329223.2400000035,326313.5500000035,2909.6900000000023
26205,2022-08-31 13:45:00,1943.64,331166.8800000035,326313.5500000035,4853.330000000016
26206,2022-08-31 13:50:00,325.05,331491.9300000035,326313.5500000035,5178.380000000005
26207,2022-08-31 13:55:00,758.42,332250.35000000347,326313.5500000035,5936.799999999988
26208,2022-08-31 14:00:00,-971.95,331278.40000000346,326313.5500000035,4964.849999999977
26209,2022-08-31 14:05:00,754.89,332033.2900000035,326313.5500000035,5719.739999999991
26210,2022-08-31 14:10:00,-1678.56,330354.7300000035,326313.5500000035,4041.179999999993
26211,2022-08-31 14:15:00,1070.06,331424.7900000035,326313.5500000035,5111.239999999991
26212,2022-08-31 14:20:00,-169.69,331255.10000000347,326313.5500000035,4941.549999999988
26213,2022-08-31 14:25:00,-1613.72,329641.3800000035,326313.5500000035,3327.8300000000163
26214,2022-08-31 14:30:00,1781.64,331423.0200000035,326313.5500000035,5109.47000000003
26215,2022-08-31 14:35:00,800.0,332223.0200000035,326313.5500000035,5909.47000000003
26216,2022-08-31 14:40:00,-1400.27,330822.7500000035,326313.5500000035,4509.200000000012
26217,2022-08-31 14:45:00,-752.8,330069.9500000035,326313.5500000035,3756.4000000000233
26218,2022-08-31 14:50:00,-170.56,329899.3900000035,326313.5500000035,3585.8400000000256
26219,2022-08-31 14:55:00,644.86,330544.2500000035,326313.5500000035,4230.700000000012
26220,2022-08-31 15:00:00,1486.93,332031.1800000035,326313.5500000035,5717.630000000005
26221,2022-08-31 15:05:00,-1798.27,330232.91000000347,326313.5500000035,3919.359999999986
26222,2022-08-31 15:10:00,811.42,331044.33000000345,326313.5500000035,4730.77999999997
26223,2022-08-31 15:15:00,-391.35,330652.9800000035,326313.5500000035,4339.429999999993
26224,2022-08-31 15:20:00,-1179.38,329473.60000000347,326313.5500000035,3160.0499999999884
26225,2022-08-31 15:25:00,872.13,330345.7300000035,326313.5500000035,4032.179999999993
26226,2022-08-31 15:30:00,-1128.02,329217.71000000346,326313.5500000035,2904.1599999999744
26227,2022-08-31 15:35:00,-617.9,328599.81000000343,326313.5500000035,2286.259999999951
26228,2022-08-31 15:40:00,-325.73,328274.08000000345,326313.5500000035,1960.5299999999697
26229,2022-08-31 15:45:00,-567.85,327706.2300000035,326313.5500000035,1392.679999999993
26230,2022-08-31 15:50:00,-1625.31,326080.9200000035,326313.5500000035,-232.63000000000466
26231,2022-08-31 15:55:00,-578.6,325502.3200000035,326313.5500000035,-811.2299999999814
26232,2022-08-31 16:00:00,-1745.61,323756.7100000035,326313.5500000035,-2556.8399999999674
26233,2022-08-31 16:05:00,12.41,323769.1200000035,326313.5500000035,-2544.429999999993
26234,2022-08-31 16:10:00,-1988.23,321780.8900000035,326313.5500000035,-4532.659999999974
26235,2022-08-31 16:15:00,415.13,322196.0200000035,326313.5500000035,-4117.52999999997
26236,2022-08-31 16:20:00,1465.93,323661.9500000035,326313.5500000035,-2651.5999999999767
26237,2022-08-31 16:25:00,1626.48,325288.4300000035,326313.5500000035,-1025.1199999999953
26238,2022-08-31 16:30:00,-1649.83,323638.60000000347,326313.5500000035,-2674.9500000000116
26239,2022-08-31 16:35:00,-1805.22,321833.3800000035,326313.5500000035,-4480.169999999984
26240,2022-08-31 16:40:00,44.56,321877.9400000035,326313.5500000035,-4435.609999999986
26241,2022-08-31 16:45:00,425.53,322303.4700000035,326313.5500000035,-4010.079999999958
26242,2022-08-31 16:50:00,-788.26,321515.2100000035,326313.5500000035,-4798.339999999967
26243,2022-08-31 16:55:00,1012.41,322527.6200000035,326313.5500000035,-3785.929999999993
26244,2022-09-01 08:00:00,812.05,323339.6700000035,322527.6200000035,812.0499999999884
26245,2022-09-01 08:05:00,-1154.02,322185.65000000346,322527.6200000035,-341.97000000003027
26246,2022-09-01 08:10:00,1376.93,323562.58000000345,322527.6200000035,1034.9599999999627
26247,2022-09-01 08:15:00,598.8,324161.38000000344,322527.6200000035,1633.759999999951
26248,2022-09-01 08:20:00,828.7,324990.08000000345,322527.6200000035,2462.4599999999627
26249,2022-09-01 08:25:00,-1898.3,323091.78000000346,322527.6200000035,564.1599999999744
26250,2022-09-01 08:30:00,-1671.33,321420.45000000345,322527.6200000035,-1107.170000000042
26251,2022-09-01 08:35:00,-1756.92,319663.53000000346,322527.6200000035,-2864.0900000000256
26252,2022-09-01 08:40:00,-1672.7,317990.83000000345,322527.6200000035,-4536.790000000037
26253,2022-09-01 08:45:00,163.18,318154.01000000344,322527.6200000035,-4373.610000000044
26254,2022-09-01 08:50:00,1943.4,320097.41000000347,322527.6200000035,-2430.210000000021
26255,2022-09-01 08:55:00,-1266.43,318830.9800000035,322527.6200000035,-3696.640000000014
26256,2022-09-01 09:00:00,-180.61,318650.3700000035,322527.6200000035,-3877.25
26257,2022-09-01 09:05:00,1659.27,320309.6400000035,322527.6200000035,-2217.9799999999814
26258,2022-09-01 09:10:00,-1124.14,319185.5000000035,322527.6200000035,-3342.1199999999953
26259,2022-09-01 09:15:00,-45.36,319140.1400000035,322527.6200000035,-3387.4799999999814
26260,2022-09-01 09:20:00,1829.19,320969.3300000035,322527.6200000035,-1558.289999999979
26261,2022-09-01 09:25:00,-1103.07,319866.2600000035,322527.6200000035,-2661.359999999986
26262,2022-09-01 09:30:00,-891.52,318974.7400000035,322527.6200000035,-3552.8800000000047
26263,2022-09-01 09:35:00,-1283.31,317691.4300000035,322527.6200000035,-4836.190000000002
26264,2022-09-01 09:40:00,665.51,318356.9400000035,322527.6200000035,-4170.679999999993
26265,2022-09-01 09:45:00,359.81,318716.7500000035,322527.6200000035,-3810.8699999999953
26266,2022-09-01 09:50:00,-1206.4,317510.35000000347,322527.6200000035,-5017.270000000019
26267,2022-09-01 09:55:00,-702.29,316808.0600000035,322527.6200000035,-5719.559999999998
26268,2022-09-01 10:00:00,-45.66,316762.4000000035,322527.6200000035,-5765.219999999972
26269,2022-09-01 10:05:00,742.19,317504.5900000035,322527.6200000035,-5023.02999999997
26270,2022-09-01 10:10:00,-1412.59,316092.0000000035,322527.6200000035,-6435.619999999995
26271,2022-09-01 10:15:00,787.88,316879.8800000035,322527.6200000035,-5647.739999999991
26272,2022-09-01 10:20:00,-1303.27,315576.6100000035,322527.6200000035,-6951.010000000009
26273,2022-09-01 10:25:00,-627.23,314949.3800000035,322527.6200000035,-7578.239999999991
26274,2022-09-01 10:30:00,589.17,315538.5500000035,322527.6200000035,-6989.070000000007
26275,2022-09-01 10:35:00,-158.46,315380.09000000346,322527.6200000035,-7147.530000000028
26276,2022-09-01 10:40:00,949.19,316329.28000000346,322527.6200000035,-6198.340000000026
26277,2022-09-01 10:45:00,-1954.47,314374.8100000035,322527.6200000035,-8152.809999999998
26278,2022-09-01 10:50:00,809.38,315184.1900000035,322527.6200000035,-7343.429999999993
26279,2022-09-01 10:55:00,-1522.86,313661.3300000035,322527.6200000035,-8866.289999999979
26280,2022-09-01 11:00:00,1946.83,315608.1600000035,322527.6200000035,-6919.459999999963
26281,2022-09-01 11:05:00,1639.98,317248.1400000035,322527.6200000035,-5279.479999999981
26282,2022-09-01 11:10:00,-174.03,317074.1100000035,322527.6200000035,-5453.510000000009
26283,2022-09-01 11:15:00,1167.63,318241.7400000035,322527.6200000035,-4285.880000000005
26284,2022-09-01 11:20:00,461.81,318703.5500000035,322527.6200000035,-3824.070000000007
26285,2022-09-01 11:25:00,266.79,318970.34000000346,322527.6200000035,-3557.280000000028
26286,2022-09-01 11:30:00,1420.54,320390.88000000344,322527.6200000035,-2136.740000000049
26287,2022-09-01 11:35:00,1086.08,321476.96000000346,322527.6200000035,-1050.6600000000326
26288,2022-09-01 11:40:00,-1417.86,320059.10000000347,322527.6200000035,-2468.5200000000186
26289,2022-09-01 11:45:00,-1705.5,318353.60000000347,322527.6200000035,-4174.020000000019
26290,2022-09-01 11:50:00,-1793.53,316560.07000000344,322527.6200000035,-5967.550000000047
26291,2022-09-01 11:55:00,644.04,317204.1100000034,322527.6200000035,-5323.5100000000675
26292,2022-09-01 12:00:00,-790.42,316413.69000000344,322527.6200000035,-6113.930000000051
26293,2022-09-01 12:05:00,-1601.29,314812.40000000346,322527.6200000035,-7715.22000000003
26294,2022-09-01 12:10:00,-860.37,313952.03000000346,322527.6200000035,-8575.590000000026
26295,2022-09-01 12:15:00,-1939.12,312012.91000000347,322527.6200000035,-10514.710000000021
26296,2022-09-01 12:20:00,-1815.5,310197.41000000347,322527.6200000035,-12330.210000000021
26297,2022-09-01 12:25:00,1179.13,311376.5400000035,322527.6200000035,-11151.080000000016
26298,2022-09-01 12:30:00,-1141.56,310234.9800000035,322527.6200000035,-12292.640000000014
26299,2022-09-01 12:35:00,541.27,310776.2500000035,322527.6200000035,-11751.369999999995
26300,2022-09-01 12:40:00,-403.31,310372.9400000035,322527.6200000035,-12154.679999999993
26301,2022-09-01 12:45:00,1203.62,311576.5600000035,322527.6200000035,-10951.059999999998
26302,2022-09-01 12:50:00,-1753.12,309823.4400000035,322527.6200000035,-12704.179999999993
26303,2022-09-01 12:55:00,-101.9,309721.5400000035,322527.6200000035,-12806.080000000016
26304,2022-09-01 13:00:00,-501.23,309220.3100000035,322527.6200000035,-13307.309999999998
26305,2022-09-01 13:05:00,953.02,310173.3300000035,322527.6200000035,-12354.289999999979
26306,2022-09-01 13:10:00,1615.19,311788.5200000035,322527.6200000035,-10739.099999999977
26307,2022-09-01 13:15:00,1476.31,313264.8300000035,322527.6200000035,-9262.789999999979
26308,2022-09-01 13:20:00,-1372.77,311892.0600000035,322527.6200000035,-10635.559999999998
26309,2022-09-01 13:25:00,-284.76,311607.3000000035,322527.6200000035,-10920.320000000007
26310,2022-09-01 13:30:00,-59.42,311547.8800000035,322527.6200000035,-10979.73999999999
26311,2022-09-01 13:35:00,843.17,312391.0500000035,322527.6200000035,-10136.570000000007
26312,2022-09-01 13:40:00,144.65,312535.7000000035,322527.6200000035,-9991.919999999984
26313,2022-09-01 13:45:00,569.11,313104.8100000035,322527.6200000035,-9422.809999999998
26314,2022-09-01 13:50:00,137.91,313242.72000000346,322527.6200000035,-9284.900000000023
26315,2022-09-01 13:55:00,-613.31,312629.41000000347,322527.6200000035,-9898.210000000021
26316,2022-09-01 14:00:00,-281.56,312347.85000000347,322527.6200000035,-10179.770000000019
26317,2022-09-01 14:05:00,-1405.73,310942.1200000035,322527.6200000035,-11585.5
26318,2022-09-01 14:10:00,-960.06,309982.0600000035,322527.6200000035,-12545.559999999998
26319,2022-09-01 14:15:00,-1527.6,308454.4600000035,322527.6200000035,-14073.159999999974
26320,2022-09-01 14:20:00,-250.09,308204.3700000035,322527.6200000035,-14323.25
26321,2022-09-01 14:25:00,1093.95,309298.3200000035,322527.6200000035,-13229.299999999988
26322,2022-09-01 14:30:00,-290.61,309007.7100000035,322527.6200000035,-13519.909999999974
26323,2022-09-01 14:35:00,-1485.93,307521.7800000035,322527.6200000035,-15005.839999999967
26324,2022-09-01 14:40:00,-475.45,307046.3300000035,322527.6200000035,-15481.289999999979
26325,2022-09-01 14:45:00,-1617.67,305428.6600000035,322527.6200000035,-17098.959999999963
26326,2022-09-01 14:50:00,-144.46,305284.2000000035,322527.6200000035,-17243.419999999984
26327,2022-09-01 14:55:00,527.94,305812.1400000035,322527.6200000035,-16715.47999999998
26328,2022-09-01 15:00:00,-339.23,305472.9100000035,322527.6200000035,-17054.709999999963
26329,2022-09-01 15:05:00,1371.06,306843.9700000035,322527.6200000035,-15683.649999999965
26330,2022-09-01 15:10:00,-1813.69,305030.2800000035,322527.6200000035,-17497.339999999967
26331,2022-09-01 15:15:00,1282.65,306312.93000000354,322527.6200000035,-16214.689999999944
26332,2022-09-01 15:20:00,-679.65,305633.2800000035,322527.6200000035,-16894.339999999967
26333,2022-09-01 15:25:00,458.44,306091.7200000035,322527.6200000035,-16435.899999999965
26334,2022-09-01 15:30:00,306.53,306398.25000000355,322527.6200000035,-16129.369999999937
26335,2022-09-01 15:35:00,-164.63,306233.62000000355,322527.6200000035,-16293.999999999942
26336,2022-09-01 15:40:00,-1023.81,305209.81000000355,322527.6200000035,-17317.80999999994
26337,2022-09-01 15:45:00,-435.5,304774.31000000355,322527.6200000035,-17753.30999999994
26338,2022-09-01 15:50:00,556.06,305330.37000000355,322527.6200000035,-17197.24999999994
26339,2022-09-01 15:55:00,1398.41,306728.7800000035,322527.6200000035,-15798.839999999967
26340,2022-09-01 16:00:00,901.63,307630.4100000035,322527.6200000035,-14897.209999999963
26341,2022-09-01 16:05:00,-539.19,307091.2200000035,322527.6200000035,-15436.399999999965
26342,2022-09-01 16:10:00,-740.82,306350.4000000035,322527.6200000035,-16177.219999999972
26343,2022-09-01 16:15:00,551.73,306902.1300000035,322527.6200000035,-15625.48999999999
26344,2022-09-01 16:20:00,-295.69,306606.4400000035,322527.6200000035,-15921.179999999993
26345,2022-09-01 16:25:00,-1087.39,305519.0500000035,322527.6200000035,-17008.570000000007
26346,2022-09-01 16:30:00,693.78,306212.8300000035,322527.6200000035,-16314.789999999979
26347,2022-09-01 16:35:00,-1100.22,305112.61000000354,322527.6200000035,-17415.00999999995
26348,2022-09-01 16:40:00,476.55,305589.1600000035,322527.6200000035,-16938.459999999963
26349,2022-09-01 16:45:00,1089.41,306678.5700000035,322527.6200000035,-15849.049999999988
26350,2022-09-01 16:50:00,-1962.3,304716.2700000035,322527.6200000035,-17811.349999999977
26351,2022-09-01 16:55:00,-797.86,303918.4100000035,322527.6200000035,-18609.209999999963
26352,2022-09-02 08:00:00,-1832.66,302085.75000000355,303918.4100000035,-1832.6599999999744
26353,2022-09-02 08:05:00,-1996.26,300089.49000000354,303918.4100000035,-3828.9199999999837
26354,2022-09-02 08:10:00,1692.52,301782.01000000356,303918.4100000035,-2136.399999999965
26355,2022-09-02 08:15:00,725.16,302507.17000000353,303918.4100000035,-1411.2399999999907
26356,2022-09-02 08:20:00,1859.07,304366.24000000354,303918.4100000035,447.8300000000163
26357,2022-09-02 08:25:00,-359.11,304007.13000000356,303918.4100000035,88.72000000003027
26358,2022-09-02 08:30:00,1635.02,305642.1500000036,303918.4100000035,1723.740000000049
26359,2022-09-02 08:35:00,1693.81,307335.9600000036,303918.4100000035,3417.5500000000466
26360,2022-09-02 08:40:00,1338.09,308674.0500000036,303918.4100000035,4755.640000000072
26361,2022-09-02 08:45:00,959.15,309633.2000000036,303918.4100000035,5714.7900000000955
26362,2022-09-02 08:50:00,-1586.91,308046.29000000365,303918.4100000035,4127.880000000121
26363,2022-09-02 08:55:00,-1636.49,306409.80000000366,303918.4100000035,2491.3900000001304
26364,2022-09-02 09:00:00,-1283.3,305126.50000000367,303918.4100000035,1208.090000000142
26365,2022-09-02 09:05:00,888.79,306015.29000000365,303918.4100000035,2096.880000000121
26366,2022-09-02 09:10:00,-1316.58,304698.71000000363,303918.4100000035,780.3000000001048
26367,2022-09-02 09:15:00,-52.35,304646.36000000365,303918.4100000035,727.9500000001281
26368,2022-09-02 09:20:00,-236.94,304409.42000000365,303918.4100000035,491.01000000012573
26369,2022-09-02 09:25:00,-203.64,304205.78000000364,303918.4100000035,287.37000000011176
26370,2022-09-02 09:30:00,1170.65,305376.43000000366,303918.4100000035,1458.020000000135
26371,2022-09-02 09:35:00,-266.4,305110.03000000364,303918.4100000035,1191.6200000001118
26372,2022-09-02 09:40:00,1981.43,307091.46000000363,303918.4100000035,3173.050000000105
26373,2022-09-02 09:45:00,-1223.46,305868.0000000036,303918.4100000035,1949.5900000000838
26374,2022-09-02 09:50:00,979.69,306847.6900000036,303918.4100000035,2929.280000000086
26375,2022-09-02 09:55:00,1214.78,308062.47000000364,303918.4100000035,4144.060000000114
26376,2022-09-02 10:00:00,-1887.34,306175.1300000036,303918.4100000035,2256.7200000000885
26377,2022-09-02 10:05:00,1885.45,308060.5800000036,303918.4100000035,4142.1700000001
26378,2022-09-02 10:10:00,-234.63,307825.9500000036,303918.4100000035,3907.5400000000955
26379,2022-09-02 10:15:00,1189.54,309015.4900000036,303918.4100000035,5097.0800000000745
26380,2022-09-02 10:20:00,1288.41,310303.9000000036,303918.4100000035,6385.490000000049
26381,2022-09-02 10:25:00,1877.47,312181.37000000355,303918.4100000035,8262.960000000021
26382,2022-09-02 10:30:00,1395.89,313577.26000000356,303918.4100000035,9658.850000000035
26383,2022-09-02 10:35:00,-1482.96,312094.30000000354,303918.4100000035,8175.890000000014
26384,2022-09-02 10:40:00,1557.54,313651.8400000035,303918.4100000035,9733.429999999993
26385,2022-09-02 10:45:00,1415.02,315066.86000000354,303918.4100000035,11148.450000000012
26386,2022-09-02 10:50:00,-1886.74,313180.12000000355,303918.4100000035,9261.710000000021
26387,2022-09-02 10:55:00,-1006.75,312173.37000000355,303918.4100000035,8254.960000000021
26388,2022-09-02 11:00:00,1530.69,313704.06000000355,303918.4100000035,9785.650000000023
26389,2022-09-02 11:05:00,1532.27,315236.33000000357,303918.4100000035,11317.920000000042
26390,2022-09-02 11:10:00,-1777.29,313459.0400000036,303918.4100000035,9540.630000000063
26391,2022-09-02 11:15:00,-979.99,312479.0500000036,303918.4100000035,8560.640000000072
26392,2022-09-02 11:20:00,-266.3,312212.7500000036,303918.4100000035,8294.340000000084
26393,2022-09-02 11:25:00,-946.55,311266.2000000036,303918.4100000035,7347.7900000000955
26394,2022-09-02 11:30:00,606.03,311872.23000000365,303918.4100000035,7953.820000000123
26395,2022-09-02 11:35:00,-1878.77,309993.46000000363,303918.4100000035,6075.050000000105
26396,2022-09-02 11:40:00,542.91,310536.3700000036,303918.4100000035,6617.960000000079
26397,2022-09-02 11:45:00,-662.66,309873.71000000363,303918.4100000035,5955.300000000105
26398,2022-09-02 11:50:00,669.79,310543.5000000036,303918.4100000035,6625.090000000084
26399,2022-09-02 11:55:00,1590.51,312134.0100000036,303918.4100000035,8215.600000000093
26400,2022-09-02 12:00:00,-1017.97,311116.04000000365,303918.4100000035,7197.630000000121
26401,2022-09-02 12:05:00,-280.93,310835.11000000365,303918.4100000035,6916.700000000128
26402,2022-09-02 12:10:00,598.98,311434.09000000363,303918.4100000035,7515.680000000109
26403,2022-09-02 12:15:00,-98.72,311335.37000000366,303918.4100000035,7416.960000000137
26404,2022-09-02 12:20:00,1407.3,312742.67000000365,303918.4100000035,8824.260000000126
26405,2022-09-02 12:25:00,1082.7,313825.37000000366,303918.4100000035,9906.960000000137
26406,2022-09-02 12:30:00,1824.28,315649.6500000037,303918.4100000035,11731.240000000165
26407,2022-09-02 12:35:00,-1736.92,313912.7300000037,303918.4100000035,9994.320000000182
26408,2022-09-02 12:40:00,-1830.11,312082.6200000037,303918.4100000035,8164.210000000196
26409,2022-09-02 12:45:00,-731.44,311351.1800000037,303918.4100000035,7432.770000000193
26410,2022-09-02 12:50:00,-1553.39,309797.7900000037,303918.4100000035,5879.380000000179
26411,2022-09-02 12:55:00,-1906.76,307891.0300000037,303918.4100000035,3972.62000000017
26412,2022-09-02 13:00:00,-1632.24,306258.7900000037,303918.4100000035,2340.3800000001793
26413,2022-09-02 13:05:00,-1270.64,304988.1500000037,303918.4100000035,1069.7400000001653
26414,2022-09-02 13:10:00,1310.04,306298.19000000367,303918.4100000035,2379.7800000001444
26415,2022-09-02 13:15:00,-95.74,306202.4500000037,303918.4100000035,2284.0400000001537
26416,2022-09-02 13:20:00,1596.23,307798.68000000366,303918.4100000035,3880.270000000135
26417,2022-09-02 13:25:00,-1118.93,306679.75000000367,303918.4100000035,2761.340000000142
26418,2022-09-02 13:30:00,-510.38,306169.37000000366,303918.4100000035,2250.9600000001374
26419,2022-09-02 13:35:00,-1770.81,304398.56000000366,303918.4100000035,480.1500000001397
26420,2022-09-02 13:40:00,1751.8,306150.36000000365,303918.4100000035,2231.950000000128
26421,2022-09-02 13:45:00,1954.33,308104.69000000367,303918.4100000035,4186.280000000144
26422,2022-09-02 13:50:00,276.76,308381.4500000037,303918.4100000035,4463.040000000154
26423,2022-09-02 13:55:00,-1287.23,307094.2200000037,303918.4100000035,3175.8100000001723
26424,2022-09-02 14:00:00,1872.31,308966.5300000037,303918.4100000035,5048.12000000017
26425,2022-09-02 14:05:00,597.61,309564.1400000037,303918.4100000035,5645.730000000156
26426,2022-09-02 14:10:00,-764.18,308799.9600000037,303918.4100000035,4881.550000000163
26427,2022-09-02 14:15:00,784.49,309584.4500000037,303918.4100000035,5666.040000000154
26428,2022-09-02 14:20:00,-309.1,309275.3500000037,303918.4100000035,5356.940000000177
26429,2022-09-02 14:25:00,645.21,309920.5600000037,303918.4100000035,6002.150000000198
26430,2022-09-02 14:30:00,1319.51,311240.07000000373,303918.4100000035,7321.660000000207
26431,2022-09-02 14:35:00,-237.31,311002.76000000373,303918.4100000035,7084.35000000021
26432,2022-09-02 14:40:00,1960.02,312962.78000000375,303918.4100000035,9044.370000000228
26433,2022-09-02 14:45:00,-480.04,312482.7400000038,303918.4100000035,8564.33000000025
26434,2022-09-02 14:50:00,1966.55,314449.29000000376,303918.4100000035,10530.880000000237
26435,2022-09-02 14:55:00,1211.06,315660.35000000376,303918.4100000035,11741.940000000235
26436,2022-09-02 15:00:00,-1408.59,314251.76000000373,303918.4100000035,10333.35000000021
26437,2022-09-02 15:05:00,185.7,314437.46000000375,303918.4100000035,10519.050000000221
26438,2022-09-02 15:10:00,782.06,315219.52000000374,303918.4100000035,11301.110000000219
26439,2022-09-02 15:15:00,-621.49,314598.03000000375,303918.4100000035,10679.620000000228
26440,2022-09-02 15:20:00,-884.66,313713.3700000038,303918.4100000035,9794.960000000254
26441,2022-09-02 15:25:00,1053.52,314766.8900000038,303918.4100000035,10848.480000000272
26442,2022-09-02 15:30:00,-49.66,314717.2300000038,303918.4100000035,10798.820000000298
26443,2022-09-02 15:35:00,-1128.26,313588.9700000038,303918.4100000035,9670.560000000289
26444,2022-09-02 15:40:00,873.55,314462.5200000038,303918.4100000035,10544.110000000277
26445,2022-09-02 15:45:00,138.13,314600.6500000038,303918.4100000035,10682.240000000282
26446,2022-09-02 15:50:00,235.66,314836.3100000038,303918.4100000035,10917.900000000256
26447,2022-09-02 15:55:00,-1890.94,312945.3700000038,303918.4100000035,9026.960000000254
26448,2022-09-02 16:00:00,-878.1,312067.2700000038,303918.4100000035,8148.860000000277
26449,2022-09-02 16:05:00,1718.73,313786.0000000038,303918.4100000035,9867.590000000258
26450,2022-09-02 16:10:00,1505.13,315291.1300000038,303918.4100000035,11372.720000000263
26451,2022-09-02 16:15:00,1295.27,316586.4000000038,303918.4100000035,12667.990000000282
26452,2022-09-02 16:20:00,-495.86,316090.5400000038,303918.4100000035,12172.130000000296
26453,2022-09-02 16:25:00,-198.3,315892.24000000383,303918.4100000035,11973.830000000307
26454,2022-09-02 16:30:00,1180.98,317073.2200000038,303918.4100000035,13154.810000000289
26455,2022-09-02 16:35:00,-1126.7,315946.5200000038,303918.4100000035,12028.110000000277
26456,2022-09-02 16:40:00,-1139.57,314806.9500000038,303918.4100000035,10888.54000000027
26457,2022-09-02 16:45:00,-1221.33,313585.6200000038,303918.4100000035,9667.210000000254
26458,2022-09-02 16:50:00,524.37,314109.9900000038,303918.4100000035,10191.58000000025
26459,2022-09-02 16:55:00,-1095.59,313014.40000000375,303918.4100000035,9095.990000000224
26460,2022-09-03 08:00:00,-508.41,312505.9900000038,313014.40000000375,-508.4099999999744
26461,2022-09-03 08:05:00,417.72,312923.71000000375,313014.40000000375,-90.69000000000233
26462,2022-09-03 08:10:00,-1896.89,311026.82000000373,313014.40000000375,-1987.5800000000163
26463,2022-09-03 08:15:00,138.89,311165.71000000375,313014.40000000375,-1848.6900000000023
26464,2022-09-03 08:20:00,182.84,311348.5500000038,313014.40000000375,-1665.8499999999767
26465,2022-09-03 08:25:00,382.65,311731.2000000038,313014.40000000375,-1283.1999999999534
26466,2022-09-03 08:30:00,-1334.44,310396.7600000038,313014.40000000375,-2617.6399999999558
26467,2022-09-03 08:35:00,-1675.29,308721.4700000038,313014.40000000375,-4292.929999999935
26468,2022-09-03 08:40:00,-41.16,308680.31000000384,313014.40000000375,-4334.089999999909
26469,2022-09-03 08:45:00,-565.16,308115.15000000386,313014.40000000375,-4899.249999999884
26470,2022-09-03 08:50:00,-76.98,308038.1700000039,313014.40000000375,-4976.229999999865
26471,2022-09-03 08:55:00,1070.31,309108.4800000039,313014.40000000375,-3905.9199999998673
26472,2022-09-03 09:00:00,-1004.95,308103.53000000387,313014.40000000375,-4910.869999999879
26473,2022-09-03 09:05:00,-258.02,307845.51000000385,313014.40000000375,-5168.889999999898
26474,2022-09-03 09:10:00,-723.59,307121.9200000038,313014.40000000375,-5892.479999999923
26475,2022-09-03 09:15:00,-1894.71,305227.2100000038,313014.40000000375,-7787.189999999944
26476,2022-09-03 09:20:00,-983.93,304243.2800000038,313014.40000000375,-8771.119999999937
26477,2022-09-03 09:25:00,-43.27,304200.0100000038,313014.40000000375,-8814.389999999956
26478,2022-09-03 09:30:00,1430.22,305630.23000000376,313014.40000000375,-7384.169999999984
26479,2022-09-03 09:35:00,-351.31,305278.92000000377,313014.40000000375,-7735.479999999981
26480,2022-09-03 09:40:00,180.85,305459.77000000374,313014.40000000375,-7554.630000000005
26481,2022-09-03 09:45:00,72.07,305531.84000000375,313014.40000000375,-7482.559999999998
26482,2022-09-03 09:50:00,1146.76,306678.60000000376,313014.40000000375,-6335.799999999988
26483,2022-09-03 09:55:00,-1634.77,305043.83000000374,313014.40000000375,-7970.570000000007
26484,2022-09-03 10:00:00,1376.54,306420.3700000037,313014.40000000375,-6594.030000000028
26485,2022-09-03 10:05:00,1638.11,308058.4800000037,313014.40000000375,-4955.920000000042
26486,2022-09-03 10:10:00,253.75,308312.2300000037,313014.40000000375,-4702.170000000042
26487,2022-09-03 10:15:00,344.04,308656.2700000037,313014.40000000375,-4358.130000000063
26488,2022-09-03 10:20:00,6.74,308663.0100000037,313014.40000000375,-4351.390000000072
26489,2022-09-03 10:25:00,1831.71,310494.7200000037,313014.40000000375,-2519.680000000051
26490,2022-09-03 10:30:00,-561.83,309932.8900000037,313014.40000000375,-3081.5100000000675
26491,2022-09-03 10:35:00,1544.42,311477.31000000366,313014.40000000375,-1537.0900000000838
26492,2022-09-03 10:40:00,146.08,311623.3900000037,313014.40000000375,-1391.0100000000675
26493,2022-09-03 10:45:00,1467.48,313090.87000000366,313014.40000000375,76.46999999991385
26494,2022-09-03 10:50:00,-1383.85,311707.0200000037,313014.40000000375,-1307.3800000000629
26495,2022-09-03 10:55:00,910.24,312617.2600000037,313014.40000000375,-397.1400000000722
26496,2022-09-03 11:00:00,1580.6,314197.86000000365,313014.40000000375,1183.4599999999045
26497,2022-09-03 11:05:00,423.62,314621.48000000365,313014.40000000375,1607.0799999998999
26498,2022-09-03 11:10:00,895.87,315517.35000000364,313014.40000000375,2502.949999999895
26499,2022-09-03 11:15:00,-959.01,314558.34000000363,313014.40000000375,1543.939999999886
26500,2022-09-03 11:20:00,992.87,315551.21000000363,313014.40000000375,2536.8099999998813
26501,2022-09-03 11:25:00,-1862.19,313689.0200000036,313014.40000000375,674.6199999998789
26502,2022-09-03 11:30:00,-987.77,312701.2500000036,313014.40000000375,-313.1500000001397
26503,2022-09-03 11:35:00,526.3,313227.5500000036,313014.40000000375,213.14999999984866
26504,2022-09-03 11:40:00,-1564.66,311662.8900000036,313014.40000000375,-1351.5100000001257
26505,2022-09-03 11:45:00,-1863.86,309799.03000000364,313014.40000000375,-3215.3700000001118
26506,2022-09-03 11:50:00,596.36,310395.3900000036,313014.40000000375,-2619.0100000001257
26507,2022-09-03 11:55:00,-109.03,310286.3600000036,313014.40000000375,-2728.0400000001537
26508,2022-09-03 12:00:00,-18.79,310267.5700000036,313014.40000000375,-2746.8300000001327
26509,2022-09-03 12:05:00,50.69,310318.2600000036,313014.40000000375,-2696.1400000001304
26510,2022-09-03 12:10:00,-331.58,309986.6800000036,313014.40000000375,-3027.7200000001467
26511,2022-09-03 12:15:00,-1541.82,308444.8600000036,313014.40000000375,-4569.540000000154
26512,2022-09-03 12:20:00,658.31,309103.1700000036,313014.40000000375,-3911.230000000156
26513,2022-09-03 12:25:00,490.02,309593.1900000036,313014.40000000375,-3421.2100000001374
26514,2022-09-03 12:30:00,-903.13,308690.0600000036,313014.40000000375,-4324.340000000142
26515,2022-09-03 12:35:00,205.76,308895.8200000036,313014.40000000375,-4118.580000000133
26516,2022-09-03 12:40:00,1841.38,310737.2000000036,313014.40000000375,-2277.200000000128
26517,2022-09-03 12:45:00,-360.89,310376.3100000036,313014.40000000375,-2638.090000000142
26518,2022-09-03 12:50:00,1501.09,311877.40000000363,313014.40000000375,-1137.0000000001164
26519,2022-09-03 12:55:00,-411.63,311465.7700000036,313014.40000000375,-1548.630000000121
26520,2022-09-03 13:00:00,325.2,311790.97000000364,313014.40000000375,-1223.4300000001094
26521,2022-09-03 13:05:00,1031.39,312822.36000000365,313014.40000000375,-192.04000000009546
26522,2022-09-03 13:10:00,1830.16,314652.5200000036,313014.40000000375,1638.119999999879
26523,2022-09-03 13:15:00,1941.05,316593.5700000036,313014.40000000375,3579.1699999998673
26524,2022-09-03 13:20:00,1542.13,318135.7000000036,313014.40000000375,5121.299999999872
26525,2022-09-03 13:25:00,1762.64,319898.34000000363,313014.40000000375,6883.939999999886
26526,2022-09-03 13:30:00,750.24,320648.5800000036,313014.40000000375,7634.179999999877
26527,2022-09-03 13:35:00,1273.06,321921.6400000036,313014.40000000375,8907.239999999874
26528,2022-09-03 13:40:00,-943.39,320978.2500000036,313014.40000000375,7963.84999999986
26529,2022-09-03 13:45:00,319.35,321297.6000000036,313014.40000000375,8283.199999999837
26530,2022-09-03 13:50:00,-1656.35,319641.2500000036,313014.40000000375,6626.84999999986
26531,2022-09-03 13:55:00,-646.66,318994.59000000363,313014.40000000375,5980.189999999886
26532,2022-09-03 14:00:00,-499.07,318495.5200000036,313014.40000000375,5481.119999999879
26533,2022-09-03 14:05:00,-259.64,318235.8800000036,313014.40000000375,5221.479999999865
26534,2022-09-03 14:10:00,124.31,318360.1900000036,313014.40000000375,5345.789999999863
26535,2022-09-03 14:15:00,1715.41,320075.6000000036,313014.40000000375,7061.199999999837
26536,2022-09-03 14:20:00,-188.63,319886.9700000036,313014.40000000375,6872.569999999832
26537,2022-09-03 14:25:00,-590.75,319296.2200000036,313014.40000000375,6281.819999999832
26538,2022-09-03 14:30:00,-93.08,319203.14000000356,313014.40000000375,6188.739999999816
26539,2022-09-03 14:35:00,-1675.38,317527.76000000356,313014.40000000375,4513.359999999811
26540,2022-09-03 14:40:00,-1317.46,316210.30000000354,313014.40000000375,3195.8999999997905
26541,2022-09-03 14:45:00,-672.15,315538.1500000035,313014.40000000375,2523.749999999767
26542,2022-09-03 14:50:00,557.21,316095.36000000354,313014.40000000375,3080.959999999788
26543,2022-09-03 14:55:00,1624.03,317719.39000000356,313014.40000000375,4704.989999999816
26544,2022-09-03 15:00:00,315.49,318034.88000000356,313014.40000000375,5020.479999999807
26545,2022-09-03 15:05:00,1896.57,319931.45000000356,313014.40000000375,6917.049999999814
26546,2022-09-03 15:10:00,1335.44,321266.89000000356,313014.40000000375,8252.489999999816
26547,2022-09-03 15:15:00,17.02,321283.9100000036,313014.40000000375,8269.509999999835
26548,2022-09-03 15:20:00,422.74,321706.6500000036,313014.40000000375,8692.249999999825
26549,2022-09-03 15:25:00,309.25,322015.9000000036,313014.40000000375,9001.499999999825
26550,2022-09-03 15:30:00,1394.31,323410.2100000036,313014.40000000375,10395.809999999823
26551,2022-09-03 15:35:00,1756.7,325166.9100000036,313014.40000000375,12152.509999999835
26552,2022-09-03 15:40:00,-56.76,325110.1500000036,313014.40000000375,12095.749999999825
26553,2022-09-03 15:45:00,-1912.67,323197.4800000036,313014.40000000375,10183.079999999842
26554,2022-09-03 15:50:00,598.98,323796.4600000036,313014.40000000375,10782.059999999823
26555,2022-09-03 15:55:00,763.98,324560.44000000355,313014.40000000375,11546.039999999804
26556,2022-09-03 16:00:00,708.13,325268.57000000356,313014.40000000375,12254.169999999809
26557,2022-09-03 16:05:00,-1860.68,323407.89000000356,313014.40000000375,10393.489999999816
26558,2022-09-03 16:10:00,1612.47,325020.36000000354,313014.40000000375,12005.959999999788
26559,2022-09-03 16:15:00,-514.13,324506.23000000353,313014.40000000375,11491.829999999783
26560,2022-09-03 16:20:00,713.56,325219.79000000353,313014.40000000375,12205.389999999781
26561,2022-09-03 16:25:00,1795.87,327015.6600000035,313014.40000000375,14001.259999999776
26562,2022-09-03 16:30:00,396.31,327411.9700000035,313014.40000000375,14397.569999999774
26563,2022-09-03 16:35:00,868.29,328280.2600000035,313014.40000000375,15265.859999999753
26564,2022-09-03 16:40:00,-323.41,327956.8500000035,313014.40000000375,14942.449999999779
26565,2022-09-03 16:45:00,861.51,328818.36000000354,313014.40000000375,15803.959999999788
26566,2022-09-03 16:50:00,1049.59,329867.95000000356,313014.40000000375,16853.549999999814
26567,2022-09-03 16:55:00,-1705.11,328162.8400000036,313014.40000000375,15148.439999999828
26568,2022-09-04 08:00:00,828.05,328990.89000000356,328162.8400000036,828.0499999999884
26569,2022-09-04 08:05:00,-830.26,328160.63000000356,328162.8400000036,-2.2100000000209548
26570,2022-09-04 08:10:00,1454.02,329614.6500000036,328162.8400000036,1451.8099999999977
26571,2022-09-04 08:15:00,-109.49,329505.1600000036,328162.8400000036,1342.320000000007
26572,2022-09-04 08:20:00,1309.42,330814.58000000357,328162.8400000036,2651.7399999999907
26573,2022-09-04 08:25:00,-260.01,330554.57000000356,328162.8400000036,2391.7299999999814
26574,2022-09-04 08:30:00,-1080.0,329474.57000000356,328162.8400000036,1311.7299999999814
26575,2022-09-04 08:35:00,-874.76,328599.81000000355,328162.8400000036,436.96999999997206
26576,2022-09-04 08:40:00,1982.43,330582.24000000354,328162.8400000036,2419.399999999965
26577,2022-09-04 08:45:00,824.24,331406.48000000353,328162.8400000036,3243.6399999999558
26578,2022-09-04 08:50:00,-1583.8,329822.68000000354,328162.8400000036,1659.8399999999674
26579,2022-09-04 08:55:00,1287.25,331109.93000000354,328162.8400000036,2947.0899999999674
26580,2022-09-04 09:00:00,1587.82,332697.75000000355,328162.8400000036,4534.909999999974
26581,2022-09-04 09:05:00,777.12,333474.87000000355,328162.8400000036,5312.02999999997
26582,2022-09-04 09:10:00,1447.94,334922.81000000355,328162.8400000036,6759.969999999972
26583,2022-09-04 09:15:00,12.35,334935.1600000035,328162.8400000036,6772.319999999949
26584,2022-09-04 09:20:00,-1719.6,333215.56000000355,328162.8400000036,5052.719999999972
26585,2022-09-04 09:25:00,-718.2,332497.36000000354,328162.8400000036,4334.51999999996
26586,2022-09-04 09:30:00,-1249.58,331247.7800000035,328162.8400000036,3084.939999999944
26587,2022-09-04 09:35:00,718.93,331966.7100000035,328162.8400000036,3803.869999999937
26588,2022-09-04 09:40:00,-593.32,331373.3900000035,328162.8400000036,3210.54999999993
26589,2022-09-04 09:45:00,-12.79,331360.6000000035,328162.8400000036,3197.759999999951
26590,2022-09-04 09:50:00,1054.79,332415.3900000035,328162.8400000036,4252.54999999993
26591,2022-09-04 09:55:00,-740.26,331675.1300000035,328162.8400000036,3512.289999999921
26592,2022-09-04 10:00:00,-1549.71,330125.4200000035,328162.8400000036,1962.5799999998999
26593,2022-09-04 10:05:00,-1523.91,328601.5100000035,328162.8400000036,438.6699999999255
26594,2022-09-04 10:10:00,248.8,328850.3100000035,328162.8400000036,687.4699999999139
26595,2022-09-04 10:15:00,661.59,329511.9000000035,328162.8400000036,1349.0599999999395
26596,2022-09-04 10:20:00,1240.65,330752.55000000354,328162.8400000036,2589.7099999999627
26597,2022-09-04 10:25:00,-1386.79,329365.76000000356,328162.8400000036,1202.9199999999837
26598,2022-09-04 10:30:00,1819.63,331185.39000000356,328162.8400000036,3022.5499999999884
26599,2022-09-04 10:35:00,816.4,332001.7900000036,328162.8400000036,3838.9500000000116
26600,2022-09-04 10:40:00,1479.8,333481.5900000036,328162.8400000036,5318.75
26601,2022-09-04 10:45:00,-17.55,333464.0400000036,328162.8400000036,5301.200000000012
26602,2022-09-04 10:50:00,-735.74,332728.3000000036,328162.8400000036,4565.460000000021
26603,2022-09-04 10:55:00,358.25,333086.5500000036,328162.8400000036,4923.710000000021
26604,2022-09-04 11:00:00,-1357.38,331729.1700000036,328162.8400000036,3566.3300000000163
26605,2022-09-04 11:05:00,-512.48,331216.6900000036,328162.8400000036,3053.850000000035
26606,2022-09-04 11:10:00,1199.06,332415.7500000036,328162.8400000036,4252.910000000033
26607,2022-09-04 11:15:00,596.42,333012.1700000036,328162.8400000036,4849.330000000016
26608,2022-09-04 11:20:00,1162.54,334174.7100000036,328162.8400000036,6011.869999999995
26609,2022-09-04 11:25:00,-820.6,333354.1100000036,328162.8400000036,5191.270000000019
26610,2022-09-04 11:30:00,-1629.56,331724.5500000036,328162.8400000036,3561.710000000021
26611,2022-09-04 11:35:00,1928.74,333653.2900000036,328162.8400000036,5490.450000000012
26612,2022-09-04 11:40:00,-747.69,332905.6000000036,328162.8400000036,4742.760000000009
26613,2022-09-04 11:45:00,1797.54,334703.14000000356,328162.8400000036,6540.299999999988
26614,2022-09-04 11:50:00,909.93,335613.07000000356,328162.8400000036,7450.229999999981
26615,2022-09-04 11:55:00,1474.68,337087.75000000355,328162.8400000036,8924.909999999974
26616,2022-09-04 12:00:00,502.65,337590.4000000036,328162.8400000036,9427.559999999998
26617,2022-09-04 12:05:00,-1392.25,336198.1500000036,328162.8400000036,8035.309999999998
26618,2022-09-04 12:10:00,927.74,337125.89000000356,328162.8400000036,8963.049999999988
26619,2022-09-04 12:15:00,1934.9,339060.7900000036,328162.8400000036,10897.950000000012
26620,2022-09-04 12:20:00,-416.95,338643.8400000036,328162.8400000036,10481.0
26621,2022-09-04 12:25:00,1391.86,340035.70000000356,328162.8400000036,11872.859999999986
26622,2022-09-04 12:30:00,1913.86,341949.56000000355,328162.8400000036,13786.719999999972
26623,2022-09-04 12:35:00,-1492.21,340457.3500000035,328162.8400000036,12294.509999999951
26624,2022-09-04 12:40:00,483.31,340940.6600000035,328162.8400000036,12777.819999999949
26625,2022-09-04 12:45:00,969.29,341909.9500000035,328162.8400000036,13747.109999999928
26626,2022-09-04 12:50:00,-1000.76,340909.1900000035,328162.8400000036,12746.349999999919
26627,2022-09-04 12:55:00,-1828.76,339080.4300000035,328162.8400000036,10917.58999999991
26628,2022-09-04 13:00:00,1697.15,340777.5800000035,328162.8400000036,12614.739999999932
26629,2022-09-04 13:05:00,-1110.77,339666.8100000035,328162.8400000036,11503.969999999914
26630,2022-09-04 13:10:00,243.9,339910.7100000035,328162.8400000036,11747.869999999937
26631,2022-09-04 13:15:00,-1607.55,338303.1600000035,328162.8400000036,10140.319999999949
26632,2022-09-04 13:20:00,-1830.74,336472.42000000353,328162.8400000036,8309.579999999958
26633,2022-09-04 13:25:00,-780.04,335692.38000000356,328162.8400000036,7529.539999999979
26634,2022-09-04 13:30:00,-1422.44,334269.94000000355,328162.8400000036,6107.099999999977
26635,2022-09-04 13:35:00,19.6,334289.54000000353,328162.8400000036,6126.699999999953
26636,2022-09-04 13:40:00,886.62,335176.1600000035,328162.8400000036,7013.319999999949
26637,2022-09-04 13:45:00,928.57,336104.73000000353,328162.8400000036,7941.889999999956
26638,2022-09-04 13:50:00,237.81,336342.54000000353,328162.8400000036,8179.699999999953
26639,2022-09-04 13:55:00,162.07,336504.61000000354,328162.8400000036,8341.76999999996
26640,2022-09-04 14:00:00,-412.06,336092.55000000354,328162.8400000036,7929.709999999963
26641,2022-09-04 14:05:00,1197.14,337289.69000000355,328162.8400000036,9126.849999999977
26642,2022-09-04 14:10:00,-835.09,336454.6000000035,328162.8400000036,8291.759999999951
26643,2022-09-04 14:15:00,1830.66,338285.2600000035,328162.8400000036,10122.419999999925
26644,2022-09-04 14:20:00,-1376.92,336908.3400000035,328162.8400000036,8745.499999999942
26645,2022-09-04 14:25:00,117.79,337026.1300000035,328162.8400000036,8863.28999999992
26646,2022-09-04 14:30:00,1918.38,338944.5100000035,328162.8400000036,10781.669999999925
26647,2022-09-04 14:35:00,-1269.18,337675.3300000035,328162.8400000036,9512.489999999932
26648,2022-09-04 14:40:00,510.36,338185.6900000035,328162.8400000036,10022.849999999919
26649,2022-09-04 14:45:00,-750.75,337434.9400000035,328162.8400000036,9272.099999999919
26650,2022-09-04 14:50:00,952.03,338386.9700000035,328162.8400000036,10224.129999999946
26651,2022-09-04 14:55:00,1831.09,340218.06000000355,328162.8400000036,12055.219999999972
26652,2022-09-04 15:00:00,1897.03,342115.0900000036,328162.8400000036,13952.25
26653,2022-09-04 15:05:00,-219.61,341895.4800000036,328162.8400000036,13732.640000000014
26654,2022-09-04 15:10:00,-1226.75,340668.7300000036,328162.8400000036,12505.890000000014
26655,2022-09-04 15:15:00,-920.36,339748.3700000036,328162.8400000036,11585.530000000028
26656,2022-09-04 15:20:00,-1176.75,338571.6200000036,328162.8400000036,10408.780000000028
26657,2022-09-04 15:25:00,-1477.62,337094.0000000036,328162.8400000036,8931.160000000033
26658,2022-09-04 15:30:00,1406.72,338500.7200000036,328162.8400000036,10337.880000000005
26659,2022-09-04 15:35:00,159.94,338660.6600000036,328162.8400000036,10497.820000000007
26660,2022-09-04 15:40:00,1552.75,340213.4100000036,328162.8400000036,12050.570000000007
26661,2022-09-04 15:45:00,-69.43,340143.9800000036,328162.8400000036,11981.140000000014
26662,2022-09-04 15:50:00,-1958.26,338185.7200000036,328162.8400000036,10022.880000000005
26663,2022-09-04 15:55:00,-874.11,337311.6100000036,328162.8400000036,9148.770000000019
26664,2022-09-04 16:00:00,-1054.64,336256.9700000036,328162.8400000036,8094.130000000005
26665,2022-09-04 16:05:00,-1400.32,334856.6500000036,328162.8400000036,6693.809999999998
26666,2022-09-04 16:10:00,992.9,335849.5500000036,328162.8400000036,7686.710000000021
26667,2022-09-04 16:15:00,-1816.83,334032.7200000036,328162.8400000036,5869.880000000005
26668,2022-09-04 16:20:00,1297.34,335330.0600000036,328162.8400000036,7167.22000000003
26669,2022-09-04 16:25:00,-1732.06,333598.0000000036,328162.8400000036,5435.160000000033
26670,2022-09-04 16:30:00,-1930.13,331667.8700000036,328162.8400000036,3505.030000000028
26671,2022-09-04 16:35:00,-1822.55,329845.3200000036,328162.8400000036,1682.4800000000396
26672,2022-09-04 16:40:00,632.34,330477.66000000364,328162.8400000036,2314.820000000065
26673,2022-09-04 16:45:00,-394.39,330083.2700000036,328162.8400000036,1920.4300000000512
26674,2022-09-04 16:50:00,-1950.61,328132.66000000364,328162.8400000036,-30.179999999934807
26675,2022-09-04 16:55:00,-835.3,327297.36000000365,328162.8400000036,-865.4799999999232
26676,2022-09-05 08:00:00,-1126.35,326171.0100000037,327297.36000000365,-1126.3499999999767
26677,2022-09-05 08:05:00,-869.01,325302.00000000367,327297.36000000365,-1995.359999999986
26678,2022-09-05 08:10:00,-1192.88,324109.12000000366,327297.36000000365,-3188.2399999999907
26679,2022-09-05 08:15:00,796.04,324905.16000000364,327297.36000000365,-2392.2000000000116
26680,2022-09-05 08:20:00,-1635.43,323269.73000000365,327297.36000000365,-4027.6300000000047
26681,2022-09-05 08:25:00,854.23,324123.96000000363,327297.36000000365,-3173.4000000000233
26682,2022-09-05 08:30:00,-745.02,323378.9400000036,327297.36000000365,-3918.420000000042
26683,2022-09-05 08:35:00,510.14,323889.0800000036,327297.36000000365,-3408.280000000028
26684,2022-09-05 08:40:00,-262.53,323626.5500000036,327297.36000000365,-3670.810000000056
26685,2022-09-05 08:45:00,606.67,324233.2200000036,327297.36000000365,-3064.140000000072
26686,2022-09-05 08:50:00,-1384.66,322848.5600000036,327297.36000000365,-4448.800000000047
26687,2022-09-05 08:55:00,-292.65,322555.9100000036,327297.36000000365,-4741.45000000007
26688,2022-09-05 09:00:00,1747.24,324303.1500000036,327297.36000000365,-2994.210000000079
26689,2022-09-05 09:05:00,1313.25,325616.4000000036,327297.36000000365,-1680.9600000000792
26690,2022-09-05 09:10:00,1683.45,327299.8500000036,327297.36000000365,2.489999999932479
26691,2022-09-05 09:15:00,1315.39,328615.2400000036,327297.36000000365,1317.8799999999464
26692,2022-09-05 09:20:00,-1557.16,327058.0800000036,327297.36000000365,-239.28000000002794
26693,2022-09-05 09:25:00,1223.94,328282.0200000036,327297.36000000365,984.6599999999744
26694,2022-09-05 09:30:00,433.64,328715.66000000364,327297.36000000365,1418.2999999999884
26695,2022-09-05 09:35:00,-1952.72,326762.94000000367,327297.36000000365,-534.4199999999837
26696,2022-09-05 09:40:00,-1009.55,325753.3900000037,327297.36000000365,-1543.969999999972
26697,2022-09-05 09:45:00,284.65,326038.0400000037,327297.36000000365,-1259.3199999999488
26698,2022-09-05 09:50:00,1515.97,327554.0100000037,327297.36000000365,256.6500000000233
26699,2022-09-05 09:55:00,-672.03,326881.98000000365,327297.36000000365,-415.38000000000466
26700,2022-09-05 10:00:00,-1143.21,325738.7700000036,327297.36000000365,-1558.5900000000256
26701,2022-09-05 10:05:00,-857.2,324881.5700000036,327297.36000000365,-2415.7900000000373
26702,2022-09-05 10:10:00,1965.53,326847.10000000364,327297.36000000365,-450.2600000000093
26703,2022-09-05 10:15:00,-1080.41,325766.69000000367,327297.36000000365,-1530.6699999999837
26704,2022-09-05 10:20:00,278.81,326045.50000000367,327297.36000000365,-1251.859999999986
26705,2022-09-05 10:25:00,-780.68,325264.8200000037,327297.36000000365,-2032.539999999979
26706,2022-09-05 10:30:00,-1505.33,323759.49000000366,327297.36000000365,-3537.8699999999953
26707,2022-09-05 10:35:00,129.09,323888.5800000037,327297.36000000365,-3408.7799999999697
26708,2022-09-05 10:40:00,-1709.9,322178.68000000366,327297.36000000365,-5118.679999999993
26709,2022-09-05 10:45:00,-308.11,321870.5700000037,327297.36000000365,-5426.789999999979
26710,2022-09-05 10:50:00,40.64,321911.2100000037,327297.36000000365,-5386.149999999965
26711,2022-09-05 10:55:00,1855.31,323766.5200000037,327297.36000000365,-3530.8399999999674
26712,2022-09-05 11:00:00,-44.36,323722.1600000037,327297.36000000365,-3575.1999999999534
26713,2022-09-05 11:05:00,-1820.66,321901.5000000037,327297.36000000365,-5395.859999999928
26714,2022-09-05 11:10:00,-1674.21,320227.2900000037,327297.36000000365,-7070.069999999949
26715,2022-09-05 11:15:00,-1272.62,318954.6700000037,327297.36000000365,-8342.689999999944
26716,2022-09-05 11:20:00,420.43,319375.1000000037,327297.36000000365,-7922.259999999951
26717,2022-09-05 11:25:00,-1964.38,317410.7200000037,327297.36000000365,-9886.639999999956
26718,2022-09-05 11:30:00,1626.25,319036.9700000037,327297.36000000365,-8260.389999999956
26719,2022-09-05 11:35:00,-1892.94,317144.0300000037,327297.36000000365,-10153.329999999958
26720,2022-09-05 11:40:00,-1905.32,315238.7100000037,327297.36000000365,-12058.649999999965
26721,2022-09-05 11:45:00,217.47,315456.18000000366,327297.36000000365,-11841.179999999993
26722,2022-09-05 11:50:00,-163.69,315292.49000000366,327297.36000000365,-12004.869999999995
26723,2022-09-05 11:55:00,-1429.48,313863.0100000037,327297.36000000365,-13434.349999999977
26724,2022-09-05 12:00:00,-1519.22,312343.7900000037,327297.36000000365,-14953.569999999949
26725,2022-09-05 12:05:00,1217.17,313560.9600000037,327297.36000000365,-13736.399999999965
26726,2022-09-05 12:10:00,1255.98,314816.94000000367,327297.36000000365,-12480.419999999984
26727,2022-09-05 12:15:00,-1045.14,313771.80000000366,327297.36000000365,-13525.559999999998
26728,2022-09-05 12:20:00,-490.79,313281.0100000037,327297.36000000365,-14016.349999999977
26729,2022-09-05 12:25:00,691.48,313972.49000000366,327297.36000000365,-13324.869999999995
26730,2022-09-05 12:30:00,368.72,314341.21000000363,327297.36000000365,-12956.150000000023
26731,2022-09-05 12:35:00,1567.31,315908.5200000036,327297.36000000365,-11388.840000000026
26732,2022-09-05 12:40:00,735.94,316644.46000000363,327297.36000000365,-10652.900000000023
26733,2022-09-05 12:45:00,836.71,317481.17000000365,327297.36000000365,-9816.190000000002
26734,2022-09-05 12:50:00,-1304.81,316176.36000000365,327297.36000000365,-11121.0
26735,2022-09-05 12:55:00,-1072.83,315103.53000000364,327297.36000000365,-12193.830000000016
26736,2022-09-05 13:00:00,-1811.61,313291.92000000365,327297.36000000365,-14005.440000000002
26737,2022-09-05 13:05:00,-1726.06,311565.86000000365,327297.36000000365,-15731.5
26738,2022-09-05 13:10:00,646.2,312212.06000000366,327297.36000000365,-15085.299999999988
26739,2022-09-05 13:15:00,1185.0,313397.06000000366,327297.36000000365,-13900.299999999988
26740,2022-09-05 13:20:00,-144.39,313252.67000000365,327297.36000000365,-14044.690000000002
26741,2022-09-05 13:25:00,-604.62,312648.05000000366,327297.36000000365,-14649.309999999998
26742,2022-09-05 13:30:00,-846.24,311801.81000000366,327297.36000000365,-15495.549999999988
26743,2022-09-05 13:35:00,873.24,312675.05000000366,327297.36000000365,-14622.309999999998
26744,2022-09-05 13:40:00,218.63,312893.68000000366,327297.36000000365,-14403.679999999993
26745,2022-09-05 13:45:00,-1823.68,311070.00000000367,327297.36000000365,-16227.359999999986
26746,2022-09-05 13:50:00,1956.52,313026.5200000037,327297.36000000365,-14270.839999999967
26747,2022-09-05 13:55:00,-1109.34,311917.18000000366,327297.36000000365,-15380.179999999993
26748,2022-09-05 14:00:00,-1655.76,310261.42000000365,327297.36000000365,-17035.940000000002
26749,2022-09-05 14:05:00,-1374.2,308887.22000000364,327297.36000000365,-18410.140000000014
26750,2022-09-05 14:10:00,-1399.07,307488.15000000363,327297.36000000365,-19809.21000000002
26751,2022-09-05 14:15:00,716.05,308204.2000000036,327297.36000000365,-19093.160000000033
26752,2022-09-05 14:20:00,-1938.12,306266.0800000036,327297.36000000365,-21031.280000000028
26753,2022-09-05 14:25:00,-1242.26,305023.8200000036,327297.36000000365,-22273.540000000037
26754,2022-09-05 14:30:00,530.54,305554.3600000036,327297.36000000365,-21743.00000000006
26755,2022-09-05 14:35:00,284.58,305838.9400000036,327297.36000000365,-21458.420000000042
26756,2022-09-05 14:40:00,-853.39,304985.5500000036,327297.36000000365,-22311.810000000056
26757,2022-09-05 14:45:00,1950.52,306936.0700000036,327297.36000000365,-20361.290000000037
26758,2022-09-05 14:50:00,439.08,307375.15000000363,327297.36000000365,-19922.21000000002
26759,2022-09-05 14:55:00,-1125.36,306249.79000000365,327297.36000000365,-21047.570000000007
26760,2022-09-05 15:00:00,-1117.78,305132.0100000036,327297.36000000365,-22165.350000000035
26761,2022-09-05 15:05:00,1380.99,306513.0000000036,327297.36000000365,-20784.360000000044
26762,2022-09-05 15:10:00,386.95,306899.9500000036,327297.36000000365,-20397.410000000033
26763,2022-09-05 15:15:00,-1164.71,305735.2400000036,327297.36000000365,-21562.120000000054
26764,2022-09-05 15:20:00,1159.24,306894.4800000036,327297.36000000365,-20402.880000000063
26765,2022-09-05 15:25:00,-908.24,305986.2400000036,327297.36000000365,-21311.120000000054
26766,2022-09-05 15:30:00,635.7,306621.9400000036,327297.36000000365,-20675.420000000042
26767,2022-09-05 15:35:00,-580.78,306041.1600000036,327297.36000000365,-21256.20000000007
26768,2022-09-05 15:40:00,379.29,306420.45000000356,327297.36000000365,-20876.91000000009
26769,2022-09-05 15:45:00,1094.0,307514.45000000356,327297.36000000365,-19782.91000000009
26770,2022-09-05 15:50:00,-102.3,307412.1500000036,327297.36000000365,-19885.21000000008
26771,2022-09-05 15:55:00,-909.05,306503.1000000036,327297.36000000365,-20794.260000000068
26772,2022-09-05 16:00:00,1203.5,307706.6000000036,327297.36000000365,-19590.760000000068
26773,2022-09-05 16:05:00,-87.04,307619.5600000036,327297.36000000365,-19677.800000000047
26774,2022-09-05 16:10:00,930.94,308550.5000000036,327297.36000000365,-18746.860000000044
26775,2022-09-05 16:15:00,953.29,309503.7900000036,327297.36000000365,-17793.570000000065
26776,2022-09-05 16:20:00,1740.49,311244.2800000036,327297.36000000365,-16053.080000000075
26777,2022-09-05 16:25:00,683.81,311928.0900000036,327297.36000000365,-15369.270000000077
26778,2022-09-05 16:30:00,-238.97,311689.1200000036,327297.36000000365,-15608.240000000049
26779,2022-09-05 16:35:00,531.59,312220.71000000363,327297.36000000365,-15076.650000000023
26780,2022-09-05 16:40:00,-1892.92,310327.79000000365,327297.36000000365,-16969.570000000007
26781,2022-09-05 16:45:00,1237.39,311565.18000000366,327297.36000000365,-15732.179999999993
26782,2022-09-05 16:50:00,-1788.68,309776.50000000367,327297.36000000365,-17520.859999999986
26783,2022-09-05 16:55:00,-415.33,309361.17000000365,327297.36000000365,-17936.190000000002
26784,2022-09-06 08:00:00,-1724.48,307636.69000000367,309361.17000000365,-1724.4799999999814
26785,2022-09-06 08:05:00,-696.47,306940.2200000037,309361.17000000365,-2420.9499999999534
26786,2022-09-06 08:10:00,1784.83,308725.0500000037,309361.17000000365,-636.1199999999371
26787,2022-09-06 08:15:00,-73.99,308651.0600000037,309361.17000000365,-710.1099999999278
26788,2022-09-06 08:20:00,-1290.13,307360.9300000037,309361.17000000365,-2000.2399999999325
26789,2022-09-06 08:25:00,-1292.6,306068.33000000374,309361.17000000365,-3292.839999999909
26790,2022-09-06 08:30:00,1153.59,307221.92000000377,309361.17000000365,-2139.2499999998836
26791,2022-09-06 08:35:00,1022.09,308244.0100000038,309361.17000000365,-1117.159999999858
26792,2022-09-06 08:40:00,215.08,308459.0900000038,309361.17000000365,-902.0799999998417
26793,2022-09-06 08:45:00,-1665.62,306793.4700000038,309361.17000000365,-2567.699999999837
26794,2022-09-06 08:50:00,-1084.1,305709.37000000384,309361.17000000365,-3651.7999999998137
26795,2022-09-06 08:55:00,-624.95,305084.4200000038,309361.17000000365,-4276.749999999825
26796,2022-09-06 09:00:00,-1708.87,303375.55000000383,309361.17000000365,-5985.619999999821
26797,2022-09-06 09:05:00,-1728.33,301647.2200000038,309361.17000000365,-7713.949999999837
26798,2022-09-06 09:10:00,894.99,302542.2100000038,309361.17000000365,-6818.959999999846
26799,2022-09-06 09:15:00,-1406.61,301135.6000000038,309361.17000000365,-8225.569999999832
26800,2022-09-06 09:20:00,159.37,301294.9700000038,309361.17000000365,-8066.199999999837
26801,2022-09-06 09:25:00,-1594.73,299700.24000000383,309361.17000000365,-9660.929999999818
26802,2022-09-06 09:30:00,526.53,300226.77000000386,309361.17000000365,-9134.39999999979
26803,2022-09-06 09:35:00,900.83,301127.6000000039,309361.17000000365,-8233.569999999774
26804,2022-09-06 09:40:00,-1249.6,299878.0000000039,309361.17000000365,-9483.16999999975
26805,2022-09-06 09:45:00,278.46,300156.4600000039,309361.17000000365,-9204.70999999973
26806,2022-09-06 09:50:00,-1347.9,298808.5600000039,309361.17000000365,-10552.609999999753
26807,2022-09-06 09:55:00,630.79,299439.3500000039,309361.17000000365,-9921.819999999774
26808,2022-09-06 10:00:00,418.69,299858.0400000039,309361.17000000365,-9503.129999999772
26809,2022-09-06 10:05:00,1778.62,301636.6600000039,309361.17000000365,-7724.5099999997765
26810,2022-09-06 10:10:00,454.9,302091.5600000039,309361.17000000365,-7269.609999999753
26811,2022-09-06 10:15:00,579.62,302671.1800000039,309361.17000000365,-6689.989999999758
26812,2022-09-06 10:20:00,187.58,302858.7600000039,309361.17000000365,-6502.409999999742
26813,2022-09-06 10:25:00,-450.72,302408.04000000394,309361.17000000365,-6953.129999999714
26814,2022-09-06 10:30:00,1222.91,303630.9500000039,309361.17000000365,-5730.219999999739
26815,2022-09-06 10:35:00,-1448.37,302182.5800000039,309361.17000000365,-7178.589999999735
26816,2022-09-06 10:40:00,1569.96,303752.54000000394,309361.17000000365,-5608.629999999714
26817,2022-09-06 10:45:00,1308.11,305060.6500000039,309361.17000000365,-4300.519999999728
26818,2022-09-06 10:50:00,-1291.49,303769.16000000393,309361.17000000365,-5592.009999999718
26819,2022-09-06 10:55:00,-1107.19,302661.97000000393,309361.17000000365,-6699.199999999721
26820,2022-09-06 11:00:00,-791.07,301870.9000000039,309361.17000000365,-7490.269999999728
26821,2022-09-06 11:05:00,724.81,302595.7100000039,309361.17000000365,-6765.45999999973
26822,2022-09-06 11:10:00,-1350.65,301245.0600000039,309361.17000000365,-8116.109999999753
26823,2022-09-06 11:15:00,73.47,301318.53000000387,309361.17000000365,-8042.639999999781
26824,2022-09-06 11:20:00,1693.87,303012.40000000386,309361.17000000365,-6348.769999999786
26825,2022-09-06 11:25:00,546.72,303559.12000000384,309361.17000000365,-5802.049999999814
26826,2022-09-06 11:30:00,419.31,303978.43000000383,309361.17000000365,-5382.739999999816
26827,2022-09-06 11:35:00,-75.4,303903.0300000038,309361.17000000365,-5458.139999999839
26828,2022-09-06 11:40:00,1995.69,305898.7200000038,309361.17000000365,-3462.449999999837
26829,2022-09-06 11:45:00,1330.31,307229.0300000038,309361.17000000365,-2132.1399999998393
26830,2022-09-06 11:50:00,-590.95,306638.0800000038,309361.17000000365,-2723.089999999851
26831,2022-09-06 11:55:00,335.54,306973.6200000038,309361.17000000365,-2387.549999999872
26832,2022-09-06 12:00:00,-517.58,306456.04000000376,309361.17000000365,-2905.1299999998882
26833,2022-09-06 12:05:00,-612.62,305843.42000000377,309361.17000000365,-3517.7499999998836
26834,2022-09-06 12:10:00,1256.08,307099.5000000038,309361.17000000365,-2261.6699999998673
26835,2022-09-06 12:15:00,626.27,307725.7700000038,309361.17000000365,-1635.3999999998487
26836,2022-09-06 12:20:00,-427.87,307297.9000000038,309361.17000000365,-2063.269999999844
26837,2022-09-06 12:25:00,62.93,307360.8300000038,309361.17000000365,-2000.339999999851
26838,2022-09-06 12:30:00,-1289.92,306070.9100000038,309361.17000000365,-3290.2599999998347
26839,2022-09-06 12:35:00,-304.85,305766.06000000384,309361.17000000365,-3595.1099999998114
26840,2022-09-06 12:40:00,-582.68,305183.38000000385,309361.17000000365,-4177.789999999804
26841,2022-09-06 12:45:00,-1692.15,303491.2300000038,309361.17000000365,-5869.939999999828
26842,2022-09-06 12:50:00,411.51,303902.74000000383,309361.17000000365,-5458.429999999818
26843,2022-09-06 12:55:00,-985.43,302917.31000000384,309361.17000000365,-6443.859999999811
26844,2022-09-06 13:00:00,-1328.62,301588.69000000384,309361.17000000365,-7772.479999999807
26845,2022-09-06 13:05:00,-1871.08,299717.6100000038,309361.17000000365,-9643.559999999823
26846,2022-09-06 13:10:00,1891.28,301608.89000000386,309361.17000000365,-7752.279999999795
26847,2022-09-06 13:15:00,1243.76,302852.65000000386,309361.17000000365,-6508.519999999786
26848,2022-09-06 13:20:00,179.88,303032.53000000387,309361.17000000365,-6328.639999999781
26849,2022-09-06 13:25:00,1691.77,304724.3000000039,309361.17000000365,-4636.8699999997625
26850,2022-09-06 13:30:00,-1436.96,303287.34000000387,309361.17000000365,-6073.8299999997835
26851,2022-09-06 13:35:00,-1906.72,301380.6200000039,309361.17000000365,-7980.5499999997555
26852,2022-09-06 13:40:00,1568.5,302949.1200000039,309361.17000000365,-6412.0499999997555
26853,2022-09-06 13:45:00,-1752.4,301196.7200000039,309361.17000000365,-8164.449999999779
26854,2022-09-06 13:50:00,1471.89,302668.6100000039,309361.17000000365,-6692.559999999765
26855,2022-09-06 13:55:00,-568.95,302099.6600000039,309361.17000000365,-7261.5099999997765
26856,2022-09-06 14:00:00,-1098.99,301000.6700000039,309361.17000000365,-8360.499999999767
26857,2022-09-06 14:05:00,-1749.94,299250.7300000039,309361.17000000365,-10110.43999999977
26858,2022-09-06 14:10:00,1913.52,301164.2500000039,309361.17000000365,-8196.91999999975
26859,2022-09-06 14:15:00,-1319.01,299845.2400000039,309361.17000000365,-9515.92999999976
26860,2022-09-06 14:20:00,-740.53,299104.71000000386,309361.17000000365,-10256.459999999788
26861,2022-09-06 14:25:00,-1185.3,297919.4100000039,309361.17000000365,-11441.759999999776
26862,2022-09-06 14:30:00,1074.13,298993.5400000039,309361.17000000365,-10367.629999999772
26863,2022-09-06 14:35:00,-1385.83,297607.71000000386,309361.17000000365,-11753.459999999788
26864,2022-09-06 14:40:00,1455.87,299063.58000000386,309361.17000000365,-10297.589999999793
26865,2022-09-06 14:45:00,-1634.57,297429.01000000385,309361.17000000365,-11932.1599999998
26866,2022-09-06 14:50:00,698.72,298127.7300000038,309361.17000000365,-11233.439999999828
26867,2022-09-06 14:55:00,-1098.63,297029.1000000038,309361.17000000365,-12332.069999999832
26868,2022-09-06 15:00:00,555.22,297584.3200000038,309361.17000000365,-11776.84999999986
26869,2022-09-06 15:05:00,1949.13,299533.4500000038,309361.17000000365,-9827.719999999856
26870,2022-09-06 15:10:00,704.12,300237.5700000038,309361.17000000365,-9123.59999999986
26871,2022-09-06 15:15:00,-1790.57,298447.0000000038,309361.17000000365,-10914.169999999867
26872,2022-09-06 15:20:00,8.08,298455.0800000038,309361.17000000365,-10906.089999999851
26873,2022-09-06 15:25:00,-304.71,298150.3700000038,309361.17000000365,-11210.799999999872
26874,2022-09-06 15:30:00,-1927.26,296223.11000000377,309361.17000000365,-13138.059999999881
26875,2022-09-06 15:35:00,1036.9,297260.0100000038,309361.17000000365,-12101.159999999858
26876,2022-09-06 15:40:00,209.22,297469.23000000376,309361.17000000365,-11891.939999999886
26877,2022-09-06 15:45:00,286.0,297755.23000000376,309361.17000000365,-11605.939999999886
26878,2022-09-06 15:50:00,1563.8,299319.03000000375,309361.17000000365,-10042.139999999898
26879,2022-09-06 15:55:00,1307.39,300626.42000000377,309361.17000000365,-8734.749999999884
26880,2022-09-06 16:00:00,865.15,301491.5700000038,309361.17000000365,-7869.59999999986
26881,2022-09-06 16:05:00,-1311.43,300180.1400000038,309361.17000000365,-9181.029999999853
26882,2022-09-06 16:10:00,-1630.87,298549.2700000038,309361.17000000365,-10811.899999999849
26883,2022-09-06 16:15:00,1255.96,299805.2300000038,309361.17000000365,-9555.939999999828
26884,2022-09-06 16:20:00,1996.99,301802.2200000038,309361.17000000365,-7558.949999999837
26885,2022-09-06 16:25:00,1639.33,303441.55000000383,309361.17000000365,-5919.619999999821
26886,2022-09-06 16:30:00,-1445.86,301995.69000000384,309361.17000000365,-7365.479999999807
26887,2022-09-06 16:35:00,-1146.38,300849.31000000384,309361.17000000365,-8511.859999999811
26888,2022-09-06 16:40:00,-1658.23,299191.08000000386,309361.17000000365,-10170.089999999793
26889,2022-09-06 16:45:00,-1176.33,298014.75000000384,309361.17000000365,-11346.419999999809
26890,2022-09-06 16:50:00,1368.29,299383.0400000038,309361.17000000365,-9978.12999999983
26891,2022-09-06 16:55:00,-396.7,298986.3400000038,309361.17000000365,-10374.829999999842
26892,2022-09-07 08:00:00,-1657.69,297328.6500000038,298986.3400000038,-1657.6900000000023
26893,2022-09-07 08:05:00,412.77,297741.4200000038,298986.3400000038,-1244.9199999999837
26894,2022-09-07 08:10:00,319.4,298060.82000000385,298986.3400000038,-925.5199999999604
26895,2022-09-07 08:15:00,-845.27,297215.55000000383,298986.3400000038,-1770.789999999979
26896,2022-09-07 08:20:00,-203.1,297012.45000000385,298986.3400000038,-1973.8899999999558
26897,2022-09-07 08:25:00,1265.22,298277.6700000038,298986.3400000038,-708.6699999999837
26898,2022-09-07 08:30:00,1210.38,299488.05000000383,298986.3400000038,501.71000000002095
26899,2022-09-07 08:35:00,4.22,299492.2700000038,298986.3400000038,505.929999999993
26900,2022-09-07 08:40:00,-767.04,298725.2300000038,298986.3400000038,-261.10999999998603
26901,2022-09-07 08:45:00,1222.34,299947.57000000385,298986.3400000038,961.2300000000396
26902,2022-09-07 08:50:00,-1984.07,297963.50000000384,298986.3400000038,-1022.8399999999674
26903,2022-09-07 08:55:00,-700.86,297262.64000000386,298986.3400000038,-1723.6999999999534
26904,2022-09-07 09:00:00,1184.96,298447.6000000039,298986.3400000038,-538.7399999999325
26905,2022-09-07 09:05:00,-398.72,298048.8800000039,298986.3400000038,-937.4599999999045
26906,2022-09-07 09:10:00,-1965.93,296082.9500000039,298986.3400000038,-2903.3899999998976
26907,2022-09-07 09:15:00,-1348.83,294734.1200000039,298986.3400000038,-4252.219999999914
26908,2022-09-07 09:20:00,-573.01,294161.1100000039,298986.3400000038,-4825.229999999923
26909,2022-09-07 09:25:00,14.65,294175.7600000039,298986.3400000038,-4810.5799999999
26910,2022-09-07 09:30:00,-1918.18,292257.5800000039,298986.3400000038,-6728.759999999893
26911,2022-09-07 09:35:00,1461.81,293719.3900000039,298986.3400000038,-5266.949999999895
26912,2022-09-07 09:40:00,-155.91,293563.48000000394,298986.3400000038,-5422.85999999987
26913,2022-09-07 09:45:00,1905.1,295468.5800000039,298986.3400000038,-3517.759999999893
26914,2022-09-07 09:50:00,1106.21,296574.79000000394,298986.3400000038,-2411.549999999872
26915,2022-09-07 09:55:00,1701.78,298276.57000000397,298986.3400000038,-709.769999999844
26916,2022-09-07 10:00:00,1442.13,299718.70000000397,298986.3400000038,732.3600000001607
26917,2022-09-07 10:05:00,-596.74,299121.960000004,298986.3400000038,135.62000000016997
26918,2022-09-07 10:10:00,-159.51,298962.45000000397,298986.3400000038,-23.889999999839347
26919,2022-09-07 10:15:00,1901.85,300864.30000000395,298986.3400000038,1877.9600000001374
26920,2022-09-07 10:20:00,-1180.32,299683.98000000394,298986.3400000038,697.6400000001304
26921,2022-09-07 10:25:00,-968.61,298715.37000000395,298986.3400000038,-270.96999999985565
26922,2022-09-07 10:30:00,1212.04,299927.41000000393,298986.3400000038,941.0700000001234
26923,2022-09-07 10:35:00,1086.6,301014.0100000039,298986.3400000038,2027.6700000001001
26924,2022-09-07 10:40:00,457.48,301471.4900000039,298986.3400000038,2485.1500000000815
26925,2022-09-07 10:45:00,243.99,301715.4800000039,298986.3400000038,2729.140000000072
26926,2022-09-07 10:50:00,-1536.65,300178.83000000386,298986.3400000038,1192.490000000049
26927,2022-09-07 10:55:00,-700.45,299478.38000000385,298986.3400000038,492.04000000003725
26928,2022-09-07 11:00:00,242.96,299721.34000000387,298986.3400000038,735.0000000000582
26929,2022-09-07 11:05:00,1949.52,301670.8600000039,298986.3400000038,2684.520000000077
26930,2022-09-07 11:10:00,1148.28,302819.1400000039,298986.3400000038,3832.800000000105
26931,2022-09-07 11:15:00,188.58,303007.72000000393,298986.3400000038,4021.380000000121
26932,2022-09-07 11:20:00,925.38,303933.10000000393,298986.3400000038,4946.760000000126
26933,2022-09-07 11:25:00,1492.58,305425.68000000395,298986.3400000038,6439.340000000142
26934,2022-09-07 11:30:00,-1517.71,303907.97000000393,298986.3400000038,4921.630000000121
26935,2022-09-07 11:35:00,-931.21,302976.7600000039,298986.3400000038,3990.4200000001
26936,2022-09-07 11:40:00,950.34,303927.10000000393,298986.3400000038,4940.760000000126
26937,2022-09-07 11:45:00,-815.14,303111.9600000039,298986.3400000038,4125.620000000112
26938,2022-09-07 11:50:00,941.44,304053.4000000039,298986.3400000038,5067.060000000114
26939,2022-09-07 11:55:00,-1915.08,302138.3200000039,298986.3400000038,3151.980000000098
26940,2022-09-07 12:00:00,-1849.67,300288.6500000039,298986.3400000038,1302.310000000114
26941,2022-09-07 12:05:00,-675.71,299612.9400000039,298986.3400000038,626.6000000000931
26942,2022-09-07 12:10:00,1384.78,300997.72000000393,298986.3400000038,2011.380000000121
26943,2022-09-07 12:15:00,664.34,301662.06000000396,298986.3400000038,2675.7200000001467
26944,2022-09-07 12:20:00,1813.02,303475.080000004,298986.3400000038,4488.740000000165
26945,2022-09-07 12:25:00,61.81,303536.890000004,298986.3400000038,4550.550000000163
26946,2022-09-07 12:30:00,-1652.99,301883.900000004,298986.3400000038,2897.5600000001723
26947,2022-09-07 12:35:00,-121.21,301762.69000000396,298986.3400000038,2776.3500000001513
26948,2022-09-07 12:40:00,1722.7,303485.390000004,298986.3400000038,4499.050000000163
26949,2022-09-07 12:45:00,205.45,303690.840000004,298986.3400000038,4704.500000000175
26950,2022-09-07 12:50:00,190.11,303880.95000000397,298986.3400000038,4894.610000000161
26951,2022-09-07 12:55:00,168.73,304049.68000000395,298986.3400000038,5063.340000000142
26952,2022-09-07 13:00:00,1264.83,305314.51000000397,298986.3400000038,6328.170000000158
26953,2022-09-07 13:05:00,398.38,305712.890000004,298986.3400000038,6726.550000000163
26954,2022-09-07 13:10:00,-85.49,305627.400000004,298986.3400000038,6641.060000000172
26955,2022-09-07 13:15:00,-715.94,304911.460000004,298986.3400000038,5925.12000000017
26956,2022-09-07 13:20:00,1914.25,306825.710000004,298986.3400000038,7839.37000000017
26957,2022-09-07 13:25:00,-770.14,306055.57000000397,298986.3400000038,7069.230000000156
26958,2022-09-07 13:30:00,-1948.37,304107.20000000397,298986.3400000038,5120.860000000161
26959,2022-09-07 13:35:00,-1607.72,302499.480000004,298986.3400000038,3513.1400000001886
26960,2022-09-07 13:40:00,-296.56,302202.920000004,298986.3400000038,3216.580000000191
26961,2022-09-07 13:45:00,22.92,302225.840000004,298986.3400000038,3239.5000000001746
26962,2022-09-07 13:50:00,-1019.41,301206.430000004,298986.3400000038,2220.0900000002002
26963,2022-09-07 13:55:00,-993.15,300213.280000004,298986.3400000038,1226.940000000177
26964,2022-09-07 14:00:00,-1262.24,298951.040000004,298986.3400000038,-35.299999999813735
26965,2022-09-07 14:05:00,-1859.47,297091.570000004,298986.3400000038,-1894.7699999997858
26966,2022-09-07 14:10:00,-325.13,296766.440000004,298986.3400000038,-2219.8999999997905
26967,2022-09-07 14:15:00,1218.68,297985.120000004,298986.3400000038,-1001.2199999997974
26968,2022-09-07 14:20:00,-818.22,297166.90000000404,298986.3400000038,-1819.4399999997695
26969,2022-09-07 14:25:00,1916.67,299083.570000004,298986.3400000038,97.2300000002142
26970,2022-09-07 14:30:00,1940.35,301023.920000004,298986.3400000038,2037.580000000191
26971,2022-09-07 14:35:00,-1799.54,299224.380000004,298986.3400000038,238.04000000021188
26972,2022-09-07 14:40:00,-835.08,298389.300000004,298986.3400000038,-597.0399999998044
26973,2022-09-07 14:45:00,-1459.97,296929.33000000403,298986.3400000038,-2057.0099999997765
26974,2022-09-07 14:50:00,108.23,297037.560000004,298986.3400000038,-1948.779999999795
26975,2022-09-07 14:55:00,-1683.91,295353.65000000404,298986.3400000038,-3632.6899999997695
26976,2022-09-07 15:00:00,-223.87,295129.78000000404,298986.3400000038,-3856.559999999765
26977,2022-09-07 15:05:00,-1066.73,294063.05000000406,298986.3400000038,-4923.289999999746
26978,2022-09-07 15:10:00,1239.69,295302.74000000407,298986.3400000038,-3683.599999999744
26979,2022-09-07 15:15:00,-942.36,294360.3800000041,298986.3400000038,-4625.95999999973
26980,2022-09-07 15:20:00,34.99,294395.37000000407,298986.3400000038,-4590.969999999739
26981,2022-09-07 15:25:00,-788.91,293606.4600000041,298986.3400000038,-5379.879999999714
26982,2022-09-07 15:30:00,65.97,293672.43000000407,298986.3400000038,-5313.909999999742
26983,2022-09-07 15:35:00,1031.67,294704.10000000405,298986.3400000038,-4282.239999999758
26984,2022-09-07 15:40:00,1014.12,295718.22000000405,298986.3400000038,-3268.1199999997625
26985,2022-09-07 15:45:00,674.48,296392.700000004,298986.3400000038,-2593.639999999781
26986,2022-09-07 15:50:00,102.34,296495.04000000405,298986.3400000038,-2491.2999999997555
26987,2022-09-07 15:55:00,-747.36,295747.68000000407,298986.3400000038,-3238.6599999997416
26988,2022-09-07 16:00:00,1854.51,297602.1900000041,298986.3400000038,-1384.1499999997322
26989,2022-09-07 16:05:00,794.66,298396.85000000405,298986.3400000038,-589.4899999997579
26990,2022-09-07 16:10:00,-135.83,298261.02000000403,298986.3400000038,-725.3199999997742
26991,2022-09-07 16:15:00,-168.04,298092.98000000406,298986.3400000038,-893.3599999997532
26992,2022-09-07 16:20:00,-1839.37,296253.61000000406,298986.3400000038,-2732.7299999997485
26993,2022-09-07 16:25:00,1813.96,298067.5700000041,298986.3400000038,-918.7699999997276
26994,2022-09-07 16:30:00,133.25,298200.8200000041,298986.3400000038,-785.5199999997276
26995,2022-09-07 16:35:00,37.81,298238.6300000041,298986.3400000038,-747.7099999997299
26996,2022-09-07 16:40:00,-867.77,297370.86000000406,298986.3400000038,-1615.4799999997485
26997,2022-09-07 16:45:00,-1634.67,295736.1900000041,298986.3400000038,-3250.1499999997322
26998,2022-09-07 16:50:00,-530.55,295205.6400000041,298986.3400000038,-3780.6999999997206
26999,2022-09-07 16:55:00,1012.92,296218.5600000041,298986.3400000038,-2767.779999999737
27000,2022-09-08 08:00:00,-670.77,295547.79000000405,296218.5600000041,-670.7700000000186
27001,2022-09-08 08:05:00,-1707.09,293840.700000004,296218.5600000041,-2377.8600000000442
27002,2022-09-08 08:10:00,346.76,294187.46000000404,296218.5600000041,-2031.100000000035
27003,2022-09-08 08:15:00,1728.66,295916.120000004,296218.5600000041,-302.44000000006054
27004,2022-09-08 08:20:00,-635.31,295280.810000004,296218.5600000041,-937.7500000000582
27005,2022-09-08 08:25:00,67.39,295348.200000004,296218.5600000041,-870.3600000000442
27006,2022-09-08 08:30:00,1891.24,297239.440000004,296218.5600000041,1020.8799999999464
27007,2022-09-08 08:35:00,502.67,297742.110000004,296218.5600000041,1523.5499999999302
27008,2022-09-08 08:40:00,1291.13,299033.240000004,296218.5600000041,2814.679999999935
27009,2022-09-08 08:45:00,-164.18,298869.060000004,296218.5600000041,2650.499999999942
27010,2022-09-08 08:50:00,-1472.72,297396.34000000404,296218.5600000041,1177.7799999999697
27011,2022-09-08 08:55:00,207.8,297604.14000000403,296218.5600000041,1385.579999999958
27012,2022-09-08 09:00:00,1170.38,298774.52000000403,296218.5600000041,2555.9599999999627
27013,2022-09-08 09:05:00,413.31,299187.83000000403,296218.5600000041,2969.2699999999604
27014,2022-09-08 09:10:00,-490.38,298697.450000004,296218.5600000041,2478.8899999999558
27015,2022-09-08 09:15:00,304.02,299001.47000000405,296218.5600000041,2782.9099999999744
27016,2022-09-08 09:20:00,942.43,299943.90000000404,296218.5600000041,3725.3399999999674
27017,2022-09-08 09:25:00,-1973.82,297970.08000000403,296218.5600000041,1751.5199999999604
27018,2022-09-08 09:30:00,-190.43,297779.65000000404,296218.5600000041,1561.0899999999674
27019,2022-09-08 09:35:00,-377.96,297401.690000004,296218.5600000041,1183.1299999999464
27020,2022-09-08 09:40:00,-540.26,296861.430000004,296218.5600000041,642.8699999999371
27021,2022-09-08 09:45:00,-238.41,296623.02000000403,296218.5600000041,404.45999999996275
27022,2022-09-08 09:50:00,262.72,296885.740000004,296218.5600000041,667.1799999999348
27023,2022-09-08 09:55:00,895.69,297781.430000004,296218.5600000041,1562.8699999999371
27024,2022-09-08 10:00:00,55.07,297836.500000004,296218.5600000041,1617.9399999999441
27025,2022-09-08 10:05:00,-204.79,297631.71000000404,296218.5600000041,1413.149999999965
27026,2022-09-08 10:10:00,1941.4,299573.11000000406,296218.5600000041,3354.5499999999884
27027,2022-09-08 10:15:00,-63.83,299509.28000000404,296218.5600000041,3290.719999999972
27028,2022-09-08 10:20:00,-203.51,299305.77000000403,296218.5600000041,3087.2099999999627
27029,2022-09-08 10:25:00,-1399.53,297906.240000004,296218.5600000041,1687.6799999999348
27030,2022-09-08 10:30:00,1436.51,299342.750000004,296218.5600000041,3124.189999999944
27031,2022-09-08 10:35:00,-1263.56,298079.190000004,296218.5600000041,1860.6299999999464
27032,2022-09-08 10:40:00,-1847.6,296231.59000000404,296218.5600000041,13.029999999969732
27033,2022-09-08 10:45:00,-1182.8,295048.79000000405,296218.5600000041,-1169.7700000000186
27034,2022-09-08 10:50:00,255.15,295303.9400000041,296218.5600000041,-914.6199999999953
27035,2022-09-08 10:55:00,-1512.49,293791.4500000041,296218.5600000041,-2427.109999999986
27036,2022-09-08 11:00:00,-1142.58,292648.87000000407,296218.5600000041,-3569.6900000000023
27037,2022-09-08 11:05:00,1389.9,294038.7700000041,296218.5600000041,-2179.789999999979
27038,2022-09-08 11:10:00,729.38,294768.1500000041,296218.5600000041,-1450.4099999999744
27039,2022-09-08 11:15:00,1697.36,296465.5100000041,296218.5600000041,246.95000000001164
27040,2022-09-08 11:20:00,1459.55,297925.0600000041,296218.5600000041,1706.5
27041,2022-09-08 11:25:00,503.56,298428.62000000407,296218.5600000041,2210.0599999999977
27042,2022-09-08 11:30:00,-977.93,297450.6900000041,296218.5600000041,1232.1300000000047
27043,2022-09-08 11:35:00,310.98,297761.67000000406,296218.5600000041,1543.109999999986
27044,2022-09-08 11:40:00,38.71,297800.3800000041,296218.5600000041,1581.820000000007
27045,2022-09-08 11:45:00,-1789.84,296010.54000000405,296218.5600000041,-208.02000000001863
27046,2022-09-08 11:50:00,1092.85,297103.39000000403,296218.5600000041,884.8299999999581
27047,2022-09-08 11:55:00,-660.88,296442.510000004,296218.5600000041,223.94999999995343
27048,2022-09-08 12:00:00,-1107.27,295335.240000004,296218.5600000041,-883.3200000000652
27049,2022-09-08 12:05:00,516.49,295851.730000004,296218.5600000041,-366.8300000000745
27050,2022-09-08 12:10:00,-1170.79,294680.940000004,296218.5600000041,-1537.6200000000536
27051,2022-09-08 12:15:00,1622.19,296303.130000004,296218.5600000041,84.56999999994878
27052,2022-09-08 12:20:00,1989.17,298292.300000004,296218.5600000041,2073.7399999999325
27053,2022-09-08 12:25:00,502.06,298794.360000004,296218.5600000041,2575.79999999993
27054,2022-09-08 12:30:00,1757.29,300551.650000004,296218.5600000041,4333.089999999909
27055,2022-09-08 12:35:00,-573.66,299977.990000004,296218.5600000041,3759.429999999935
27056,2022-09-08 12:40:00,-198.27,299779.720000004,296218.5600000041,3561.159999999916
27057,2022-09-08 12:45:00,-220.55,299559.170000004,296218.5600000041,3340.609999999928
27058,2022-09-08 12:50:00,-1415.1,298144.070000004,296218.5600000041,1925.509999999951
27059,2022-09-08 12:55:00,1635.07,299779.14000000403,296218.5600000041,3560.579999999958
27060,2022-09-08 13:00:00,-1557.29,298221.85000000405,296218.5600000041,2003.289999999979
27061,2022-09-08 13:05:00,187.17,298409.02000000403,296218.5600000041,2190.4599999999627
27062,2022-09-08 13:10:00,-1702.87,296706.15000000404,296218.5600000041,487.5899999999674
27063,2022-09-08 13:15:00,925.99,297632.14000000403,296218.5600000041,1413.579999999958
27064,2022-09-08 13:20:00,385.45,298017.59000000404,296218.5600000041,1799.0299999999697
27065,2022-09-08 13:25:00,670.49,298688.08000000403,296218.5600000041,2469.5199999999604
27066,2022-09-08 13:30:00,-667.45,298020.630000004,296218.5600000041,1802.0699999999488
27067,2022-09-08 13:35:00,-1704.97,296315.66000000405,296218.5600000041,97.09999999997672
27068,2022-09-08 13:40:00,139.7,296455.36000000406,296218.5600000041,236.79999999998836
27069,2022-09-08 13:45:00,-648.28,295807.08000000403,296218.5600000041,-411.4800000000396
27070,2022-09-08 13:50:00,56.18,295863.260000004,296218.5600000041,-355.30000000004657
27071,2022-09-08 13:55:00,1956.37,297819.630000004,296218.5600000041,1601.0699999999488
27072,2022-09-08 14:00:00,-1363.88,296455.750000004,296218.5600000041,237.18999999994412
27073,2022-09-08 14:05:00,1839.92,298295.670000004,296218.5600000041,2077.109999999928
27074,2022-09-08 14:10:00,898.75,299194.420000004,296218.5600000041,2975.859999999928
27075,2022-09-08 14:15:00,507.19,299701.610000004,296218.5600000041,3483.04999999993
27076,2022-09-08 14:20:00,343.78,300045.39000000403,296218.5600000041,3826.829999999958
27077,2022-09-08 14:25:00,-115.11,299930.28000000404,296218.5600000041,3711.719999999972
27078,2022-09-08 14:30:00,-1591.47,298338.8100000041,296218.5600000041,2120.25
27079,2022-09-08 14:35:00,-1188.56,297150.2500000041,296218.5600000041,931.6900000000023
27080,2022-09-08 14:40:00,272.54,297422.79000000405,296218.5600000041,1204.2299999999814
27081,2022-09-08 14:45:00,1948.86,299371.65000000404,296218.5600000041,3153.0899999999674
27082,2022-09-08 14:50:00,1928.19,301299.84000000404,296218.5600000041,5081.27999999997
27083,2022-09-08 14:55:00,1830.43,303130.27000000403,296218.5600000041,6911.709999999963
27084,2022-09-08 15:00:00,-1231.51,301898.760000004,296218.5600000041,5680.199999999953
27085,2022-09-08 15:05:00,1280.49,303179.250000004,296218.5600000041,6960.689999999944
27086,2022-09-08 15:10:00,1710.05,304889.300000004,296218.5600000041,8670.739999999932
27087,2022-09-08 15:15:00,628.12,305517.420000004,296218.5600000041,9298.859999999928
27088,2022-09-08 15:20:00,1920.7,307438.120000004,296218.5600000041,11219.55999999994
27089,2022-09-08 15:25:00,908.88,308347.000000004,296218.5600000041,12128.439999999944
27090,2022-09-08 15:30:00,233.98,308580.980000004,296218.5600000041,12362.419999999925
27091,2022-09-08 15:35:00,37.25,308618.230000004,296218.5600000041,12399.669999999925
27092,2022-09-08 15:40:00,372.46,308990.690000004,296218.5600000041,12772.129999999946
27093,2022-09-08 15:45:00,824.33,309815.02000000403,296218.5600000041,13596.459999999963
27094,2022-09-08 15:50:00,1036.92,310851.940000004,296218.5600000041,14633.379999999946
27095,2022-09-08 15:55:00,-102.09,310749.850000004,296218.5600000041,14531.28999999992
27096,2022-09-08 16:00:00,1408.68,312158.530000004,296218.5600000041,15939.969999999914
27097,2022-09-08 16:05:00,303.2,312461.730000004,296218.5600000041,16243.169999999925
27098,2022-09-08 16:10:00,-645.36,311816.370000004,296218.5600000041,15597.80999999994
27099,2022-09-08 16:15:00,-6.59,311809.780000004,296218.5600000041,15591.219999999914
27100,2022-09-08 16:20:00,-1952.69,309857.090000004,296218.5600000041,13638.529999999912
27101,2022-09-08 16:25:00,365.91,310223.00000000396,296218.5600000041,14004.439999999886
27102,2022-09-08 16:30:00,-1600.78,308622.22000000393,296218.5600000041,12403.659999999858
27103,2022-09-08 16:35:00,-1799.64,306822.5800000039,296218.5600000041,10604.019999999844
27104,2022-09-08 16:40:00,143.34,306965.92000000394,296218.5600000041,10747.35999999987
27105,2022-09-08 16:45:00,1759.18,308725.10000000393,296218.5600000041,12506.539999999863
27106,2022-09-08 16:50:00,1211.42,309936.5200000039,296218.5600000041,13717.959999999846
27107,2022-09-08 16:55:00,-1925.8,308010.72000000393,296218.5600000041,11792.159999999858
27108,2022-09-09 08:00:00,56.65,308067.37000000395,308010.72000000393,56.65000000002328
27109,2022-09-09 08:05:00,502.23,308569.60000000393,308010.72000000393,558.8800000000047
27110,2022-09-09 08:10:00,-1609.65,306959.9500000039,308010.72000000393,-1050.7700000000186
27111,2022-09-09 08:15:00,409.78,307369.73000000394,308010.72000000393,-640.9899999999907
27112,2022-09-09 08:20:00,-1079.85,306289.88000000396,308010.72000000393,-1720.8399999999674
27113,2022-09-09 08:25:00,-1025.25,305264.63000000396,308010.72000000393,-2746.0899999999674
27114,2022-09-09 08:30:00,217.53,305482.160000004,308010.72000000393,-2528.5599999999395
27115,2022-09-09 08:35:00,493.08,305975.240000004,308010.72000000393,-2035.4799999999232
27116,2022-09-09 08:40:00,427.26,306402.500000004,308010.72000000393,-1608.2199999999139
27117,2022-09-09 08:45:00,-749.27,305653.230000004,308010.72000000393,-2357.4899999999325
27118,2022-09-09 08:50:00,553.31,306206.540000004,308010.72000000393,-1804.1799999999348
27119,2022-09-09 08:55:00,685.65,306892.190000004,308010.72000000393,-1118.5299999999115
27120,2022-09-09 09:00:00,614.35,307506.540000004,308010.72000000393,-504.1799999999348
27121,2022-09-09 09:05:00,1930.88,309437.420000004,308010.72000000393,1426.7000000000698
27122,2022-09-09 09:10:00,-633.94,308803.480000004,308010.72000000393,792.7600000000675
27123,2022-09-09 09:15:00,-1995.74,306807.740000004,308010.72000000393,-1202.9799999999232
27124,2022-09-09 09:20:00,-1734.76,305072.980000004,308010.72000000393,-2937.7399999999325
27125,2022-09-09 09:25:00,-185.01,304887.970000004,308010.72000000393,-3122.749999999942
27126,2022-09-09 09:30:00,-77.2,304810.770000004,308010.72000000393,-3199.9499999999534
27127,2022-09-09 09:35:00,-374.47,304436.300000004,308010.72000000393,-3574.4199999999255
27128,2022-09-09 09:40:00,-371.31,304064.990000004,308010.72000000393,-3945.729999999923
27129,2022-09-09 09:45:00,-1646.59,302418.400000004,308010.72000000393,-5592.319999999949
27130,2022-09-09 09:50:00,1333.39,303751.790000004,308010.72000000393,-4258.929999999935
27131,2022-09-09 09:55:00,929.49,304681.280000004,308010.72000000393,-3329.439999999944
27132,2022-09-09 10:00:00,-742.01,303939.270000004,308010.72000000393,-4071.4499999999534
27133,2022-09-09 10:05:00,-1791.17,302148.100000004,308010.72000000393,-5862.619999999937
27134,2022-09-09 10:10:00,271.93,302420.030000004,308010.72000000393,-5590.689999999944
27135,2022-09-09 10:15:00,814.48,303234.51000000397,308010.72000000393,-4776.209999999963
27136,2022-09-09 10:20:00,-1737.59,301496.92000000394,308010.72000000393,-6513.799999999988
27137,2022-09-09 10:25:00,-1310.94,300185.98000000394,308010.72000000393,-7824.739999999991
27138,2022-09-09 10:30:00,-575.47,299610.51000000397,308010.72000000393,-8400.209999999963
27139,2022-09-09 10:35:00,1585.69,301196.20000000397,308010.72000000393,-6814.51999999996
27140,2022-09-09 10:40:00,250.4,301446.600000004,308010.72000000393,-6564.119999999937
27141,2022-09-09 10:45:00,-1569.66,299876.940000004,308010.72000000393,-8133.7799999999115
27142,2022-09-09 10:50:00,927.18,300804.120000004,308010.72000000393,-7206.5999999999185
27143,2022-09-09 10:55:00,1307.7,302111.820000004,308010.72000000393,-5898.899999999907
27144,2022-09-09 11:00:00,1956.72,304068.540000004,308010.72000000393,-3942.179999999935
27145,2022-09-09 11:05:00,746.45,304814.990000004,308010.72000000393,-3195.729999999923
27146,2022-09-09 11:10:00,-207.88,304607.110000004,308010.72000000393,-3403.609999999928
27147,2022-09-09 11:15:00,-904.23,303702.880000004,308010.72000000393,-4307.839999999909
27148,2022-09-09 11:20:00,561.21,304264.09000000404,308010.72000000393,-3746.6299999998882
27149,2022-09-09 11:25:00,-655.77,303608.320000004,308010.72000000393,-4402.399999999907
27150,2022-09-09 11:30:00,1964.28,305572.60000000405,308010.72000000393,-2438.119999999879
27151,2022-09-09 11:35:00,-76.07,305496.53000000404,308010.72000000393,-2514.189999999886
27152,2022-09-09 11:40:00,-1914.42,303582.11000000406,308010.72000000393,-4428.60999999987
27153,2022-09-09 11:45:00,-87.32,303494.79000000405,308010.72000000393,-4515.929999999877
27154,2022-09-09 11:50:00,517.54,304012.33000000403,308010.72000000393,-3998.3899999998976
27155,2022-09-09 11:55:00,-1614.03,302398.300000004,308010.72000000393,-5612.4199999999255
27156,2022-09-09 12:00:00,-1249.87,301148.430000004,308010.72000000393,-6862.289999999921
27157,2022-09-09 12:05:00,1711.26,302859.690000004,308010.72000000393,-5151.0299999999115
27158,2022-09-09 12:10:00,-1602.54,301257.15000000404,308010.72000000393,-6753.569999999891
27159,2022-09-09 12:15:00,1600.34,302857.49000000407,308010.72000000393,-5153.229999999865
27160,2022-09-09 12:20:00,531.0,303388.49000000407,308010.72000000393,-4622.229999999865
27161,2022-09-09 12:25:00,-1829.94,301558.55000000406,308010.72000000393,-6452.169999999867
27162,2022-09-09 12:30:00,149.49,301708.04000000405,308010.72000000393,-6302.679999999877
27163,2022-09-09 12:35:00,1398.01,303106.05000000406,308010.72000000393,-4904.669999999867
27164,2022-09-09 12:40:00,1869.19,304975.24000000407,308010.72000000393,-3035.479999999865
27165,2022-09-09 12:45:00,-1282.41,303692.8300000041,308010.72000000393,-4317.889999999839
27166,2022-09-09 12:50:00,-1430.42,302262.4100000041,308010.72000000393,-5748.309999999823
27167,2022-09-09 12:55:00,1781.0,304043.4100000041,308010.72000000393,-3967.309999999823
27168,2022-09-09 13:00:00,-1355.86,302687.5500000041,308010.72000000393,-5323.169999999809
27169,2022-09-09 13:05:00,-686.26,302001.2900000041,308010.72000000393,-6009.429999999818
27170,2022-09-09 13:10:00,-574.04,301427.25000000413,308010.72000000393,-6583.469999999797
27171,2022-09-09 13:15:00,-1598.24,299829.01000000414,308010.72000000393,-8181.709999999788
27172,2022-09-09 13:20:00,-1058.95,298770.06000000413,308010.72000000393,-9240.6599999998
27173,2022-09-09 13:25:00,-1812.04,296958.02000000415,308010.72000000393,-11052.699999999779
27174,2022-09-09 13:30:00,-354.39,296603.63000000414,308010.72000000393,-11407.089999999793
27175,2022-09-09 13:35:00,-1765.0,294838.63000000414,308010.72000000393,-13172.089999999793
27176,2022-09-09 13:40:00,-1963.23,292875.40000000416,308010.72000000393,-15135.319999999774
27177,2022-09-09 13:45:00,740.62,293616.02000000415,308010.72000000393,-14394.699999999779
27178,2022-09-09 13:50:00,-65.02,293551.00000000413,308010.72000000393,-14459.719999999797
27179,2022-09-09 13:55:00,-1859.05,291691.95000000414,308010.72000000393,-16318.769999999786
27180,2022-09-09 14:00:00,492.94,292184.89000000415,308010.72000000393,-15825.829999999783
27181,2022-09-09 14:05:00,-1979.58,290205.31000000413,308010.72000000393,-17805.4099999998
27182,2022-09-09 14:10:00,-269.93,289935.38000000414,308010.72000000393,-18075.339999999793
27183,2022-09-09 14:15:00,1285.26,291220.64000000415,308010.72000000393,-16790.079999999783
27184,2022-09-09 14:20:00,-1425.35,289795.29000000417,308010.72000000393,-18215.42999999976
27185,2022-09-09 14:25:00,869.45,290664.7400000042,308010.72000000393,-17345.97999999975
27186,2022-09-09 14:30:00,548.79,291213.53000000416,308010.72000000393,-16797.18999999977
27187,2022-09-09 14:35:00,-199.62,291013.91000000417,308010.72000000393,-16996.809999999765
27188,2022-09-09 14:40:00,-178.6,290835.3100000042,308010.72000000393,-17175.40999999974
27189,2022-09-09 14:45:00,1996.4,292831.7100000042,308010.72000000393,-15179.009999999718
27190,2022-09-09 14:50:00,483.09,293314.80000000424,308010.72000000393,-14695.919999999693
27191,2022-09-09 14:55:00,-667.35,292647.45000000426,308010.72000000393,-15363.26999999967
27192,2022-09-09 15:00:00,-1527.36,291120.0900000043,308010.72000000393,-16890.629999999655
27193,2022-09-09 15:05:00,-1712.31,289407.7800000043,308010.72000000393,-18602.939999999653
27194,2022-09-09 15:10:00,673.15,290080.9300000043,308010.72000000393,-17929.78999999963
27195,2022-09-09 15:15:00,929.94,291010.8700000043,308010.72000000393,-16999.849999999627
27196,2022-09-09 15:20:00,-1694.94,289315.9300000043,308010.72000000393,-18694.78999999963
27197,2022-09-09 15:25:00,-1424.64,287891.2900000043,308010.72000000393,-20119.429999999644
27198,2022-09-09 15:30:00,-1498.37,286392.9200000043,308010.72000000393,-21617.79999999964
27199,2022-09-09 15:35:00,1943.5,288336.4200000043,308010.72000000393,-19674.29999999964
27200,2022-09-09 15:40:00,-202.62,288133.8000000043,308010.72000000393,-19876.919999999634
27201,2022-09-09 15:45:00,1087.61,289221.4100000043,308010.72000000393,-18789.30999999965
27202,2022-09-09 15:50:00,552.7,289774.1100000043,308010.72000000393,-18236.609999999637
27203,2022-09-09 15:55:00,-1326.63,288447.4800000043,308010.72000000393,-19563.23999999964
27204,2022-09-09 16:00:00,289.37,288736.8500000043,308010.72000000393,-19273.869999999646
27205,2022-09-09 16:05:00,-481.26,288255.5900000043,308010.72000000393,-19755.129999999655
27206,2022-09-09 16:10:00,661.94,288917.5300000043,308010.72000000393,-19093.189999999653
27207,2022-09-09 16:15:00,-639.08,288278.45000000426,308010.72000000393,-19732.26999999967
27208,2022-09-09 16:20:00,380.26,288658.71000000427,308010.72000000393,-19352.00999999966
27209,2022-09-09 16:25:00,-924.83,287733.88000000425,308010.72000000393,-20276.839999999676
27210,2022-09-09 16:30:00,587.94,288321.82000000426,308010.72000000393,-19688.899999999674
27211,2022-09-09 16:35:00,-548.53,287773.2900000042,308010.72000000393,-20237.429999999702
27212,2022-09-09 16:40:00,1102.85,288876.1400000042,308010.72000000393,-19134.579999999725
27213,2022-09-09 16:45:00,1534.87,290411.0100000042,308010.72000000393,-17599.70999999973
27214,2022-09-09 16:50:00,419.9,290830.9100000042,308010.72000000393,-17179.809999999707
27215,2022-09-09 16:55:00,1603.81,292434.7200000042,308010.72000000393,-15575.999999999709
27216,2022-09-10 08:00:00,1117.09,293551.81000000425,292434.7200000042,1117.0900000000256
27217,2022-09-10 08:05:00,-1005.64,292546.17000000423,292434.7200000042,111.45000000001164
27218,2022-09-10 08:10:00,544.45,293090.62000000424,292434.7200000042,655.9000000000233
27219,2022-09-10 08:15:00,154.63,293245.25000000425,292434.7200000042,810.5300000000279
27220,2022-09-10 08:20:00,322.17,293567.42000000423,292434.7200000042,1132.7000000000116
27221,2022-09-10 08:25:00,-1034.46,292532.9600000042,292434.7200000042,98.23999999999069
27222,2022-09-10 08:30:00,1165.69,293698.6500000042,292434.7200000042,1263.929999999993
27223,2022-09-10 08:35:00,-542.58,293156.0700000042,292434.7200000042,721.3499999999767
27224,2022-09-10 08:40:00,464.86,293620.9300000042,292434.7200000042,1186.2099999999627
27225,2022-09-10 08:45:00,-984.9,292636.03000000416,292434.7200000042,201.30999999993946
27226,2022-09-10 08:50:00,-1649.25,290986.78000000416,292434.7200000042,-1447.9400000000605
27227,2022-09-10 08:55:00,-1174.8,289811.9800000042,292434.7200000042,-2622.740000000049
27228,2022-09-10 09:00:00,1244.3,291056.28000000416,292434.7200000042,-1378.4400000000605
27229,2022-09-10 09:05:00,-135.89,290920.39000000415,292434.7200000042,-1514.3300000000745
27230,2022-09-10 09:10:00,-1795.54,289124.85000000417,292434.7200000042,-3309.8700000000536
27231,2022-09-10 09:15:00,475.42,289600.27000000415,292434.7200000042,-2834.45000000007
27232,2022-09-10 09:20:00,-1758.12,287842.15000000416,292434.7200000042,-4592.570000000065
27233,2022-09-10 09:25:00,631.85,288474.00000000413,292434.7200000042,-3960.7200000000885
27234,2022-09-10 09:30:00,-1056.39,287417.6100000041,292434.7200000042,-5017.110000000102
27235,2022-09-10 09:35:00,1522.31,288939.9200000041,292434.7200000042,-3494.800000000105
27236,2022-09-10 09:40:00,1696.15,290636.07000000414,292434.7200000042,-1798.6500000000815
27237,2022-09-10 09:45:00,-1408.95,289227.1200000041,292434.7200000042,-3207.600000000093
27238,2022-09-10 09:50:00,-1033.84,288193.2800000041,292434.7200000042,-4241.440000000119
27239,2022-09-10 09:55:00,-1834.32,286358.9600000041,292434.7200000042,-6075.760000000126
27240,2022-09-10 10:00:00,1398.32,287757.2800000041,292434.7200000042,-4677.440000000119
27241,2022-09-10 10:05:00,-732.8,287024.4800000041,292434.7200000042,-5410.240000000107
27242,2022-09-10 10:10:00,-853.31,286171.1700000041,292434.7200000042,-6263.550000000105
27243,2022-09-10 10:15:00,-1937.11,284234.06000000413,292434.7200000042,-8200.66000000009
27244,2022-09-10 10:20:00,-251.56,283982.50000000413,292434.7200000042,-8452.220000000088
27245,2022-09-10 10:25:00,1663.8,285646.3000000041,292434.7200000042,-6788.4200000001
27246,2022-09-10 10:30:00,1181.78,286828.08000000415,292434.7200000042,-5606.640000000072
27247,2022-09-10 10:35:00,-643.91,286184.1700000042,292434.7200000042,-6250.550000000047
27248,2022-09-10 10:40:00,-1482.84,284701.33000000415,292434.7200000042,-7733.390000000072
27249,2022-09-10 10:45:00,-818.14,283883.19000000414,292434.7200000042,-8551.530000000086
27250,2022-09-10 10:50:00,-1230.64,282652.5500000041,292434.7200000042,-9782.1700000001
27251,2022-09-10 10:55:00,1437.75,284090.3000000041,292434.7200000042,-8344.4200000001
27252,2022-09-10 11:00:00,749.17,284839.4700000041,292434.7200000042,-7595.250000000116
27253,2022-09-10 11:05:00,266.43,285105.9000000041,292434.7200000042,-7328.820000000123
27254,2022-09-10 11:10:00,-1780.78,283325.12000000407,292434.7200000042,-9109.600000000151
27255,2022-09-10 11:15:00,1495.69,284820.8100000041,292434.7200000042,-7613.910000000149
27256,2022-09-10 11:20:00,1928.6,286749.41000000405,292434.7200000042,-5685.310000000172
27257,2022-09-10 11:25:00,-248.66,286500.7500000041,292434.7200000042,-5933.970000000147
27258,2022-09-10 11:30:00,1446.54,287947.29000000405,292434.7200000042,-4487.430000000168
27259,2022-09-10 11:35:00,187.46,288134.7500000041,292434.7200000042,-4299.970000000147
27260,2022-09-10 11:40:00,656.06,288790.8100000041,292434.7200000042,-3643.910000000149
27261,2022-09-10 11:45:00,-1029.56,287761.2500000041,292434.7200000042,-4673.470000000147
27262,2022-09-10 11:50:00,1263.55,289024.80000000406,292434.7200000042,-3409.9200000001583
27263,2022-09-10 11:55:00,-943.79,288081.0100000041,292434.7200000042,-4353.710000000137
27264,2022-09-10 12:00:00,1426.28,289507.2900000041,292434.7200000042,-2927.4300000001094
27265,2022-09-10 12:05:00,-375.14,289132.1500000041,292434.7200000042,-3302.5700000001234
27266,2022-09-10 12:10:00,118.58,289250.7300000041,292434.7200000042,-3183.990000000107
27267,2022-09-10 12:15:00,-1060.74,288189.9900000041,292434.7200000042,-4244.730000000098
27268,2022-09-10 12:20:00,-875.86,287314.13000000414,292434.7200000042,-5120.590000000084
27269,2022-09-10 12:25:00,-234.5,287079.63000000414,292434.7200000042,-5355.090000000084
27270,2022-09-10 12:30:00,218.74,287298.3700000041,292434.7200000042,-5136.350000000093
27271,2022-09-10 12:35:00,1834.82,289133.19000000414,292434.7200000042,-3301.530000000086
27272,2022-09-10 12:40:00,-1855.12,287278.07000000414,292434.7200000042,-5156.6500000000815
27273,2022-09-10 12:45:00,-1008.09,286269.9800000041,292434.7200000042,-6164.740000000107
27274,2022-09-10 12:50:00,893.15,287163.13000000414,292434.7200000042,-5271.590000000084
27275,2022-09-10 12:55:00,-1238.02,285925.1100000041,292434.7200000042,-6509.610000000102
27276,2022-09-10 13:00:00,-1791.18,284133.9300000041,292434.7200000042,-8300.790000000095
27277,2022-09-10 13:05:00,1537.69,285671.6200000041,292434.7200000042,-6763.100000000093
27278,2022-09-10 13:10:00,1031.53,286703.15000000416,292434.7200000042,-5731.570000000065
27279,2022-09-10 13:15:00,-721.71,285981.44000000414,292434.7200000042,-6453.280000000086
27280,2022-09-10 13:20:00,-1402.72,284578.72000000416,292434.7200000042,-7856.000000000058
27281,2022-09-10 13:25:00,1891.33,286470.0500000042,292434.7200000042,-5964.670000000042
27282,2022-09-10 13:30:00,-1472.91,284997.1400000042,292434.7200000042,-7437.580000000016
27283,2022-09-10 13:35:00,1256.58,286253.7200000042,292434.7200000042,-6181.0
27284,2022-09-10 13:40:00,1571.4,287825.12000000424,292434.7200000042,-4609.599999999977
27285,2022-09-10 13:45:00,-149.27,287675.8500000042,292434.7200000042,-4758.869999999995
27286,2022-09-10 13:50:00,1787.54,289463.3900000042,292434.7200000042,-2971.3300000000163
27287,2022-09-10 13:55:00,1767.61,291231.0000000042,292434.7200000042,-1203.7200000000303
27288,2022-09-10 14:00:00,-530.79,290700.2100000042,292434.7200000042,-1734.5100000000093
27289,2022-09-10 14:05:00,-1408.38,289291.8300000042,292434.7200000042,-3142.890000000014
27290,2022-09-10 14:10:00,-813.46,288478.3700000042,292434.7200000042,-3956.350000000035
27291,2022-09-10 14:15:00,1188.55,289666.9200000042,292434.7200000042,-2767.8000000000466
27292,2022-09-10 14:20:00,1906.66,291573.58000000415,292434.7200000042,-861.1400000000722
27293,2022-09-10 14:25:00,448.71,292022.29000000417,292434.7200000042,-412.4300000000512
27294,2022-09-10 14:30:00,-474.55,291547.7400000042,292434.7200000042,-886.9800000000396
27295,2022-09-10 14:35:00,727.88,292275.6200000042,292434.7200000042,-159.10000000003492
27296,2022-09-10 14:40:00,-896.52,291379.10000000417,292434.7200000042,-1055.6200000000536
27297,2022-09-10 14:45:00,-454.64,290924.46000000415,292434.7200000042,-1510.2600000000675
27298,2022-09-10 14:50:00,1738.76,292663.22000000416,292434.7200000042,228.4999999999418
27299,2022-09-10 14:55:00,-1537.71,291125.51000000414,292434.7200000042,-1309.2100000000792
27300,2022-09-10 15:00:00,-1105.47,290020.04000000417,292434.7200000042,-2414.680000000051
27301,2022-09-10 15:05:00,250.8,290270.84000000416,292434.7200000042,-2163.880000000063
27302,2022-09-10 15:10:00,1367.22,291638.06000000413,292434.7200000042,-796.6600000000908
27303,2022-09-10 15:15:00,1676.64,293314.70000000414,292434.7200000042,879.9799999999232
27304,2022-09-10 15:20:00,-447.28,292867.4200000041,292434.7200000042,432.6999999998952
27305,2022-09-10 15:25:00,-229.76,292637.6600000041,292434.7200000042,202.9399999998859
27306,2022-09-10 15:30:00,1150.35,293788.0100000041,292434.7200000042,1353.2899999998626
27307,2022-09-10 15:35:00,-1245.9,292542.11000000406,292434.7200000042,107.38999999983935
27308,2022-09-10 15:40:00,-606.16,291935.9500000041,292434.7200000042,-498.77000000013504
27309,2022-09-10 15:45:00,-923.09,291012.86000000406,292434.7200000042,-1421.8600000001607
27310,2022-09-10 15:50:00,1382.13,292394.99000000407,292434.7200000042,-39.730000000156
27311,2022-09-10 15:55:00,-1614.5,290780.49000000407,292434.7200000042,-1654.230000000156
27312,2022-09-10 16:00:00,1707.52,292488.0100000041,292434.7200000042,53.28999999986263
27313,2022-09-10 16:05:00,-838.45,291649.5600000041,292434.7200000042,-785.160000000149
27314,2022-09-10 16:10:00,1359.63,293009.1900000041,292434.7200000042,574.4699999998556
27315,2022-09-10 16:15:00,1706.63,294715.8200000041,292434.7200000042,2281.0999999998603
27316,2022-09-10 16:20:00,-468.74,294247.0800000041,292434.7200000042,1812.3599999998696
27317,2022-09-10 16:25:00,930.92,295178.0000000041,292434.7200000042,2743.2799999998533
27318,2022-09-10 16:30:00,1745.71,296923.7100000041,292434.7200000042,4488.989999999874
27319,2022-09-10 16:35:00,-822.86,296100.8500000041,292434.7200000042,3666.1299999998882
27320,2022-09-10 16:40:00,1944.53,298045.38000000414,292434.7200000042,5610.659999999916
27321,2022-09-10 16:45:00,1385.94,299431.32000000414,292434.7200000042,6996.5999999999185
27322,2022-09-10 16:50:00,-1182.26,298249.06000000413,292434.7200000042,5814.339999999909
27323,2022-09-10 16:55:00,-685.17,297563.89000000415,292434.7200000042,5129.1699999999255
27324,2022-09-11 08:00:00,33.27,297597.16000000417,297563.89000000415,33.27000000001863
27325,2022-09-11 08:05:00,-1721.7,295875.46000000415,297563.89000000415,-1688.429999999993
27326,2022-09-11 08:10:00,1540.48,297415.94000000414,297563.89000000415,-147.95000000001164
27327,2022-09-11 08:15:00,1115.7,298531.64000000415,297563.89000000415,967.75
27328,2022-09-11 08:20:00,-1345.84,297185.8000000041,297563.89000000415,-378.0900000000256
27329,2022-09-11 08:25:00,-1271.4,295914.4000000041,297563.89000000415,-1649.490000000049
27330,2022-09-11 08:30:00,-452.44,295461.9600000041,297563.89000000415,-2101.930000000051
27331,2022-09-11 08:35:00,1090.6,296552.5600000041,297563.89000000415,-1011.3300000000745
27332,2022-09-11 08:40:00,1835.97,298388.53000000404,297563.89000000415,824.6399999998976
27333,2022-09-11 08:45:00,1712.79,300101.320000004,297563.89000000415,2537.4299999998766
27334,2022-09-11 08:50:00,-71.49,300029.83000000403,297563.89000000415,2465.939999999886
27335,2022-09-11 08:55:00,1758.37,301788.200000004,297563.89000000415,4224.309999999881
27336,2022-09-11 09:00:00,624.64,302412.84000000404,297563.89000000415,4848.949999999895
27337,2022-09-11 09:05:00,-171.17,302241.67000000406,297563.89000000415,4677.7799999999115
27338,2022-09-11 09:10:00,-1892.46,300349.21000000404,297563.89000000415,2785.3199999998906
27339,2022-09-11 09:15:00,-539.3,299809.91000000405,297563.89000000415,2246.019999999902
27340,2022-09-11 09:20:00,521.37,300331.28000000404,297563.89000000415,2767.3899999998976
27341,2022-09-11 09:25:00,-1264.45,299066.83000000403,297563.89000000415,1502.939999999886
27342,2022-09-11 09:30:00,-1031.97,298034.86000000406,297563.89000000415,470.96999999991385
27343,2022-09-11 09:35:00,-312.12,297722.74000000407,297563.89000000415,158.8499999999185
27344,2022-09-11 09:40:00,-10.86,297711.8800000041,297563.89000000415,147.98999999993248
27345,2022-09-11 09:45:00,-1512.18,296199.7000000041,297563.89000000415,-1364.1900000000605
27346,2022-09-11 09:50:00,-273.91,295925.7900000041,297563.89000000415,-1638.100000000035
27347,2022-09-11 09:55:00,1350.93,297276.7200000041,297563.89000000415,-287.1700000000419
27348,2022-09-11 10:00:00,57.9,297334.6200000041,297563.89000000415,-229.27000000001863
27349,2022-09-11 10:05:00,-1314.34,296020.2800000041,297563.89000000415,-1543.6100000000442
27350,2022-09-11 10:10:00,-228.67,295791.6100000041,297563.89000000415,-1772.280000000028
27351,2022-09-11 10:15:00,23.93,295815.5400000041,297563.89000000415,-1748.350000000035
27352,2022-09-11 10:20:00,-1104.46,294711.0800000041,297563.89000000415,-2852.810000000056
27353,2022-09-11 10:25:00,-627.32,294083.7600000041,297563.89000000415,-3480.130000000063
27354,2022-09-11 10:30:00,818.18,294901.9400000041,297563.89000000415,-2661.95000000007
27355,2022-09-11 10:35:00,560.77,295462.7100000041,297563.89000000415,-2101.180000000051
27356,2022-09-11 10:40:00,-1367.08,294095.6300000041,297563.89000000415,-3468.2600000000675
27357,2022-09-11 10:45:00,-415.47,293680.1600000041,297563.89000000415,-3883.7300000000396
27358,2022-09-11 10:50:00,1265.75,294945.9100000041,297563.89000000415,-2617.9800000000396
27359,2022-09-11 10:55:00,1305.06,296250.9700000041,297563.89000000415,-1312.920000000042
27360,2022-09-11 11:00:00,1758.37,298009.3400000041,297563.89000000415,445.44999999995343
27361,2022-09-11 11:05:00,-1494.78,296514.5600000041,297563.89000000415,-1049.3300000000745
27362,2022-09-11 11:10:00,-1326.19,295188.37000000407,297563.89000000415,-2375.520000000077
27363,2022-09-11 11:15:00,-771.56,294416.8100000041,297563.89000000415,-3147.0800000000745
27364,2022-09-11 11:20:00,-976.29,293440.5200000041,297563.89000000415,-4123.370000000054
27365,2022-09-11 11:25:00,-1773.31,291667.2100000041,297563.89000000415,-5896.680000000051
27366,2022-09-11 11:30:00,-1554.21,290113.0000000041,297563.89000000415,-7450.890000000072
27367,2022-09-11 11:35:00,8.42,290121.42000000406,297563.89000000415,-7442.4700000000885
27368,2022-09-11 11:40:00,-688.08,289433.34000000404,297563.89000000415,-8130.550000000105
27369,2022-09-11 11:45:00,-1465.43,287967.91000000405,297563.89000000415,-9595.980000000098
27370,2022-09-11 11:50:00,-1891.38,286076.53000000404,297563.89000000415,-11487.360000000102
27371,2022-09-11 11:55:00,-853.85,285222.68000000407,297563.89000000415,-12341.21000000008
27372,2022-09-11 12:00:00,287.39,285510.0700000041,297563.89000000415,-12053.820000000065
27373,2022-09-11 12:05:00,842.53,286352.6000000041,297563.89000000415,-11211.290000000037
27374,2022-09-11 12:10:00,812.91,287165.5100000041,297563.89000000415,-10398.380000000063
27375,2022-09-11 12:15:00,-1542.82,285622.6900000041,297563.89000000415,-11941.20000000007
27376,2022-09-11 12:20:00,1469.31,287092.0000000041,297563.89000000415,-10471.890000000072
27377,2022-09-11 12:25:00,-301.51,286790.49000000407,297563.89000000415,-10773.400000000081
27378,2022-09-11 12:30:00,1378.24,288168.73000000406,297563.89000000415,-9395.16000000009
27379,2022-09-11 12:35:00,742.36,288911.09000000404,297563.89000000415,-8652.800000000105
27380,2022-09-11 12:40:00,-422.66,288488.43000000407,297563.89000000415,-9075.46000000008
27381,2022-09-11 12:45:00,1248.37,289736.80000000406,297563.89000000415,-7827.090000000084
27382,2022-09-11 12:50:00,160.85,289897.65000000404,297563.89000000415,-7666.240000000107
27383,2022-09-11 12:55:00,1378.16,291275.810000004,297563.89000000415,-6288.080000000133
27384,2022-09-11 13:00:00,661.81,291937.620000004,297563.89000000415,-5626.270000000135
27385,2022-09-11 13:05:00,1876.88,293814.500000004,297563.89000000415,-3749.3900000001304
27386,2022-09-11 13:10:00,-1162.86,292651.64000000403,297563.89000000415,-4912.250000000116
27387,2022-09-11 13:15:00,-524.54,292127.10000000405,297563.89000000415,-5436.7900000000955
27388,2022-09-11 13:20:00,-1547.63,290579.47000000405,297563.89000000415,-6984.4200000001
27389,2022-09-11 13:25:00,1723.24,292302.71000000404,297563.89000000415,-5261.180000000109
27390,2022-09-11 13:30:00,-567.44,291735.27000000403,297563.89000000415,-5828.620000000112
27391,2022-09-11 13:35:00,-1667.08,290068.190000004,297563.89000000415,-7495.700000000128
27392,2022-09-11 13:40:00,703.9,290772.09000000404,297563.89000000415,-6791.800000000105
27393,2022-09-11 13:45:00,898.56,291670.65000000404,297563.89000000415,-5893.240000000107
27394,2022-09-11 13:50:00,-1015.78,290654.870000004,297563.89000000415,-6909.020000000135
27395,2022-09-11 13:55:00,-1793.49,288861.380000004,297563.89000000415,-8702.510000000126
27396,2022-09-11 14:00:00,1699.55,290560.930000004,297563.89000000415,-7002.960000000137
27397,2022-09-11 14:05:00,-828.5,289732.430000004,297563.89000000415,-7831.460000000137
27398,2022-09-11 14:10:00,1317.05,291049.480000004,297563.89000000415,-6514.410000000149
27399,2022-09-11 14:15:00,1652.13,292701.610000004,297563.89000000415,-4862.280000000144
27400,2022-09-11 14:20:00,-693.98,292007.630000004,297563.89000000415,-5556.260000000126
27401,2022-09-11 14:25:00,-916.94,291090.690000004,297563.89000000415,-6473.200000000128
27402,2022-09-11 14:30:00,1300.27,292390.96000000404,297563.89000000415,-5172.930000000109
27403,2022-09-11 14:35:00,121.0,292511.96000000404,297563.89000000415,-5051.930000000109
27404,2022-09-11 14:40:00,-959.17,291552.79000000405,297563.89000000415,-6011.100000000093
27405,2022-09-11 14:45:00,722.97,292275.760000004,297563.89000000415,-5288.130000000121
27406,2022-09-11 14:50:00,-1807.64,290468.120000004,297563.89000000415,-7095.770000000135
27407,2022-09-11 14:55:00,434.54,290902.660000004,297563.89000000415,-6661.230000000156
27408,2022-09-11 15:00:00,982.73,291885.390000004,297563.89000000415,-5678.500000000175
27409,2022-09-11 15:05:00,1829.25,293714.640000004,297563.89000000415,-3849.2500000001746
27410,2022-09-11 15:10:00,-703.64,293011.00000000396,297563.89000000415,-4552.890000000189
27411,2022-09-11 15:15:00,1901.37,294912.37000000395,297563.89000000415,-2651.5200000001932
27412,2022-09-11 15:20:00,-1537.39,293374.98000000394,297563.89000000415,-4188.910000000207
27413,2022-09-11 15:25:00,1577.65,294952.63000000396,297563.89000000415,-2611.260000000184
27414,2022-09-11 15:30:00,183.63,295136.26000000397,297563.89000000415,-2427.6300000001793
27415,2022-09-11 15:35:00,-1086.2,294050.06000000396,297563.89000000415,-3513.830000000191
27416,2022-09-11 15:40:00,1226.05,295276.11000000394,297563.89000000415,-2287.7800000002026
27417,2022-09-11 15:45:00,-1862.89,293413.22000000393,297563.89000000415,-4150.6700000002165
27418,2022-09-11 15:50:00,132.7,293545.92000000394,297563.89000000415,-4017.970000000205
27419,2022-09-11 15:55:00,1899.34,295445.26000000397,297563.89000000415,-2118.6300000001793
27420,2022-09-11 16:00:00,429.62,295874.88000000396,297563.89000000415,-1689.010000000184
27421,2022-09-11 16:05:00,-814.34,295060.54000000394,297563.89000000415,-2503.3500000002095
27422,2022-09-11 16:10:00,-1235.59,293824.9500000039,297563.89000000415,-3738.940000000235
27423,2022-09-11 16:15:00,901.88,294726.8300000039,297563.89000000415,-2837.0600000002305
27424,2022-09-11 16:20:00,1349.16,296075.9900000039,297563.89000000415,-1487.9000000002561
27425,2022-09-11 16:25:00,1125.89,297201.8800000039,297563.89000000415,-362.01000000024214
27426,2022-09-11 16:30:00,-624.54,296577.3400000039,297563.89000000415,-986.5500000002212
27427,2022-09-11 16:35:00,-792.36,295784.98000000394,297563.89000000415,-1778.9100000002072
27428,2022-09-11 16:40:00,-993.6,294791.38000000396,297563.89000000415,-2772.510000000184
27429,2022-09-11 16:45:00,-1314.37,293477.01000000397,297563.89000000415,-4086.8800000001793
27430,2022-09-11 16:50:00,-742.6,292734.410000004,297563.89000000415,-4829.480000000156
27431,2022-09-11 16:55:00,17.63,292752.040000004,297563.89000000415,-4811.850000000151
27432,2022-09-12 08:00:00,113.21,292865.250000004,292752.040000004,113.21000000002095
27433,2022-09-12 08:05:00,1232.17,294097.420000004,292752.040000004,1345.3800000000047
27434,2022-09-12 08:10:00,-206.53,293890.890000004,292752.040000004,1138.8499999999767
27435,2022-09-12 08:15:00,1492.43,295383.32000000397,292752.040000004,2631.2799999999697
27436,2022-09-12 08:20:00,857.91,296241.23000000394,292752.040000004,3489.189999999944
27437,2022-09-12 08:25:00,-1998.27,294242.9600000039,292752.040000004,1490.9199999999255
27438,2022-09-12 08:30:00,65.38,294308.3400000039,292752.040000004,1556.2999999999302
27439,2022-09-12 08:35:00,-140.95,294167.3900000039,292752.040000004,1415.3499999999185
27440,2022-09-12 08:40:00,1736.06,295903.4500000039,292752.040000004,3151.409999999916
27441,2022-09-12 08:45:00,951.38,296854.8300000039,292752.040000004,4102.789999999921
27442,2022-09-12 08:50:00,1997.81,298852.6400000039,292752.040000004,6100.5999999999185
27443,2022-09-12 08:55:00,59.82,298912.4600000039,292752.040000004,6160.4199999999255
27444,2022-09-12 09:00:00,-1468.44,297444.0200000039,292752.040000004,4691.979999999923
27445,2022-09-12 09:05:00,-1964.4,295479.6200000039,292752.040000004,2727.5799999999
27446,2022-09-12 09:10:00,740.34,296219.9600000039,292752.040000004,3467.9199999999255
27447,2022-09-12 09:15:00,1623.93,297843.8900000039,292752.040000004,5091.8499999999185
27448,2022-09-12 09:20:00,-1254.72,296589.17000000394,292752.040000004,3837.1299999999464
27449,2022-09-12 09:25:00,-1850.02,294739.1500000039,292752.040000004,1987.1099999999278
27450,2022-09-12 09:30:00,-1457.27,293281.8800000039,292752.040000004,529.8399999999092
27451,2022-09-12 09:35:00,407.09,293688.97000000393,292752.040000004,936.9299999999348
27452,2022-09-12 09:40:00,-967.21,292721.7600000039,292752.040000004,-30.280000000086147
27453,2022-09-12 09:45:00,1240.07,293961.8300000039,292752.040000004,1209.7899999999208
27454,2022-09-12 09:50:00,-1209.16,292752.67000000394,292752.040000004,0.629999999946449
27455,2022-09-12 09:55:00,350.37,293103.04000000394,292752.040000004,350.9999999999418
27456,2022-09-12 10:00:00,-900.55,292202.49000000395,292752.040000004,-549.5500000000466
27457,2022-09-12 10:05:00,-343.46,291859.0300000039,292752.040000004,-893.0100000000675
27458,2022-09-12 10:10:00,68.61,291927.6400000039,292752.040000004,-824.4000000000815
27459,2022-09-12 10:15:00,-1494.5,290433.1400000039,292752.040000004,-2318.9000000000815
27460,2022-09-12 10:20:00,-1106.44,289326.7000000039,292752.040000004,-3425.340000000084
27461,2022-09-12 10:25:00,1255.34,290582.04000000394,292752.040000004,-2170.000000000058
27462,2022-09-12 10:30:00,643.4,291225.44000000396,292752.040000004,-1526.600000000035
27463,2022-09-12 10:35:00,-1292.37,289933.07000000397,292752.040000004,-2818.9700000000303
27464,2022-09-12 10:40:00,-1945.23,287987.840000004,292752.040000004,-4764.200000000012
27465,2022-09-12 10:45:00,69.02,288056.860000004,292752.040000004,-4695.179999999993
27466,2022-09-12 10:50:00,426.01,288482.870000004,292752.040000004,-4269.169999999984
27467,2022-09-12 10:55:00,-712.26,287770.610000004,292752.040000004,-4981.429999999993
27468,2022-09-12 11:00:00,1519.75,289290.360000004,292752.040000004,-3461.679999999993
27469,2022-09-12 11:05:00,49.7,289340.060000004,292752.040000004,-3411.9799999999814
27470,2022-09-12 11:10:00,81.87,289421.930000004,292752.040000004,-3330.109999999986
27471,2022-09-12 11:15:00,1461.35,290883.280000004,292752.040000004,-1868.7600000000093
27472,2022-09-12 11:20:00,-1439.36,289443.920000004,292752.040000004,-3308.1199999999953
27473,2022-09-12 11:25:00,-177.46,289266.460000004,292752.040000004,-3485.5800000000163
27474,2022-09-12 11:30:00,198.35,289464.81000000396,292752.040000004,-3287.2300000000396
27475,2022-09-12 11:35:00,593.05,290057.86000000394,292752.040000004,-2694.180000000051
27476,2022-09-12 11:40:00,-1963.38,288094.48000000394,292752.040000004,-4657.560000000056
27477,2022-09-12 11:45:00,-886.17,287208.31000000396,292752.040000004,-5543.73000000004
27478,2022-09-12 11:50:00,-14.16,287194.150000004,292752.040000004,-5557.890000000014
27479,2022-09-12 11:55:00,-1293.23,285900.920000004,292752.040000004,-6851.119999999995
27480,2022-09-12 12:00:00,-1976.2,283924.720000004,292752.040000004,-8827.320000000007
27481,2022-09-12 12:05:00,1707.5,285632.220000004,292752.040000004,-7119.820000000007
27482,2022-09-12 12:10:00,1487.29,287119.51000000397,292752.040000004,-5632.530000000028
27483,2022-09-12 12:15:00,-11.63,287107.88000000396,292752.040000004,-5644.160000000033
27484,2022-09-12 12:20:00,814.36,287922.24000000395,292752.040000004,-4829.800000000047
27485,2022-09-12 12:25:00,1964.96,289887.20000000397,292752.040000004,-2864.8400000000256
27486,2022-09-12 12:30:00,-1648.99,288238.210000004,292752.040000004,-4513.830000000016
27487,2022-09-12 12:35:00,-445.21,287793.00000000396,292752.040000004,-4959.040000000037
27488,2022-09-12 12:40:00,693.37,288486.37000000395,292752.040000004,-4265.670000000042
27489,2022-09-12 12:45:00,-215.98,288270.390000004,292752.040000004,-4481.650000000023
27490,2022-09-12 12:50:00,-1974.83,286295.56000000396,292752.040000004,-6456.48000000004
27491,2022-09-12 12:55:00,-436.24,285859.32000000397,292752.040000004,-6892.72000000003
27492,2022-09-12 13:00:00,-1970.8,283888.520000004,292752.040000004,-8863.520000000019
27493,2022-09-12 13:05:00,897.99,284786.51000000397,292752.040000004,-7965.530000000028
27494,2022-09-12 13:10:00,1076.27,285862.780000004,292752.040000004,-6889.260000000009
27495,2022-09-12 13:15:00,-1526.59,284336.19000000396,292752.040000004,-8415.850000000035
27496,2022-09-12 13:20:00,-165.93,284170.26000000397,292752.040000004,-8581.780000000028
27497,2022-09-12 13:25:00,-1419.53,282750.73000000394,292752.040000004,-10001.310000000056
27498,2022-09-12 13:30:00,-1645.18,281105.55000000395,292752.040000004,-11646.490000000049
27499,2022-09-12 13:35:00,1497.98,282603.5300000039,292752.040000004,-10148.510000000068
27500,2022-09-12 13:40:00,1971.96,284575.49000000395,292752.040000004,-8176.550000000047
27501,2022-09-12 13:45:00,1708.48,286283.97000000393,292752.040000004,-6468.070000000065
27502,2022-09-12 13:50:00,-262.27,286021.7000000039,292752.040000004,-6730.340000000084
27503,2022-09-12 13:55:00,-339.15,285682.5500000039,292752.040000004,-7069.490000000107
27504,2022-09-12 14:00:00,-1940.85,283741.7000000039,292752.040000004,-9010.340000000084
27505,2022-09-12 14:05:00,1850.16,285591.8600000039,292752.040000004,-7160.180000000109
27506,2022-09-12 14:10:00,6.61,285598.4700000039,292752.040000004,-7153.570000000123
27507,2022-09-12 14:15:00,-299.97,285298.5000000039,292752.040000004,-7453.5400000000955
27508,2022-09-12 14:20:00,-278.86,285019.6400000039,292752.040000004,-7732.4000000000815
27509,2022-09-12 14:25:00,653.65,285673.29000000394,292752.040000004,-7078.750000000058
27510,2022-09-12 14:30:00,-858.88,284814.41000000393,292752.040000004,-7937.630000000063
27511,2022-09-12 14:35:00,513.87,285328.2800000039,292752.040000004,-7423.7600000000675
27512,2022-09-12 14:40:00,1562.44,286890.72000000393,292752.040000004,-5861.320000000065
27513,2022-09-12 14:45:00,-766.81,286123.91000000393,292752.040000004,-6628.130000000063
27514,2022-09-12 14:50:00,-1874.67,284249.24000000395,292752.040000004,-8502.800000000047
27515,2022-09-12 14:55:00,920.77,285170.01000000397,292752.040000004,-7582.030000000028
27516,2022-09-12 15:00:00,734.39,285904.400000004,292752.040000004,-6847.640000000014
27517,2022-09-12 15:05:00,-584.17,285320.230000004,292752.040000004,-7431.809999999998
27518,2022-09-12 15:10:00,-1200.9,284119.330000004,292752.040000004,-8632.710000000021
27519,2022-09-12 15:15:00,-1508.84,282610.49000000395,292752.040000004,-10141.550000000047
27520,2022-09-12 15:20:00,-174.73,282435.76000000397,292752.040000004,-10316.280000000028
27521,2022-09-12 15:25:00,1464.92,283900.68000000395,292752.040000004,-8851.360000000044
27522,2022-09-12 15:30:00,485.16,284385.8400000039,292752.040000004,-8366.20000000007
27523,2022-09-12 15:35:00,-163.99,284221.85000000393,292752.040000004,-8530.19000000006
27524,2022-09-12 15:40:00,-1146.14,283075.7100000039,292752.040000004,-9676.330000000075
27525,2022-09-12 15:45:00,-1109.66,281966.05000000395,292752.040000004,-10785.990000000049
27526,2022-09-12 15:50:00,861.01,282827.06000000396,292752.040000004,-9924.98000000004
27527,2022-09-12 15:55:00,-329.77,282497.29000000394,292752.040000004,-10254.750000000058
27528,2022-09-12 16:00:00,1657.91,284155.2000000039,292752.040000004,-8596.840000000084
27529,2022-09-12 16:05:00,-621.06,283534.1400000039,292752.040000004,-9217.900000000081
27530,2022-09-12 16:10:00,-311.41,283222.73000000394,292752.040000004,-9529.310000000056
27531,2022-09-12 16:15:00,288.95,283511.68000000395,292752.040000004,-9240.360000000044
27532,2022-09-12 16:20:00,-926.51,282585.17000000394,292752.040000004,-10166.870000000054
27533,2022-09-12 16:25:00,1876.92,284462.0900000039,292752.040000004,-8289.95000000007
27534,2022-09-12 16:30:00,1894.37,286356.4600000039,292752.040000004,-6395.5800000000745
27535,2022-09-12 16:35:00,1409.8,287766.2600000039,292752.040000004,-4985.780000000086
27536,2022-09-12 16:40:00,1150.48,288916.7400000039,292752.040000004,-3835.300000000105
27537,2022-09-12 16:45:00,-973.45,287943.2900000039,292752.040000004,-4808.750000000116
27538,2022-09-12 16:50:00,1151.96,289095.2500000039,292752.040000004,-3656.7900000000955
27539,2022-09-12 16:55:00,-650.48,288444.7700000039,292752.040000004,-4307.270000000077
27540,2022-09-13 08:00:00,1729.87,290174.6400000039,288444.7700000039,1729.8699999999953
27541,2022-09-13 08:05:00,-514.64,289660.0000000039,288444.7700000039,1215.2299999999814
27542,2022-09-13 08:10:00,1455.91,291115.9100000039,288444.7700000039,2671.1399999999558
27543,2022-09-13 08:15:00,1011.67,292127.58000000386,288444.7700000039,3682.8099999999395
27544,2022-09-13 08:20:00,-1534.76,290592.82000000385,288444.7700000039,2148.04999999993
27545,2022-09-13 08:25:00,1738.31,292331.13000000385,288444.7700000039,3886.359999999928
27546,2022-09-13 08:30:00,-842.45,291488.68000000383,288444.7700000039,3043.909999999916
27547,2022-09-13 08:35:00,-339.99,291148.69000000384,288444.7700000039,2703.9199999999255
27548,2022-09-13 08:40:00,-897.09,290251.6000000038,288444.7700000039,1806.8299999998999
27549,2022-09-13 08:45:00,1688.36,291939.9600000038,288444.7700000039,3495.189999999886
27550,2022-09-13 08:50:00,624.72,292564.6800000038,288444.7700000039,4119.909999999858
27551,2022-09-13 08:55:00,1937.78,294502.4600000038,288444.7700000039,6057.689999999886
27552,2022-09-13 09:00:00,1611.78,296114.24000000383,288444.7700000039,7669.469999999914
27553,2022-09-13 09:05:00,1569.15,297683.39000000386,288444.7700000039,9238.619999999937
27554,2022-09-13 09:10:00,552.26,298235.65000000386,288444.7700000039,9790.879999999946
27555,2022-09-13 09:15:00,-1843.62,296392.03000000387,288444.7700000039,7947.259999999951
27556,2022-09-13 09:20:00,1869.15,298261.1800000039,288444.7700000039,9816.409999999974
27557,2022-09-13 09:25:00,573.5,298834.6800000039,288444.7700000039,10389.909999999974
27558,2022-09-13 09:30:00,1501.1,300335.78000000387,288444.7700000039,11891.009999999951
27559,2022-09-13 09:35:00,-1283.34,299052.44000000384,288444.7700000039,10607.669999999925
27560,2022-09-13 09:40:00,1818.32,300870.76000000385,288444.7700000039,12425.989999999932
27561,2022-09-13 09:45:00,-1612.73,299258.03000000387,288444.7700000039,10813.259999999951
27562,2022-09-13 09:50:00,1637.3,300895.33000000386,288444.7700000039,12450.55999999994
27563,2022-09-13 09:55:00,331.33,301226.6600000039,288444.7700000039,12781.889999999956
27564,2022-09-13 10:00:00,-1447.22,299779.4400000039,288444.7700000039,11334.669999999984
27565,2022-09-13 10:05:00,242.02,300021.4600000039,288444.7700000039,11576.690000000002
27566,2022-09-13 10:10:00,578.33,300599.79000000394,288444.7700000039,12155.020000000019
27567,2022-09-13 10:15:00,-523.26,300076.5300000039,288444.7700000039,11631.76000000001
27568,2022-09-13 10:20:00,698.98,300775.5100000039,288444.7700000039,12330.73999999999
27569,2022-09-13 10:25:00,-1712.03,299063.4800000039,288444.7700000039,10618.709999999963
27570,2022-09-13 10:30:00,124.84,299188.3200000039,288444.7700000039,10743.549999999988
27571,2022-09-13 10:35:00,-1102.47,298085.85000000393,288444.7700000039,9641.080000000016
27572,2022-09-13 10:40:00,201.22,298287.0700000039,288444.7700000039,9842.299999999988
27573,2022-09-13 10:45:00,1193.03,299480.10000000393,288444.7700000039,11035.330000000016
27574,2022-09-13 10:50:00,-1772.25,297707.85000000393,288444.7700000039,9263.080000000016
27575,2022-09-13 10:55:00,295.78,298003.63000000396,288444.7700000039,9558.860000000044
27576,2022-09-13 11:00:00,804.89,298808.520000004,288444.7700000039,10363.750000000058
27577,2022-09-13 11:05:00,410.12,299218.640000004,288444.7700000039,10773.870000000054
27578,2022-09-13 11:10:00,278.86,299497.50000000396,288444.7700000039,11052.73000000004
27579,2022-09-13 11:15:00,-10.61,299486.890000004,288444.7700000039,11042.120000000054
27580,2022-09-13 11:20:00,994.41,300481.30000000395,288444.7700000039,12036.530000000028
27581,2022-09-13 11:25:00,-1326.82,299154.48000000394,288444.7700000039,10709.710000000021
27582,2022-09-13 11:30:00,784.59,299939.07000000397,288444.7700000039,11494.300000000047
27583,2022-09-13 11:35:00,-689.09,299249.98000000394,288444.7700000039,10805.210000000021
27584,2022-09-13 11:40:00,82.59,299332.57000000397,288444.7700000039,10887.800000000047
27585,2022-09-13 11:45:00,-697.26,298635.31000000396,288444.7700000039,10190.540000000037
27586,2022-09-13 11:50:00,835.42,299470.73000000394,288444.7700000039,11025.960000000021
27587,2022-09-13 11:55:00,-149.76,299320.97000000393,288444.7700000039,10876.200000000012
27588,2022-09-13 12:00:00,62.58,299383.55000000395,288444.7700000039,10938.780000000028
27589,2022-09-13 12:05:00,1351.05,300734.60000000393,288444.7700000039,12289.830000000016
27590,2022-09-13 12:10:00,-1083.62,299650.98000000394,288444.7700000039,11206.210000000021
27591,2022-09-13 12:15:00,-1995.08,297655.9000000039,288444.7700000039,9211.130000000005
27592,2022-09-13 12:20:00,427.5,298083.4000000039,288444.7700000039,9638.630000000005
27593,2022-09-13 12:25:00,-1714.69,296368.7100000039,288444.7700000039,7923.940000000002
27594,2022-09-13 12:30:00,167.13,296535.8400000039,288444.7700000039,8091.070000000007
27595,2022-09-13 12:35:00,251.55,296787.3900000039,288444.7700000039,8342.619999999995
27596,2022-09-13 12:40:00,-993.27,295794.1200000039,288444.7700000039,7349.349999999977
27597,2022-09-13 12:45:00,-492.86,295301.2600000039,288444.7700000039,6856.489999999991
27598,2022-09-13 12:50:00,-1888.52,293412.7400000039,288444.7700000039,4967.969999999972
27599,2022-09-13 12:55:00,-683.75,292728.9900000039,288444.7700000039,4284.219999999972
27600,2022-09-13 13:00:00,1982.28,294711.2700000039,288444.7700000039,6266.5
27601,2022-09-13 13:05:00,-170.32,294540.9500000039,288444.7700000039,6096.179999999993
27602,2022-09-13 13:10:00,-1738.76,292802.1900000039,288444.7700000039,4357.419999999984
27603,2022-09-13 13:15:00,1883.57,294685.7600000039,288444.7700000039,6240.989999999991
27604,2022-09-13 13:20:00,-1031.08,293654.6800000039,288444.7700000039,5209.909999999974
27605,2022-09-13 13:25:00,-973.82,292680.8600000039,288444.7700000039,4236.089999999967
27606,2022-09-13 13:30:00,-1389.12,291291.7400000039,288444.7700000039,2846.969999999972
27607,2022-09-13 13:35:00,1336.13,292627.8700000039,288444.7700000039,4183.099999999977
27608,2022-09-13 13:40:00,1459.08,294086.9500000039,288444.7700000039,5642.179999999993
27609,2022-09-13 13:45:00,-1547.75,292539.2000000039,288444.7700000039,4094.429999999993
27610,2022-09-13 13:50:00,1453.41,293992.6100000039,288444.7700000039,5547.839999999967
27611,2022-09-13 13:55:00,-1161.26,292831.3500000039,288444.7700000039,4386.579999999958
27612,2022-09-13 14:00:00,-436.91,292394.4400000039,288444.7700000039,3949.6699999999837
27613,2022-09-13 14:05:00,424.46,292818.9000000039,288444.7700000039,4374.130000000005
27614,2022-09-13 14:10:00,-1646.21,291172.6900000039,288444.7700000039,2727.9199999999837
27615,2022-09-13 14:15:00,-1307.11,289865.5800000039,288444.7700000039,1420.8099999999977
27616,2022-09-13 14:20:00,-684.58,289181.0000000039,288444.7700000039,736.2299999999814
27617,2022-09-13 14:25:00,-1740.97,287440.0300000039,288444.7700000039,-1004.7399999999907
27618,2022-09-13 14:30:00,-362.53,287077.5000000039,288444.7700000039,-1367.2700000000186
27619,2022-09-13 14:35:00,-889.69,286187.8100000039,288444.7700000039,-2256.960000000021
27620,2022-09-13 14:40:00,-385.98,285801.8300000039,288444.7700000039,-2642.9400000000023
27621,2022-09-13 14:45:00,1771.21,287573.04000000394,288444.7700000039,-871.7299999999814
27622,2022-09-13 14:50:00,1142.37,288715.41000000393,288444.7700000039,270.64000000001397
27623,2022-09-13 14:55:00,876.57,289591.98000000394,288444.7700000039,1147.210000000021
27624,2022-09-13 15:00:00,1312.9,290904.88000000396,288444.7700000039,2460.1100000000442
27625,2022-09-13 15:05:00,43.43,290948.31000000396,288444.7700000039,2503.5400000000373
27626,2022-09-13 15:10:00,-224.57,290723.74000000395,288444.7700000039,2278.9700000000303
27627,2022-09-13 15:15:00,384.11,291107.85000000393,288444.7700000039,2663.0800000000163
27628,2022-09-13 15:20:00,-1936.71,289171.1400000039,288444.7700000039,726.3699999999953
27629,2022-09-13 15:25:00,564.55,289735.6900000039,288444.7700000039,1290.9199999999837
27630,2022-09-13 15:30:00,-321.23,289414.4600000039,288444.7700000039,969.6900000000023
27631,2022-09-13 15:35:00,-1589.25,287825.2100000039,288444.7700000039,-619.5599999999977
27632,2022-09-13 15:40:00,-1202.19,286623.0200000039,288444.7700000039,-1821.75
27633,2022-09-13 15:45:00,1743.97,288366.9900000039,288444.7700000039,-77.78000000002794
27634,2022-09-13 15:50:00,1419.35,289786.34000000387,288444.7700000039,1341.5699999999488
27635,2022-09-13 15:55:00,-1595.68,288190.6600000039,288444.7700000039,-254.11000000004424
27636,2022-09-13 16:00:00,-1010.67,287179.9900000039,288444.7700000039,-1264.780000000028
27637,2022-09-13 16:05:00,-514.43,286665.5600000039,288444.7700000039,-1779.210000000021
27638,2022-09-13 16:10:00,-1668.53,284997.03000000387,288444.7700000039,-3447.740000000049
27639,2022-09-13 16:15:00,-1812.92,283184.1100000039,288444.7700000039,-5260.660000000033
27640,2022-09-13 16:20:00,797.63,283981.7400000039,288444.7700000039,-4463.030000000028
27641,2022-09-13 16:25:00,1823.86,285805.6000000039,288444.7700000039,-2639.170000000042
27642,2022-09-13 16:30:00,-811.27,284994.33000000386,288444.7700000039,-3450.4400000000605
27643,2022-09-13 16:35:00,690.13,285684.46000000386,288444.7700000039,-2760.310000000056
27644,2022-09-13 16:40:00,214.53,285898.9900000039,288444.7700000039,-2545.780000000028
27645,2022-09-13 16:45:00,-1569.66,284329.3300000039,288444.7700000039,-4115.440000000002
27646,2022-09-13 16:50:00,286.52,284615.85000000393,288444.7700000039,-3828.9199999999837
27647,2022-09-13 16:55:00,1478.65,286094.50000000396,288444.7700000039,-2350.2699999999604
27648,2022-09-14 08:00:00,-1429.86,284664.640000004,286094.50000000396,-1429.859999999986
27649,2022-09-14 08:05:00,-318.9,284345.74000000395,286094.50000000396,-1748.7600000000093
27650,2022-09-14 08:10:00,1218.53,285564.270000004,286094.50000000396,-530.2299999999814
27651,2022-09-14 08:15:00,-1138.89,284425.38000000396,286094.50000000396,-1669.1199999999953
27652,2022-09-14 08:20:00,-841.97,283583.410000004,286094.50000000396,-2511.0899999999674
27653,2022-09-14 08:25:00,-234.44,283348.970000004,286094.50000000396,-2745.5299999999697
27654,2022-09-14 08:30:00,1613.51,284962.480000004,286094.50000000396,-1132.0199999999604
27655,2022-09-14 08:35:00,1655.15,286617.630000004,286094.50000000396,523.1300000000629
27656,2022-09-14 08:40:00,164.41,286782.040000004,286094.50000000396,687.5400000000373
27657,2022-09-14 08:45:00,-172.92,286609.120000004,286094.50000000396,514.6200000000536
27658,2022-09-14 08:50:00,-1776.16,284832.96000000404,286094.50000000396,-1261.5399999999208
27659,2022-09-14 08:55:00,752.48,285585.440000004,286094.50000000396,-509.05999999993946
27660,2022-09-14 09:00:00,-109.56,285475.880000004,286094.50000000396,-618.6199999999371
27661,2022-09-14 09:05:00,1718.06,287193.940000004,286094.50000000396,1099.4400000000605
27662,2022-09-14 09:10:00,-1581.57,285612.370000004,286094.50000000396,-482.12999999994645
27663,2022-09-14 09:15:00,364.78,285977.15000000404,286094.50000000396,-117.34999999991851
27664,2022-09-14 09:20:00,-667.43,285309.72000000405,286094.50000000396,-784.7799999999115
27665,2022-09-14 09:25:00,-1440.13,283869.59000000404,286094.50000000396,-2224.909999999916
27666,2022-09-14 09:30:00,-304.95,283564.64000000403,286094.50000000396,-2529.859999999928
27667,2022-09-14 09:35:00,-532.06,283032.58000000403,286094.50000000396,-3061.9199999999255
27668,2022-09-14 09:40:00,-767.79,282264.79000000405,286094.50000000396,-3829.7099999999045
27669,2022-09-14 09:45:00,699.31,282964.10000000405,286094.50000000396,-3130.399999999907
27670,2022-09-14 09:50:00,-901.64,282062.46000000404,286094.50000000396,-4032.039999999921
27671,2022-09-14 09:55:00,-565.07,281497.39000000403,286094.50000000396,-4597.109999999928
27672,2022-09-14 10:00:00,683.77,282181.16000000405,286094.50000000396,-3913.339999999909
27673,2022-09-14 10:05:00,-1165.8,281015.36000000406,286094.50000000396,-5079.139999999898
27674,2022-09-14 10:10:00,1371.58,282386.9400000041,286094.50000000396,-3707.5599999998813
27675,2022-09-14 10:15:00,1671.61,284058.55000000406,286094.50000000396,-2035.9499999998952
27676,2022-09-14 10:20:00,196.93,284255.48000000406,286094.50000000396,-1839.0199999999022
27677,2022-09-14 10:25:00,-708.78,283546.700000004,286094.50000000396,-2547.79999999993
27678,2022-09-14 10:30:00,1820.69,285367.39000000403,286094.50000000396,-727.1099999999278
27679,2022-09-14 10:35:00,-1764.25,283603.14000000403,286094.50000000396,-2491.359999999928
27680,2022-09-14 10:40:00,1803.13,285406.27000000403,286094.50000000396,-688.2299999999232
27681,2022-09-14 10:45:00,-93.07,285313.200000004,286094.50000000396,-781.2999999999302
27682,2022-09-14 10:50:00,282.02,285595.22000000405,286094.50000000396,-499.2799999999115
27683,2022-09-14 10:55:00,-1773.51,283821.71000000404,286094.50000000396,-2272.789999999921
27684,2022-09-14 11:00:00,-774.81,283046.90000000404,286094.50000000396,-3047.5999999999185
27685,2022-09-14 11:05:00,145.13,283192.03000000404,286094.50000000396,-2902.469999999914
27686,2022-09-14 11:10:00,-785.81,282406.22000000405,286094.50000000396,-3688.2799999999115
27687,2022-09-14 11:15:00,939.03,283345.2500000041,286094.50000000396,-2749.2499999998836
27688,2022-09-14 11:20:00,-1004.51,282340.74000000407,286094.50000000396,-3753.759999999893
27689,2022-09-14 11:25:00,-961.38,281379.36000000406,286094.50000000396,-4715.139999999898
27690,2022-09-14 11:30:00,491.48,281870.84000000404,286094.50000000396,-4223.659999999916
27691,2022-09-14 11:35:00,-1412.52,280458.320000004,286094.50000000396,-5636.179999999935
27692,2022-09-14 11:40:00,-1950.6,278507.72000000405,286094.50000000396,-7586.7799999999115
27693,2022-09-14 11:45:00,-1035.65,277472.070000004,286094.50000000396,-8622.429999999935
27694,2022-09-14 11:50:00,704.24,278176.310000004,286094.50000000396,-7918.189999999944
27695,2022-09-14 11:55:00,597.72,278774.030000004,286094.50000000396,-7320.469999999972
27696,2022-09-14 12:00:00,-694.66,278079.370000004,286094.50000000396,-8015.129999999946
27697,2022-09-14 12:05:00,-545.81,277533.560000004,286094.50000000396,-8560.939999999944
27698,2022-09-14 12:10:00,442.8,277976.360000004,286094.50000000396,-8118.139999999956
27699,2022-09-14 12:15:00,1137.69,279114.050000004,286094.50000000396,-6980.449999999953
27700,2022-09-14 12:20:00,714.88,279828.930000004,286094.50000000396,-6265.569999999949
27701,2022-09-14 12:25:00,724.78,280553.71000000404,286094.50000000396,-5540.789999999921
27702,2022-09-14 12:30:00,1334.65,281888.36000000406,286094.50000000396,-4206.139999999898
27703,2022-09-14 12:35:00,1987.46,283875.8200000041,286094.50000000396,-2218.6799999998766
27704,2022-09-14 12:40:00,1626.62,285502.4400000041,286094.50000000396,-592.0599999998813
27705,2022-09-14 12:45:00,1033.5,286535.9400000041,286094.50000000396,441.44000000011874
27706,2022-09-14 12:50:00,-1909.24,284626.7000000041,286094.50000000396,-1467.799999999872
27707,2022-09-14 12:55:00,-731.92,283894.7800000041,286094.50000000396,-2199.7199999998556
27708,2022-09-14 13:00:00,1463.53,285358.31000000413,286094.50000000396,-736.1899999998277
27709,2022-09-14 13:05:00,-966.25,284392.06000000413,286094.50000000396,-1702.4399999998277
27710,2022-09-14 13:10:00,587.27,284979.33000000415,286094.50000000396,-1115.169999999809
27711,2022-09-14 13:15:00,-1587.53,283391.8000000041,286094.50000000396,-2702.699999999837
27712,2022-09-14 13:20:00,-1900.81,281490.9900000041,286094.50000000396,-4603.509999999835
27713,2022-09-14 13:25:00,-309.18,281181.81000000413,286094.50000000396,-4912.689999999828
27714,2022-09-14 13:30:00,-711.43,280470.38000000414,286094.50000000396,-5624.119999999821
27715,2022-09-14 13:35:00,47.26,280517.64000000415,286094.50000000396,-5576.859999999811
27716,2022-09-14 13:40:00,870.06,281387.70000000414,286094.50000000396,-4706.799999999814
27717,2022-09-14 13:45:00,1003.29,282390.9900000041,286094.50000000396,-3703.5099999998347
27718,2022-09-14 13:50:00,13.95,282404.94000000414,286094.50000000396,-3689.559999999823
27719,2022-09-14 13:55:00,-376.22,282028.72000000416,286094.50000000396,-4065.779999999795
27720,2022-09-14 14:00:00,416.66,282445.38000000414,286094.50000000396,-3649.1199999998207
27721,2022-09-14 14:05:00,-1564.62,280880.76000000414,286094.50000000396,-5213.739999999816
27722,2022-09-14 14:10:00,1294.83,282175.59000000416,286094.50000000396,-3918.9099999997998
27723,2022-09-14 14:15:00,-1584.52,280591.07000000414,286094.50000000396,-5503.429999999818
27724,2022-09-14 14:20:00,-446.71,280144.3600000041,286094.50000000396,-5950.139999999839
27725,2022-09-14 14:25:00,331.61,280475.9700000041,286094.50000000396,-5618.529999999853
27726,2022-09-14 14:30:00,-408.91,280067.06000000413,286094.50000000396,-6027.439999999828
27727,2022-09-14 14:35:00,1547.21,281614.27000000415,286094.50000000396,-4480.229999999807
27728,2022-09-14 14:40:00,-1109.23,280505.04000000417,286094.50000000396,-5589.459999999788
27729,2022-09-14 14:45:00,1037.22,281542.26000000414,286094.50000000396,-4552.239999999816
27730,2022-09-14 14:50:00,1573.22,283115.4800000041,286094.50000000396,-2979.019999999844
27731,2022-09-14 14:55:00,63.78,283179.26000000414,286094.50000000396,-2915.239999999816
27732,2022-09-14 15:00:00,-1291.36,281887.90000000416,286094.50000000396,-4206.599999999802
27733,2022-09-14 15:05:00,-394.13,281493.77000000415,286094.50000000396,-4600.729999999807
27734,2022-09-14 15:10:00,-924.09,280569.6800000041,286094.50000000396,-5524.819999999832
27735,2022-09-14 15:15:00,-661.83,279907.8500000041,286094.50000000396,-6186.649999999849
27736,2022-09-14 15:20:00,-1360.67,278547.1800000041,286094.50000000396,-7547.319999999832
27737,2022-09-14 15:25:00,-1649.36,276897.82000000414,286094.50000000396,-9196.679999999818
27738,2022-09-14 15:30:00,1839.49,278737.31000000413,286094.50000000396,-7357.189999999828
27739,2022-09-14 15:35:00,1709.4,280446.71000000415,286094.50000000396,-5647.789999999804
27740,2022-09-14 15:40:00,-203.93,280242.78000000416,286094.50000000396,-5851.719999999797
27741,2022-09-14 15:45:00,-955.21,279287.57000000414,286094.50000000396,-6806.929999999818
27742,2022-09-14 15:50:00,-780.13,278507.44000000414,286094.50000000396,-7587.059999999823
27743,2022-09-14 15:55:00,-274.94,278232.50000000413,286094.50000000396,-7861.999999999825
27744,2022-09-14 16:00:00,1455.61,279688.1100000041,286094.50000000396,-6406.389999999839
27745,2022-09-14 16:05:00,-942.97,278745.14000000415,286094.50000000396,-7349.359999999811
27746,2022-09-14 16:10:00,1675.15,280420.29000000417,286094.50000000396,-5674.209999999788
27747,2022-09-14 16:15:00,259.98,280680.27000000415,286094.50000000396,-5414.229999999807
27748,2022-09-14 16:20:00,-976.54,279703.7300000042,286094.50000000396,-6390.769999999786
27749,2022-09-14 16:25:00,1021.06,280724.79000000417,286094.50000000396,-5369.709999999788
27750,2022-09-14 16:30:00,707.99,281432.78000000416,286094.50000000396,-4661.719999999797
27751,2022-09-14 16:35:00,342.51,281775.29000000417,286094.50000000396,-4319.209999999788
27752,2022-09-14 16:40:00,-14.2,281761.09000000416,286094.50000000396,-4333.4099999998
27753,2022-09-14 16:45:00,-1788.69,279972.40000000416,286094.50000000396,-6122.099999999802
27754,2022-09-14 16:50:00,834.82,280807.22000000416,286094.50000000396,-5287.279999999795
27755,2022-09-14 16:55:00,-35.64,280771.58000000415,286094.50000000396,-5322.919999999809
27756,2022-09-15 08:00:00,678.52,281450.10000000417,280771.58000000415,678.5200000000186
27757,2022-09-15 08:05:00,631.01,282081.1100000042,280771.58000000415,1309.530000000028
27758,2022-09-15 08:10:00,368.08,282449.1900000042,280771.58000000415,1677.6100000000442
27759,2022-09-15 08:15:00,-810.7,281638.4900000042,280771.58000000415,866.9100000000326
27760,2022-09-15 08:20:00,-446.74,281191.7500000042,280771.58000000415,420.1700000000419
27761,2022-09-15 08:25:00,-220.63,280971.1200000042,280771.58000000415,199.54000000003725
27762,2022-09-15 08:30:00,-424.11,280547.0100000042,280771.58000000415,-224.56999999994878
27763,2022-09-15 08:35:00,-1622.43,278924.5800000042,280771.58000000415,-1846.9999999999418
27764,2022-09-15 08:40:00,842.91,279767.4900000042,280771.58000000415,-1004.0899999999674
27765,2022-09-15 08:45:00,1070.36,280837.85000000417,280771.58000000415,66.27000000001863
27766,2022-09-15 08:50:00,1451.69,282289.54000000417,280771.58000000415,1517.960000000021
27767,2022-09-15 08:55:00,-1198.26,281091.28000000416,280771.58000000415,319.70000000001164
27768,2022-09-15 09:00:00,-1756.97,279334.3100000042,280771.58000000415,-1437.2699999999604
27769,2022-09-15 09:05:00,1326.04,280660.35000000417,280771.58000000415,-111.22999999998137
27770,2022-09-15 09:10:00,-879.76,279780.59000000416,280771.58000000415,-990.9899999999907
27771,2022-09-15 09:15:00,571.94,280352.53000000416,280771.58000000415,-419.04999999998836
27772,2022-09-15 09:20:00,-1526.48,278826.0500000042,280771.58000000415,-1945.5299999999697
27773,2022-09-15 09:25:00,557.17,279383.22000000416,280771.58000000415,-1388.359999999986
27774,2022-09-15 09:30:00,-184.6,279198.6200000042,280771.58000000415,-1572.9599999999627
27775,2022-09-15 09:35:00,-1899.74,277298.8800000042,280771.58000000415,-3472.6999999999534
27776,2022-09-15 09:40:00,398.81,277697.6900000042,280771.58000000415,-3073.8899999999558
27777,2022-09-15 09:45:00,-411.56,277286.1300000042,280771.58000000415,-3485.4499999999534
27778,2022-09-15 09:50:00,-1861.32,275424.8100000042,280771.58000000415,-5346.76999999996
27779,2022-09-15 09:55:00,1236.92,276661.7300000042,280771.58000000415,-4109.849999999977
27780,2022-09-15 10:00:00,-823.98,275837.7500000042,280771.58000000415,-4933.829999999958
27781,2022-09-15 10:05:00,1563.59,277401.3400000042,280771.58000000415,-3370.2399999999325
27782,2022-09-15 10:10:00,-563.49,276837.8500000042,280771.58000000415,-3933.729999999923
27783,2022-09-15 10:15:00,-292.64,276545.2100000042,280771.58000000415,-4226.369999999937
27784,2022-09-15 10:20:00,-1844.99,274700.2200000042,280771.58000000415,-6071.359999999928
27785,2022-09-15 10:25:00,-8.73,274691.49000000424,280771.58000000415,-6080.089999999909
27786,2022-09-15 10:30:00,68.27,274759.76000000426,280771.58000000415,-6011.819999999891
27787,2022-09-15 10:35:00,-749.11,274010.6500000043,280771.58000000415,-6760.929999999877
27788,2022-09-15 10:40:00,334.93,274345.58000000427,280771.58000000415,-6425.999999999884
27789,2022-09-15 10:45:00,-337.75,274007.83000000427,280771.58000000415,-6763.749999999884
27790,2022-09-15 10:50:00,-1412.29,272595.5400000043,280771.58000000415,-8176.039999999863
27791,2022-09-15 10:55:00,-1603.41,270992.1300000043,280771.58000000415,-9779.449999999837
27792,2022-09-15 11:00:00,1410.0,272402.1300000043,280771.58000000415,-8369.449999999837
27793,2022-09-15 11:05:00,1384.26,273786.3900000043,280771.58000000415,-6985.189999999828
27794,2022-09-15 11:10:00,1674.02,275460.41000000434,280771.58000000415,-5311.169999999809
27795,2022-09-15 11:15:00,-948.46,274511.9500000043,280771.58000000415,-6259.62999999983
27796,2022-09-15 11:20:00,-499.57,274012.3800000043,280771.58000000415,-6759.199999999837
27797,2022-09-15 11:25:00,-1831.03,272181.3500000043,280771.58000000415,-8590.229999999865
27798,2022-09-15 11:30:00,-698.71,271482.64000000426,280771.58000000415,-9288.939999999886
27799,2022-09-15 11:35:00,-33.86,271448.7800000043,280771.58000000415,-9322.799999999872
27800,2022-09-15 11:40:00,-1211.19,270237.5900000043,280771.58000000415,-10533.989999999874
27801,2022-09-15 11:45:00,952.83,271190.4200000043,280771.58000000415,-9581.159999999858
27802,2022-09-15 11:50:00,143.66,271334.08000000427,280771.58000000415,-9437.499999999884
27803,2022-09-15 11:55:00,187.69,271521.77000000427,280771.58000000415,-9249.809999999881
27804,2022-09-15 12:00:00,-57.41,271464.3600000043,280771.58000000415,-9307.219999999856
27805,2022-09-15 12:05:00,126.45,271590.8100000043,280771.58000000415,-9180.769999999844
27806,2022-09-15 12:10:00,1579.88,273170.6900000043,280771.58000000415,-7600.889999999839
27807,2022-09-15 12:15:00,-897.51,272273.1800000043,280771.58000000415,-8498.399999999849
27808,2022-09-15 12:20:00,1140.94,273414.1200000043,280771.58000000415,-7357.459999999846
27809,2022-09-15 12:25:00,-1849.44,271564.6800000043,280771.58000000415,-9206.899999999849
27810,2022-09-15 12:30:00,-495.83,271068.8500000043,280771.58000000415,-9702.729999999865
27811,2022-09-15 12:35:00,-1546.17,269522.6800000043,280771.58000000415,-11248.899999999849
27812,2022-09-15 12:40:00,-1907.91,267614.7700000043,280771.58000000415,-13156.809999999823
27813,2022-09-15 12:45:00,1102.21,268716.98000000435,280771.58000000415,-12054.599999999802
27814,2022-09-15 12:50:00,-416.8,268300.18000000436,280771.58000000415,-12471.39999999979
27815,2022-09-15 12:55:00,1118.93,269419.11000000435,280771.58000000415,-11352.469999999797
27816,2022-09-15 13:00:00,1090.13,270509.24000000436,280771.58000000415,-10262.339999999793
27817,2022-09-15 13:05:00,-326.13,270183.11000000435,280771.58000000415,-10588.469999999797
27818,2022-09-15 13:10:00,-1502.71,268680.40000000433,280771.58000000415,-12091.179999999818
27819,2022-09-15 13:15:00,-384.0,268296.40000000433,280771.58000000415,-12475.179999999818
27820,2022-09-15 13:20:00,-1506.11,266790.29000000434,280771.58000000415,-13981.289999999804
27821,2022-09-15 13:25:00,1675.18,268465.47000000434,280771.58000000415,-12306.109999999811
27822,2022-09-15 13:30:00,-1921.22,266544.25000000437,280771.58000000415,-14227.329999999783
27823,2022-09-15 13:35:00,724.43,267268.68000000436,280771.58000000415,-13502.89999999979
27824,2022-09-15 13:40:00,-1695.84,265572.84000000433,280771.58000000415,-15198.739999999816
27825,2022-09-15 13:45:00,407.89,265980.73000000435,280771.58000000415,-14790.849999999802
27826,2022-09-15 13:50:00,1205.91,267186.6400000043,280771.58000000415,-13584.939999999828
27827,2022-09-15 13:55:00,-1937.54,265249.10000000434,280771.58000000415,-15522.479999999807
27828,2022-09-15 14:00:00,-826.67,264422.43000000436,280771.58000000415,-16349.14999999979
27829,2022-09-15 14:05:00,-327.61,264094.8200000044,280771.58000000415,-16676.759999999776
27830,2022-09-15 14:10:00,-1072.05,263022.7700000044,280771.58000000415,-17748.809999999765
27831,2022-09-15 14:15:00,103.68,263126.4500000044,280771.58000000415,-17645.129999999772
27832,2022-09-15 14:20:00,-468.9,262657.55000000435,280771.58000000415,-18114.029999999795
27833,2022-09-15 14:25:00,-1411.93,261245.62000000436,280771.58000000415,-19525.959999999788
27834,2022-09-15 14:30:00,-740.96,260504.66000000437,280771.58000000415,-20266.91999999978
27835,2022-09-15 14:35:00,1140.06,261644.72000000437,280771.58000000415,-19126.859999999782
27836,2022-09-15 14:40:00,1520.58,263165.30000000435,280771.58000000415,-17606.279999999795
27837,2022-09-15 14:45:00,1470.09,264635.3900000044,280771.58000000415,-16136.18999999977
27838,2022-09-15 14:50:00,-1901.79,262733.6000000044,280771.58000000415,-18037.97999999975
27839,2022-09-15 14:55:00,-321.11,262412.4900000044,280771.58000000415,-18359.089999999735
27840,2022-09-15 15:00:00,1815.66,264228.1500000044,280771.58000000415,-16543.42999999976
27841,2022-09-15 15:05:00,28.1,264256.25000000437,280771.58000000415,-16515.329999999783
27842,2022-09-15 15:10:00,-421.32,263834.93000000436,280771.58000000415,-16936.64999999979
27843,2022-09-15 15:15:00,-117.49,263717.44000000437,280771.58000000415,-17054.13999999978
27844,2022-09-15 15:20:00,-880.15,262837.29000000434,280771.58000000415,-17934.289999999804
27845,2022-09-15 15:25:00,-763.42,262073.87000000433,280771.58000000415,-18697.709999999817
27846,2022-09-15 15:30:00,-1367.01,260706.86000000432,280771.58000000415,-20064.719999999827
27847,2022-09-15 15:35:00,-1432.95,259273.9100000043,280771.58000000415,-21497.66999999984
27848,2022-09-15 15:40:00,1232.35,260506.26000000432,280771.58000000415,-20265.319999999832
27849,2022-09-15 15:45:00,-1039.6,259466.6600000043,280771.58000000415,-21304.91999999984
27850,2022-09-15 15:50:00,729.74,260196.4000000043,280771.58000000415,-20575.179999999847
27851,2022-09-15 15:55:00,-360.31,259836.0900000043,280771.58000000415,-20935.489999999845
27852,2022-09-15 16:00:00,-1948.84,257887.2500000043,280771.58000000415,-22884.32999999984
27853,2022-09-15 16:05:00,77.18,257964.4300000043,280771.58000000415,-22807.14999999985
27854,2022-09-15 16:10:00,798.79,258763.2200000043,280771.58000000415,-22008.35999999984
27855,2022-09-15 16:15:00,125.16,258888.3800000043,280771.58000000415,-21883.199999999837
27856,2022-09-15 16:20:00,1944.13,260832.51000000432,280771.58000000415,-19939.069999999832
27857,2022-09-15 16:25:00,1447.09,262279.60000000434,280771.58000000415,-18491.979999999807
27858,2022-09-15 16:30:00,1089.69,263369.29000000434,280771.58000000415,-17402.289999999804
27859,2022-09-15 16:35:00,553.53,263922.8200000044,280771.58000000415,-16848.759999999776
27860,2022-09-15 16:40:00,-1310.89,262611.93000000436,280771.58000000415,-18159.64999999979
27861,2022-09-15 16:45:00,534.31,263146.24000000436,280771.58000000415,-17625.339999999793
27862,2022-09-15 16:50:00,165.07,263311.31000000436,280771.58000000415,-17460.269999999786
27863,2022-09-15 16:55:00,300.86,263612.17000000435,280771.58000000415,-17159.4099999998
27864,2022-09-16 08:00:00,1642.56,265254.73000000435,263612.17000000435,1642.5599999999977
27865,2022-09-16 08:05:00,230.81,265485.54000000434,263612.17000000435,1873.3699999999953
27866,2022-09-16 08:10:00,841.3,266326.84000000433,263612.17000000435,2714.6699999999837
27867,2022-09-16 08:15:00,-1996.63,264330.2100000043,263612.17000000435,718.039999999979
27868,2022-09-16 08:20:00,1878.34,266208.55000000435,263612.17000000435,2596.3800000000047
27869,2022-09-16 08:25:00,-83.4,266125.15000000433,263612.17000000435,2512.9799999999814
27870,2022-09-16 08:30:00,1808.86,267934.0100000043,263612.17000000435,4321.839999999967
27871,2022-09-16 08:35:00,-1386.41,266547.60000000434,263612.17000000435,2935.429999999993
27872,2022-09-16 08:40:00,-501.39,266046.2100000043,263612.17000000435,2434.039999999979
27873,2022-09-16 08:45:00,879.35,266925.5600000043,263612.17000000435,3313.3899999999558
27874,2022-09-16 08:50:00,1467.54,268393.1000000043,263612.17000000435,4780.929999999935
27875,2022-09-16 08:55:00,679.64,269072.7400000043,263612.17000000435,5460.569999999949
27876,2022-09-16 09:00:00,698.92,269771.6600000043,263612.17000000435,6159.4899999999325
27877,2022-09-16 09:05:00,-942.99,268828.6700000043,263612.17000000435,5216.499999999942
27878,2022-09-16 09:10:00,-703.56,268125.1100000043,263612.17000000435,4512.939999999944
27879,2022-09-16 09:15:00,1025.27,269150.3800000043,263612.17000000435,5538.209999999963
27880,2022-09-16 09:20:00,-1390.44,267759.9400000043,263612.17000000435,4147.76999999996
27881,2022-09-16 09:25:00,-776.74,266983.2000000043,263612.17000000435,3371.0299999999697
27882,2022-09-16 09:30:00,71.73,267054.9300000043,263612.17000000435,3442.759999999951
27883,2022-09-16 09:35:00,-1245.99,265808.9400000043,263612.17000000435,2196.7699999999604
27884,2022-09-16 09:40:00,-824.07,264984.8700000043,263612.17000000435,1372.6999999999534
27885,2022-09-16 09:45:00,805.24,265790.1100000043,263612.17000000435,2177.939999999944
27886,2022-09-16 09:50:00,-1331.02,264459.0900000043,263612.17000000435,846.9199999999255
27887,2022-09-16 09:55:00,-1070.82,263388.27000000427,263612.17000000435,-223.9000000000815
27888,2022-09-16 10:00:00,1401.43,264789.70000000426,263612.17000000435,1177.5299999999115
27889,2022-09-16 10:05:00,1378.63,266168.33000000427,263612.17000000435,2556.159999999916
27890,2022-09-16 10:10:00,-1586.92,264581.4100000043,263612.17000000435,969.2399999999325
27891,2022-09-16 10:15:00,377.26,264958.6700000043,263612.17000000435,1346.4999999999418
27892,2022-09-16 10:20:00,-858.85,264099.8200000043,263612.17000000435,487.6499999999651
27893,2022-09-16 10:25:00,1342.51,265442.3300000043,263612.17000000435,1830.1599999999744
27894,2022-09-16 10:30:00,1093.26,266535.59000000433,263612.17000000435,2923.4199999999837
27895,2022-09-16 10:35:00,1103.5,267639.09000000433,263612.17000000435,4026.9199999999837
27896,2022-09-16 10:40:00,-1816.18,265822.91000000434,263612.17000000435,2210.7399999999907
27897,2022-09-16 10:45:00,-472.01,265350.90000000433,263612.17000000435,1738.7299999999814
27898,2022-09-16 10:50:00,1046.86,266397.7600000043,263612.17000000435,2785.5899999999674
27899,2022-09-16 10:55:00,-1526.79,264870.97000000434,263612.17000000435,1258.7999999999884
27900,2022-09-16 11:00:00,1072.74,265943.7100000043,263612.17000000435,2331.539999999979
27901,2022-09-16 11:05:00,357.55,266301.2600000043,263612.17000000435,2689.0899999999674
27902,2022-09-16 11:10:00,-1274.84,265026.4200000043,263612.17000000435,1414.2499999999418
27903,2022-09-16 11:15:00,-1400.59,263625.83000000427,263612.17000000435,13.659999999916181
27904,2022-09-16 11:20:00,1495.05,265120.88000000425,263612.17000000435,1508.7099999999045
27905,2022-09-16 11:25:00,643.34,265764.2200000043,263612.17000000435,2152.04999999993
27906,2022-09-16 11:30:00,-1440.77,264323.45000000426,263612.17000000435,711.2799999999115
27907,2022-09-16 11:35:00,-120.98,264202.4700000043,263612.17000000435,590.2999999999302
27908,2022-09-16 11:40:00,1660.33,265862.8000000043,263612.17000000435,2250.6299999999464
27909,2022-09-16 11:45:00,-1199.12,264663.6800000043,263612.17000000435,1051.509999999951
27910,2022-09-16 11:50:00,-1615.31,263048.3700000043,263612.17000000435,-563.8000000000466
27911,2022-09-16 11:55:00,-431.09,262617.2800000043,263612.17000000435,-994.8900000000722
27912,2022-09-16 12:00:00,-1900.85,260716.43000000427,263612.17000000435,-2895.740000000078
27913,2022-09-16 12:05:00,-261.21,260455.22000000428,263612.17000000435,-3156.95000000007
27914,2022-09-16 12:10:00,-946.8,259508.4200000043,263612.17000000435,-4103.750000000058
27915,2022-09-16 12:15:00,-407.0,259101.4200000043,263612.17000000435,-4510.750000000058
27916,2022-09-16 12:20:00,-1672.84,257428.5800000043,263612.17000000435,-6183.590000000055
27917,2022-09-16 12:25:00,32.24,257460.82000000429,263612.17000000435,-6151.350000000064
27918,2022-09-16 12:30:00,1312.5,258773.32000000429,263612.17000000435,-4838.850000000064
27919,2022-09-16 12:35:00,-1644.55,257128.7700000043,263612.17000000435,-6483.400000000052
27920,2022-09-16 12:40:00,1215.21,258343.9800000043,263612.17000000435,-5268.1900000000605
27921,2022-09-16 12:45:00,1615.48,259959.4600000043,263612.17000000435,-3652.71000000005
27922,2022-09-16 12:50:00,-1286.83,258672.6300000043,263612.17000000435,-4939.540000000037
27923,2022-09-16 12:55:00,-2.11,258670.52000000433,263612.17000000435,-4941.650000000023
27924,2022-09-16 13:00:00,1489.73,260160.25000000434,263612.17000000435,-3451.920000000013
27925,2022-09-16 13:05:00,1411.16,261571.41000000434,263612.17000000435,-2040.7600000000093
27926,2022-09-16 13:10:00,88.3,261659.71000000433,263612.17000000435,-1952.460000000021
27927,2022-09-16 13:15:00,1459.29,263119.0000000043,263612.17000000435,-493.1700000000419
27928,2022-09-16 13:20:00,-171.79,262947.2100000043,263612.17000000435,-664.960000000021
27929,2022-09-16 13:25:00,-1824.46,261122.75000000434,263612.17000000435,-2489.420000000013
27930,2022-09-16 13:30:00,-1726.42,259396.33000000432,263612.17000000435,-4215.840000000026
27931,2022-09-16 13:35:00,686.31,260082.64000000432,263612.17000000435,-3529.530000000028
27932,2022-09-16 13:40:00,1008.97,261091.61000000432,263612.17000000435,-2520.560000000027
27933,2022-09-16 13:45:00,-459.39,260632.2200000043,263612.17000000435,-2979.9500000000407
27934,2022-09-16 13:50:00,-1524.84,259107.3800000043,263612.17000000435,-4504.790000000037
27935,2022-09-16 13:55:00,-1494.57,257612.8100000043,263612.17000000435,-5999.360000000044
27936,2022-09-16 14:00:00,-200.43,257412.3800000043,263612.17000000435,-6199.790000000037
27937,2022-09-16 14:05:00,135.15,257547.5300000043,263612.17000000435,-6064.640000000043
27938,2022-09-16 14:10:00,265.08,257812.6100000043,263612.17000000435,-5799.560000000056
27939,2022-09-16 14:15:00,-1810.4,256002.2100000043,263612.17000000435,-7609.96000000005
27940,2022-09-16 14:20:00,-1759.49,254242.7200000043,263612.17000000435,-9369.45000000004
27941,2022-09-16 14:25:00,-504.38,253738.3400000043,263612.17000000435,-9873.830000000045
27942,2022-09-16 14:30:00,712.27,254450.6100000043,263612.17000000435,-9161.560000000056
27943,2022-09-16 14:35:00,8.3,254458.91000000428,263612.17000000435,-9153.260000000068
27944,2022-09-16 14:40:00,-123.12,254335.7900000043,263612.17000000435,-9276.380000000063
27945,2022-09-16 14:45:00,-964.85,253370.94000000428,263612.17000000435,-10241.230000000069
27946,2022-09-16 14:50:00,1039.77,254410.71000000427,263612.17000000435,-9201.46000000008
27947,2022-09-16 14:55:00,1886.13,256296.84000000427,263612.17000000435,-7315.3300000000745
27948,2022-09-16 15:00:00,-284.67,256012.17000000426,263612.17000000435,-7600.000000000087
27949,2022-09-16 15:05:00,1819.02,257831.19000000425,263612.17000000435,-5780.980000000098
27950,2022-09-16 15:10:00,-928.73,256902.46000000424,263612.17000000435,-6709.710000000108
27951,2022-09-16 15:15:00,-245.52,256656.94000000425,263612.17000000435,-6955.230000000098
27952,2022-09-16 15:20:00,331.09,256988.03000000425,263612.17000000435,-6624.140000000101
27953,2022-09-16 15:25:00,-1194.91,255793.12000000424,263612.17000000435,-7819.050000000105
27954,2022-09-16 15:30:00,289.27,256082.39000000423,263612.17000000435,-7529.780000000115
27955,2022-09-16 15:35:00,-721.05,255361.34000000425,263612.17000000435,-8250.830000000104
27956,2022-09-16 15:40:00,732.26,256093.60000000425,263612.17000000435,-7518.570000000094
27957,2022-09-16 15:45:00,1727.85,257821.45000000426,263612.17000000435,-5790.7200000000885
27958,2022-09-16 15:50:00,585.79,258407.24000000427,263612.17000000435,-5204.93000000008
27959,2022-09-16 15:55:00,-550.92,257856.32000000426,263612.17000000435,-5755.850000000093
27960,2022-09-16 16:00:00,-1557.28,256299.04000000426,263612.17000000435,-7313.130000000092
27961,2022-09-16 16:05:00,605.92,256904.96000000427,263612.17000000435,-6707.210000000079
27962,2022-09-16 16:10:00,608.58,257513.54000000426,263612.17000000435,-6098.630000000092
27963,2022-09-16 16:15:00,-304.79,257208.75000000425,263612.17000000435,-6403.4200000001
27964,2022-09-16 16:20:00,-1295.47,255913.28000000425,263612.17000000435,-7698.890000000101
27965,2022-09-16 16:25:00,1476.27,257389.55000000424,263612.17000000435,-6222.620000000112
27966,2022-09-16 16:30:00,1943.62,259333.17000000423,263612.17000000435,-4279.000000000116
27967,2022-09-16 16:35:00,810.47,260143.64000000423,263612.17000000435,-3468.5300000001153
27968,2022-09-16 16:40:00,1080.32,261223.96000000424,263612.17000000435,-2388.2100000001083
27969,2022-09-16 16:45:00,901.97,262125.93000000424,263612.17000000435,-1486.240000000107
27970,2022-09-16 16:50:00,-75.81,262050.12000000424,263612.17000000435,-1562.0500000001048
27971,2022-09-16 16:55:00,752.09,262802.21000000427,263612.17000000435,-809.9600000000792
27972,2022-09-17 08:00:00,-741.57,262060.64000000426,262802.21000000427,-741.570000000007
27973,2022-09-17 08:05:00,1304.99,263365.63000000425,262802.21000000427,563.4199999999837
27974,2022-09-17 08:10:00,-342.17,263023.46000000427,262802.21000000427,221.25
27975,2022-09-17 08:15:00,-1586.28,261437.18000000427,262802.21000000427,-1365.0299999999988
27976,2022-09-17 08:20:00,889.64,262326.82000000426,262802.21000000427,-475.39000000001397
27977,2022-09-17 08:25:00,827.31,263154.13000000425,262802.21000000427,351.9199999999837
27978,2022-09-17 08:30:00,-1881.27,261272.86000000426,262802.21000000427,-1529.3500000000058
27979,2022-09-17 08:35:00,1897.37,263170.2300000043,262802.21000000427,368.0200000000186
27980,2022-09-17 08:40:00,-1308.94,261861.2900000043,262802.21000000427,-940.9199999999837
27981,2022-09-17 08:45:00,-440.49,261420.8000000043,262802.21000000427,-1381.4099999999744
27982,2022-09-17 08:50:00,986.13,262406.9300000043,262802.21000000427,-395.27999999996973
27983,2022-09-17 08:55:00,-904.65,261502.2800000043,262802.21000000427,-1299.929999999964
27984,2022-09-17 09:00:00,-1377.74,260124.54000000432,262802.21000000427,-2677.6699999999546
27985,2022-09-17 09:05:00,-1221.0,258903.54000000432,262802.21000000427,-3898.6699999999546
27986,2022-09-17 09:10:00,-650.2,258253.3400000043,262802.21000000427,-4548.869999999966
27987,2022-09-17 09:15:00,-1809.5,256443.8400000043,262802.21000000427,-6358.369999999966
27988,2022-09-17 09:20:00,-764.02,255679.8200000043,262802.21000000427,-7122.389999999956
27989,2022-09-17 09:25:00,-1268.97,254410.8500000043,262802.21000000427,-8391.359999999957
27990,2022-09-17 09:30:00,-1863.16,252547.6900000043,262802.21000000427,-10254.51999999996
27991,2022-09-17 09:35:00,124.7,252672.39000000432,262802.21000000427,-10129.819999999949
27992,2022-09-17 09:40:00,-266.77,252405.62000000433,262802.21000000427,-10396.589999999938
27993,2022-09-17 09:45:00,228.33,252633.95000000432,262802.21000000427,-10168.259999999951
27994,2022-09-17 09:50:00,-873.12,251760.83000000432,262802.21000000427,-11041.379999999946
27995,2022-09-17 09:55:00,-463.66,251297.17000000432,262802.21000000427,-11505.03999999995
27996,2022-09-17 10:00:00,-1182.93,250114.24000000433,262802.21000000427,-12687.969999999943
27997,2022-09-17 10:05:00,-1623.07,248491.17000000432,262802.21000000427,-14311.03999999995
27998,2022-09-17 10:10:00,744.97,249236.14000000432,262802.21000000427,-13566.069999999949
27999,2022-09-17 10:15:00,-1135.82,248100.3200000043,262802.21000000427,-14701.889999999956
28000,2022-09-17 10:20:00,6.91,248107.23000000432,262802.21000000427,-14694.979999999952
28001,2022-09-17 10:25:00,-826.35,247280.8800000043,262802.21000000427,-15521.329999999958
28002,2022-09-17 10:30:00,637.04,247917.92000000432,262802.21000000427,-14884.28999999995
28003,2022-09-17 10:35:00,1487.61,249405.5300000043,262802.21000000427,-13396.679999999964
28004,2022-09-17 10:40:00,-633.64,248771.8900000043,262802.21000000427,-14030.319999999978
28005,2022-09-17 10:45:00,1576.62,250348.5100000043,262802.21000000427,-12453.699999999983
28006,2022-09-17 10:50:00,402.66,250751.1700000043,262802.21000000427,-12051.039999999979
28007,2022-09-17 10:55:00,551.49,251302.66000000428,262802.21000000427,-11499.549999999988
28008,2022-09-17 11:00:00,-972.86,250329.8000000043,262802.21000000427,-12472.409999999974
28009,2022-09-17 11:05:00,190.65,250520.4500000043,262802.21000000427,-12281.75999999998
28010,2022-09-17 11:10:00,-710.02,249810.4300000043,262802.21000000427,-12991.77999999997
28011,2022-09-17 11:15:00,1688.18,251498.6100000043,262802.21000000427,-11303.599999999977
28012,2022-09-17 11:20:00,-1169.11,250329.5000000043,262802.21000000427,-12472.709999999963
28013,2022-09-17 11:25:00,1689.41,252018.9100000043,262802.21000000427,-10783.29999999996
28014,2022-09-17 11:30:00,685.85,252704.76000000432,262802.21000000427,-10097.449999999953
28015,2022-09-17 11:35:00,924.57,253629.33000000432,262802.21000000427,-9172.879999999946
28016,2022-09-17 11:40:00,8.42,253637.75000000434,262802.21000000427,-9164.459999999934
28017,2022-09-17 11:45:00,1554.54,255192.29000000434,262802.21000000427,-7609.9199999999255
28018,2022-09-17 11:50:00,338.31,255530.60000000434,262802.21000000427,-7271.609999999928
28019,2022-09-17 11:55:00,228.95,255759.55000000435,262802.21000000427,-7042.659999999916
28020,2022-09-17 12:00:00,1768.79,257528.34000000436,262802.21000000427,-5273.869999999908
28021,2022-09-17 12:05:00,731.63,258259.97000000437,262802.21000000427,-4542.239999999903
28022,2022-09-17 12:10:00,441.99,258701.96000000436,262802.21000000427,-4100.249999999913
28023,2022-09-17 12:15:00,1916.67,260618.63000000437,262802.21000000427,-2183.5799999999
28024,2022-09-17 12:20:00,-1725.95,258892.68000000436,262802.21000000427,-3909.5299999999115
28025,2022-09-17 12:25:00,-1085.51,257807.17000000435,262802.21000000427,-4995.039999999921
28026,2022-09-17 12:30:00,-785.07,257022.10000000434,262802.21000000427,-5780.109999999928
28027,2022-09-17 12:35:00,-669.64,256352.46000000433,262802.21000000427,-6449.749999999942
28028,2022-09-17 12:40:00,-1638.28,254714.18000000433,262802.21000000427,-8088.029999999941
28029,2022-09-17 12:45:00,3.84,254718.02000000433,262802.21000000427,-8084.189999999944
28030,2022-09-17 12:50:00,964.62,255682.64000000432,262802.21000000427,-7119.569999999949
28031,2022-09-17 12:55:00,-1100.2,254582.4400000043,262802.21000000427,-8219.76999999996
28032,2022-09-17 13:00:00,-770.11,253812.33000000432,262802.21000000427,-8989.879999999946
28033,2022-09-17 13:05:00,1321.67,255134.00000000434,262802.21000000427,-7668.209999999934
28034,2022-09-17 13:10:00,1533.46,256667.46000000433,262802.21000000427,-6134.749999999942
28035,2022-09-17 13:15:00,-1595.64,255071.8200000043,262802.21000000427,-7730.389999999956
28036,2022-09-17 13:20:00,-826.11,254245.71000000433,262802.21000000427,-8556.499999999942
28037,2022-09-17 13:25:00,-806.96,253438.75000000434,262802.21000000427,-9363.459999999934
28038,2022-09-17 13:30:00,-810.55,252628.20000000435,262802.21000000427,-10174.009999999922
28039,2022-09-17 13:35:00,31.63,252659.83000000435,262802.21000000427,-10142.379999999917
28040,2022-09-17 13:40:00,-667.13,251992.70000000435,262802.21000000427,-10809.509999999922
28041,2022-09-17 13:45:00,-1409.96,250582.74000000436,262802.21000000427,-12219.469999999914
28042,2022-09-17 13:50:00,-985.68,249597.06000000436,262802.21000000427,-13205.149999999907
28043,2022-09-17 13:55:00,652.44,250249.50000000437,262802.21000000427,-12552.709999999905
28044,2022-09-17 14:00:00,487.79,250737.29000000437,262802.21000000427,-12064.919999999896
28045,2022-09-17 14:05:00,-1371.93,249365.36000000438,262802.21000000427,-13436.84999999989
28046,2022-09-17 14:10:00,-870.02,248495.3400000044,262802.21000000427,-14306.869999999879
28047,2022-09-17 14:15:00,-535.77,247959.5700000044,262802.21000000427,-14842.639999999868
28048,2022-09-17 14:20:00,-95.57,247864.0000000044,262802.21000000427,-14938.209999999875
28049,2022-09-17 14:25:00,-1848.26,246015.74000000439,262802.21000000427,-16786.469999999885
28050,2022-09-17 14:30:00,1164.67,247180.4100000044,262802.21000000427,-15621.799999999872
28051,2022-09-17 14:35:00,326.16,247506.5700000044,262802.21000000427,-15295.639999999868
28052,2022-09-17 14:40:00,207.38,247713.9500000044,262802.21000000427,-15088.259999999864
28053,2022-09-17 14:45:00,1301.54,249015.4900000044,262802.21000000427,-13786.719999999856
28054,2022-09-17 14:50:00,-623.58,248391.91000000443,262802.21000000427,-14410.299999999843
28055,2022-09-17 14:55:00,784.12,249176.03000000442,262802.21000000427,-13626.179999999847
28056,2022-09-17 15:00:00,935.9,250111.93000000442,262802.21000000427,-12690.279999999853
28057,2022-09-17 15:05:00,-51.25,250060.68000000442,262802.21000000427,-12741.529999999853
28058,2022-09-17 15:10:00,-629.56,249431.12000000442,262802.21000000427,-13371.089999999851
28059,2022-09-17 15:15:00,1751.66,251182.78000000442,262802.21000000427,-11619.429999999847
28060,2022-09-17 15:20:00,-1288.09,249894.69000000443,262802.21000000427,-12907.519999999844
28061,2022-09-17 15:25:00,-1020.67,248874.0200000044,262802.21000000427,-13928.189999999857
28062,2022-09-17 15:30:00,1502.78,250376.8000000044,262802.21000000427,-12425.409999999858
28063,2022-09-17 15:35:00,-1285.69,249091.1100000044,262802.21000000427,-13711.09999999986
28064,2022-09-17 15:40:00,-1117.34,247973.7700000044,262802.21000000427,-14828.439999999857
28065,2022-09-17 15:45:00,-1658.48,246315.2900000044,262802.21000000427,-16486.919999999867
28066,2022-09-17 15:50:00,1950.85,248266.1400000044,262802.21000000427,-14536.069999999861
28067,2022-09-17 15:55:00,1892.35,250158.4900000044,262802.21000000427,-12643.719999999856
28068,2022-09-17 16:00:00,-312.15,249846.34000000442,262802.21000000427,-12955.86999999985
28069,2022-09-17 16:05:00,-149.64,249696.7000000044,262802.21000000427,-13105.509999999864
28070,2022-09-17 16:10:00,-1622.74,248073.96000000442,262802.21000000427,-14728.249999999854
28071,2022-09-17 16:15:00,-501.95,247572.0100000044,262802.21000000427,-15230.199999999866
28072,2022-09-17 16:20:00,-593.2,246978.8100000044,262802.21000000427,-15823.399999999878
28073,2022-09-17 16:25:00,-308.52,246670.2900000044,262802.21000000427,-16131.919999999867
28074,2022-09-17 16:30:00,-492.96,246177.3300000044,262802.21000000427,-16624.87999999986
28075,2022-09-17 16:35:00,734.73,246912.06000000442,262802.21000000427,-15890.149999999849
28076,2022-09-17 16:40:00,1490.0,248402.06000000442,262802.21000000427,-14400.149999999849
28077,2022-09-17 16:45:00,-262.44,248139.62000000442,262802.21000000427,-14662.589999999851
28078,2022-09-17 16:50:00,844.07,248983.69000000443,262802.21000000427,-13818.519999999844
28079,2022-09-17 16:55:00,1648.42,250632.11000000444,262802.21000000427,-12170.099999999831
28080,2022-09-18 08:00:00,808.71,251440.82000000443,250632.11000000444,808.7099999999919
28081,2022-09-18 08:05:00,-150.6,251290.22000000442,250632.11000000444,658.109999999986
28082,2022-09-18 08:10:00,-1022.6,250267.62000000442,250632.11000000444,-364.4900000000198
28083,2022-09-18 08:15:00,273.68,250541.3000000044,250632.11000000444,-90.81000000002678
28084,2022-09-18 08:20:00,1480.86,252022.1600000044,250632.11000000444,1390.0499999999593
28085,2022-09-18 08:25:00,1200.47,253222.6300000044,250632.11000000444,2590.5199999999604
28086,2022-09-18 08:30:00,1190.55,254413.1800000044,250632.11000000444,3781.069999999949
28087,2022-09-18 08:35:00,1687.13,256100.3100000044,250632.11000000444,5468.199999999953
28088,2022-09-18 08:40:00,-1880.49,254219.8200000044,250632.11000000444,3587.7099999999627
28089,2022-09-18 08:45:00,1816.27,256036.0900000044,250632.11000000444,5403.979999999952
28090,2022-09-18 08:50:00,168.6,256204.6900000044,250632.11000000444,5572.579999999958
28091,2022-09-18 08:55:00,652.34,256857.0300000044,250632.11000000444,6224.919999999955
28092,2022-09-18 09:00:00,1046.88,257903.9100000044,250632.11000000444,7271.799999999959
28093,2022-09-18 09:05:00,-2.26,257901.6500000044,250632.11000000444,7269.53999999995
28094,2022-09-18 09:10:00,-1439.17,256462.48000000438,250632.11000000444,5830.369999999937
28095,2022-09-18 09:15:00,-130.35,256332.13000000437,250632.11000000444,5700.019999999931
28096,2022-09-18 09:20:00,143.14,256475.27000000438,250632.11000000444,5843.159999999945
28097,2022-09-18 09:25:00,875.31,257350.58000000438,250632.11000000444,6718.469999999943
28098,2022-09-18 09:30:00,-1346.91,256003.67000000438,250632.11000000444,5371.5599999999395
28099,2022-09-18 09:35:00,1015.34,257019.01000000437,250632.11000000444,6386.899999999936
28100,2022-09-18 09:40:00,-1024.51,255994.50000000437,250632.11000000444,5362.389999999927
28101,2022-09-18 09:45:00,-1073.47,254921.03000000436,250632.11000000444,4288.9199999999255
28102,2022-09-18 09:50:00,-260.56,254660.47000000437,250632.11000000444,4028.359999999928
28103,2022-09-18 09:55:00,-1381.94,253278.53000000436,250632.11000000444,2646.4199999999255
28104,2022-09-18 10:00:00,21.43,253299.96000000436,250632.11000000444,2667.8499999999185
28105,2022-09-18 10:05:00,316.59,253616.55000000435,250632.11000000444,2984.439999999915
28106,2022-09-18 10:10:00,14.45,253631.00000000437,250632.11000000444,2998.8899999999267
28107,2022-09-18 10:15:00,-1318.45,252312.55000000435,250632.11000000444,1680.439999999915
28108,2022-09-18 10:20:00,-1716.63,250595.92000000435,250632.11000000444,-36.19000000008964
28109,2022-09-18 10:25:00,-1750.62,248845.30000000435,250632.11000000444,-1786.810000000085
28110,2022-09-18 10:30:00,-327.66,248517.64000000435,250632.11000000444,-2114.4700000000885
28111,2022-09-18 10:35:00,-1878.12,246639.52000000436,250632.11000000444,-3992.590000000084
28112,2022-09-18 10:40:00,-1133.1,245506.42000000435,250632.11000000444,-5125.69000000009
28113,2022-09-18 10:45:00,957.49,246463.91000000434,250632.11000000444,-4168.200000000099
28114,2022-09-18 10:50:00,439.94,246903.85000000434,250632.11000000444,-3728.2600000000966
28115,2022-09-18 10:55:00,1516.66,248420.51000000435,250632.11000000444,-2211.600000000093
28116,2022-09-18 11:00:00,-1677.24,246743.27000000436,250632.11000000444,-3888.840000000084
28117,2022-09-18 11:05:00,1957.22,248700.49000000436,250632.11000000444,-1931.6200000000827
28118,2022-09-18 11:10:00,-1404.08,247296.41000000437,250632.11000000444,-3335.70000000007
28119,2022-09-18 11:15:00,637.94,247934.35000000437,250632.11000000444,-2697.7600000000675
28120,2022-09-18 11:20:00,-818.93,247115.42000000438,250632.11000000444,-3516.6900000000605
28121,2022-09-18 11:25:00,1037.47,248152.89000000438,250632.11000000444,-2479.2200000000594
28122,2022-09-18 11:30:00,-977.94,247174.95000000438,250632.11000000444,-3457.1600000000617
28123,2022-09-18 11:35:00,261.57,247436.52000000438,250632.11000000444,-3195.5900000000547
28124,2022-09-18 11:40:00,1013.51,248450.0300000044,250632.11000000444,-2182.0800000000454
28125,2022-09-18 11:45:00,1880.67,250330.7000000044,250632.11000000444,-301.4100000000326
28126,2022-09-18 11:50:00,-1863.83,248466.87000000442,250632.11000000444,-2165.24000000002
28127,2022-09-18 11:55:00,764.76,249231.63000000443,250632.11000000444,-1400.4800000000105
28128,2022-09-18 12:00:00,1076.41,250308.04000000443,250632.11000000444,-324.070000000007
28129,2022-09-18 12:05:00,-685.27,249622.77000000444,250632.11000000444,-1009.3399999999965
28130,2022-09-18 12:10:00,707.12,250329.89000000444,250632.11000000444,-302.22000000000116
28131,2022-09-18 12:15:00,1854.91,252184.80000000444,250632.11000000444,1552.6900000000023
28132,2022-09-18 12:20:00,803.92,252988.72000000445,250632.11000000444,2356.610000000015
28133,2022-09-18 12:25:00,1599.12,254587.84000000445,250632.11000000444,3955.7300000000105
28134,2022-09-18 12:30:00,-661.85,253925.99000000444,250632.11000000444,3293.8800000000047
28135,2022-09-18 12:35:00,1070.31,254996.30000000444,250632.11000000444,4364.190000000002
28136,2022-09-18 12:40:00,-1574.34,253421.96000000444,250632.11000000444,2789.850000000006
28137,2022-09-18 12:45:00,211.2,253633.16000000446,250632.11000000444,3001.0500000000175
28138,2022-09-18 12:50:00,939.46,254572.62000000445,250632.11000000444,3940.5100000000093
28139,2022-09-18 12:55:00,-1851.46,252721.16000000446,250632.11000000444,2089.0500000000175
28140,2022-09-18 13:00:00,900.02,253621.18000000445,250632.11000000444,2989.070000000007
28141,2022-09-18 13:05:00,1867.34,255488.52000000444,250632.11000000444,4856.4100000000035
28142,2022-09-18 13:10:00,526.62,256015.14000000444,250632.11000000444,5383.029999999999
28143,2022-09-18 13:15:00,701.7,256716.84000000445,250632.11000000444,6084.7300000000105
28144,2022-09-18 13:20:00,-1089.95,255626.89000000444,250632.11000000444,4994.779999999999
28145,2022-09-18 13:25:00,996.97,256623.86000000444,250632.11000000444,5991.75
28146,2022-09-18 13:30:00,602.45,257226.31000000445,250632.11000000444,6594.200000000012
28147,2022-09-18 13:35:00,-755.98,256470.33000000444,250632.11000000444,5838.220000000001
28148,2022-09-18 13:40:00,1514.48,257984.81000000445,250632.11000000444,7352.700000000012
28149,2022-09-18 13:45:00,799.46,258784.27000000444,250632.11000000444,8152.1600000000035
28150,2022-09-18 13:50:00,-1425.15,257359.12000000445,250632.11000000444,6727.010000000009
28151,2022-09-18 13:55:00,-310.12,257049.00000000445,250632.11000000444,6416.890000000014
28152,2022-09-18 14:00:00,-533.88,256515.12000000445,250632.11000000444,5883.010000000009
28153,2022-09-18 14:05:00,-431.22,256083.90000000445,250632.11000000444,5451.790000000008
28154,2022-09-18 14:10:00,209.5,256293.40000000445,250632.11000000444,5661.290000000008
28155,2022-09-18 14:15:00,509.32,256802.72000000445,250632.11000000444,6170.610000000015
28156,2022-09-18 14:20:00,-506.48,256296.24000000444,250632.11000000444,5664.130000000005
28157,2022-09-18 14:25:00,-931.53,255364.71000000444,250632.11000000444,4732.600000000006
28158,2022-09-18 14:30:00,1438.15,256802.86000000444,250632.11000000444,6170.75
28159,2022-09-18 14:35:00,-716.81,256086.05000000444,250632.11000000444,5453.940000000002
28160,2022-09-18 14:40:00,-1929.39,254156.66000000443,250632.11000000444,3524.5499999999884
28161,2022-09-18 14:45:00,-1870.6,252286.06000000442,250632.11000000444,1653.9499999999825
28162,2022-09-18 14:50:00,-1447.61,250838.45000000444,250632.11000000444,206.3399999999965
28163,2022-09-18 14:55:00,1434.95,252273.40000000445,250632.11000000444,1641.2900000000081
28164,2022-09-18 15:00:00,-1025.62,251247.78000000445,250632.11000000444,615.6700000000128
28165,2022-09-18 15:05:00,1776.03,253023.81000000445,250632.11000000444,2391.7000000000116
28166,2022-09-18 15:10:00,-53.42,252970.39000000444,250632.11000000444,2338.279999999999
28167,2022-09-18 15:15:00,136.5,253106.89000000444,250632.11000000444,2474.779999999999
28168,2022-09-18 15:20:00,593.49,253700.38000000443,250632.11000000444,3068.2699999999895
28169,2022-09-18 15:25:00,1836.8,255537.18000000442,250632.11000000444,4905.069999999978
28170,2022-09-18 15:30:00,770.47,256307.65000000442,250632.11000000444,5675.539999999979
28171,2022-09-18 15:35:00,1682.04,257989.69000000443,250632.11000000444,7357.579999999987
28172,2022-09-18 15:40:00,678.86,258668.5500000044,250632.11000000444,8036.439999999973
28173,2022-09-18 15:45:00,-409.89,258258.6600000044,250632.11000000444,7626.549999999959
28174,2022-09-18 15:50:00,-1536.74,256721.9200000044,250632.11000000444,6089.809999999969
28175,2022-09-18 15:55:00,725.07,257446.9900000044,250632.11000000444,6814.879999999976
28176,2022-09-18 16:00:00,-1908.5,255538.4900000044,250632.11000000444,4906.379999999976
28177,2022-09-18 16:05:00,511.87,256050.3600000044,250632.11000000444,5418.249999999971
28178,2022-09-18 16:10:00,-1009.53,255040.8300000044,250632.11000000444,4408.719999999972
28179,2022-09-18 16:15:00,-457.06,254583.7700000044,250632.11000000444,3951.6599999999744
28180,2022-09-18 16:20:00,-781.11,253802.66000000443,250632.11000000444,3170.5499999999884
28181,2022-09-18 16:25:00,147.79,253950.45000000444,250632.11000000444,3318.3399999999965
28182,2022-09-18 16:30:00,-1813.35,252137.10000000443,250632.11000000444,1504.9899999999907
28183,2022-09-18 16:35:00,-328.3,251808.80000000444,250632.11000000444,1176.6900000000023
28184,2022-09-18 16:40:00,-1026.66,250782.14000000444,250632.11000000444,150.02999999999884
28185,2022-09-18 16:45:00,1007.28,251789.42000000444,250632.11000000444,1157.3099999999977
28186,2022-09-18 16:50:00,24.01,251813.43000000445,250632.11000000444,1181.320000000007
28187,2022-09-18 16:55:00,-512.07,251301.36000000444,250632.11000000444,669.25
28188,2022-09-19 08:00:00,-385.27,250916.09000000445,251301.36000000444,-385.2699999999895
28189,2022-09-19 08:05:00,702.07,251618.16000000446,251301.36000000444,316.80000000001746
28190,2022-09-19 08:10:00,-1601.64,250016.52000000444,251301.36000000444,-1284.8399999999965
28191,2022-09-19 08:15:00,-1729.1,248287.42000000444,251301.36000000444,-3013.9400000000023
28192,2022-09-19 08:20:00,627.24,248914.66000000443,251301.36000000444,-2386.7000000000116
28193,2022-09-19 08:25:00,-559.24,248355.42000000444,251301.36000000444,-2945.9400000000023
28194,2022-09-19 08:30:00,-1811.07,246544.35000000443,251301.36000000444,-4757.010000000009
28195,2022-09-19 08:35:00,-1819.94,244724.41000000443,251301.36000000444,-6576.950000000012
28196,2022-09-19 08:40:00,-966.76,243757.65000000442,251301.36000000444,-7543.710000000021
28197,2022-09-19 08:45:00,949.91,244707.56000000442,251301.36000000444,-6593.8000000000175
28198,2022-09-19 08:50:00,112.84,244820.40000000442,251301.36000000444,-6480.960000000021
28199,2022-09-19 08:55:00,-737.93,244082.47000000442,251301.36000000444,-7218.890000000014
28200,2022-09-19 09:00:00,-544.52,243537.95000000444,251301.36000000444,-7763.4100000000035
28201,2022-09-19 09:05:00,-476.09,243061.86000000444,251301.36000000444,-8239.5
28202,2022-09-19 09:10:00,736.97,243798.83000000444,251301.36000000444,-7502.529999999999
28203,2022-09-19 09:15:00,58.11,243856.94000000443,251301.36000000444,-7444.420000000013
28204,2022-09-19 09:20:00,-926.7,242930.2400000044,251301.36000000444,-8371.120000000024
28205,2022-09-19 09:25:00,-1417.52,241512.72000000442,251301.36000000444,-9788.640000000014
28206,2022-09-19 09:30:00,-1032.53,240480.19000000443,251301.36000000444,-10821.170000000013
28207,2022-09-19 09:35:00,-296.55,240183.64000000444,251301.36000000444,-11117.720000000001
28208,2022-09-19 09:40:00,-1488.53,238695.11000000444,251301.36000000444,-12606.25
28209,2022-09-19 09:45:00,810.77,239505.88000000443,251301.36000000444,-11795.48000000001
28210,2022-09-19 09:50:00,-119.4,239386.48000000443,251301.36000000444,-11914.880000000005
28211,2022-09-19 09:55:00,608.44,239994.92000000444,251301.36000000444,-11306.440000000002
28212,2022-09-19 10:00:00,-1782.69,238212.23000000443,251301.36000000444,-13089.130000000005
28213,2022-09-19 10:05:00,-1466.27,236745.96000000444,251301.36000000444,-14555.399999999994
28214,2022-09-19 10:10:00,-1527.93,235218.03000000445,251301.36000000444,-16083.329999999987
28215,2022-09-19 10:15:00,-853.35,234364.68000000445,251301.36000000444,-16936.679999999993
28216,2022-09-19 10:20:00,1206.31,235570.99000000444,251301.36000000444,-15730.369999999995
28217,2022-09-19 10:25:00,-1420.03,234150.96000000444,251301.36000000444,-17150.399999999994
28218,2022-09-19 10:30:00,-443.97,233706.99000000444,251301.36000000444,-17594.369999999995
28219,2022-09-19 10:35:00,-575.37,233131.62000000445,251301.36000000444,-18169.73999999999
28220,2022-09-19 10:40:00,1203.9,234335.52000000444,251301.36000000444,-16965.839999999997
28221,2022-09-19 10:45:00,747.88,235083.40000000445,251301.36000000444,-16217.959999999992
28222,2022-09-19 10:50:00,-123.44,234959.96000000444,251301.36000000444,-16341.399999999994
28223,2022-09-19 10:55:00,949.21,235909.17000000444,251301.36000000444,-15392.190000000002
28224,2022-09-19 11:00:00,-607.12,235302.05000000444,251301.36000000444,-15999.309999999998
28225,2022-09-19 11:05:00,-1519.36,233782.69000000446,251301.36000000444,-17518.669999999984
28226,2022-09-19 11:10:00,-1897.27,231885.42000000447,251301.36000000444,-19415.939999999973
28227,2022-09-19 11:15:00,-852.18,231033.24000000447,251301.36000000444,-20268.119999999966
28228,2022-09-19 11:20:00,6.74,231039.98000000446,251301.36000000444,-20261.379999999976
28229,2022-09-19 11:25:00,-1496.08,229543.90000000448,251301.36000000444,-21757.459999999963
28230,2022-09-19 11:30:00,-569.73,228974.17000000447,251301.36000000444,-22327.189999999973
28231,2022-09-19 11:35:00,-1937.81,227036.36000000447,251301.36000000444,-24264.99999999997
28232,2022-09-19 11:40:00,1441.92,228478.28000000448,251301.36000000444,-22823.079999999958
28233,2022-09-19 11:45:00,1304.51,229782.7900000045,251301.36000000444,-21518.56999999995
28234,2022-09-19 11:50:00,-128.82,229653.97000000448,251301.36000000444,-21647.389999999956
28235,2022-09-19 11:55:00,-1369.46,228284.5100000045,251301.36000000444,-23016.849999999948
28236,2022-09-19 12:00:00,-439.0,227845.5100000045,251301.36000000444,-23455.849999999948
28237,2022-09-19 12:05:00,842.12,228687.6300000045,251301.36000000444,-22613.729999999952
28238,2022-09-19 12:10:00,-223.53,228464.1000000045,251301.36000000444,-22837.25999999995
28239,2022-09-19 12:15:00,-971.59,227492.5100000045,251301.36000000444,-23808.849999999948
28240,2022-09-19 12:20:00,-678.47,226814.0400000045,251301.36000000444,-24487.31999999995
28241,2022-09-19 12:25:00,1931.49,228745.53000000448,251301.36000000444,-22555.829999999958
28242,2022-09-19 12:30:00,237.52,228983.05000000447,251301.36000000444,-22318.30999999997
28243,2022-09-19 12:35:00,1348.85,230331.90000000448,251301.36000000444,-20969.459999999963
28244,2022-09-19 12:40:00,-1272.89,229059.01000000446,251301.36000000444,-22242.349999999977
28245,2022-09-19 12:45:00,-1732.92,227326.09000000445,251301.36000000444,-23975.26999999999
28246,2022-09-19 12:50:00,-1307.24,226018.85000000446,251301.36000000444,-25282.50999999998
28247,2022-09-19 12:55:00,-1549.57,224469.28000000445,251301.36000000444,-26832.079999999987
28248,2022-09-19 13:00:00,1560.08,226029.36000000444,251301.36000000444,-25272.0
28249,2022-09-19 13:05:00,1310.16,227339.52000000444,251301.36000000444,-23961.839999999997
28250,2022-09-19 13:10:00,1958.78,229298.30000000444,251301.36000000444,-22003.059999999998
28251,2022-09-19 13:15:00,1355.5,230653.80000000444,251301.36000000444,-20647.559999999998
28252,2022-09-19 13:20:00,1141.55,231795.35000000443,251301.36000000444,-19506.01000000001
28253,2022-09-19 13:25:00,-1439.54,230355.81000000442,251301.36000000444,-20945.550000000017
28254,2022-09-19 13:30:00,337.2,230693.01000000443,251301.36000000444,-20608.350000000006
28255,2022-09-19 13:35:00,-1874.03,228818.98000000443,251301.36000000444,-22482.380000000005
28256,2022-09-19 13:40:00,1765.15,230584.13000000443,251301.36000000444,-20717.23000000001
28257,2022-09-19 13:45:00,1875.63,232459.76000000443,251301.36000000444,-18841.600000000006
28258,2022-09-19 13:50:00,1367.22,233826.98000000443,251301.36000000444,-17474.380000000005
28259,2022-09-19 13:55:00,-1486.26,232340.72000000442,251301.36000000444,-18960.640000000014
28260,2022-09-19 14:00:00,-982.21,231358.51000000443,251301.36000000444,-19942.850000000006
28261,2022-09-19 14:05:00,-1729.85,229628.66000000443,251301.36000000444,-21672.70000000001
28262,2022-09-19 14:10:00,-1342.36,228286.30000000444,251301.36000000444,-23015.059999999998
28263,2022-09-19 14:15:00,-189.55,228096.75000000445,251301.36000000444,-23204.609999999986
28264,2022-09-19 14:20:00,-653.14,227443.61000000444,251301.36000000444,-23857.75
28265,2022-09-19 14:25:00,-1553.58,225890.03000000445,251301.36000000444,-25411.329999999987
28266,2022-09-19 14:30:00,-1958.14,223931.89000000444,251301.36000000444,-27369.47
28267,2022-09-19 14:35:00,-207.27,223724.62000000445,251301.36000000444,-27576.73999999999
28268,2022-09-19 14:40:00,-1680.26,222044.36000000444,251301.36000000444,-29257.0
28269,2022-09-19 14:45:00,-844.41,221199.95000000444,251301.36000000444,-30101.410000000003
28270,2022-09-19 14:50:00,565.06,221765.01000000443,251301.36000000444,-29536.350000000006
28271,2022-09-19 14:55:00,165.28,221930.29000000443,251301.36000000444,-29371.070000000007
28272,2022-09-19 15:00:00,368.61,222298.90000000442,251301.36000000444,-29002.46000000002
28273,2022-09-19 15:05:00,141.19,222440.09000000442,251301.36000000444,-28861.27000000002
28274,2022-09-19 15:10:00,-1358.92,221081.1700000044,251301.36000000444,-30220.19000000003
28275,2022-09-19 15:15:00,-1125.08,219956.09000000442,251301.36000000444,-31345.27000000002
28276,2022-09-19 15:20:00,-553.13,219402.96000000442,251301.36000000444,-31898.400000000023
28277,2022-09-19 15:25:00,548.78,219951.7400000044,251301.36000000444,-31349.620000000024
28278,2022-09-19 15:30:00,-1860.42,218091.3200000044,251301.36000000444,-33210.04000000004
28279,2022-09-19 15:35:00,242.78,218334.1000000044,251301.36000000444,-32967.26000000004
28280,2022-09-19 15:40:00,-1268.79,217065.3100000044,251301.36000000444,-34236.05000000005
28281,2022-09-19 15:45:00,1318.12,218383.4300000044,251301.36000000444,-32917.93000000005
28282,2022-09-19 15:50:00,1111.08,219494.51000000437,251301.36000000444,-31806.850000000064
28283,2022-09-19 15:55:00,-1391.18,218103.33000000438,251301.36000000444,-33198.03000000006
28284,2022-09-19 16:00:00,1598.23,219701.5600000044,251301.36000000444,-31599.800000000047
28285,2022-09-19 16:05:00,-74.04,219627.52000000438,251301.36000000444,-31673.840000000055
28286,2022-09-19 16:10:00,587.0,220214.52000000438,251301.36000000444,-31086.840000000055
28287,2022-09-19 16:15:00,487.22,220701.74000000439,251301.36000000444,-30599.620000000054
28288,2022-09-19 16:20:00,-660.9,220040.8400000044,251301.36000000444,-31260.520000000048
28289,2022-09-19 16:25:00,1288.07,221328.9100000044,251301.36000000444,-29972.45000000004
28290,2022-09-19 16:30:00,10.83,221339.74000000439,251301.36000000444,-29961.620000000054
28291,2022-09-19 16:35:00,-1460.38,219879.36000000438,251301.36000000444,-31422.00000000006
28292,2022-09-19 16:40:00,1076.29,220955.6500000044,251301.36000000444,-30345.71000000005
28293,2022-09-19 16:45:00,60.72,221016.3700000044,251301.36000000444,-30284.99000000005
28294,2022-09-19 16:50:00,-517.6,220498.77000000438,251301.36000000444,-30802.590000000055
28295,2022-09-19 16:55:00,146.76,220645.5300000044,251301.36000000444,-30655.830000000045
28296,2022-09-20 08:00:00,-1953.83,218691.7000000044,220645.5300000044,-1953.8299999999872
28297,2022-09-20 08:05:00,354.57,219046.2700000044,220645.5300000044,-1599.2599999999802
28298,2022-09-20 08:10:00,242.36,219288.6300000044,220645.5300000044,-1356.8999999999942
28299,2022-09-20 08:15:00,-1010.16,218278.4700000044,220645.5300000044,-2367.0599999999977
28300,2022-09-20 08:20:00,-1407.67,216870.80000000438,220645.5300000044,-3774.7300000000105
28301,2022-09-20 08:25:00,1710.12,218580.92000000438,220645.5300000044,-2064.610000000015
28302,2022-09-20 08:30:00,107.32,218688.24000000439,220645.5300000044,-1957.2900000000081
28303,2022-09-20 08:35:00,1029.05,219717.29000000437,220645.5300000044,-928.2400000000198
28304,2022-09-20 08:40:00,864.95,220582.24000000439,220645.5300000044,-63.29000000000815
28305,2022-09-20 08:45:00,918.26,221500.5000000044,220645.5300000044,854.9700000000012
28306,2022-09-20 08:50:00,814.9,222315.4000000044,220645.5300000044,1669.8699999999953
28307,2022-09-20 08:55:00,725.52,223040.92000000438,220645.5300000044,2395.389999999985
28308,2022-09-20 09:00:00,-1185.73,221855.19000000437,220645.5300000044,1209.6599999999744
28309,2022-09-20 09:05:00,-163.54,221691.65000000436,220645.5300000044,1046.1199999999662
28310,2022-09-20 09:10:00,1370.63,223062.28000000436,220645.5300000044,2416.749999999971
28311,2022-09-20 09:15:00,-1219.17,221843.11000000435,220645.5300000044,1197.579999999958
28312,2022-09-20 09:20:00,1003.29,222846.40000000436,220645.5300000044,2200.8699999999662
28313,2022-09-20 09:25:00,1696.81,224543.21000000436,220645.5300000044,3897.679999999964
28314,2022-09-20 09:30:00,750.03,225293.24000000436,220645.5300000044,4647.709999999963
28315,2022-09-20 09:35:00,1928.21,227221.45000000435,220645.5300000044,6575.919999999955
28316,2022-09-20 09:40:00,1574.94,228796.39000000435,220645.5300000044,8150.859999999957
28317,2022-09-20 09:45:00,1190.12,229986.51000000435,220645.5300000044,9340.979999999952
28318,2022-09-20 09:50:00,-4.98,229981.53000000434,220645.5300000044,9335.999999999942
28319,2022-09-20 09:55:00,65.19,230046.72000000434,220645.5300000044,9401.189999999944
28320,2022-09-20 10:00:00,-873.7,229173.02000000433,220645.5300000044,8527.489999999932
28321,2022-09-20 10:05:00,438.76,229611.78000000434,220645.5300000044,8966.249999999942
28322,2022-09-20 10:10:00,-1499.1,228112.68000000433,220645.5300000044,7467.149999999936
28323,2022-09-20 10:15:00,557.02,228669.70000000432,220645.5300000044,8024.1699999999255
28324,2022-09-20 10:20:00,-1756.76,226912.9400000043,220645.5300000044,6267.409999999916
28325,2022-09-20 10:25:00,1118.24,228031.1800000043,220645.5300000044,7385.649999999907
28326,2022-09-20 10:30:00,733.28,228764.4600000043,220645.5300000044,8118.929999999906
28327,2022-09-20 10:35:00,-582.76,228181.7000000043,220645.5300000044,7536.169999999896
28328,2022-09-20 10:40:00,-802.75,227378.9500000043,220645.5300000044,6733.419999999896
28329,2022-09-20 10:45:00,-38.64,227340.31000000428,220645.5300000044,6694.779999999882
28330,2022-09-20 10:50:00,408.53,227748.84000000427,220645.5300000044,7103.309999999881
28331,2022-09-20 10:55:00,1886.22,229635.06000000428,220645.5300000044,8989.529999999882
28332,2022-09-20 11:00:00,-1305.08,228329.9800000043,220645.5300000044,7684.449999999895
28333,2022-09-20 11:05:00,-153.56,228176.4200000043,220645.5300000044,7530.889999999898
28334,2022-09-20 11:10:00,1451.98,229628.4000000043,220645.5300000044,8982.869999999908
28335,2022-09-20 11:15:00,-659.91,228968.4900000043,220645.5300000044,8322.959999999905
28336,2022-09-20 11:20:00,-1114.6,227853.8900000043,220645.5300000044,7208.359999999899
28337,2022-09-20 11:25:00,1373.92,229227.8100000043,220645.5300000044,8582.279999999912
28338,2022-09-20 11:30:00,930.03,230157.8400000043,220645.5300000044,9512.30999999991
28339,2022-09-20 11:35:00,-561.98,229595.8600000043,220645.5300000044,8950.3299999999
28340,2022-09-20 11:40:00,1369.8,230965.66000000428,220645.5300000044,10320.129999999888
28341,2022-09-20 11:45:00,-1975.27,228990.3900000043,220645.5300000044,8344.859999999899
28342,2022-09-20 11:50:00,-726.25,228264.1400000043,220645.5300000044,7618.609999999899
28343,2022-09-20 11:55:00,1484.12,229748.2600000043,220645.5300000044,9102.729999999894
28344,2022-09-20 12:00:00,-671.95,229076.31000000428,220645.5300000044,8430.779999999882
28345,2022-09-20 12:05:00,1216.46,230292.77000000427,220645.5300000044,9647.239999999874
28346,2022-09-20 12:10:00,-1932.38,228360.39000000426,220645.5300000044,7714.85999999987
28347,2022-09-20 12:15:00,-804.78,227555.61000000426,220645.5300000044,6910.079999999871
28348,2022-09-20 12:20:00,-828.06,226727.55000000427,220645.5300000044,6082.019999999873
28349,2022-09-20 12:25:00,-1724.79,225002.76000000426,220645.5300000044,4357.229999999865
28350,2022-09-20 12:30:00,629.1,225631.86000000426,220645.5300000044,4986.329999999871
28351,2022-09-20 12:35:00,813.52,226445.38000000425,220645.5300000044,5799.84999999986
28352,2022-09-20 12:40:00,-965.64,225479.74000000424,220645.5300000044,4834.209999999846
28353,2022-09-20 12:45:00,-1542.88,223936.86000000424,220645.5300000044,3291.3299999998417
28354,2022-09-20 12:50:00,-1814.57,222122.29000000423,220645.5300000044,1476.7599999998347
28355,2022-09-20 12:55:00,-1183.96,220938.33000000424,220645.5300000044,292.79999999984284
28356,2022-09-20 13:00:00,622.24,221560.57000000423,220645.5300000044,915.0399999998335
28357,2022-09-20 13:05:00,-1769.44,219791.13000000422,220645.5300000044,-854.4000000001688
28358,2022-09-20 13:10:00,653.34,220444.47000000422,220645.5300000044,-201.0600000001723
28359,2022-09-20 13:15:00,1991.68,222436.1500000042,220645.5300000044,1790.6199999998207
28360,2022-09-20 13:20:00,-1568.56,220867.59000000422,220645.5300000044,222.05999999982305
28361,2022-09-20 13:25:00,-1141.4,219726.19000000422,220645.5300000044,-919.3400000001711
28362,2022-09-20 13:30:00,274.54,220000.73000000423,220645.5300000044,-644.800000000163
28363,2022-09-20 13:35:00,-165.83,219834.90000000424,220645.5300000044,-810.6300000001502
28364,2022-09-20 13:40:00,1280.86,221115.76000000423,220645.5300000044,470.22999999983585
28365,2022-09-20 13:45:00,-479.08,220636.68000000424,220645.5300000044,-8.85000000015134
28366,2022-09-20 13:50:00,171.69,220808.37000000424,220645.5300000044,162.839999999851
28367,2022-09-20 13:55:00,1690.48,222498.85000000425,220645.5300000044,1853.3199999998615
28368,2022-09-20 14:00:00,1328.31,223827.16000000425,220645.5300000044,3181.629999999859
28369,2022-09-20 14:05:00,-353.3,223473.86000000426,220645.5300000044,2828.329999999871
28370,2022-09-20 14:10:00,-1885.01,221588.85000000425,220645.5300000044,943.3199999998615
28371,2022-09-20 14:15:00,640.22,222229.07000000426,220645.5300000044,1583.5399999998626
28372,2022-09-20 14:20:00,-1531.48,220697.59000000425,220645.5300000044,52.05999999985215
28373,2022-09-20 14:25:00,-271.65,220425.94000000425,220645.5300000044,-219.59000000014203
28374,2022-09-20 14:30:00,-822.92,219603.02000000424,220645.5300000044,-1042.5100000001548
28375,2022-09-20 14:35:00,1387.93,220990.95000000423,220645.5300000044,345.4199999998382
28376,2022-09-20 14:40:00,-164.9,220826.05000000424,220645.5300000044,180.519999999844
28377,2022-09-20 14:45:00,-1174.31,219651.74000000424,220645.5300000044,-993.7900000001537
28378,2022-09-20 14:50:00,-1514.39,218137.35000000423,220645.5300000044,-2508.1800000001676
28379,2022-09-20 14:55:00,-632.81,217504.54000000423,220645.5300000044,-3140.9900000001653
28380,2022-09-20 15:00:00,-132.71,217371.83000000424,220645.5300000044,-3273.700000000157
28381,2022-09-20 15:05:00,-359.45,217012.38000000422,220645.5300000044,-3633.150000000169
28382,2022-09-20 15:10:00,1130.72,218143.10000000423,220645.5300000044,-2502.4300000001676
28383,2022-09-20 15:15:00,1786.96,219930.06000000422,220645.5300000044,-715.4700000001758
28384,2022-09-20 15:20:00,-41.41,219888.6500000042,220645.5300000044,-756.8800000001793
28385,2022-09-20 15:25:00,-822.34,219066.31000000422,220645.5300000044,-1579.2200000001758
28386,2022-09-20 15:30:00,-549.88,218516.4300000042,220645.5300000044,-2129.1000000001804
28387,2022-09-20 15:35:00,-1600.77,216915.66000000422,220645.5300000044,-3729.87000000017
28388,2022-09-20 15:40:00,1108.01,218023.67000000423,220645.5300000044,-2621.8600000001607
28389,2022-09-20 15:45:00,1518.56,219542.23000000423,220645.5300000044,-1103.300000000163
28390,2022-09-20 15:50:00,1516.66,221058.89000000423,220645.5300000044,413.3599999998405
28391,2022-09-20 15:55:00,-1832.17,219226.72000000422,220645.5300000044,-1418.8100000001723
28392,2022-09-20 16:00:00,100.28,219327.00000000422,220645.5300000044,-1318.5300000001735
28393,2022-09-20 16:05:00,690.34,220017.34000000422,220645.5300000044,-628.190000000177
28394,2022-09-20 16:10:00,1518.27,221535.6100000042,220645.5300000044,890.0799999998126
28395,2022-09-20 16:15:00,1055.6,222591.2100000042,220645.5300000044,1945.6799999998184
28396,2022-09-20 16:20:00,-1918.76,220672.4500000042,220645.5300000044,26.91999999980908
28397,2022-09-20 16:25:00,-462.99,220209.4600000042,220645.5300000044,-436.0700000001816
28398,2022-09-20 16:30:00,1966.7,222176.16000000422,220645.5300000044,1530.62999999983
28399,2022-09-20 16:35:00,650.07,222826.23000000423,220645.5300000044,2180.699999999837
28400,2022-09-20 16:40:00,1642.67,224468.90000000424,220645.5300000044,3823.36999999985
28401,2022-09-20 16:45:00,297.71,224766.61000000424,220645.5300000044,4121.079999999842
28402,2022-09-20 16:50:00,-493.97,224272.64000000423,220645.5300000044,3627.1099999998405
28403,2022-09-20 16:55:00,389.01,224661.65000000424,220645.5300000044,4016.11999999985
28404,2022-09-21 08:00:00,-574.7,224086.95000000423,224661.65000000424,-574.7000000000116
28405,2022-09-21 08:05:00,89.02,224175.97000000422,224661.65000000424,-485.6800000000221
28406,2022-09-21 08:10:00,1838.19,226014.16000000422,224661.65000000424,1352.5099999999802
28407,2022-09-21 08:15:00,1411.42,227425.58000000424,224661.65000000424,2763.929999999993
28408,2022-09-21 08:20:00,408.07,227833.65000000424,224661.65000000424,3172.0
28409,2022-09-21 08:25:00,1887.43,229721.08000000424,224661.65000000424,5059.429999999993
28410,2022-09-21 08:30:00,-313.99,229407.09000000425,224661.65000000424,4745.440000000002
28411,2022-09-21 08:35:00,-1597.28,227809.81000000425,224661.65000000424,3148.1600000000035
28412,2022-09-21 08:40:00,1915.37,229725.18000000424,224661.65000000424,5063.529999999999
28413,2022-09-21 08:45:00,1811.83,231537.01000000423,224661.65000000424,6875.359999999986
28414,2022-09-21 08:50:00,-1855.34,229681.67000000423,224661.65000000424,5020.0199999999895
28415,2022-09-21 08:55:00,-1062.77,228618.90000000424,224661.65000000424,3957.25
28416,2022-09-21 09:00:00,1557.96,230176.86000000424,224661.65000000424,5515.209999999992
28417,2022-09-21 09:05:00,226.41,230403.27000000424,224661.65000000424,5741.619999999995
28418,2022-09-21 09:10:00,1400.77,231804.04000000423,224661.65000000424,7142.389999999985
28419,2022-09-21 09:15:00,206.71,232010.75000000422,224661.65000000424,7349.099999999977
28420,2022-09-21 09:20:00,1842.32,233853.07000000423,224661.65000000424,9191.419999999984
28421,2022-09-21 09:25:00,1804.01,235657.08000000424,224661.65000000424,10995.429999999993
28422,2022-09-21 09:30:00,247.22,235904.30000000424,224661.65000000424,11242.649999999994
28423,2022-09-21 09:35:00,1314.2,237218.50000000425,224661.65000000424,12556.850000000006
28424,2022-09-21 09:40:00,1050.94,238269.44000000425,224661.65000000424,13607.790000000008
28425,2022-09-21 09:45:00,212.05,238481.49000000424,224661.65000000424,13819.839999999997
28426,2022-09-21 09:50:00,-1799.21,236682.28000000425,224661.65000000424,12020.630000000005
28427,2022-09-21 09:55:00,1810.74,238493.02000000424,224661.65000000424,13831.369999999995
28428,2022-09-21 10:00:00,116.34,238609.36000000424,224661.65000000424,13947.709999999992
28429,2022-09-21 10:05:00,-376.63,238232.73000000423,224661.65000000424,13571.079999999987
28430,2022-09-21 10:10:00,-787.28,237445.45000000423,224661.65000000424,12783.799999999988
28431,2022-09-21 10:15:00,859.71,238305.16000000422,224661.65000000424,13643.50999999998
28432,2022-09-21 10:20:00,871.44,239176.60000000423,224661.65000000424,14514.949999999983
28433,2022-09-21 10:25:00,-1245.36,237931.24000000424,224661.65000000424,13269.589999999997
28434,2022-09-21 10:30:00,-170.19,237761.05000000424,224661.65000000424,13099.399999999994
28435,2022-09-21 10:35:00,-598.98,237162.07000000423,224661.65000000424,12500.419999999984
28436,2022-09-21 10:40:00,848.12,238010.19000000422,224661.65000000424,13348.539999999979
28437,2022-09-21 10:45:00,-246.58,237763.61000000424,224661.65000000424,13101.959999999992
28438,2022-09-21 10:50:00,573.98,238337.59000000425,224661.65000000424,13675.940000000002
28439,2022-09-21 10:55:00,-1152.89,237184.70000000423,224661.65000000424,12523.049999999988
28440,2022-09-21 11:00:00,459.74,237644.44000000422,224661.65000000424,12982.789999999979
28441,2022-09-21 11:05:00,-1867.17,235777.2700000042,224661.65000000424,11115.619999999966
28442,2022-09-21 11:10:00,404.1,236181.37000000422,224661.65000000424,11519.719999999972
28443,2022-09-21 11:15:00,1644.45,237825.82000000423,224661.65000000424,13164.169999999984
28444,2022-09-21 11:20:00,725.77,238551.59000000422,224661.65000000424,13889.939999999973
28445,2022-09-21 11:25:00,1946.38,240497.97000000422,224661.65000000424,15836.319999999978
28446,2022-09-21 11:30:00,1775.42,242273.39000000423,224661.65000000424,17611.73999999999
28447,2022-09-21 11:35:00,133.82,242407.21000000424,224661.65000000424,17745.559999999998
28448,2022-09-21 11:40:00,-313.55,242093.66000000425,224661.65000000424,17432.01000000001
28449,2022-09-21 11:45:00,1555.07,243648.73000000426,224661.65000000424,18987.080000000016
28450,2022-09-21 11:50:00,107.73,243756.46000000427,224661.65000000424,19094.810000000027
28451,2022-09-21 11:55:00,61.87,243818.33000000427,224661.65000000424,19156.680000000022
28452,2022-09-21 12:00:00,-1277.65,242540.68000000427,224661.65000000424,17879.030000000028
28453,2022-09-21 12:05:00,1543.3,244083.98000000426,224661.65000000424,19422.330000000016
28454,2022-09-21 12:10:00,1606.63,245690.61000000426,224661.65000000424,21028.96000000002
28455,2022-09-21 12:15:00,-1448.55,244242.06000000428,224661.65000000424,19580.410000000033
28456,2022-09-21 12:20:00,1517.64,245759.7000000043,224661.65000000424,21098.050000000047
28457,2022-09-21 12:25:00,-250.44,245509.2600000043,224661.65000000424,20847.610000000044
28458,2022-09-21 12:30:00,-757.42,244751.84000000427,224661.65000000424,20090.19000000003
28459,2022-09-21 12:35:00,-1135.54,243616.30000000427,224661.65000000424,18954.650000000023
28460,2022-09-21 12:40:00,414.38,244030.68000000427,224661.65000000424,19369.030000000028
28461,2022-09-21 12:45:00,-313.78,243716.90000000427,224661.65000000424,19055.25000000003
28462,2022-09-21 12:50:00,-257.05,243459.85000000428,224661.65000000424,18798.20000000004
28463,2022-09-21 12:55:00,517.14,243976.9900000043,224661.65000000424,19315.340000000055
28464,2022-09-21 13:00:00,-918.39,243058.60000000428,224661.65000000424,18396.95000000004
28465,2022-09-21 13:05:00,-748.77,242309.8300000043,224661.65000000424,17648.18000000005
28466,2022-09-21 13:10:00,1095.85,243405.6800000043,224661.65000000424,18744.030000000057
28467,2022-09-21 13:15:00,87.24,243492.9200000043,224661.65000000424,18831.270000000048
28468,2022-09-21 13:20:00,910.35,244403.2700000043,224661.65000000424,19741.620000000054
28469,2022-09-21 13:25:00,-1887.0,242516.2700000043,224661.65000000424,17854.620000000054
28470,2022-09-21 13:30:00,-1618.02,240898.2500000043,224661.65000000424,16236.600000000064
28471,2022-09-21 13:35:00,1574.11,242472.3600000043,224661.65000000424,17810.71000000005
28472,2022-09-21 13:40:00,-1111.6,241360.7600000043,224661.65000000424,16699.110000000044
28473,2022-09-21 13:45:00,-214.04,241146.72000000428,224661.65000000424,16485.070000000036
28474,2022-09-21 13:50:00,1644.65,242791.37000000427,224661.65000000424,18129.72000000003
28475,2022-09-21 13:55:00,473.24,243264.61000000426,224661.65000000424,18602.96000000002
28476,2022-09-21 14:00:00,-77.39,243187.22000000425,224661.65000000424,18525.570000000007
28477,2022-09-21 14:05:00,-465.33,242721.89000000426,224661.65000000424,18060.24000000002
28478,2022-09-21 14:10:00,-369.47,242352.42000000426,224661.65000000424,17690.77000000002
28479,2022-09-21 14:15:00,1309.55,243661.97000000425,224661.65000000424,19000.320000000007
28480,2022-09-21 14:20:00,1338.5,245000.47000000425,224661.65000000424,20338.820000000007
28481,2022-09-21 14:25:00,717.28,245717.75000000425,224661.65000000424,21056.100000000006
28482,2022-09-21 14:30:00,-1947.81,243769.94000000425,224661.65000000424,19108.290000000008
28483,2022-09-21 14:35:00,-1801.18,241968.76000000426,224661.65000000424,17307.110000000015
28484,2022-09-21 14:40:00,1591.22,243559.98000000426,224661.65000000424,18898.330000000016
28485,2022-09-21 14:45:00,-1372.0,242187.98000000426,224661.65000000424,17526.330000000016
28486,2022-09-21 14:50:00,-1063.1,241124.88000000425,224661.65000000424,16463.23000000001
28487,2022-09-21 14:55:00,-330.02,240794.86000000426,224661.65000000424,16133.210000000021
28488,2022-09-21 15:00:00,603.83,241398.69000000425,224661.65000000424,16737.040000000008
28489,2022-09-21 15:05:00,-666.49,240732.20000000426,224661.65000000424,16070.550000000017
28490,2022-09-21 15:10:00,1688.84,242421.04000000426,224661.65000000424,17759.390000000014
28491,2022-09-21 15:15:00,1441.87,243862.91000000425,224661.65000000424,19201.26000000001
28492,2022-09-21 15:20:00,799.16,244662.07000000426,224661.65000000424,20000.420000000013
28493,2022-09-21 15:25:00,-972.1,243689.97000000425,224661.65000000424,19028.320000000007
28494,2022-09-21 15:30:00,-1939.49,241750.48000000426,224661.65000000424,17088.830000000016
28495,2022-09-21 15:35:00,-384.12,241366.36000000426,224661.65000000424,16704.71000000002
28496,2022-09-21 15:40:00,685.88,242052.24000000427,224661.65000000424,17390.590000000026
28497,2022-09-21 15:45:00,773.38,242825.62000000427,224661.65000000424,18163.97000000003
28498,2022-09-21 15:50:00,99.36,242924.98000000426,224661.65000000424,18263.330000000016
28499,2022-09-21 15:55:00,324.25,243249.23000000426,224661.65000000424,18587.580000000016
28500,2022-09-21 16:00:00,1460.82,244710.05000000427,224661.65000000424,20048.400000000023
28501,2022-09-21 16:05:00,1171.16,245881.21000000427,224661.65000000424,21219.560000000027
28502,2022-09-21 16:10:00,1094.3,246975.51000000426,224661.65000000424,22313.860000000015
28503,2022-09-21 16:15:00,-402.58,246572.93000000427,224661.65000000424,21911.280000000028
28504,2022-09-21 16:20:00,1331.46,247904.39000000426,224661.65000000424,23242.74000000002
28505,2022-09-21 16:25:00,-1036.88,246867.51000000426,224661.65000000424,22205.860000000015
28506,2022-09-21 16:30:00,955.06,247822.57000000426,224661.65000000424,23160.920000000013
28507,2022-09-21 16:35:00,-581.29,247241.28000000425,224661.65000000424,22579.630000000005
28508,2022-09-21 16:40:00,149.7,247390.98000000426,224661.65000000424,22729.330000000016
28509,2022-09-21 16:45:00,249.15,247640.13000000425,224661.65000000424,22978.48000000001
28510,2022-09-21 16:50:00,-550.57,247089.56000000425,224661.65000000424,22427.910000000003
28511,2022-09-21 16:55:00,585.31,247674.87000000424,224661.65000000424,23013.22
28512,2022-09-22 08:00:00,-1470.87,246204.00000000425,247674.87000000424,-1470.8699999999953
28513,2022-09-22 08:05:00,-854.19,245349.81000000425,247674.87000000424,-2325.0599999999977
28514,2022-09-22 08:10:00,490.29,245840.10000000425,247674.87000000424,-1834.7699999999895
28515,2022-09-22 08:15:00,596.53,246436.63000000425,247674.87000000424,-1238.2399999999907
28516,2022-09-22 08:20:00,-1861.34,244575.29000000426,247674.87000000424,-3099.579999999987
28517,2022-09-22 08:25:00,-715.37,243859.92000000426,247674.87000000424,-3814.9499999999825
28518,2022-09-22 08:30:00,1192.86,245052.78000000425,247674.87000000424,-2622.0899999999965
28519,2022-09-22 08:35:00,-1139.84,243912.94000000425,247674.87000000424,-3761.929999999993
28520,2022-09-22 08:40:00,-1885.41,242027.53000000425,247674.87000000424,-5647.3399999999965
28521,2022-09-22 08:45:00,-794.12,241233.41000000425,247674.87000000424,-6441.459999999992
28522,2022-09-22 08:50:00,-1562.36,239671.05000000427,247674.87000000424,-8003.819999999978
28523,2022-09-22 08:55:00,-519.45,239151.60000000425,247674.87000000424,-8523.26999999999
28524,2022-09-22 09:00:00,353.44,239505.04000000426,247674.87000000424,-8169.829999999987
28525,2022-09-22 09:05:00,-985.49,238519.55000000427,247674.87000000424,-9155.319999999978
28526,2022-09-22 09:10:00,-702.23,237817.32000000426,247674.87000000424,-9857.549999999988
28527,2022-09-22 09:15:00,1419.72,239237.04000000426,247674.87000000424,-8437.829999999987
28528,2022-09-22 09:20:00,1925.73,241162.77000000427,247674.87000000424,-6512.099999999977
28529,2022-09-22 09:25:00,1550.16,242712.93000000427,247674.87000000424,-4961.939999999973
28530,2022-09-22 09:30:00,769.38,243482.31000000428,247674.87000000424,-4192.559999999969
28531,2022-09-22 09:35:00,-831.24,242651.07000000429,247674.87000000424,-5023.799999999959
28532,2022-09-22 09:40:00,935.83,243586.90000000427,247674.87000000424,-4087.969999999972
28533,2022-09-22 09:45:00,1369.05,244955.95000000426,247674.87000000424,-2718.9199999999837
28534,2022-09-22 09:50:00,-801.68,244154.27000000427,247674.87000000424,-3520.5999999999767
28535,2022-09-22 09:55:00,-549.52,243604.75000000428,247674.87000000424,-4070.1199999999662
28536,2022-09-22 10:00:00,-294.32,243310.43000000427,247674.87000000424,-4364.439999999973
28537,2022-09-22 10:05:00,651.78,243962.21000000427,247674.87000000424,-3712.6599999999744
28538,2022-09-22 10:10:00,401.67,244363.88000000428,247674.87000000424,-3310.9899999999616
28539,2022-09-22 10:15:00,89.86,244453.74000000427,247674.87000000424,-3221.1299999999756
28540,2022-09-22 10:20:00,-1697.37,242756.37000000427,247674.87000000424,-4918.499999999971
28541,2022-09-22 10:25:00,1152.54,243908.91000000428,247674.87000000424,-3765.9599999999627
28542,2022-09-22 10:30:00,1220.21,245129.12000000427,247674.87000000424,-2545.749999999971
28543,2022-09-22 10:35:00,471.81,245600.93000000427,247674.87000000424,-2073.939999999973
28544,2022-09-22 10:40:00,-1722.42,243878.51000000426,247674.87000000424,-3796.359999999986
28545,2022-09-22 10:45:00,1516.55,245395.06000000425,247674.87000000424,-2279.8099999999977
28546,2022-09-22 10:50:00,-1652.68,243742.38000000425,247674.87000000424,-3932.4899999999907
28547,2022-09-22 10:55:00,-908.0,242834.38000000425,247674.87000000424,-4840.489999999991
28548,2022-09-22 11:00:00,-1575.14,241259.24000000424,247674.87000000424,-6415.630000000005
28549,2022-09-22 11:05:00,-686.23,240573.01000000423,247674.87000000424,-7101.860000000015
28550,2022-09-22 11:10:00,-783.27,239789.74000000424,247674.87000000424,-7885.130000000005
28551,2022-09-22 11:15:00,-506.27,239283.47000000425,247674.87000000424,-8391.399999999994
28552,2022-09-22 11:20:00,455.95,239739.42000000426,247674.87000000424,-7935.4499999999825
28553,2022-09-22 11:25:00,-735.75,239003.67000000426,247674.87000000424,-8671.199999999983
28554,2022-09-22 11:30:00,234.47,239238.14000000426,247674.87000000424,-8436.729999999981
28555,2022-09-22 11:35:00,1790.15,241028.29000000426,247674.87000000424,-6646.579999999987
28556,2022-09-22 11:40:00,-49.44,240978.85000000425,247674.87000000424,-6696.0199999999895
28557,2022-09-22 11:45:00,-243.8,240735.05000000427,247674.87000000424,-6939.819999999978
28558,2022-09-22 11:50:00,-1090.27,239644.78000000428,247674.87000000424,-8030.089999999967
28559,2022-09-22 11:55:00,-1698.48,237946.30000000427,247674.87000000424,-9728.569999999978
28560,2022-09-22 12:00:00,-134.73,237811.57000000426,247674.87000000424,-9863.299999999988
28561,2022-09-22 12:05:00,-1097.09,236714.48000000426,247674.87000000424,-10960.389999999985
28562,2022-09-22 12:10:00,-1370.93,235343.55000000427,247674.87000000424,-12331.319999999978
28563,2022-09-22 12:15:00,-794.59,234548.96000000427,247674.87000000424,-13125.909999999974
28564,2022-09-22 12:20:00,1721.76,236270.72000000428,247674.87000000424,-11404.149999999965
28565,2022-09-22 12:25:00,403.91,236674.63000000428,247674.87000000424,-11000.239999999962
28566,2022-09-22 12:30:00,1212.41,237887.0400000043,247674.87000000424,-9787.829999999958
28567,2022-09-22 12:35:00,-1975.19,235911.85000000428,247674.87000000424,-11763.01999999996
28568,2022-09-22 12:40:00,1520.13,237431.9800000043,247674.87000000424,-10242.889999999956
28569,2022-09-22 12:45:00,-1690.42,235741.56000000428,247674.87000000424,-11933.309999999969
28570,2022-09-22 12:50:00,-1574.67,234166.89000000426,247674.87000000424,-13507.979999999981
28571,2022-09-22 12:55:00,1011.07,235177.96000000427,247674.87000000424,-12496.909999999974
28572,2022-09-22 13:00:00,-1918.91,233259.05000000427,247674.87000000424,-14415.819999999978
28573,2022-09-22 13:05:00,1673.5,234932.55000000427,247674.87000000424,-12742.319999999978
28574,2022-09-22 13:10:00,699.67,235632.22000000428,247674.87000000424,-12042.649999999965
28575,2022-09-22 13:15:00,57.96,235690.18000000427,247674.87000000424,-11984.689999999973
28576,2022-09-22 13:20:00,285.02,235975.20000000426,247674.87000000424,-11699.669999999984
28577,2022-09-22 13:25:00,-1720.77,234254.43000000427,247674.87000000424,-13420.439999999973
28578,2022-09-22 13:30:00,1714.81,235969.24000000427,247674.87000000424,-11705.629999999976
28579,2022-09-22 13:35:00,-294.19,235675.05000000427,247674.87000000424,-11999.819999999978
28580,2022-09-22 13:40:00,1614.31,237289.36000000426,247674.87000000424,-10385.50999999998
28581,2022-09-22 13:45:00,-1750.04,235539.32000000426,247674.87000000424,-12135.549999999988
28582,2022-09-22 13:50:00,-1625.47,233913.85000000425,247674.87000000424,-13761.01999999999
28583,2022-09-22 13:55:00,1883.62,235797.47000000425,247674.87000000424,-11877.399999999994
28584,2022-09-22 14:00:00,-164.77,235632.70000000426,247674.87000000424,-12042.169999999984
28585,2022-09-22 14:05:00,370.98,236003.68000000427,247674.87000000424,-11671.189999999973
28586,2022-09-22 14:10:00,307.24,236310.92000000426,247674.87000000424,-11363.949999999983
28587,2022-09-22 14:15:00,700.64,237011.56000000428,247674.87000000424,-10663.309999999969
28588,2022-09-22 14:20:00,377.78,237389.34000000427,247674.87000000424,-10285.52999999997
28589,2022-09-22 14:25:00,-5.73,237383.61000000426,247674.87000000424,-10291.25999999998
28590,2022-09-22 14:30:00,-1901.11,235482.50000000428,247674.87000000424,-12192.369999999966
28591,2022-09-22 14:35:00,513.21,235995.71000000427,247674.87000000424,-11679.159999999974
28592,2022-09-22 14:40:00,-617.32,235378.39000000426,247674.87000000424,-12296.479999999981
28593,2022-09-22 14:45:00,687.75,236066.14000000426,247674.87000000424,-11608.729999999981
28594,2022-09-22 14:50:00,-791.8,235274.34000000427,247674.87000000424,-12400.52999999997
28595,2022-09-22 14:55:00,629.01,235903.35000000428,247674.87000000424,-11771.51999999996
28596,2022-09-22 15:00:00,1356.21,237259.56000000428,247674.87000000424,-10415.309999999969
28597,2022-09-22 15:05:00,-1480.54,235779.02000000427,247674.87000000424,-11895.849999999977
28598,2022-09-22 15:10:00,912.68,236691.70000000426,247674.87000000424,-10983.169999999984
28599,2022-09-22 15:15:00,-1803.94,234887.76000000426,247674.87000000424,-12787.109999999986
28600,2022-09-22 15:20:00,1835.45,236723.21000000427,247674.87000000424,-10951.659999999974
28601,2022-09-22 15:25:00,552.56,237275.77000000427,247674.87000000424,-10399.099999999977
28602,2022-09-22 15:30:00,-1833.02,235442.75000000428,247674.87000000424,-12232.119999999966
28603,2022-09-22 15:35:00,-1517.27,233925.4800000043,247674.87000000424,-13749.389999999956
28604,2022-09-22 15:40:00,-1249.25,232676.2300000043,247674.87000000424,-14998.639999999956
28605,2022-09-22 15:45:00,998.49,233674.72000000428,247674.87000000424,-14000.149999999965
28606,2022-09-22 15:50:00,-1034.57,232640.15000000427,247674.87000000424,-15034.719999999972
28607,2022-09-22 15:55:00,-248.55,232391.60000000428,247674.87000000424,-15283.26999999996
28608,2022-09-22 16:00:00,-1789.81,230601.7900000043,247674.87000000424,-17073.079999999958
28609,2022-09-22 16:05:00,-819.38,229782.41000000428,247674.87000000424,-17892.459999999963
28610,2022-09-22 16:10:00,1737.99,231520.40000000427,247674.87000000424,-16154.469999999972
28611,2022-09-22 16:15:00,1183.11,232703.51000000426,247674.87000000424,-14971.359999999986
28612,2022-09-22 16:20:00,-880.86,231822.65000000427,247674.87000000424,-15852.219999999972
28613,2022-09-22 16:25:00,-160.88,231661.77000000427,247674.87000000424,-16013.099999999977
28614,2022-09-22 16:30:00,-1621.53,230040.24000000427,247674.87000000424,-17634.629999999976
28615,2022-09-22 16:35:00,-325.04,229715.20000000426,247674.87000000424,-17959.669999999984
28616,2022-09-22 16:40:00,267.5,229982.70000000426,247674.87000000424,-17692.169999999984
28617,2022-09-22 16:45:00,-151.51,229831.19000000425,247674.87000000424,-17843.679999999993
28618,2022-09-22 16:50:00,-532.06,229299.13000000425,247674.87000000424,-18375.73999999999
28619,2022-09-22 16:55:00,727.18,230026.31000000425,247674.87000000424,-17648.559999999998
28620,2022-09-23 08:00:00,-92.88,229933.43000000424,230026.31000000425,-92.88000000000466
28621,2022-09-23 08:05:00,-1558.94,228374.49000000424,230026.31000000425,-1651.820000000007
28622,2022-09-23 08:10:00,1715.46,230089.95000000423,230026.31000000425,63.639999999984866
28623,2022-09-23 08:15:00,1296.21,231386.16000000422,230026.31000000425,1359.8499999999767
28624,2022-09-23 08:20:00,-1188.74,230197.42000000423,230026.31000000425,171.10999999998603
28625,2022-09-23 08:25:00,517.72,230715.14000000423,230026.31000000425,688.8299999999872
28626,2022-09-23 08:30:00,-1963.53,228751.61000000424,230026.31000000425,-1274.7000000000116
28627,2022-09-23 08:35:00,446.95,229198.56000000425,230026.31000000425,-827.75
28628,2022-09-23 08:40:00,-71.87,229126.69000000425,230026.31000000425,-899.6199999999953
28629,2022-09-23 08:45:00,1428.1,230554.79000000426,230026.31000000425,528.4800000000105
28630,2022-09-23 08:50:00,1348.44,231903.23000000426,230026.31000000425,1876.9200000000128
28631,2022-09-23 08:55:00,-209.2,231694.03000000425,230026.31000000425,1667.7200000000012
28632,2022-09-23 09:00:00,214.1,231908.13000000425,230026.31000000425,1881.820000000007
28633,2022-09-23 09:05:00,1032.8,232940.93000000424,230026.31000000425,2914.6199999999953
28634,2022-09-23 09:10:00,-918.52,232022.41000000425,230026.31000000425,1996.1000000000058
28635,2022-09-23 09:15:00,-1989.05,230033.36000000426,230026.31000000425,7.050000000017462
28636,2022-09-23 09:20:00,-1212.38,228820.98000000426,230026.31000000425,-1205.3299999999872
28637,2022-09-23 09:25:00,482.05,229303.03000000425,230026.31000000425,-723.2799999999988
28638,2022-09-23 09:30:00,-1797.7,227505.33000000424,230026.31000000425,-2520.9800000000105
28639,2022-09-23 09:35:00,-1932.72,225572.61000000424,230026.31000000425,-4453.700000000012
28640,2022-09-23 09:40:00,-1947.87,223624.74000000424,230026.31000000425,-6401.570000000007
28641,2022-09-23 09:45:00,-1795.01,221829.73000000423,230026.31000000425,-8196.580000000016
28642,2022-09-23 09:50:00,-1359.83,220469.90000000424,230026.31000000425,-9556.410000000003
28643,2022-09-23 09:55:00,-1140.86,219329.04000000426,230026.31000000425,-10697.26999999999
28644,2022-09-23 10:00:00,300.93,219629.97000000425,230026.31000000425,-10396.339999999997
28645,2022-09-23 10:05:00,-1886.02,217743.95000000426,230026.31000000425,-12282.359999999986
28646,2022-09-23 10:10:00,-162.32,217581.63000000425,230026.31000000425,-12444.679999999993
28647,2022-09-23 10:15:00,-1132.46,216449.17000000426,230026.31000000425,-13577.139999999985
28648,2022-09-23 10:20:00,298.99,216748.16000000425,230026.31000000425,-13278.149999999994
28649,2022-09-23 10:25:00,786.55,217534.71000000424,230026.31000000425,-12491.600000000006
28650,2022-09-23 10:30:00,-956.91,216577.80000000424,230026.31000000425,-13448.51000000001
28651,2022-09-23 10:35:00,696.86,217274.66000000422,230026.31000000425,-12751.650000000023
28652,2022-09-23 10:40:00,-1308.2,215966.4600000042,230026.31000000425,-14059.850000000035
28653,2022-09-23 10:45:00,-828.36,215138.10000000423,230026.31000000425,-14888.210000000021
28654,2022-09-23 10:50:00,710.13,215848.23000000423,230026.31000000425,-14178.080000000016
28655,2022-09-23 10:55:00,-1809.7,214038.53000000422,230026.31000000425,-15987.780000000028
28656,2022-09-23 11:00:00,1769.17,215807.70000000423,230026.31000000425,-14218.610000000015
28657,2022-09-23 11:05:00,-453.06,215354.64000000423,230026.31000000425,-14671.670000000013
28658,2022-09-23 11:10:00,366.22,215720.86000000424,230026.31000000425,-14305.450000000012
28659,2022-09-23 11:15:00,-670.84,215050.02000000424,230026.31000000425,-14976.290000000008
28660,2022-09-23 11:20:00,1846.88,216896.90000000424,230026.31000000425,-13129.410000000003
28661,2022-09-23 11:25:00,1861.54,218758.44000000425,230026.31000000425,-11267.869999999995
28662,2022-09-23 11:30:00,1339.84,220098.28000000425,230026.31000000425,-9928.029999999999
28663,2022-09-23 11:35:00,407.71,220505.99000000424,230026.31000000425,-9520.320000000007
28664,2022-09-23 11:40:00,-604.26,219901.73000000423,230026.31000000425,-10124.580000000016
28665,2022-09-23 11:45:00,698.71,220600.44000000422,230026.31000000425,-9425.870000000024
28666,2022-09-23 11:50:00,-409.07,220191.37000000422,230026.31000000425,-9834.940000000031
28667,2022-09-23 11:55:00,-1138.44,219052.9300000042,230026.31000000425,-10973.380000000034
28668,2022-09-23 12:00:00,1772.67,220825.60000000423,230026.31000000425,-9200.710000000021
28669,2022-09-23 12:05:00,615.72,221441.32000000423,230026.31000000425,-8584.99000000002
28670,2022-09-23 12:10:00,-1584.14,219857.1800000042,230026.31000000425,-10169.130000000034
28671,2022-09-23 12:15:00,-1575.43,218281.75000000422,230026.31000000425,-11744.560000000027
28672,2022-09-23 12:20:00,-178.37,218103.38000000422,230026.31000000425,-11922.930000000022
28673,2022-09-23 12:25:00,-1339.05,216764.33000000424,230026.31000000425,-13261.98000000001
28674,2022-09-23 12:30:00,-302.32,216462.01000000423,230026.31000000425,-13564.300000000017
28675,2022-09-23 12:35:00,1473.48,217935.49000000424,230026.31000000425,-12090.820000000007
28676,2022-09-23 12:40:00,153.85,218089.34000000425,230026.31000000425,-11936.970000000001
28677,2022-09-23 12:45:00,631.88,218721.22000000425,230026.31000000425,-11305.089999999997
28678,2022-09-23 12:50:00,-1506.96,217214.26000000426,230026.31000000425,-12812.049999999988
28679,2022-09-23 12:55:00,1494.22,218708.48000000426,230026.31000000425,-11317.829999999987
28680,2022-09-23 13:00:00,-1230.26,217478.22000000425,230026.31000000425,-12548.089999999997
28681,2022-09-23 13:05:00,-1719.85,215758.37000000424,230026.31000000425,-14267.940000000002
28682,2022-09-23 13:10:00,934.21,216692.58000000424,230026.31000000425,-13333.73000000001
28683,2022-09-23 13:15:00,-178.75,216513.83000000424,230026.31000000425,-13512.48000000001
28684,2022-09-23 13:20:00,-792.49,215721.34000000425,230026.31000000425,-14304.970000000001
28685,2022-09-23 13:25:00,328.69,216050.03000000425,230026.31000000425,-13976.279999999999
28686,2022-09-23 13:30:00,1774.31,217824.34000000425,230026.31000000425,-12201.970000000001
28687,2022-09-23 13:35:00,-1495.6,216328.74000000424,230026.31000000425,-13697.570000000007
28688,2022-09-23 13:40:00,1329.75,217658.49000000424,230026.31000000425,-12367.820000000007
28689,2022-09-23 13:45:00,1628.63,219287.12000000424,230026.31000000425,-10739.190000000002
28690,2022-09-23 13:50:00,-62.25,219224.87000000424,230026.31000000425,-10801.440000000002
28691,2022-09-23 13:55:00,-982.08,218242.79000000426,230026.31000000425,-11783.51999999999
28692,2022-09-23 14:00:00,-1513.89,216728.90000000424,230026.31000000425,-13297.410000000003
28693,2022-09-23 14:05:00,-208.68,216520.22000000425,230026.31000000425,-13506.089999999997
28694,2022-09-23 14:10:00,600.3,217120.52000000424,230026.31000000425,-12905.790000000008
28695,2022-09-23 14:15:00,1712.55,218833.07000000423,230026.31000000425,-11193.24000000002
28696,2022-09-23 14:20:00,-89.54,218743.53000000422,230026.31000000425,-11282.780000000028
28697,2022-09-23 14:25:00,-918.33,217825.20000000423,230026.31000000425,-12201.110000000015
28698,2022-09-23 14:30:00,304.62,218129.82000000423,230026.31000000425,-11896.49000000002
28699,2022-09-23 14:35:00,463.57,218593.39000000423,230026.31000000425,-11432.920000000013
28700,2022-09-23 14:40:00,-877.01,217716.38000000422,230026.31000000425,-12309.930000000022
28701,2022-09-23 14:45:00,586.13,218302.51000000423,230026.31000000425,-11723.800000000017
28702,2022-09-23 14:50:00,1963.26,220265.77000000424,230026.31000000425,-9760.540000000008
28703,2022-09-23 14:55:00,-944.79,219320.98000000423,230026.31000000425,-10705.330000000016
28704,2022-09-23 15:00:00,-1123.57,218197.41000000422,230026.31000000425,-11828.900000000023
28705,2022-09-23 15:05:00,-145.39,218052.0200000042,230026.31000000425,-11974.290000000037
28706,2022-09-23 15:10:00,1603.59,219655.6100000042,230026.31000000425,-10370.70000000004
28707,2022-09-23 15:15:00,-1819.65,217835.9600000042,230026.31000000425,-12190.350000000035
28708,2022-09-23 15:20:00,1448.47,219284.4300000042,230026.31000000425,-10741.880000000034
28709,2022-09-23 15:25:00,1515.92,220800.35000000423,230026.31000000425,-9225.960000000021
28710,2022-09-23 15:30:00,1201.58,222001.9300000042,230026.31000000425,-8024.380000000034
28711,2022-09-23 15:35:00,674.25,222676.1800000042,230026.31000000425,-7350.130000000034
28712,2022-09-23 15:40:00,1969.83,224646.0100000042,230026.31000000425,-5380.300000000047
28713,2022-09-23 15:45:00,1485.74,226131.7500000042,230026.31000000425,-3894.560000000056
28714,2022-09-23 15:50:00,811.88,226943.6300000042,230026.31000000425,-3082.680000000051
28715,2022-09-23 15:55:00,28.29,226971.9200000042,230026.31000000425,-3054.390000000043
28716,2022-09-23 16:00:00,1056.7,228028.62000000422,230026.31000000425,-1997.6900000000314
28717,2022-09-23 16:05:00,600.66,228629.28000000422,230026.31000000425,-1397.030000000028
28718,2022-09-23 16:10:00,303.06,228932.34000000422,230026.31000000425,-1093.9700000000303
28719,2022-09-23 16:15:00,581.69,229514.03000000422,230026.31000000425,-512.2800000000279
28720,2022-09-23 16:20:00,1530.2,231044.23000000423,230026.31000000425,1017.9199999999837
28721,2022-09-23 16:25:00,-287.32,230756.91000000422,230026.31000000425,730.5999999999767
28722,2022-09-23 16:30:00,-924.68,229832.23000000423,230026.31000000425,-194.0800000000163
28723,2022-09-23 16:35:00,-1320.66,228511.57000000423,230026.31000000425,-1514.7400000000198
28724,2022-09-23 16:40:00,-180.38,228331.19000000422,230026.31000000425,-1695.1200000000244
28725,2022-09-23 16:45:00,1308.43,229639.62000000422,230026.31000000425,-386.69000000003143
28726,2022-09-23 16:50:00,1032.59,230672.2100000042,230026.31000000425,645.8999999999651
28727,2022-09-23 16:55:00,531.55,231203.7600000042,230026.31000000425,1177.4499999999534
28728,2022-09-24 08:00:00,-1229.47,229974.2900000042,231203.7600000042,-1229.4700000000012
28729,2022-09-24 08:05:00,1483.82,231458.1100000042,231203.7600000042,254.35000000000582
28730,2022-09-24 08:10:00,680.16,232138.2700000042,231203.7600000042,934.5100000000093
28731,2022-09-24 08:15:00,96.4,232234.6700000042,231203.7600000042,1030.9100000000035
28732,2022-09-24 08:20:00,-1726.8,230507.87000000422,231203.7600000042,-695.8899999999849
28733,2022-09-24 08:25:00,-516.43,229991.44000000422,231203.7600000042,-1212.3199999999779
28734,2022-09-24 08:30:00,-682.65,229308.79000000423,231203.7600000042,-1894.969999999972
28735,2022-09-24 08:35:00,90.59,229399.38000000422,231203.7600000042,-1804.3799999999756
28736,2022-09-24 08:40:00,1831.31,231230.69000000422,231203.7600000042,26.93000000002212
28737,2022-09-24 08:45:00,-63.46,231167.23000000423,231203.7600000042,-36.52999999996973
28738,2022-09-24 08:50:00,-878.21,230289.02000000424,231203.7600000042,-914.7399999999616
28739,2022-09-24 08:55:00,-830.67,229458.35000000423,231203.7600000042,-1745.4099999999744
28740,2022-09-24 09:00:00,1743.15,231201.50000000422,231203.7600000042,-2.2599999999802094
28741,2022-09-24 09:05:00,1137.64,232339.14000000423,231203.7600000042,1135.3800000000338
28742,2022-09-24 09:10:00,309.29,232648.43000000424,231203.7600000042,1444.670000000042
28743,2022-09-24 09:15:00,-1648.96,230999.47000000425,231203.7600000042,-204.28999999994994
28744,2022-09-24 09:20:00,-1379.15,229620.32000000426,231203.7600000042,-1583.4399999999441
28745,2022-09-24 09:25:00,-1791.53,227828.79000000426,231203.7600000042,-3374.969999999943
28746,2022-09-24 09:30:00,-401.24,227427.55000000427,231203.7600000042,-3776.2099999999336
28747,2022-09-24 09:35:00,1059.65,228487.20000000426,231203.7600000042,-2716.5599999999395
28748,2022-09-24 09:40:00,-1009.55,227477.65000000427,231203.7600000042,-3726.109999999928
28749,2022-09-24 09:45:00,-1316.7,226160.95000000426,231203.7600000042,-5042.8099999999395
28750,2022-09-24 09:50:00,1633.29,227794.24000000427,231203.7600000042,-3409.5199999999313
28751,2022-09-24 09:55:00,1568.54,229362.78000000428,231203.7600000042,-1840.9799999999232
28752,2022-09-24 10:00:00,932.43,230295.21000000427,231203.7600000042,-908.5499999999302
28753,2022-09-24 10:05:00,1073.99,231369.20000000426,231203.7600000042,165.44000000006054
28754,2022-09-24 10:10:00,-174.8,231194.40000000427,231203.7600000042,-9.359999999927823
28755,2022-09-24 10:15:00,-1087.0,230107.40000000427,231203.7600000042,-1096.3599999999278
28756,2022-09-24 10:20:00,486.36,230593.76000000426,231203.7600000042,-609.9999999999418
28757,2022-09-24 10:25:00,-20.39,230573.37000000424,231203.7600000042,-630.3899999999558
28758,2022-09-24 10:30:00,-1177.43,229395.94000000425,231203.7600000042,-1807.8199999999488
28759,2022-09-24 10:35:00,-1196.03,228199.91000000425,231203.7600000042,-3003.8499999999476
28760,2022-09-24 10:40:00,-1655.86,226544.05000000427,231203.7600000042,-4659.709999999934
28761,2022-09-24 10:45:00,1810.57,228354.62000000427,231203.7600000042,-2849.1399999999267
28762,2022-09-24 10:50:00,-1921.0,226433.62000000427,231203.7600000042,-4770.139999999927
28763,2022-09-24 10:55:00,1285.76,227719.38000000428,231203.7600000042,-3484.3799999999173
28764,2022-09-24 11:00:00,0.64,227720.0200000043,231203.7600000042,-3483.7399999999034
28765,2022-09-24 11:05:00,-1300.71,226419.3100000043,231203.7600000042,-4784.449999999895
28766,2022-09-24 11:10:00,-1662.11,224757.20000000432,231203.7600000042,-6446.559999999881
28767,2022-09-24 11:15:00,1848.6,226605.80000000432,231203.7600000042,-4597.959999999875
28768,2022-09-24 11:20:00,-1465.88,225139.92000000432,231203.7600000042,-6063.83999999988
28769,2022-09-24 11:25:00,-1735.61,223404.31000000433,231203.7600000042,-7799.449999999866
28770,2022-09-24 11:30:00,-1507.22,221897.09000000433,231203.7600000042,-9306.669999999867
28771,2022-09-24 11:35:00,-247.69,221649.40000000433,231203.7600000042,-9554.35999999987
28772,2022-09-24 11:40:00,-1391.75,220257.65000000433,231203.7600000042,-10946.10999999987
28773,2022-09-24 11:45:00,-595.13,219662.52000000433,231203.7600000042,-11541.239999999874
28774,2022-09-24 11:50:00,-1345.54,218316.98000000432,231203.7600000042,-12886.779999999882
28775,2022-09-24 11:55:00,644.36,218961.3400000043,231203.7600000042,-12242.419999999896
28776,2022-09-24 12:00:00,1338.92,220300.26000000432,231203.7600000042,-10903.499999999884
28777,2022-09-24 12:05:00,-1762.58,218537.68000000433,231203.7600000042,-12666.07999999987
28778,2022-09-24 12:10:00,-1869.65,216668.03000000434,231203.7600000042,-14535.729999999865
28779,2022-09-24 12:15:00,-1119.49,215548.54000000434,231203.7600000042,-15655.219999999856
28780,2022-09-24 12:20:00,1186.75,216735.29000000434,231203.7600000042,-14468.469999999856
28781,2022-09-24 12:25:00,941.02,217676.31000000433,231203.7600000042,-13527.449999999866
28782,2022-09-24 12:30:00,21.86,217698.17000000432,231203.7600000042,-13505.58999999988
28783,2022-09-24 12:35:00,-1022.68,216675.49000000433,231203.7600000042,-14528.269999999873
28784,2022-09-24 12:40:00,1672.77,218348.26000000432,231203.7600000042,-12855.499999999884
28785,2022-09-24 12:45:00,-810.96,217537.30000000432,231203.7600000042,-13666.459999999875
28786,2022-09-24 12:50:00,1653.0,219190.30000000432,231203.7600000042,-12013.459999999875
28787,2022-09-24 12:55:00,-1727.86,217462.44000000434,231203.7600000042,-13741.319999999861
28788,2022-09-24 13:00:00,-535.13,216927.31000000433,231203.7600000042,-14276.449999999866
28789,2022-09-24 13:05:00,1089.86,218017.17000000432,231203.7600000042,-13186.58999999988
28790,2022-09-24 13:10:00,-97.07,217920.1000000043,231203.7600000042,-13283.659999999887
28791,2022-09-24 13:15:00,608.46,218528.5600000043,231203.7600000042,-12675.199999999895
28792,2022-09-24 13:20:00,1029.04,219557.6000000043,231203.7600000042,-11646.159999999887
28793,2022-09-24 13:25:00,-1868.09,217689.51000000432,231203.7600000042,-13514.249999999884
28794,2022-09-24 13:30:00,-646.39,217043.1200000043,231203.7600000042,-14160.639999999898
28795,2022-09-24 13:35:00,324.22,217367.3400000043,231203.7600000042,-13836.419999999896
28796,2022-09-24 13:40:00,3.07,217370.4100000043,231203.7600000042,-13833.34999999989
28797,2022-09-24 13:45:00,-1875.06,215495.3500000043,231203.7600000042,-15708.409999999887
28798,2022-09-24 13:50:00,995.14,216490.49000000433,231203.7600000042,-14713.269999999873
28799,2022-09-24 13:55:00,242.9,216733.39000000432,231203.7600000042,-14470.369999999879
28800,2022-09-24 14:00:00,-173.3,216560.09000000433,231203.7600000042,-14643.669999999867
28801,2022-09-24 14:05:00,1702.55,218262.64000000432,231203.7600000042,-12941.119999999879
28802,2022-09-24 14:10:00,-1535.91,216726.73000000432,231203.7600000042,-14477.029999999882
28803,2022-09-24 14:15:00,-726.53,216000.20000000432,231203.7600000042,-15203.559999999881
28804,2022-09-24 14:20:00,1613.83,217614.0300000043,231203.7600000042,-13589.729999999894
28805,2022-09-24 14:25:00,-869.28,216744.7500000043,231203.7600000042,-14459.009999999893
28806,2022-09-24 14:30:00,-1685.04,215059.7100000043,231203.7600000042,-16144.049999999901
28807,2022-09-24 14:35:00,1996.6,217056.3100000043,231203.7600000042,-14147.449999999895
28808,2022-09-24 14:40:00,1886.92,218943.23000000432,231203.7600000042,-12260.529999999882
28809,2022-09-24 14:45:00,858.4,219801.6300000043,231203.7600000042,-11402.129999999888
28810,2022-09-24 14:50:00,1754.33,221555.9600000043,231203.7600000042,-9647.799999999901
28811,2022-09-24 14:55:00,323.5,221879.4600000043,231203.7600000042,-9324.299999999901
28812,2022-09-24 15:00:00,-1509.31,220370.1500000043,231203.7600000042,-10833.609999999899
28813,2022-09-24 15:05:00,-1275.93,219094.2200000043,231203.7600000042,-12109.539999999892
28814,2022-09-24 15:10:00,1207.62,220301.8400000043,231203.7600000042,-10901.919999999896
28815,2022-09-24 15:15:00,-654.42,219647.4200000043,231203.7600000042,-11556.33999999991
28816,2022-09-24 15:20:00,1393.01,221040.4300000043,231203.7600000042,-10163.3299999999
28817,2022-09-24 15:25:00,366.65,221407.0800000043,231203.7600000042,-9796.679999999906
28818,2022-09-24 15:30:00,-108.9,221298.1800000043,231203.7600000042,-9905.5799999999
28819,2022-09-24 15:35:00,1149.13,222447.3100000043,231203.7600000042,-8756.449999999895
28820,2022-09-24 15:40:00,-1641.8,220805.51000000432,231203.7600000042,-10398.249999999884
28821,2022-09-24 15:45:00,1957.0,222762.51000000432,231203.7600000042,-8441.249999999884
28822,2022-09-24 15:50:00,-366.29,222396.2200000043,231203.7600000042,-8807.539999999892
28823,2022-09-24 15:55:00,-93.03,222303.1900000043,231203.7600000042,-8900.56999999989
28824,2022-09-24 16:00:00,143.25,222446.4400000043,231203.7600000042,-8757.31999999989
28825,2022-09-24 16:05:00,331.97,222778.4100000043,231203.7600000042,-8425.34999999989
28826,2022-09-24 16:10:00,959.14,223737.55000000432,231203.7600000042,-7466.209999999875
28827,2022-09-24 16:15:00,536.21,224273.76000000432,231203.7600000042,-6929.999999999884
28828,2022-09-24 16:20:00,138.81,224412.5700000043,231203.7600000042,-6791.189999999886
28829,2022-09-24 16:25:00,-1720.07,222692.5000000043,231203.7600000042,-8511.259999999893
28830,2022-09-24 16:30:00,-1808.3,220884.20000000432,231203.7600000042,-10319.559999999881
28831,2022-09-24 16:35:00,-793.98,220090.2200000043,231203.7600000042,-11113.539999999892
28832,2022-09-24 16:40:00,-263.66,219826.5600000043,231203.7600000042,-11377.199999999895
28833,2022-09-24 16:45:00,-1979.05,217847.51000000432,231203.7600000042,-13356.249999999884
28834,2022-09-24 16:50:00,6.47,217853.98000000432,231203.7600000042,-13349.779999999882
28835,2022-09-24 16:55:00,-913.84,216940.14000000432,231203.7600000042,-14263.619999999879
28836,2022-09-25 08:00:00,-520.97,216419.17000000432,216940.14000000432,-520.9700000000012
28837,2022-09-25 08:05:00,-1850.87,214568.30000000432,216940.14000000432,-2371.8399999999965
28838,2022-09-25 08:10:00,-499.28,214069.02000000433,216940.14000000432,-2871.1199999999953
28839,2022-09-25 08:15:00,-832.76,213236.26000000432,216940.14000000432,-3703.8800000000047
28840,2022-09-25 08:20:00,-1440.12,211796.14000000432,216940.14000000432,-5144.0
28841,2022-09-25 08:25:00,-600.87,211195.27000000433,216940.14000000432,-5744.869999999995
28842,2022-09-25 08:30:00,155.46,211350.73000000432,216940.14000000432,-5589.4100000000035
28843,2022-09-25 08:35:00,-1378.02,209972.71000000433,216940.14000000432,-6967.429999999993
28844,2022-09-25 08:40:00,1003.22,210975.93000000433,216940.14000000432,-5964.209999999992
28845,2022-09-25 08:45:00,-308.73,210667.20000000432,216940.14000000432,-6272.940000000002
28846,2022-09-25 08:50:00,1422.71,212089.9100000043,216940.14000000432,-4850.2300000000105
28847,2022-09-25 08:55:00,-1090.78,210999.1300000043,216940.14000000432,-5941.010000000009
28848,2022-09-25 09:00:00,-1219.88,209779.2500000043,216940.14000000432,-7160.890000000014
28849,2022-09-25 09:05:00,459.95,210239.20000000432,216940.14000000432,-6700.940000000002
28850,2022-09-25 09:10:00,1619.65,211858.8500000043,216940.14000000432,-5081.290000000008
28851,2022-09-25 09:15:00,-1346.72,210512.1300000043,216940.14000000432,-6428.010000000009
28852,2022-09-25 09:20:00,-769.19,209742.9400000043,216940.14000000432,-7197.200000000012
28853,2022-09-25 09:25:00,987.96,210730.9000000043,216940.14000000432,-6209.24000000002
28854,2022-09-25 09:30:00,851.03,211581.9300000043,216940.14000000432,-5358.210000000021
28855,2022-09-25 09:35:00,-1789.94,209791.9900000043,216940.14000000432,-7148.150000000023
28856,2022-09-25 09:40:00,1712.49,211504.4800000043,216940.14000000432,-5435.660000000033
28857,2022-09-25 09:45:00,1541.78,213046.2600000043,216940.14000000432,-3893.8800000000338
28858,2022-09-25 09:50:00,383.66,213429.9200000043,216940.14000000432,-3510.2200000000303
28859,2022-09-25 09:55:00,-948.14,212481.78000000428,216940.14000000432,-4458.360000000044
28860,2022-09-25 10:00:00,-1113.98,211367.80000000427,216940.14000000432,-5572.340000000055
28861,2022-09-25 10:05:00,263.03,211630.83000000427,216940.14000000432,-5309.310000000056
28862,2022-09-25 10:10:00,588.63,212219.46000000427,216940.14000000432,-4720.680000000051
28863,2022-09-25 10:15:00,1746.76,213966.22000000428,216940.14000000432,-2973.920000000042
28864,2022-09-25 10:20:00,-1109.39,212856.83000000427,216940.14000000432,-4083.310000000056
28865,2022-09-25 10:25:00,1193.71,214050.54000000426,216940.14000000432,-2889.600000000064
28866,2022-09-25 10:30:00,-649.15,213401.39000000426,216940.14000000432,-3538.750000000058
28867,2022-09-25 10:35:00,1437.01,214838.40000000427,216940.14000000432,-2101.740000000049
28868,2022-09-25 10:40:00,1609.22,216447.62000000427,216940.14000000432,-492.52000000004773
28869,2022-09-25 10:45:00,377.67,216825.2900000043,216940.14000000432,-114.85000000003492
28870,2022-09-25 10:50:00,908.87,217734.16000000428,216940.14000000432,794.0199999999604
28871,2022-09-25 10:55:00,1283.73,219017.8900000043,216940.14000000432,2077.749999999971
28872,2022-09-25 11:00:00,460.28,219478.1700000043,216940.14000000432,2538.0299999999697
28873,2022-09-25 11:05:00,1980.41,221458.5800000043,216940.14000000432,4518.439999999973
28874,2022-09-25 11:10:00,-1692.96,219765.6200000043,216940.14000000432,2825.4799999999814
28875,2022-09-25 11:15:00,-1554.72,218210.9000000043,216940.14000000432,1270.7599999999802
28876,2022-09-25 11:20:00,472.95,218683.8500000043,216940.14000000432,1743.7099999999919
28877,2022-09-25 11:25:00,362.53,219046.3800000043,216940.14000000432,2106.2399999999907
28878,2022-09-25 11:30:00,444.09,219490.4700000043,216940.14000000432,2550.329999999987
28879,2022-09-25 11:35:00,1418.38,220908.8500000043,216940.14000000432,3968.709999999992
28880,2022-09-25 11:40:00,654.16,221563.01000000432,216940.14000000432,4622.869999999995
28881,2022-09-25 11:45:00,480.46,222043.4700000043,216940.14000000432,5103.329999999987
28882,2022-09-25 11:50:00,-227.72,221815.7500000043,216940.14000000432,4875.609999999986
28883,2022-09-25 11:55:00,-1094.15,220721.6000000043,216940.14000000432,3781.459999999992
28884,2022-09-25 12:00:00,-227.54,220494.0600000043,216940.14000000432,3553.9199999999837
28885,2022-09-25 12:05:00,1988.26,222482.3200000043,216940.14000000432,5542.179999999993
28886,2022-09-25 12:10:00,967.03,223449.3500000043,216940.14000000432,6509.209999999992
28887,2022-09-25 12:15:00,-717.38,222731.9700000043,216940.14000000432,5791.829999999987
28888,2022-09-25 12:20:00,936.01,223667.98000000432,216940.14000000432,6727.8399999999965
28889,2022-09-25 12:25:00,590.78,224258.76000000432,216940.14000000432,7318.619999999995
28890,2022-09-25 12:30:00,-706.35,223552.4100000043,216940.14000000432,6612.2699999999895
28891,2022-09-25 12:35:00,-207.89,223344.5200000043,216940.14000000432,6404.379999999976
28892,2022-09-25 12:40:00,1709.37,225053.8900000043,216940.14000000432,8113.749999999971
28893,2022-09-25 12:45:00,362.72,225416.6100000043,216940.14000000432,8476.469999999972
28894,2022-09-25 12:50:00,169.33,225585.94000000428,216940.14000000432,8645.79999999996
28895,2022-09-25 12:55:00,392.55,225978.49000000427,216940.14000000432,9038.349999999948
28896,2022-09-25 13:00:00,117.75,226096.24000000427,216940.14000000432,9156.099999999948
28897,2022-09-25 13:05:00,933.96,227030.20000000426,216940.14000000432,10090.05999999994
28898,2022-09-25 13:10:00,1263.91,228294.11000000426,216940.14000000432,11353.969999999943
28899,2022-09-25 13:15:00,-1393.0,226901.11000000426,216940.14000000432,9960.969999999943
28900,2022-09-25 13:20:00,-482.71,226418.40000000427,216940.14000000432,9478.259999999951
28901,2022-09-25 13:25:00,-357.25,226061.15000000427,216940.14000000432,9121.009999999951
28902,2022-09-25 13:30:00,1162.3,227223.45000000426,216940.14000000432,10283.30999999994
28903,2022-09-25 13:35:00,1150.55,228374.00000000425,216940.14000000432,11433.859999999928
28904,2022-09-25 13:40:00,1297.09,229671.09000000425,216940.14000000432,12730.949999999924
28905,2022-09-25 13:45:00,-1764.4,227906.69000000425,216940.14000000432,10966.54999999993
28906,2022-09-25 13:50:00,280.56,228187.25000000425,216940.14000000432,11247.109999999928
28907,2022-09-25 13:55:00,184.42,228371.67000000426,216940.14000000432,11431.52999999994
28908,2022-09-25 14:00:00,-255.58,228116.09000000427,216940.14000000432,11175.949999999953
28909,2022-09-25 14:05:00,1617.87,229733.96000000427,216940.14000000432,12793.819999999949
28910,2022-09-25 14:10:00,80.2,229814.16000000428,216940.14000000432,12874.01999999996
28911,2022-09-25 14:15:00,784.92,230599.0800000043,216940.14000000432,13658.939999999973
28912,2022-09-25 14:20:00,-974.56,229624.5200000043,216940.14000000432,12684.379999999976
28913,2022-09-25 14:25:00,1236.57,230861.0900000043,216940.14000000432,13920.949999999983
28914,2022-09-25 14:30:00,1329.52,232190.6100000043,216940.14000000432,15250.469999999972
28915,2022-09-25 14:35:00,1037.24,233227.85000000428,216940.14000000432,16287.709999999963
28916,2022-09-25 14:40:00,-949.62,232278.2300000043,216940.14000000432,15338.089999999967
28917,2022-09-25 14:45:00,-1546.74,230731.4900000043,216940.14000000432,13791.349999999977
28918,2022-09-25 14:50:00,-1004.29,229727.2000000043,216940.14000000432,12787.059999999969
28919,2022-09-25 14:55:00,-417.05,229310.1500000043,216940.14000000432,12370.00999999998
28920,2022-09-25 15:00:00,803.42,230113.5700000043,216940.14000000432,13173.429999999993
28921,2022-09-25 15:05:00,241.82,230355.39000000432,216940.14000000432,13415.25
28922,2022-09-25 15:10:00,-1807.93,228547.46000000433,216940.14000000432,11607.320000000007
28923,2022-09-25 15:15:00,1521.25,230068.71000000433,216940.14000000432,13128.570000000007
28924,2022-09-25 15:20:00,-661.09,229407.62000000433,216940.14000000432,12467.48000000001
28925,2022-09-25 15:25:00,-1889.26,227518.36000000432,216940.14000000432,10578.220000000001
28926,2022-09-25 15:30:00,-1.05,227517.31000000433,216940.14000000432,10577.170000000013
28927,2022-09-25 15:35:00,906.64,228423.95000000435,216940.14000000432,11483.810000000027
28928,2022-09-25 15:40:00,414.63,228838.58000000435,216940.14000000432,11898.440000000031
28929,2022-09-25 15:45:00,1794.61,230633.19000000434,216940.14000000432,13693.050000000017
28930,2022-09-25 15:50:00,-1455.31,229177.88000000434,216940.14000000432,12237.74000000002
28931,2022-09-25 15:55:00,-296.63,228881.25000000434,216940.14000000432,11941.110000000015
28932,2022-09-25 16:00:00,-296.98,228584.27000000433,216940.14000000432,11644.130000000005
28933,2022-09-25 16:05:00,-637.27,227947.00000000434,216940.14000000432,11006.860000000015
28934,2022-09-25 16:10:00,276.79,228223.79000000434,216940.14000000432,11283.650000000023
28935,2022-09-25 16:15:00,1227.25,229451.04000000434,216940.14000000432,12510.900000000023
28936,2022-09-25 16:20:00,-1587.61,227863.43000000436,216940.14000000432,10923.290000000037
28937,2022-09-25 16:25:00,-1988.56,225874.87000000436,216940.14000000432,8934.73000000004
28938,2022-09-25 16:30:00,325.91,226200.78000000436,216940.14000000432,9260.640000000043
28939,2022-09-25 16:35:00,-774.55,225426.23000000438,216940.14000000432,8486.090000000055
28940,2022-09-25 16:40:00,-1183.79,224242.44000000437,216940.14000000432,7302.300000000047
28941,2022-09-25 16:45:00,-444.79,223797.65000000436,216940.14000000432,6857.510000000038
28942,2022-09-25 16:50:00,1389.68,225187.33000000435,216940.14000000432,8247.190000000031
28943,2022-09-25 16:55:00,-1914.46,223272.87000000436,216940.14000000432,6332.73000000004
28944,2022-09-26 08:00:00,-285.83,222987.04000000437,223272.87000000436,-285.8299999999872
28945,2022-09-26 08:05:00,-1485.15,221501.89000000438,223272.87000000436,-1770.9799999999814
28946,2022-09-26 08:10:00,-410.78,221091.11000000438,223272.87000000436,-2181.75999999998
28947,2022-09-26 08:15:00,-383.46,220707.6500000044,223272.87000000436,-2565.219999999972
28948,2022-09-26 08:20:00,1668.45,222376.1000000044,223272.87000000436,-896.7699999999604
28949,2022-09-26 08:25:00,-95.4,222280.7000000044,223272.87000000436,-992.1699999999546
28950,2022-09-26 08:30:00,-236.16,222044.5400000044,223272.87000000436,-1228.329999999958
28951,2022-09-26 08:35:00,-857.13,221187.4100000044,223272.87000000436,-2085.4599999999627
28952,2022-09-26 08:40:00,1048.28,222235.6900000044,223272.87000000436,-1037.179999999964
28953,2022-09-26 08:45:00,-1346.58,220889.1100000044,223272.87000000436,-2383.759999999951
28954,2022-09-26 08:50:00,1993.19,222882.3000000044,223272.87000000436,-390.5699999999488
28955,2022-09-26 08:55:00,-825.08,222057.22000000442,223272.87000000436,-1215.649999999936
28956,2022-09-26 09:00:00,1273.27,223330.4900000044,223272.87000000436,57.62000000005355
28957,2022-09-26 09:05:00,-79.77,223250.72000000442,223272.87000000436,-22.14999999993597
28958,2022-09-26 09:10:00,-166.95,223083.7700000044,223272.87000000436,-189.0999999999476
28959,2022-09-26 09:15:00,279.48,223363.25000000442,223272.87000000436,90.38000000006286
28960,2022-09-26 09:20:00,-907.37,222455.88000000443,223272.87000000436,-816.9899999999325
28961,2022-09-26 09:25:00,-1266.73,221189.15000000442,223272.87000000436,-2083.719999999943
28962,2022-09-26 09:30:00,1150.89,222340.04000000443,223272.87000000436,-932.829999999929
28963,2022-09-26 09:35:00,32.13,222372.17000000444,223272.87000000436,-900.6999999999243
28964,2022-09-26 09:40:00,201.61,222573.78000000442,223272.87000000436,-699.0899999999383
28965,2022-09-26 09:45:00,1126.38,223700.16000000443,223272.87000000436,427.29000000006636
28966,2022-09-26 09:50:00,-591.56,223108.60000000443,223272.87000000436,-164.26999999993131
28967,2022-09-26 09:55:00,1530.05,224638.65000000442,223272.87000000436,1365.780000000057
28968,2022-09-26 10:00:00,-740.84,223897.81000000442,223272.87000000436,624.9400000000605
28969,2022-09-26 10:05:00,1121.83,225019.6400000044,223272.87000000436,1746.7700000000477
28970,2022-09-26 10:10:00,1868.56,226888.2000000044,223272.87000000436,3615.3300000000454
28971,2022-09-26 10:15:00,-701.52,226186.68000000442,223272.87000000436,2913.810000000056
28972,2022-09-26 10:20:00,969.59,227156.2700000044,223272.87000000436,3883.4000000000524
28973,2022-09-26 10:25:00,-1890.75,225265.5200000044,223272.87000000436,1992.6500000000524
28974,2022-09-26 10:30:00,-1642.12,223623.40000000442,223272.87000000436,350.53000000005704
28975,2022-09-26 10:35:00,286.95,223910.35000000443,223272.87000000436,637.4800000000687
28976,2022-09-26 10:40:00,1334.83,225245.18000000442,223272.87000000436,1972.3100000000559
28977,2022-09-26 10:45:00,8.83,225254.0100000044,223272.87000000436,1981.140000000043
28978,2022-09-26 10:50:00,65.11,225319.1200000044,223272.87000000436,2046.250000000029
28979,2022-09-26 10:55:00,-1050.44,224268.6800000044,223272.87000000436,995.8100000000268
28980,2022-09-26 11:00:00,1150.14,225418.8200000044,223272.87000000436,2145.9500000000407
28981,2022-09-26 11:05:00,250.21,225669.0300000044,223272.87000000436,2396.1600000000326
28982,2022-09-26 11:10:00,-193.5,225475.5300000044,223272.87000000436,2202.6600000000326
28983,2022-09-26 11:15:00,-1601.38,223874.1500000044,223272.87000000436,601.2800000000279
28984,2022-09-26 11:20:00,-1529.53,222344.6200000044,223272.87000000436,-928.2499999999709
28985,2022-09-26 11:25:00,1464.01,223808.6300000044,223272.87000000436,535.7600000000384
28986,2022-09-26 11:30:00,-456.23,223352.4000000044,223272.87000000436,79.53000000002794
28987,2022-09-26 11:35:00,-1259.76,222092.64000000438,223272.87000000436,-1180.2299999999814
28988,2022-09-26 11:40:00,-241.79,221850.85000000437,223272.87000000436,-1422.0199999999895
28989,2022-09-26 11:45:00,-1178.53,220672.32000000437,223272.87000000436,-2600.5499999999884
28990,2022-09-26 11:50:00,-69.45,220602.87000000436,223272.87000000436,-2670.0
28991,2022-09-26 11:55:00,547.6,221150.47000000437,223272.87000000436,-2122.399999999994
28992,2022-09-26 12:00:00,-707.83,220442.64000000438,223272.87000000436,-2830.2299999999814
28993,2022-09-26 12:05:00,1171.43,221614.07000000437,223272.87000000436,-1658.7999999999884
28994,2022-09-26 12:10:00,1544.72,223158.79000000437,223272.87000000436,-114.0799999999872
28995,2022-09-26 12:15:00,885.01,224043.80000000438,223272.87000000436,770.9300000000221
28996,2022-09-26 12:20:00,97.59,224141.39000000438,223272.87000000436,868.5200000000186
28997,2022-09-26 12:25:00,1041.6,225182.99000000439,223272.87000000436,1910.1200000000244
28998,2022-09-26 12:30:00,-980.92,224202.07000000437,223272.87000000436,929.2000000000116
28999,2022-09-26 12:35:00,-1297.31,222904.76000000437,223272.87000000436,-368.10999999998603
29000,2022-09-26 12:40:00,-307.46,222597.30000000438,223272.87000000436,-675.5699999999779
29001,2022-09-26 12:45:00,-1662.63,220934.67000000438,223272.87000000436,-2338.1999999999825
29002,2022-09-26 12:50:00,-1875.91,219058.76000000437,223272.87000000436,-4214.109999999986
29003,2022-09-26 12:55:00,716.1,219774.86000000438,223272.87000000436,-3498.00999999998
29004,2022-09-26 13:00:00,908.09,220682.95000000438,223272.87000000436,-2589.9199999999837
29005,2022-09-26 13:05:00,-1555.59,219127.36000000438,223272.87000000436,-4145.50999999998
29006,2022-09-26 13:10:00,37.72,219165.08000000438,223272.87000000436,-4107.789999999979
29007,2022-09-26 13:15:00,1502.99,220668.07000000437,223272.87000000436,-2604.7999999999884
29008,2022-09-26 13:20:00,-1589.92,219078.15000000436,223272.87000000436,-4194.720000000001
29009,2022-09-26 13:25:00,1278.51,220356.66000000437,223272.87000000436,-2916.209999999992
29010,2022-09-26 13:30:00,-1036.47,219320.19000000437,223272.87000000436,-3952.679999999993
29011,2022-09-26 13:35:00,-566.9,218753.29000000437,223272.87000000436,-4519.579999999987
29012,2022-09-26 13:40:00,1510.59,220263.88000000437,223272.87000000436,-3008.9899999999907
29013,2022-09-26 13:45:00,-439.53,219824.35000000437,223272.87000000436,-3448.5199999999895
29014,2022-09-26 13:50:00,-1002.14,218822.21000000436,223272.87000000436,-4450.6600000000035
29015,2022-09-26 13:55:00,149.06,218971.27000000436,223272.87000000436,-4301.600000000006
29016,2022-09-26 14:00:00,-318.26,218653.01000000435,223272.87000000436,-4619.860000000015
29017,2022-09-26 14:05:00,1013.98,219666.99000000436,223272.87000000436,-3605.8800000000047
29018,2022-09-26 14:10:00,431.06,220098.05000000435,223272.87000000436,-3174.820000000007
29019,2022-09-26 14:15:00,-1970.93,218127.12000000436,223272.87000000436,-5145.75
29020,2022-09-26 14:20:00,-627.72,217499.40000000436,223272.87000000436,-5773.470000000001
29021,2022-09-26 14:25:00,-1515.29,215984.11000000435,223272.87000000436,-7288.760000000009
29022,2022-09-26 14:30:00,674.96,216659.07000000434,223272.87000000436,-6613.8000000000175
29023,2022-09-26 14:35:00,-1580.9,215078.17000000435,223272.87000000436,-8194.700000000012
29024,2022-09-26 14:40:00,677.04,215755.21000000436,223272.87000000436,-7517.6600000000035
29025,2022-09-26 14:45:00,1244.24,216999.45000000435,223272.87000000436,-6273.420000000013
29026,2022-09-26 14:50:00,-648.62,216350.83000000435,223272.87000000436,-6922.040000000008
29027,2022-09-26 14:55:00,166.57,216517.40000000436,223272.87000000436,-6755.470000000001
29028,2022-09-26 15:00:00,622.44,217139.84000000436,223272.87000000436,-6133.029999999999
29029,2022-09-26 15:05:00,-465.89,216673.95000000435,223272.87000000436,-6598.920000000013
29030,2022-09-26 15:10:00,-548.0,216125.95000000435,223272.87000000436,-7146.920000000013
29031,2022-09-26 15:15:00,378.4,216504.35000000434,223272.87000000436,-6768.520000000019
29032,2022-09-26 15:20:00,-1472.39,215031.96000000433,223272.87000000436,-8240.910000000033
29033,2022-09-26 15:25:00,1414.09,216446.05000000432,223272.87000000436,-6826.820000000036
29034,2022-09-26 15:30:00,-581.77,215864.28000000434,223272.87000000436,-7408.590000000026
29035,2022-09-26 15:35:00,1896.98,217761.26000000435,223272.87000000436,-5511.610000000015
29036,2022-09-26 15:40:00,600.22,218361.48000000435,223272.87000000436,-4911.390000000014
29037,2022-09-26 15:45:00,-1516.71,216844.77000000436,223272.87000000436,-6428.100000000006
29038,2022-09-26 15:50:00,-1790.74,215054.03000000436,223272.87000000436,-8218.839999999997
29039,2022-09-26 15:55:00,-229.31,214824.72000000437,223272.87000000436,-8448.149999999994
29040,2022-09-26 16:00:00,963.57,215788.29000000437,223272.87000000436,-7484.579999999987
29041,2022-09-26 16:05:00,-1474.48,214313.81000000436,223272.87000000436,-8959.059999999998
29042,2022-09-26 16:10:00,-256.2,214057.61000000435,223272.87000000436,-9215.26000000001
29043,2022-09-26 16:15:00,-1234.59,212823.02000000436,223272.87000000436,-10449.850000000006
29044,2022-09-26 16:20:00,739.24,213562.26000000435,223272.87000000436,-9710.610000000015
29045,2022-09-26 16:25:00,1198.68,214760.94000000434,223272.87000000436,-8511.930000000022
29046,2022-09-26 16:30:00,203.91,214964.85000000434,223272.87000000436,-8308.020000000019
29047,2022-09-26 16:35:00,1975.72,216940.57000000434,223272.87000000436,-6332.3000000000175
29048,2022-09-26 16:40:00,549.72,217490.29000000434,223272.87000000436,-5782.580000000016
29049,2022-09-26 16:45:00,-1025.22,216465.07000000434,223272.87000000436,-6807.8000000000175
29050,2022-09-26 16:50:00,1228.58,217693.65000000433,223272.87000000436,-5579.22000000003
29051,2022-09-26 16:55:00,1007.33,218700.98000000432,223272.87000000436,-4571.890000000043
29052,2022-09-27 08:00:00,1654.28,220355.26000000432,218700.98000000432,1654.2799999999988
29053,2022-09-27 08:05:00,1030.81,221386.0700000043,218700.98000000432,2685.0899999999965
29054,2022-09-27 08:10:00,1230.7,222616.77000000433,218700.98000000432,3915.790000000008
29055,2022-09-27 08:15:00,-887.6,221729.17000000432,218700.98000000432,3028.1900000000023
29056,2022-09-27 08:20:00,507.84,222237.01000000432,218700.98000000432,3536.029999999999
29057,2022-09-27 08:25:00,1579.77,223816.7800000043,218700.98000000432,5115.799999999988
29058,2022-09-27 08:30:00,-600.42,223216.3600000043,218700.98000000432,4515.379999999976
29059,2022-09-27 08:35:00,-1484.69,221731.6700000043,218700.98000000432,3030.689999999973
29060,2022-09-27 08:40:00,-1925.0,219806.6700000043,218700.98000000432,1105.6899999999732
29061,2022-09-27 08:45:00,-1221.42,218585.25000000428,218700.98000000432,-115.73000000003958
29062,2022-09-27 08:50:00,770.17,219355.4200000043,218700.98000000432,654.4399999999732
29063,2022-09-27 08:55:00,543.19,219898.6100000043,218700.98000000432,1197.6299999999756
29064,2022-09-27 09:00:00,-478.23,219420.38000000428,218700.98000000432,719.3999999999651
29065,2022-09-27 09:05:00,1325.73,220746.1100000043,218700.98000000432,2045.1299999999756
29066,2022-09-27 09:10:00,1991.02,222737.13000000428,218700.98000000432,4036.149999999965
29067,2022-09-27 09:15:00,313.41,223050.5400000043,218700.98000000432,4349.559999999969
29068,2022-09-27 09:20:00,1429.58,224480.12000000427,218700.98000000432,5779.139999999956
29069,2022-09-27 09:25:00,410.53,224890.65000000427,218700.98000000432,6189.669999999955
29070,2022-09-27 09:30:00,-1618.64,223272.01000000426,218700.98000000432,4571.029999999941
29071,2022-09-27 09:35:00,1367.52,224639.53000000425,218700.98000000432,5938.54999999993
29072,2022-09-27 09:40:00,-892.38,223747.15000000424,218700.98000000432,5046.1699999999255
29073,2022-09-27 09:45:00,1311.68,225058.83000000424,218700.98000000432,6357.8499999999185
29074,2022-09-27 09:50:00,-303.75,224755.08000000424,218700.98000000432,6054.0999999999185
29075,2022-09-27 09:55:00,280.57,225035.65000000424,218700.98000000432,6334.6699999999255
29076,2022-09-27 10:00:00,320.61,225356.26000000423,218700.98000000432,6655.2799999999115
29077,2022-09-27 10:05:00,-1957.41,223398.85000000423,218700.98000000432,4697.869999999908
29078,2022-09-27 10:10:00,892.68,224291.53000000422,218700.98000000432,5590.549999999901
29079,2022-09-27 10:15:00,-1866.82,222424.7100000042,218700.98000000432,3723.729999999894
29080,2022-09-27 10:20:00,-1145.09,221279.62000000422,218700.98000000432,2578.6399999998976
29081,2022-09-27 10:25:00,-640.6,220639.0200000042,218700.98000000432,1938.0399999998917
29082,2022-09-27 10:30:00,-1814.72,218824.3000000042,218700.98000000432,123.31999999989057
29083,2022-09-27 10:35:00,1070.13,219894.4300000042,218700.98000000432,1193.4499999998952
29084,2022-09-27 10:40:00,64.74,219959.1700000042,218700.98000000432,1258.189999999886
29085,2022-09-27 10:45:00,1873.26,221832.4300000042,218700.98000000432,3131.449999999895
29086,2022-09-27 10:50:00,1217.1,223049.53000000422,218700.98000000432,4348.549999999901
29087,2022-09-27 10:55:00,887.38,223936.91000000422,218700.98000000432,5235.929999999906
29088,2022-09-27 11:00:00,820.63,224757.54000000423,218700.98000000432,6056.55999999991
29089,2022-09-27 11:05:00,929.4,225686.94000000422,218700.98000000432,6985.9599999999045
29090,2022-09-27 11:10:00,-476.44,225210.50000000422,218700.98000000432,6509.519999999902
29091,2022-09-27 11:15:00,-1114.01,224096.4900000042,218700.98000000432,5395.509999999893
29092,2022-09-27 11:20:00,-1519.29,222577.2000000042,218700.98000000432,3876.2199999998847
29093,2022-09-27 11:25:00,-1374.53,221202.6700000042,218700.98000000432,2501.689999999886
29094,2022-09-27 11:30:00,-705.2,220497.4700000042,218700.98000000432,1796.4899999998743
29095,2022-09-27 11:35:00,1529.06,222026.5300000042,218700.98000000432,3325.549999999872
29096,2022-09-27 11:40:00,-1232.83,220793.7000000042,218700.98000000432,2092.7199999998847
29097,2022-09-27 11:45:00,1781.29,222574.9900000042,218700.98000000432,3874.009999999893
29098,2022-09-27 11:50:00,1210.48,223785.47000000422,218700.98000000432,5084.489999999903
29099,2022-09-27 11:55:00,704.89,224490.36000000424,218700.98000000432,5789.379999999917
29100,2022-09-27 12:00:00,1155.35,225645.71000000424,218700.98000000432,6944.729999999923
29101,2022-09-27 12:05:00,-1543.48,224102.23000000423,218700.98000000432,5401.249999999913
29102,2022-09-27 12:10:00,-1732.42,222369.81000000422,218700.98000000432,3668.8299999999
29103,2022-09-27 12:15:00,1489.18,223858.9900000042,218700.98000000432,5158.009999999893
29104,2022-09-27 12:20:00,880.5,224739.4900000042,218700.98000000432,6038.509999999893
29105,2022-09-27 12:25:00,-854.6,223884.8900000042,218700.98000000432,5183.909999999887
29106,2022-09-27 12:30:00,-82.13,223802.7600000042,218700.98000000432,5101.779999999882
29107,2022-09-27 12:35:00,85.69,223888.4500000042,218700.98000000432,5187.469999999885
29108,2022-09-27 12:40:00,-848.3,223040.1500000042,218700.98000000432,4339.169999999896
29109,2022-09-27 12:45:00,453.26,223493.41000000422,218700.98000000432,4792.429999999906
29110,2022-09-27 12:50:00,-1996.07,221497.34000000422,218700.98000000432,2796.3599999998987
29111,2022-09-27 12:55:00,999.94,222497.28000000422,218700.98000000432,3796.299999999901
29112,2022-09-27 13:00:00,993.83,223491.1100000042,218700.98000000432,4790.129999999888
29113,2022-09-27 13:05:00,-1133.14,222357.9700000042,218700.98000000432,3656.9899999998743
29114,2022-09-27 13:10:00,-576.39,221781.58000000418,218700.98000000432,3080.5999999998603
29115,2022-09-27 13:15:00,1959.24,223740.82000000417,218700.98000000432,5039.839999999851
29116,2022-09-27 13:20:00,-1243.86,222496.96000000418,218700.98000000432,3795.979999999865
29117,2022-09-27 13:25:00,-974.63,221522.33000000418,218700.98000000432,2821.3499999998603
29118,2022-09-27 13:30:00,-749.94,220772.39000000418,218700.98000000432,2071.409999999858
29119,2022-09-27 13:35:00,1605.27,222377.66000000417,218700.98000000432,3676.6799999998475
29120,2022-09-27 13:40:00,40.28,222417.94000000416,218700.98000000432,3716.9599999998463
29121,2022-09-27 13:45:00,-1174.55,221243.39000000418,218700.98000000432,2542.409999999858
29122,2022-09-27 13:50:00,-559.1,220684.29000000417,218700.98000000432,1983.3099999998522
29123,2022-09-27 13:55:00,-494.05,220190.24000000418,218700.98000000432,1489.2599999998638
29124,2022-09-27 14:00:00,1405.45,221595.6900000042,218700.98000000432,2894.7099999998754
29125,2022-09-27 14:05:00,705.2,222300.8900000042,218700.98000000432,3599.909999999887
29126,2022-09-27 14:10:00,136.05,222436.9400000042,218700.98000000432,3735.9599999998754
29127,2022-09-27 14:15:00,627.04,223063.9800000042,218700.98000000432,4362.999999999884
29128,2022-09-27 14:20:00,972.66,224036.6400000042,218700.98000000432,5335.659999999887
29129,2022-09-27 14:25:00,1332.14,225368.78000000422,218700.98000000432,6667.799999999901
29130,2022-09-27 14:30:00,-69.0,225299.78000000422,218700.98000000432,6598.799999999901
29131,2022-09-27 14:35:00,1236.78,226536.56000000422,218700.98000000432,7835.5799999999
29132,2022-09-27 14:40:00,-1101.72,225434.84000000422,218700.98000000432,6733.859999999899
29133,2022-09-27 14:45:00,-1309.51,224125.3300000042,218700.98000000432,5424.349999999889
29134,2022-09-27 14:50:00,-592.13,223533.2000000042,218700.98000000432,4832.219999999885
29135,2022-09-27 14:55:00,1745.64,225278.84000000422,218700.98000000432,6577.859999999899
29136,2022-09-27 15:00:00,-1327.88,223950.9600000042,218700.98000000432,5249.979999999894
29137,2022-09-27 15:05:00,1673.05,225624.0100000042,218700.98000000432,6923.029999999882
29138,2022-09-27 15:10:00,1548.14,227172.1500000042,218700.98000000432,8471.169999999896
29139,2022-09-27 15:15:00,-500.76,226671.3900000042,218700.98000000432,7970.409999999887
29140,2022-09-27 15:20:00,742.14,227413.53000000422,218700.98000000432,8712.549999999901
29141,2022-09-27 15:25:00,-565.09,226848.44000000422,218700.98000000432,8147.4599999999045
29142,2022-09-27 15:30:00,292.82,227141.26000000423,218700.98000000432,8440.279999999912
29143,2022-09-27 15:35:00,-176.59,226964.67000000423,218700.98000000432,8263.689999999915
29144,2022-09-27 15:40:00,1026.47,227991.14000000423,218700.98000000432,9290.159999999916
29145,2022-09-27 15:45:00,-1242.18,226748.96000000424,218700.98000000432,8047.979999999923
29146,2022-09-27 15:50:00,779.32,227528.28000000425,218700.98000000432,8827.29999999993
29147,2022-09-27 15:55:00,1974.12,229502.40000000424,218700.98000000432,10801.419999999925
29148,2022-09-27 16:00:00,956.04,230458.44000000425,218700.98000000432,11757.459999999934
29149,2022-09-27 16:05:00,-1337.05,229121.39000000426,218700.98000000432,10420.409999999945
29150,2022-09-27 16:10:00,800.49,229921.88000000425,218700.98000000432,11220.899999999936
29151,2022-09-27 16:15:00,1025.54,230947.42000000426,218700.98000000432,12246.439999999944
29152,2022-09-27 16:20:00,600.04,231547.46000000427,218700.98000000432,12846.479999999952
29153,2022-09-27 16:25:00,1093.89,232641.35000000428,218700.98000000432,13940.369999999966
29154,2022-09-27 16:30:00,1411.43,234052.78000000428,218700.98000000432,15351.79999999996
29155,2022-09-27 16:35:00,709.11,234761.89000000426,218700.98000000432,16060.909999999945
29156,2022-09-27 16:40:00,1631.47,236393.36000000426,218700.98000000432,17692.379999999946
29157,2022-09-27 16:45:00,-1651.29,234742.07000000426,218700.98000000432,16041.089999999938
29158,2022-09-27 16:50:00,1390.26,236132.33000000427,218700.98000000432,17431.349999999948
29159,2022-09-27 16:55:00,-741.32,235391.01000000426,218700.98000000432,16690.02999999994
29160,2022-09-28 08:00:00,-759.86,234631.15000000427,235391.01000000426,-759.859999999986
29161,2022-09-28 08:05:00,-1952.66,232678.49000000427,235391.01000000426,-2712.5199999999895
29162,2022-09-28 08:10:00,-361.41,232317.08000000427,235391.01000000426,-3073.929999999993
29163,2022-09-28 08:15:00,-1403.58,230913.50000000428,235391.01000000426,-4477.50999999998
29164,2022-09-28 08:20:00,896.53,231810.03000000428,235391.01000000426,-3580.9799999999814
29165,2022-09-28 08:25:00,-1202.0,230608.03000000428,235391.01000000426,-4782.979999999981
29166,2022-09-28 08:30:00,-1132.16,229475.87000000427,235391.01000000426,-5915.139999999985
29167,2022-09-28 08:35:00,-374.37,229101.50000000428,235391.01000000426,-6289.50999999998
29168,2022-09-28 08:40:00,450.5,229552.00000000428,235391.01000000426,-5839.00999999998
29169,2022-09-28 08:45:00,627.91,230179.91000000428,235391.01000000426,-5211.099999999977
29170,2022-09-28 08:50:00,-1376.0,228803.91000000428,235391.01000000426,-6587.099999999977
29171,2022-09-28 08:55:00,-1728.95,227074.96000000427,235391.01000000426,-8316.049999999988
29172,2022-09-28 09:00:00,167.68,227242.64000000426,235391.01000000426,-8148.369999999995
29173,2022-09-28 09:05:00,-298.77,226943.87000000427,235391.01000000426,-8447.139999999985
29174,2022-09-28 09:10:00,447.62,227391.49000000427,235391.01000000426,-7999.5199999999895
29175,2022-09-28 09:15:00,-983.46,226408.03000000428,235391.01000000426,-8982.979999999981
29176,2022-09-28 09:20:00,-3.72,226404.31000000428,235391.01000000426,-8986.699999999983
29177,2022-09-28 09:25:00,-1074.14,225330.17000000426,235391.01000000426,-10060.839999999997
29178,2022-09-28 09:30:00,1062.0,226392.17000000426,235391.01000000426,-8998.839999999997
29179,2022-09-28 09:35:00,-1311.44,225080.73000000426,235391.01000000426,-10310.279999999999
29180,2022-09-28 09:40:00,-685.99,224394.74000000427,235391.01000000426,-10996.26999999999
29181,2022-09-28 09:45:00,71.51,224466.25000000428,235391.01000000426,-10924.75999999998
29182,2022-09-28 09:50:00,-1722.42,222743.83000000427,235391.01000000426,-12647.179999999993
29183,2022-09-28 09:55:00,-1541.83,221202.00000000428,235391.01000000426,-14189.00999999998
29184,2022-09-28 10:00:00,-184.1,221017.90000000427,235391.01000000426,-14373.109999999986
29185,2022-09-28 10:05:00,-1222.12,219795.78000000428,235391.01000000426,-15595.229999999981
29186,2022-09-28 10:10:00,-1409.11,218386.6700000043,235391.01000000426,-17004.339999999967
29187,2022-09-28 10:15:00,-917.0,217469.6700000043,235391.01000000426,-17921.339999999967
29188,2022-09-28 10:20:00,-1770.89,215698.78000000428,235391.01000000426,-19692.22999999998
29189,2022-09-28 10:25:00,1068.63,216767.41000000428,235391.01000000426,-18623.599999999977
29190,2022-09-28 10:30:00,-444.78,216322.63000000428,235391.01000000426,-19068.379999999976
29191,2022-09-28 10:35:00,-1222.57,215100.06000000428,235391.01000000426,-20290.949999999983
29192,2022-09-28 10:40:00,-1504.04,213596.02000000427,235391.01000000426,-21794.98999999999
29193,2022-09-28 10:45:00,1353.01,214949.03000000428,235391.01000000426,-20441.97999999998
29194,2022-09-28 10:50:00,-645.58,214303.4500000043,235391.01000000426,-21087.55999999997
29195,2022-09-28 10:55:00,-1266.2,213037.25000000428,235391.01000000426,-22353.75999999998
29196,2022-09-28 11:00:00,-1976.06,211061.19000000428,235391.01000000426,-24329.819999999978
29197,2022-09-28 11:05:00,297.76,211358.9500000043,235391.01000000426,-24032.05999999997
29198,2022-09-28 11:10:00,777.27,212136.22000000428,235391.01000000426,-23254.78999999998
29199,2022-09-28 11:15:00,1736.77,213872.99000000427,235391.01000000426,-21518.01999999999
29200,2022-09-28 11:20:00,1120.76,214993.75000000428,235391.01000000426,-20397.25999999998
29201,2022-09-28 11:25:00,652.7,215646.4500000043,235391.01000000426,-19744.55999999997
29202,2022-09-28 11:30:00,-1853.7,213792.75000000428,235391.01000000426,-21598.25999999998
29203,2022-09-28 11:35:00,1109.3,214902.05000000427,235391.01000000426,-20488.959999999992
29204,2022-09-28 11:40:00,-621.37,214280.68000000427,235391.01000000426,-21110.329999999987
29205,2022-09-28 11:45:00,1357.72,215638.40000000427,235391.01000000426,-19752.609999999986
29206,2022-09-28 11:50:00,-1440.34,214198.06000000428,235391.01000000426,-21192.949999999983
29207,2022-09-28 11:55:00,-1932.83,212265.2300000043,235391.01000000426,-23125.77999999997
29208,2022-09-28 12:00:00,953.1,213218.3300000043,235391.01000000426,-22172.679999999964
29209,2022-09-28 12:05:00,898.4,214116.7300000043,235391.01000000426,-21274.27999999997
29210,2022-09-28 12:10:00,1096.02,215212.75000000428,235391.01000000426,-20178.25999999998
29211,2022-09-28 12:15:00,1673.63,216886.38000000428,235391.01000000426,-18504.629999999976
29212,2022-09-28 12:20:00,-1941.59,214944.7900000043,235391.01000000426,-20446.219999999972
29213,2022-09-28 12:25:00,-1689.12,213255.6700000043,235391.01000000426,-22135.339999999967
29214,2022-09-28 12:30:00,-1855.82,211399.85000000428,235391.01000000426,-23991.159999999974
29215,2022-09-28 12:35:00,1568.32,212968.1700000043,235391.01000000426,-22422.839999999967
29216,2022-09-28 12:40:00,1678.3,214646.47000000428,235391.01000000426,-20744.53999999998
29217,2022-09-28 12:45:00,784.26,215430.7300000043,235391.01000000426,-19960.27999999997
29218,2022-09-28 12:50:00,682.72,216113.4500000043,235391.01000000426,-19277.55999999997
29219,2022-09-28 12:55:00,-1470.95,214642.50000000428,235391.01000000426,-20748.50999999998
29220,2022-09-28 13:00:00,-1062.06,213580.44000000428,235391.01000000426,-21810.569999999978
29221,2022-09-28 13:05:00,653.75,214234.19000000428,235391.01000000426,-21156.819999999978
29222,2022-09-28 13:10:00,-950.13,213284.06000000428,235391.01000000426,-22106.949999999983
29223,2022-09-28 13:15:00,907.13,214191.19000000428,235391.01000000426,-21199.819999999978
29224,2022-09-28 13:20:00,-1282.49,212908.7000000043,235391.01000000426,-22482.30999999997
29225,2022-09-28 13:25:00,-1776.86,211131.8400000043,235391.01000000426,-24259.169999999955
29226,2022-09-28 13:30:00,1992.46,213124.3000000043,235391.01000000426,-22266.709999999963
29227,2022-09-28 13:35:00,736.25,213860.5500000043,235391.01000000426,-21530.459999999963
29228,2022-09-28 13:40:00,1435.24,215295.7900000043,235391.01000000426,-20095.219999999972
29229,2022-09-28 13:45:00,842.42,216138.2100000043,235391.01000000426,-19252.79999999996
29230,2022-09-28 13:50:00,1084.61,217222.82000000429,235391.01000000426,-18168.189999999973
29231,2022-09-28 13:55:00,337.72,217560.5400000043,235391.01000000426,-17830.469999999972
29232,2022-09-28 14:00:00,-354.02,217206.5200000043,235391.01000000426,-18184.48999999996
29233,2022-09-28 14:05:00,-828.69,216377.8300000043,235391.01000000426,-19013.179999999964
29234,2022-09-28 14:10:00,1460.24,217838.07000000429,235391.01000000426,-17552.939999999973
29235,2022-09-28 14:15:00,350.8,218188.87000000427,235391.01000000426,-17202.139999999985
29236,2022-09-28 14:20:00,1492.1,219680.97000000428,235391.01000000426,-15710.039999999979
29237,2022-09-28 14:25:00,-666.31,219014.66000000428,235391.01000000426,-16376.349999999977
29238,2022-09-28 14:30:00,-229.67,218784.99000000427,235391.01000000426,-16606.01999999999
29239,2022-09-28 14:35:00,-75.1,218709.89000000426,235391.01000000426,-16681.119999999995
29240,2022-09-28 14:40:00,-977.01,217732.88000000425,235391.01000000426,-17658.130000000005
29241,2022-09-28 14:45:00,158.27,217891.15000000424,235391.01000000426,-17499.860000000015
29242,2022-09-28 14:50:00,-1262.14,216629.01000000423,235391.01000000426,-18762.00000000003
29243,2022-09-28 14:55:00,413.13,217042.14000000423,235391.01000000426,-18348.870000000024
29244,2022-09-28 15:00:00,-570.67,216471.47000000422,235391.01000000426,-18919.540000000037
29245,2022-09-28 15:05:00,1958.93,218430.4000000042,235391.01000000426,-16960.610000000044
29246,2022-09-28 15:10:00,-1306.49,217123.91000000422,235391.01000000426,-18267.100000000035
29247,2022-09-28 15:15:00,76.76,217200.67000000423,235391.01000000426,-18190.340000000026
29248,2022-09-28 15:20:00,-660.88,216539.79000000423,235391.01000000426,-18851.22000000003
29249,2022-09-28 15:25:00,450.24,216990.03000000422,235391.01000000426,-18400.98000000004
29250,2022-09-28 15:30:00,339.74,217329.7700000042,235391.01000000426,-18061.24000000005
29251,2022-09-28 15:35:00,-1216.28,216113.4900000042,235391.01000000426,-19277.520000000048
29252,2022-09-28 15:40:00,1844.33,217957.8200000042,235391.01000000426,-17433.19000000006
29253,2022-09-28 15:45:00,1940.83,219898.65000000419,235391.01000000426,-15492.360000000073
29254,2022-09-28 15:50:00,1884.65,221783.30000000418,235391.01000000426,-13607.71000000008
29255,2022-09-28 15:55:00,-76.26,221707.04000000417,235391.01000000426,-13683.970000000088
29256,2022-09-28 16:00:00,-1665.19,220041.85000000417,235391.01000000426,-15349.16000000009
29257,2022-09-28 16:05:00,-381.79,219660.06000000416,235391.01000000426,-15730.950000000099
29258,2022-09-28 16:10:00,1377.84,221037.90000000416,235391.01000000426,-14353.110000000102
29259,2022-09-28 16:15:00,1345.37,222383.27000000415,235391.01000000426,-13007.740000000107
29260,2022-09-28 16:20:00,51.83,222435.10000000414,235391.01000000426,-12955.91000000012
29261,2022-09-28 16:25:00,1305.35,223740.45000000414,235391.01000000426,-11650.560000000114
29262,2022-09-28 16:30:00,182.58,223923.03000000413,235391.01000000426,-11467.980000000127
29263,2022-09-28 16:35:00,1954.17,225877.20000000414,235391.01000000426,-9513.810000000114
29264,2022-09-28 16:40:00,-1395.79,224481.41000000414,235391.01000000426,-10909.600000000122
29265,2022-09-28 16:45:00,-625.15,223856.26000000414,235391.01000000426,-11534.750000000116
29266,2022-09-28 16:50:00,718.18,224574.44000000414,235391.01000000426,-10816.570000000123
29267,2022-09-28 16:55:00,-843.69,223730.75000000413,235391.01000000426,-11660.260000000126
29268,2022-09-29 08:00:00,-341.8,223388.95000000414,223730.75000000413,-341.79999999998836
29269,2022-09-29 08:05:00,1784.14,225173.09000000416,223730.75000000413,1442.3400000000256
29270,2022-09-29 08:10:00,1370.32,226543.41000000417,223730.75000000413,2812.6600000000326
29271,2022-09-29 08:15:00,-1714.31,224829.10000000417,223730.75000000413,1098.350000000035
29272,2022-09-29 08:20:00,-1065.89,223763.21000000415,223730.75000000413,32.460000000020955
29273,2022-09-29 08:25:00,-242.98,223520.23000000414,223730.75000000413,-210.51999999998952
29274,2022-09-29 08:30:00,1371.18,224891.41000000414,223730.75000000413,1160.6600000000035
29275,2022-09-29 08:35:00,-857.83,224033.58000000415,223730.75000000413,302.8300000000163
29276,2022-09-29 08:40:00,1361.62,225395.20000000414,223730.75000000413,1664.4500000000116
29277,2022-09-29 08:45:00,698.73,226093.93000000415,223730.75000000413,2363.180000000022
29278,2022-09-29 08:50:00,-125.17,225968.76000000414,223730.75000000413,2238.0100000000093
29279,2022-09-29 08:55:00,-540.76,225428.00000000413,223730.75000000413,1697.25
29280,2022-09-29 09:00:00,1814.98,227242.98000000414,223730.75000000413,3512.2300000000105
29281,2022-09-29 09:05:00,1624.46,228867.44000000414,223730.75000000413,5136.690000000002
29282,2022-09-29 09:10:00,16.77,228884.21000000412,223730.75000000413,5153.459999999992
29283,2022-09-29 09:15:00,-1221.98,227662.2300000041,223730.75000000413,3931.4799999999814
29284,2022-09-29 09:20:00,-1205.44,226456.7900000041,223730.75000000413,2726.039999999979
29285,2022-09-29 09:25:00,-1953.85,224502.9400000041,223730.75000000413,772.1899999999732
29286,2022-09-29 09:30:00,-1197.32,223305.6200000041,223730.75000000413,-425.13000000003376
29287,2022-09-29 09:35:00,1984.34,225289.9600000041,223730.75000000413,1559.2099999999627
29288,2022-09-29 09:40:00,-1388.43,223901.5300000041,223730.75000000413,170.77999999996973
29289,2022-09-29 09:45:00,1255.81,225157.3400000041,223730.75000000413,1426.5899999999674
29290,2022-09-29 09:50:00,-802.35,224354.9900000041,223730.75000000413,624.2399999999616
29291,2022-09-29 09:55:00,-594.57,223760.4200000041,223730.75000000413,29.669999999954598
29292,2022-09-29 10:00:00,1226.53,224986.9500000041,223730.75000000413,1256.1999999999534
29293,2022-09-29 10:05:00,-4.77,224982.1800000041,223730.75000000413,1251.429999999964
29294,2022-09-29 10:10:00,1640.18,226622.3600000041,223730.75000000413,2891.609999999957
29295,2022-09-29 10:15:00,350.88,226973.2400000041,223730.75000000413,3242.4899999999616
29296,2022-09-29 10:20:00,-1634.68,225338.5600000041,223730.75000000413,1607.8099999999686
29297,2022-09-29 10:25:00,1421.51,226760.0700000041,223730.75000000413,3029.319999999978
29298,2022-09-29 10:30:00,-449.5,226310.5700000041,223730.75000000413,2579.819999999978
29299,2022-09-29 10:35:00,850.37,227160.9400000041,223730.75000000413,3430.189999999973
29300,2022-09-29 10:40:00,-274.96,226885.9800000041,223730.75000000413,3155.2299999999814
29301,2022-09-29 10:45:00,647.45,227533.43000000413,223730.75000000413,3802.679999999993
29302,2022-09-29 10:50:00,1395.15,228928.58000000412,223730.75000000413,5197.829999999987
29303,2022-09-29 10:55:00,-1243.91,227684.67000000412,223730.75000000413,3953.9199999999837
29304,2022-09-29 11:00:00,-1450.55,226234.12000000413,223730.75000000413,2503.3699999999953
29305,2022-09-29 11:05:00,-1057.33,225176.79000000414,223730.75000000413,1446.0400000000081
29306,2022-09-29 11:10:00,1273.91,226450.70000000414,223730.75000000413,2719.9500000000116
29307,2022-09-29 11:15:00,199.83,226650.53000000413,223730.75000000413,2919.779999999999
29308,2022-09-29 11:20:00,1628.12,228278.65000000413,223730.75000000413,4547.899999999994
29309,2022-09-29 11:25:00,585.21,228863.86000000412,223730.75000000413,5133.109999999986
29310,2022-09-29 11:30:00,1965.75,230829.61000000412,223730.75000000413,7098.859999999986
29311,2022-09-29 11:35:00,950.52,231780.1300000041,223730.75000000413,8049.379999999976
29312,2022-09-29 11:40:00,-1659.9,230120.2300000041,223730.75000000413,6389.479999999981
29313,2022-09-29 11:45:00,-67.02,230053.21000000412,223730.75000000413,6322.459999999992
29314,2022-09-29 11:50:00,316.23,230369.44000000414,223730.75000000413,6638.690000000002
29315,2022-09-29 11:55:00,1045.82,231415.26000000414,223730.75000000413,7684.510000000009
29316,2022-09-29 12:00:00,-462.79,230952.47000000413,223730.75000000413,7221.720000000001
29317,2022-09-29 12:05:00,-1835.71,229116.76000000414,223730.75000000413,5386.010000000009
29318,2022-09-29 12:10:00,1838.36,230955.12000000413,223730.75000000413,7224.369999999995
29319,2022-09-29 12:15:00,70.91,231026.03000000413,223730.75000000413,7295.279999999999
29320,2022-09-29 12:20:00,1140.39,232166.42000000415,223730.75000000413,8435.670000000013
29321,2022-09-29 12:25:00,877.66,233044.08000000415,223730.75000000413,9313.330000000016
29322,2022-09-29 12:30:00,1159.09,234203.17000000415,223730.75000000413,10472.420000000013
29323,2022-09-29 12:35:00,-1062.86,233140.31000000416,223730.75000000413,9409.560000000027
29324,2022-09-29 12:40:00,1113.79,234254.10000000417,223730.75000000413,10523.350000000035
29325,2022-09-29 12:45:00,1255.46,235509.56000000416,223730.75000000413,11778.810000000027
29326,2022-09-29 12:50:00,1188.24,236697.80000000415,223730.75000000413,12967.050000000017
29327,2022-09-29 12:55:00,457.92,237155.72000000416,223730.75000000413,13424.97000000003
29328,2022-09-29 13:00:00,-1688.13,235467.59000000416,223730.75000000413,11736.840000000026
29329,2022-09-29 13:05:00,-1194.96,234272.63000000417,223730.75000000413,10541.880000000034
29330,2022-09-29 13:10:00,1183.8,235456.43000000415,223730.75000000413,11725.680000000022
29331,2022-09-29 13:15:00,704.05,236160.48000000414,223730.75000000413,12429.73000000001
29332,2022-09-29 13:20:00,-1327.84,234832.64000000415,223730.75000000413,11101.890000000014
29333,2022-09-29 13:25:00,-735.74,234096.90000000416,223730.75000000413,10366.150000000023
29334,2022-09-29 13:30:00,409.82,234506.72000000416,223730.75000000413,10775.97000000003
29335,2022-09-29 13:35:00,908.7,235415.42000000417,223730.75000000413,11684.670000000042
29336,2022-09-29 13:40:00,-523.92,234891.50000000416,223730.75000000413,11160.75000000003
29337,2022-09-29 13:45:00,1120.59,236012.09000000416,223730.75000000413,12281.340000000026
29338,2022-09-29 13:50:00,-43.41,235968.68000000415,223730.75000000413,12237.930000000022
29339,2022-09-29 13:55:00,-1946.07,234022.61000000415,223730.75000000413,10291.860000000015
29340,2022-09-29 14:00:00,-1030.14,232992.47000000413,223730.75000000413,9261.720000000001
29341,2022-09-29 14:05:00,-799.75,232192.72000000413,223730.75000000413,8461.970000000001
29342,2022-09-29 14:10:00,207.05,232399.77000000412,223730.75000000413,8669.01999999999
29343,2022-09-29 14:15:00,-1217.32,231182.45000000412,223730.75000000413,7451.6999999999825
29344,2022-09-29 14:20:00,1810.51,232992.96000000412,223730.75000000413,9262.209999999992
29345,2022-09-29 14:25:00,-379.57,232613.39000000412,223730.75000000413,8882.639999999985
29346,2022-09-29 14:30:00,-1895.65,230717.74000000412,223730.75000000413,6986.989999999991
29347,2022-09-29 14:35:00,-309.14,230408.6000000041,223730.75000000413,6677.849999999977
29348,2022-09-29 14:40:00,1042.57,231451.17000000412,223730.75000000413,7720.419999999984
29349,2022-09-29 14:45:00,-1684.13,229767.0400000041,223730.75000000413,6036.289999999979
29350,2022-09-29 14:50:00,535.28,230302.3200000041,223730.75000000413,6571.569999999978
29351,2022-09-29 14:55:00,-1009.48,229292.8400000041,223730.75000000413,5562.089999999967
29352,2022-09-29 15:00:00,0.87,229293.7100000041,223730.75000000413,5562.959999999963
29353,2022-09-29 15:05:00,936.56,230230.2700000041,223730.75000000413,6499.51999999996
29354,2022-09-29 15:10:00,-362.49,229867.7800000041,223730.75000000413,6137.02999999997
29355,2022-09-29 15:15:00,-662.75,229205.0300000041,223730.75000000413,5474.27999999997
29356,2022-09-29 15:20:00,1239.71,230444.7400000041,223730.75000000413,6713.989999999962
29357,2022-09-29 15:25:00,-982.72,229462.0200000041,223730.75000000413,5731.26999999996
29358,2022-09-29 15:30:00,1459.52,230921.54000000408,223730.75000000413,7190.78999999995
29359,2022-09-29 15:35:00,1552.16,232473.7000000041,223730.75000000413,8742.949999999953
29360,2022-09-29 15:40:00,-60.06,232413.6400000041,223730.75000000413,8682.889999999956
29361,2022-09-29 15:45:00,-121.64,232292.00000000407,223730.75000000413,8561.249999999942
29362,2022-09-29 15:50:00,1835.62,234127.62000000407,223730.75000000413,10396.869999999937
29363,2022-09-29 15:55:00,-207.21,233920.41000000408,223730.75000000413,10189.659999999945
29364,2022-09-29 16:00:00,1622.23,235542.6400000041,223730.75000000413,11811.889999999956
29365,2022-09-29 16:05:00,-97.67,235444.97000000408,223730.75000000413,11714.219999999943
29366,2022-09-29 16:10:00,342.45,235787.4200000041,223730.75000000413,12056.669999999955
29367,2022-09-29 16:15:00,1864.36,237651.78000000407,223730.75000000413,13921.02999999994
29368,2022-09-29 16:20:00,-89.76,237562.02000000406,223730.75000000413,13831.269999999931
29369,2022-09-29 16:25:00,-1805.48,235756.54000000405,223730.75000000413,12025.78999999992
29370,2022-09-29 16:30:00,1579.61,237336.15000000404,223730.75000000413,13605.399999999907
29371,2022-09-29 16:35:00,-1389.9,235946.25000000405,223730.75000000413,12215.499999999913
29372,2022-09-29 16:40:00,1678.84,237625.09000000404,223730.75000000413,13894.33999999991
29373,2022-09-29 16:45:00,1796.22,239421.31000000404,223730.75000000413,15690.55999999991
29374,2022-09-29 16:50:00,1049.06,240470.37000000404,223730.75000000413,16739.619999999908
29375,2022-09-29 16:55:00,940.69,241411.06000000404,223730.75000000413,17680.30999999991
29376,2022-09-30 08:00:00,238.01,241649.07000000405,241411.06000000404,238.0100000000093
29377,2022-09-30 08:05:00,-1031.99,240617.08000000406,241411.06000000404,-793.9799999999814
29378,2022-09-30 08:10:00,523.67,241140.75000000407,241411.06000000404,-270.30999999996857
29379,2022-09-30 08:15:00,1880.0,243020.75000000407,241411.06000000404,1609.6900000000314
29380,2022-09-30 08:20:00,-763.19,242257.56000000407,241411.06000000404,846.5000000000291
29381,2022-09-30 08:25:00,1650.49,243908.05000000406,241411.06000000404,2496.99000000002
29382,2022-09-30 08:30:00,-1438.22,242469.83000000406,241411.06000000404,1058.7700000000186
29383,2022-09-30 08:35:00,-1005.24,241464.59000000407,241411.06000000404,53.53000000002794
29384,2022-09-30 08:40:00,-543.58,240921.01000000408,241411.06000000404,-490.04999999995925
29385,2022-09-30 08:45:00,965.18,241886.19000000408,241411.06000000404,475.13000000003376
29386,2022-09-30 08:50:00,-1007.08,240879.1100000041,241411.06000000404,-531.9499999999534
29387,2022-09-30 08:55:00,935.31,241814.4200000041,241411.06000000404,403.36000000004424
29388,2022-09-30 09:00:00,1386.08,243200.50000000407,241411.06000000404,1789.4400000000314
29389,2022-09-30 09:05:00,-1489.43,241711.07000000408,241411.06000000404,300.0100000000384
29390,2022-09-30 09:10:00,205.0,241916.07000000408,241411.06000000404,505.0100000000384
29391,2022-09-30 09:15:00,1714.23,243630.3000000041,241411.06000000404,2219.240000000049
29392,2022-09-30 09:20:00,-532.05,243098.2500000041,241411.06000000404,1687.1900000000605
29393,2022-09-30 09:25:00,101.21,243199.4600000041,241411.06000000404,1788.4000000000524
29394,2022-09-30 09:30:00,1565.23,244764.6900000041,241411.06000000404,3353.630000000063
29395,2022-09-30 09:35:00,857.41,245622.1000000041,241411.06000000404,4211.040000000066
29396,2022-09-30 09:40:00,-1030.35,244591.7500000041,241411.06000000404,3180.6900000000605
29397,2022-09-30 09:45:00,-1301.39,243290.3600000041,241411.06000000404,1879.3000000000466
29398,2022-09-30 09:50:00,-1513.99,241776.3700000041,241411.06000000404,365.3100000000559
29399,2022-09-30 09:55:00,-1894.3,239882.0700000041,241411.06000000404,-1528.9899999999325
29400,2022-09-30 10:00:00,-1778.73,238103.3400000041,241411.06000000404,-3307.719999999943
29401,2022-09-30 10:05:00,-1315.13,236788.2100000041,241411.06000000404,-4622.849999999948
29402,2022-09-30 10:10:00,-678.02,236110.1900000041,241411.06000000404,-5300.869999999937
29403,2022-09-30 10:15:00,-525.01,235585.1800000041,241411.06000000404,-5825.879999999946
29404,2022-09-30 10:20:00,1099.77,236684.9500000041,241411.06000000404,-4726.109999999957
29405,2022-09-30 10:25:00,-1158.34,235526.6100000041,241411.06000000404,-5884.449999999953
29406,2022-09-30 10:30:00,315.49,235842.10000000408,241411.06000000404,-5568.959999999963
29407,2022-09-30 10:35:00,-960.55,234881.5500000041,241411.06000000404,-6529.509999999951
29408,2022-09-30 10:40:00,-798.62,234082.9300000041,241411.06000000404,-7328.129999999946
29409,2022-09-30 10:45:00,1481.93,235564.8600000041,241411.06000000404,-5846.199999999953
29410,2022-09-30 10:50:00,1863.75,237428.6100000041,241411.06000000404,-3982.4499999999534
29411,2022-09-30 10:55:00,871.7,238300.3100000041,241411.06000000404,-3110.749999999942
29412,2022-09-30 11:00:00,-1266.29,237034.0200000041,241411.06000000404,-4377.03999999995
29413,2022-09-30 11:05:00,303.09,237337.1100000041,241411.06000000404,-4073.9499999999534
29414,2022-09-30 11:10:00,870.77,238207.88000000408,241411.06000000404,-3203.179999999964
29415,2022-09-30 11:15:00,1346.18,239554.06000000407,241411.06000000404,-1856.999999999971
29416,2022-09-30 11:20:00,1102.26,240656.32000000408,241411.06000000404,-754.7399999999616
29417,2022-09-30 11:25:00,-130.89,240525.43000000407,241411.06000000404,-885.6299999999756
29418,2022-09-30 11:30:00,-1580.5,238944.93000000407,241411.06000000404,-2466.1299999999756
29419,2022-09-30 11:35:00,395.24,239340.17000000406,241411.06000000404,-2070.889999999985
29420,2022-09-30 11:40:00,-467.05,238873.12000000407,241411.06000000404,-2537.939999999973
29421,2022-09-30 11:45:00,-699.35,238173.77000000406,241411.06000000404,-3237.289999999979
29422,2022-09-30 11:50:00,1469.71,239643.48000000406,241411.06000000404,-1767.5799999999872
29423,2022-09-30 11:55:00,-1688.28,237955.20000000406,241411.06000000404,-3455.859999999986
29424,2022-09-30 12:00:00,1346.56,239301.76000000405,241411.06000000404,-2109.2999999999884
29425,2022-09-30 12:05:00,987.52,240289.28000000404,241411.06000000404,-1121.7799999999988
29426,2022-09-30 12:10:00,764.71,241053.99000000404,241411.06000000404,-357.070000000007
29427,2022-09-30 12:15:00,154.59,241208.58000000403,241411.06000000404,-202.48000000001048
29428,2022-09-30 12:20:00,730.36,241938.94000000402,241411.06000000404,527.8799999999756
29429,2022-09-30 12:25:00,-1013.82,240925.120000004,241411.06000000404,-485.94000000003143
29430,2022-09-30 12:30:00,-1971.13,238953.990000004,241411.06000000404,-2457.070000000036
29431,2022-09-30 12:35:00,736.98,239690.97000000402,241411.06000000404,-1720.0900000000256
29432,2022-09-30 12:40:00,-1760.65,237930.32000000402,241411.06000000404,-3480.74000000002
29433,2022-09-30 12:45:00,-703.82,237226.50000000402,241411.06000000404,-4184.560000000027
29434,2022-09-30 12:50:00,-1025.33,236201.17000000403,241411.06000000404,-5209.890000000014
29435,2022-09-30 12:55:00,850.93,237052.10000000402,241411.06000000404,-4358.960000000021
29436,2022-09-30 13:00:00,-1040.63,236011.47000000402,241411.06000000404,-5399.590000000026
29437,2022-09-30 13:05:00,-16.68,235994.79000000402,241411.06000000404,-5416.270000000019
29438,2022-09-30 13:10:00,914.9,236909.69000000402,241411.06000000404,-4501.370000000024
29439,2022-09-30 13:15:00,1551.27,238460.960000004,241411.06000000404,-2950.100000000035
29440,2022-09-30 13:20:00,-1419.91,237041.050000004,241411.06000000404,-4370.010000000038
29441,2022-09-30 13:25:00,129.51,237170.560000004,241411.06000000404,-4240.500000000029
29442,2022-09-30 13:30:00,1175.11,238345.670000004,241411.06000000404,-3065.390000000043
29443,2022-09-30 13:35:00,-208.33,238137.340000004,241411.06000000404,-3273.7200000000303
29444,2022-09-30 13:40:00,1638.94,239776.28000000402,241411.06000000404,-1634.780000000028
29445,2022-09-30 13:45:00,1006.22,240782.50000000402,241411.06000000404,-628.5600000000268
29446,2022-09-30 13:50:00,-1145.34,239637.16000000402,241411.06000000404,-1773.9000000000233
29447,2022-09-30 13:55:00,-1914.8,237722.36000000403,241411.06000000404,-3688.7000000000116
29448,2022-09-30 14:00:00,-1388.48,236333.88000000402,241411.06000000404,-5077.180000000022
29449,2022-09-30 14:05:00,1631.62,237965.50000000402,241411.06000000404,-3445.560000000027
29450,2022-09-30 14:10:00,-1509.49,236456.01000000403,241411.06000000404,-4955.0500000000175
29451,2022-09-30 14:15:00,-1457.19,234998.82000000402,241411.06000000404,-6412.24000000002
29452,2022-09-30 14:20:00,-582.2,234416.620000004,241411.06000000404,-6994.440000000031
29453,2022-09-30 14:25:00,773.18,235189.800000004,241411.06000000404,-6221.260000000038
29454,2022-09-30 14:30:00,-36.26,235153.540000004,241411.06000000404,-6257.520000000048
29455,2022-09-30 14:35:00,562.74,235716.280000004,241411.06000000404,-5694.780000000057
29456,2022-09-30 14:40:00,-1596.01,234120.27000000398,241411.06000000404,-7290.790000000066
29457,2022-09-30 14:45:00,-1635.03,232485.24000000398,241411.06000000404,-8925.820000000065
29458,2022-09-30 14:50:00,-1431.38,231053.86000000397,241411.06000000404,-10357.20000000007
29459,2022-09-30 14:55:00,-1520.62,229533.24000000398,241411.06000000404,-11877.820000000065
29460,2022-09-30 15:00:00,1090.28,230623.52000000398,241411.06000000404,-10787.540000000066
29461,2022-09-30 15:05:00,1198.01,231821.530000004,241411.06000000404,-9589.530000000057
29462,2022-09-30 15:10:00,110.12,231931.65000000398,241411.06000000404,-9479.410000000062
29463,2022-09-30 15:15:00,146.26,232077.910000004,241411.06000000404,-9333.150000000052
29464,2022-09-30 15:20:00,704.93,232782.84000000398,241411.06000000404,-8628.22000000006
29465,2022-09-30 15:25:00,-1303.21,231479.630000004,241411.06000000404,-9931.430000000051
29466,2022-09-30 15:30:00,319.01,231798.640000004,241411.06000000404,-9612.420000000042
29467,2022-09-30 15:35:00,-1188.58,230610.060000004,241411.06000000404,-10801.00000000003
29468,2022-09-30 15:40:00,-1255.84,229354.22000000402,241411.06000000404,-12056.840000000026
29469,2022-09-30 15:45:00,1537.98,230892.20000000403,241411.06000000404,-10518.860000000015
29470,2022-09-30 15:50:00,1129.7,232021.90000000404,241411.06000000404,-9389.160000000003
29471,2022-09-30 15:55:00,1917.97,233939.87000000404,241411.06000000404,-7471.190000000002
29472,2022-09-30 16:00:00,-1821.13,232118.74000000404,241411.06000000404,-9292.320000000007
29473,2022-09-30 16:05:00,1443.41,233562.15000000404,241411.06000000404,-7848.9100000000035
29474,2022-09-30 16:10:00,-1127.91,232434.24000000404,241411.06000000404,-8976.820000000007
29475,2022-09-30 16:15:00,-1586.0,230848.24000000404,241411.06000000404,-10562.820000000007
29476,2022-09-30 16:20:00,-1355.53,229492.71000000404,241411.06000000404,-11918.350000000006
29477,2022-09-30 16:25:00,-1549.78,227942.93000000404,241411.06000000404,-13468.130000000005
29478,2022-09-30 16:30:00,-405.53,227537.40000000404,241411.06000000404,-13873.660000000003
29479,2022-09-30 16:35:00,739.08,228276.48000000403,241411.06000000404,-13134.580000000016
29480,2022-09-30 16:40:00,1362.28,229638.76000000403,241411.06000000404,-11772.300000000017
29481,2022-09-30 16:45:00,1435.47,231074.23000000403,241411.06000000404,-10336.830000000016
29482,2022-09-30 16:50:00,-1098.39,229975.840000004,241411.06000000404,-11435.22000000003
29483,2022-09-30 16:55:00,1595.36,231571.200000004,241411.06000000404,-9839.860000000044
29484,2022-10-01 08:00:00,-1144.5,230426.700000004,231571.200000004,-1144.5
29485,2022-10-01 08:05:00,214.15,230640.850000004,231571.200000004,-930.3500000000058
29486,2022-10-01 08:10:00,-891.9,229748.950000004,231571.200000004,-1822.25
29487,2022-10-01 08:15:00,1723.77,231472.720000004,231571.200000004,-98.48000000001048
29488,2022-10-01 08:20:00,1788.49,233261.21000000398,231571.200000004,1690.0099999999802
29489,2022-10-01 08:25:00,1507.07,234768.280000004,231571.200000004,3197.079999999987
29490,2022-10-01 08:30:00,-459.78,234308.500000004,231571.200000004,2737.2999999999884
29491,2022-10-01 08:35:00,1288.3,235596.80000000398,231571.200000004,4025.5999999999767
29492,2022-10-01 08:40:00,1720.28,237317.08000000397,231571.200000004,5745.879999999976
29493,2022-10-01 08:45:00,51.92,237369.000000004,231571.200000004,5797.799999999988
29494,2022-10-01 08:50:00,984.02,238353.02000000398,231571.200000004,6781.819999999978
29495,2022-10-01 08:55:00,-1345.98,237007.04000000397,231571.200000004,5435.839999999967
29496,2022-10-01 09:00:00,-1107.36,235899.68000000398,231571.200000004,4328.479999999981
29497,2022-10-01 09:05:00,1429.7,237329.380000004,231571.200000004,5758.179999999993
29498,2022-10-01 09:10:00,-284.41,237044.970000004,231571.200000004,5473.7699999999895
29499,2022-10-01 09:15:00,-1969.62,235075.350000004,231571.200000004,3504.149999999994
29500,2022-10-01 09:20:00,-1774.68,233300.670000004,231571.200000004,1729.4700000000012
29501,2022-10-01 09:25:00,-94.58,233206.090000004,231571.200000004,1634.890000000014
29502,2022-10-01 09:30:00,-397.34,232808.75000000402,231571.200000004,1237.5500000000175
29503,2022-10-01 09:35:00,-950.22,231858.53000000402,231571.200000004,287.3300000000163
29504,2022-10-01 09:40:00,1282.98,233141.51000000403,231571.200000004,1570.3100000000268
29505,2022-10-01 09:45:00,-299.71,232841.80000000403,231571.200000004,1270.600000000035
29506,2022-10-01 09:50:00,-1541.62,231300.18000000404,231571.200000004,-271.0199999999604
29507,2022-10-01 09:55:00,-1188.37,230111.81000000404,231571.200000004,-1459.3899999999558
29508,2022-10-01 10:00:00,-974.56,229137.25000000405,231571.200000004,-2433.9499999999534
29509,2022-10-01 10:05:00,1724.27,230861.52000000403,231571.200000004,-709.6799999999639
29510,2022-10-01 10:10:00,671.32,231532.84000000404,231571.200000004,-38.359999999956926
29511,2022-10-01 10:15:00,1181.8,232714.64000000403,231571.200000004,1143.4400000000314
29512,2022-10-01 10:20:00,1136.46,233851.10000000402,231571.200000004,2279.9000000000233
29513,2022-10-01 10:25:00,1256.18,235107.28000000402,231571.200000004,3536.0800000000163
29514,2022-10-01 10:30:00,-438.61,234668.67000000403,231571.200000004,3097.4700000000303
29515,2022-10-01 10:35:00,-476.71,234191.96000000404,231571.200000004,2620.7600000000384
29516,2022-10-01 10:40:00,-1155.26,233036.70000000403,231571.200000004,1465.500000000029
29517,2022-10-01 10:45:00,1651.91,234688.61000000403,231571.200000004,3117.4100000000326
29518,2022-10-01 10:50:00,1673.31,236361.92000000403,231571.200000004,4790.72000000003
29519,2022-10-01 10:55:00,822.22,237184.14000000403,231571.200000004,5612.940000000031
29520,2022-10-01 11:00:00,1464.46,238648.60000000402,231571.200000004,7077.400000000023
29521,2022-10-01 11:05:00,-949.74,237698.86000000403,231571.200000004,6127.660000000033
29522,2022-10-01 11:10:00,1700.3,239399.16000000402,231571.200000004,7827.960000000021
29523,2022-10-01 11:15:00,171.09,239570.25000000402,231571.200000004,7999.0500000000175
29524,2022-10-01 11:20:00,1191.81,240762.060000004,231571.200000004,9190.860000000015
29525,2022-10-01 11:25:00,1566.59,242328.650000004,231571.200000004,10757.450000000012
29526,2022-10-01 11:30:00,-1682.13,240646.520000004,231571.200000004,9075.320000000007
29527,2022-10-01 11:35:00,1799.84,242446.360000004,231571.200000004,10875.160000000003
29528,2022-10-01 11:40:00,1099.43,243545.790000004,231571.200000004,11974.589999999997
29529,2022-10-01 11:45:00,554.94,244100.730000004,231571.200000004,12529.529999999999
29530,2022-10-01 11:50:00,621.05,244721.780000004,231571.200000004,13150.579999999987
29531,2022-10-01 11:55:00,-1927.35,242794.43000000398,231571.200000004,11223.229999999981
29532,2022-10-01 12:00:00,1283.58,244078.01000000397,231571.200000004,12506.809999999969
29533,2022-10-01 12:05:00,22.79,244100.80000000398,231571.200000004,12529.599999999977
29534,2022-10-01 12:10:00,-576.13,243524.67000000397,231571.200000004,11953.469999999972
29535,2022-10-01 12:15:00,-111.44,243413.23000000397,231571.200000004,11842.02999999997
29536,2022-10-01 12:20:00,-1228.22,242185.01000000397,231571.200000004,10613.809999999969
29537,2022-10-01 12:25:00,1355.87,243540.88000000396,231571.200000004,11969.679999999964
29538,2022-10-01 12:30:00,86.54,243627.42000000397,231571.200000004,12056.219999999972
29539,2022-10-01 12:35:00,1683.43,245310.85000000396,231571.200000004,13739.649999999965
29540,2022-10-01 12:40:00,1577.63,246888.48000000397,231571.200000004,15317.27999999997
29541,2022-10-01 12:45:00,205.78,247094.26000000397,231571.200000004,15523.059999999969
29542,2022-10-01 12:50:00,-1799.23,245295.03000000396,231571.200000004,13723.829999999958
29543,2022-10-01 12:55:00,-876.71,244418.32000000397,231571.200000004,12847.119999999966
29544,2022-10-01 13:00:00,-529.35,243888.97000000396,231571.200000004,12317.76999999996
29545,2022-10-01 13:05:00,-953.73,242935.24000000395,231571.200000004,11364.03999999995
29546,2022-10-01 13:10:00,659.91,243595.15000000395,231571.200000004,12023.949999999953
29547,2022-10-01 13:15:00,1217.81,244812.96000000395,231571.200000004,13241.759999999951
29548,2022-10-01 13:20:00,888.93,245701.89000000394,231571.200000004,14130.689999999944
29549,2022-10-01 13:25:00,20.84,245722.73000000394,231571.200000004,14151.52999999994
29550,2022-10-01 13:30:00,-1921.07,243801.66000000393,231571.200000004,12230.459999999934
29551,2022-10-01 13:35:00,-1935.61,241866.05000000395,231571.200000004,10294.849999999948
29552,2022-10-01 13:40:00,-1546.58,240319.47000000396,231571.200000004,8748.26999999996
29553,2022-10-01 13:45:00,-83.01,240236.46000000395,231571.200000004,8665.259999999951
29554,2022-10-01 13:50:00,536.77,240773.23000000394,231571.200000004,9202.02999999994
29555,2022-10-01 13:55:00,847.03,241620.26000000394,231571.200000004,10049.05999999994
29556,2022-10-01 14:00:00,1351.43,242971.69000000393,231571.200000004,11400.489999999932
29557,2022-10-01 14:05:00,-545.81,242425.88000000393,231571.200000004,10854.679999999935
29558,2022-10-01 14:10:00,1224.37,243650.25000000393,231571.200000004,12079.04999999993
29559,2022-10-01 14:15:00,-1820.52,241829.73000000394,231571.200000004,10258.52999999994
29560,2022-10-01 14:20:00,874.67,242704.40000000395,231571.200000004,11133.199999999953
29561,2022-10-01 14:25:00,3.92,242708.32000000397,231571.200000004,11137.119999999966
29562,2022-10-01 14:30:00,1971.29,244679.61000000397,231571.200000004,13108.409999999974
29563,2022-10-01 14:35:00,1672.01,246351.62000000398,231571.200000004,14780.419999999984
29564,2022-10-01 14:40:00,-1635.52,244716.100000004,231571.200000004,13144.899999999994
29565,2022-10-01 14:45:00,-708.9,244007.200000004,231571.200000004,12436.0
29566,2022-10-01 14:50:00,-1167.33,242839.870000004,231571.200000004,11268.670000000013
29567,2022-10-01 14:55:00,-1568.21,241271.66000000402,231571.200000004,9700.460000000021
29568,2022-10-01 15:00:00,1026.42,242298.08000000403,231571.200000004,10726.880000000034
29569,2022-10-01 15:05:00,-837.93,241460.15000000404,231571.200000004,9888.95000000004
29570,2022-10-01 15:10:00,530.11,241990.26000000403,231571.200000004,10419.060000000027
29571,2022-10-01 15:15:00,-1394.64,240595.620000004,231571.200000004,9024.420000000013
29572,2022-10-01 15:20:00,1461.3,242056.920000004,231571.200000004,10485.720000000001
29573,2022-10-01 15:25:00,597.4,242654.320000004,231571.200000004,11083.119999999995
29574,2022-10-01 15:30:00,-780.65,241873.670000004,231571.200000004,10302.470000000001
29575,2022-10-01 15:35:00,-1322.53,240551.140000004,231571.200000004,8979.940000000002
29576,2022-10-01 15:40:00,432.67,240983.810000004,231571.200000004,9412.610000000015
29577,2022-10-01 15:45:00,590.85,241574.66000000402,231571.200000004,10003.460000000021
29578,2022-10-01 15:50:00,776.98,242351.64000000403,231571.200000004,10780.440000000031
29579,2022-10-01 15:55:00,-1251.98,241099.66000000402,231571.200000004,9528.460000000021
29580,2022-10-01 16:00:00,-1811.18,239288.48000000403,231571.200000004,7717.280000000028
29581,2022-10-01 16:05:00,120.3,239408.78000000402,231571.200000004,7837.580000000016
29582,2022-10-01 16:10:00,910.1,240318.88000000402,231571.200000004,8747.680000000022
29583,2022-10-01 16:15:00,-1432.79,238886.090000004,231571.200000004,7314.890000000014
29584,2022-10-01 16:20:00,-977.12,237908.97000000402,231571.200000004,6337.770000000019
29585,2022-10-01 16:25:00,1375.31,239284.28000000402,231571.200000004,7713.080000000016
29586,2022-10-01 16:30:00,141.93,239426.210000004,231571.200000004,7855.010000000009
29587,2022-10-01 16:35:00,-1413.8,238012.41000000402,231571.200000004,6441.210000000021
29588,2022-10-01 16:40:00,-254.82,237757.590000004,231571.200000004,6186.390000000014
29589,2022-10-01 16:45:00,-1268.11,236489.48000000403,231571.200000004,4918.280000000028
29590,2022-10-01 16:50:00,-34.55,236454.93000000404,231571.200000004,4883.73000000004
29591,2022-10-01 16:55:00,462.53,236917.46000000404,231571.200000004,5346.260000000038
29592,2022-10-02 08:00:00,217.25,237134.71000000404,236917.46000000404,217.25
29593,2022-10-02 08:05:00,1611.59,238746.30000000403,236917.46000000404,1828.8399999999965
29594,2022-10-02 08:10:00,1346.53,240092.83000000403,236917.46000000404,3175.3699999999953
29595,2022-10-02 08:15:00,-1716.74,238376.09000000404,236917.46000000404,1458.6300000000047
29596,2022-10-02 08:20:00,584.09,238960.18000000404,236917.46000000404,2042.7200000000012
29597,2022-10-02 08:25:00,1667.11,240627.29000000402,236917.46000000404,3709.829999999987
29598,2022-10-02 08:30:00,-1685.85,238941.44000000402,236917.46000000404,2023.9799999999814
29599,2022-10-02 08:35:00,-1611.58,237329.86000000403,236917.46000000404,412.3999999999942
29600,2022-10-02 08:40:00,-728.4,236601.46000000404,236917.46000000404,-316.0
29601,2022-10-02 08:45:00,1729.24,238330.70000000403,236917.46000000404,1413.2399999999907
29602,2022-10-02 08:50:00,1126.26,239456.96000000404,236917.46000000404,2539.5
29603,2022-10-02 08:55:00,-372.12,239084.84000000404,236917.46000000404,2167.3800000000047
29604,2022-10-02 09:00:00,-4.16,239080.68000000404,236917.46000000404,2163.220000000001
29605,2022-10-02 09:05:00,-215.18,238865.50000000405,236917.46000000404,1948.0400000000081
29606,2022-10-02 09:10:00,954.81,239820.31000000404,236917.46000000404,2902.850000000006
29607,2022-10-02 09:15:00,-79.21,239741.10000000405,236917.46000000404,2823.640000000014
29608,2022-10-02 09:20:00,-1104.16,238636.94000000405,236917.46000000404,1719.4800000000105
29609,2022-10-02 09:25:00,-609.58,238027.36000000406,236917.46000000404,1109.9000000000233
29610,2022-10-02 09:30:00,721.57,238748.93000000407,236917.46000000404,1831.4700000000303
29611,2022-10-02 09:35:00,1644.44,240393.37000000407,236917.46000000404,3475.9100000000326
29612,2022-10-02 09:40:00,-243.71,240149.66000000408,236917.46000000404,3232.2000000000407
29613,2022-10-02 09:45:00,-1526.66,238623.00000000407,236917.46000000404,1705.5400000000373
29614,2022-10-02 09:50:00,-578.87,238044.13000000408,236917.46000000404,1126.670000000042
29615,2022-10-02 09:55:00,-848.81,237195.32000000408,236917.46000000404,277.86000000004424
29616,2022-10-02 10:00:00,-1428.94,235766.38000000408,236917.46000000404,-1151.079999999958
29617,2022-10-02 10:05:00,-1751.1,234015.28000000407,236917.46000000404,-2902.179999999964
29618,2022-10-02 10:10:00,-143.09,233872.19000000408,236917.46000000404,-3045.2699999999604
29619,2022-10-02 10:15:00,-1423.51,232448.68000000407,236917.46000000404,-4468.77999999997
29620,2022-10-02 10:20:00,-1659.9,230788.78000000407,236917.46000000404,-6128.679999999964
29621,2022-10-02 10:25:00,488.34,231277.12000000407,236917.46000000404,-5640.339999999967
29622,2022-10-02 10:30:00,858.51,232135.63000000408,236917.46000000404,-4781.829999999958
29623,2022-10-02 10:35:00,-23.85,232111.78000000407,236917.46000000404,-4805.679999999964
29624,2022-10-02 10:40:00,747.39,232859.1700000041,236917.46000000404,-4058.28999999995
29625,2022-10-02 10:45:00,1268.91,234128.0800000041,236917.46000000404,-2789.3799999999464
29626,2022-10-02 10:50:00,-618.47,233509.6100000041,236917.46000000404,-3407.8499999999476
29627,2022-10-02 10:55:00,-1029.81,232479.8000000041,236917.46000000404,-4437.659999999945
29628,2022-10-02 11:00:00,1690.3,234170.10000000408,236917.46000000404,-2747.359999999957
29629,2022-10-02 11:05:00,-679.96,233490.1400000041,236917.46000000404,-3427.319999999949
29630,2022-10-02 11:10:00,80.42,233570.5600000041,236917.46000000404,-3346.899999999936
29631,2022-10-02 11:15:00,-690.01,232880.5500000041,236917.46000000404,-4036.9099999999453
29632,2022-10-02 11:20:00,1408.6,234289.1500000041,236917.46000000404,-2628.3099999999395
29633,2022-10-02 11:25:00,-1023.98,233265.1700000041,236917.46000000404,-3652.28999999995
29634,2022-10-02 11:30:00,168.82,233433.9900000041,236917.46000000404,-3483.469999999943
29635,2022-10-02 11:35:00,645.53,234079.5200000041,236917.46000000404,-2837.939999999944
29636,2022-10-02 11:40:00,1751.17,235830.6900000041,236917.46000000404,-1086.7699999999313
29637,2022-10-02 11:45:00,115.66,235946.3500000041,236917.46000000404,-971.1099999999278
29638,2022-10-02 11:50:00,571.4,236517.7500000041,236917.46000000404,-399.70999999993364
29639,2022-10-02 11:55:00,870.92,237388.67000000412,236917.46000000404,471.21000000007916
29640,2022-10-02 12:00:00,-1317.15,236071.52000000412,236917.46000000404,-845.939999999915
29641,2022-10-02 12:05:00,-1853.56,234217.96000000412,236917.46000000404,-2699.4999999999127
29642,2022-10-02 12:10:00,-312.07,233905.89000000412,236917.46000000404,-3011.5699999999197
29643,2022-10-02 12:15:00,1114.63,235020.52000000412,236917.46000000404,-1896.939999999915
29644,2022-10-02 12:20:00,387.29,235407.81000000413,236917.46000000404,-1509.6499999999069
29645,2022-10-02 12:25:00,595.25,236003.06000000413,236917.46000000404,-914.3999999999069
29646,2022-10-02 12:30:00,-1383.04,234620.02000000412,236917.46000000404,-2297.439999999915
29647,2022-10-02 12:35:00,-788.7,233831.3200000041,236917.46000000404,-3086.1399999999267
29648,2022-10-02 12:40:00,-1953.65,231877.67000000412,236917.46000000404,-5039.789999999921
29649,2022-10-02 12:45:00,-1098.49,230779.18000000413,236917.46000000404,-6138.2799999999115
29650,2022-10-02 12:50:00,8.46,230787.64000000412,236917.46000000404,-6129.81999999992
29651,2022-10-02 12:55:00,-1247.13,229540.5100000041,236917.46000000404,-7376.949999999924
29652,2022-10-02 13:00:00,-1069.06,228471.45000000412,236917.46000000404,-8446.009999999922
29653,2022-10-02 13:05:00,-432.36,228039.09000000413,236917.46000000404,-8878.369999999908
29654,2022-10-02 13:10:00,-441.6,227597.49000000412,236917.46000000404,-9319.969999999914
29655,2022-10-02 13:15:00,1469.73,229067.22000000413,236917.46000000404,-7850.239999999903
29656,2022-10-02 13:20:00,799.98,229867.20000000414,236917.46000000404,-7050.259999999893
29657,2022-10-02 13:25:00,-1981.2,227886.00000000413,236917.46000000404,-9031.459999999905
29658,2022-10-02 13:30:00,1044.54,228930.54000000414,236917.46000000404,-7986.919999999896
29659,2022-10-02 13:35:00,1666.38,230596.92000000415,236917.46000000404,-6320.539999999892
29660,2022-10-02 13:40:00,713.03,231309.95000000414,236917.46000000404,-5607.509999999893
29661,2022-10-02 13:45:00,-1827.26,229482.69000000414,236917.46000000404,-7434.769999999902
29662,2022-10-02 13:50:00,1308.21,230790.90000000413,236917.46000000404,-6126.55999999991
29663,2022-10-02 13:55:00,1074.84,231865.74000000412,236917.46000000404,-5051.719999999914
29664,2022-10-02 14:00:00,-1468.31,230397.43000000413,236917.46000000404,-6520.0299999999115
29665,2022-10-02 14:05:00,-1301.15,229096.28000000413,236917.46000000404,-7821.179999999906
29666,2022-10-02 14:10:00,367.85,229464.13000000414,236917.46000000404,-7453.3299999999
29667,2022-10-02 14:15:00,-1786.31,227677.82000000414,236917.46000000404,-9239.639999999898
29668,2022-10-02 14:20:00,-673.76,227004.06000000413,236917.46000000404,-9913.399999999907
29669,2022-10-02 14:25:00,79.47,227083.53000000413,236917.46000000404,-9833.929999999906
29670,2022-10-02 14:30:00,190.11,227273.64000000412,236917.46000000404,-9643.81999999992
29671,2022-10-02 14:35:00,-1951.54,225322.1000000041,236917.46000000404,-11595.359999999928
29672,2022-10-02 14:40:00,-1520.22,223801.8800000041,236917.46000000404,-13115.579999999929
29673,2022-10-02 14:45:00,-1229.77,222572.11000000412,236917.46000000404,-14345.349999999919
29674,2022-10-02 14:50:00,921.99,223494.1000000041,236917.46000000404,-13423.359999999928
29675,2022-10-02 14:55:00,133.32,223627.42000000412,236917.46000000404,-13290.03999999992
29676,2022-10-02 15:00:00,-1540.98,222086.4400000041,236917.46000000404,-14831.019999999931
29677,2022-10-02 15:05:00,-1378.34,220708.1000000041,236917.46000000404,-16209.359999999928
29678,2022-10-02 15:10:00,-1649.86,219058.24000000412,236917.46000000404,-17859.219999999914
29679,2022-10-02 15:15:00,863.75,219921.99000000412,236917.46000000404,-16995.469999999914
29680,2022-10-02 15:20:00,-1403.78,218518.21000000412,236917.46000000404,-18399.249999999913
29681,2022-10-02 15:25:00,1015.82,219534.03000000413,236917.46000000404,-17383.429999999906
29682,2022-10-02 15:30:00,1319.41,220853.44000000414,236917.46000000404,-16064.019999999902
29683,2022-10-02 15:35:00,313.55,221166.99000000412,236917.46000000404,-15750.469999999914
29684,2022-10-02 15:40:00,-1372.35,219794.64000000412,236917.46000000404,-17122.81999999992
29685,2022-10-02 15:45:00,-745.54,219049.1000000041,236917.46000000404,-17868.359999999928
29686,2022-10-02 15:50:00,-539.31,218509.7900000041,236917.46000000404,-18407.669999999925
29687,2022-10-02 15:55:00,745.9,219255.6900000041,236917.46000000404,-17661.76999999993
29688,2022-10-02 16:00:00,-423.32,218832.3700000041,236917.46000000404,-18085.08999999994
29689,2022-10-02 16:05:00,1394.32,220226.6900000041,236917.46000000404,-16690.76999999993
29690,2022-10-02 16:10:00,1597.6,221824.2900000041,236917.46000000404,-15093.169999999925
29691,2022-10-02 16:15:00,1307.45,223131.74000000412,236917.46000000404,-13785.719999999914
29692,2022-10-02 16:20:00,-1463.06,221668.68000000413,236917.46000000404,-15248.779999999912
29693,2022-10-02 16:25:00,509.78,222178.46000000412,236917.46000000404,-14738.999999999913
29694,2022-10-02 16:30:00,1484.34,223662.80000000412,236917.46000000404,-13254.659999999916
29695,2022-10-02 16:35:00,646.03,224308.83000000412,236917.46000000404,-12608.629999999917
29696,2022-10-02 16:40:00,1898.21,226207.0400000041,236917.46000000404,-10710.419999999925
29697,2022-10-02 16:45:00,-1094.27,225112.77000000412,236917.46000000404,-11804.689999999915
29698,2022-10-02 16:50:00,-1765.57,223347.20000000412,236917.46000000404,-13570.259999999922
29699,2022-10-02 16:55:00,1081.47,224428.67000000412,236917.46000000404,-12488.78999999992
29700,2022-10-03 08:00:00,1828.77,226257.4400000041,224428.67000000412,1828.7699999999895
29701,2022-10-03 08:05:00,1189.57,227447.0100000041,224428.67000000412,3018.3399999999965
29702,2022-10-03 08:10:00,-696.97,226750.0400000041,224428.67000000412,2321.3699999999953
29703,2022-10-03 08:15:00,-1444.25,225305.7900000041,224428.67000000412,877.1199999999953
29704,2022-10-03 08:20:00,79.77,225385.5600000041,224428.67000000412,956.8899999999849
29705,2022-10-03 08:25:00,591.59,225977.1500000041,224428.67000000412,1548.4799999999814
29706,2022-10-03 08:30:00,-200.69,225776.4600000041,224428.67000000412,1347.789999999979
29707,2022-10-03 08:35:00,1028.53,226804.9900000041,224428.67000000412,2376.319999999978
29708,2022-10-03 08:40:00,-1814.01,224990.98000000409,224428.67000000412,562.3099999999686
29709,2022-10-03 08:45:00,1516.6,226507.5800000041,224428.67000000412,2078.9099999999744
29710,2022-10-03 08:50:00,729.86,227237.44000000408,224428.67000000412,2808.7699999999604
29711,2022-10-03 08:55:00,-764.95,226472.49000000407,224428.67000000412,2043.8199999999488
29712,2022-10-03 09:00:00,-401.07,226071.42000000406,224428.67000000412,1642.7499999999418
29713,2022-10-03 09:05:00,1672.41,227743.83000000406,224428.67000000412,3315.1599999999453
29714,2022-10-03 09:10:00,1882.41,229626.24000000407,224428.67000000412,5197.569999999949
29715,2022-10-03 09:15:00,1295.72,230921.96000000407,224428.67000000412,6493.28999999995
29716,2022-10-03 09:20:00,-34.48,230887.48000000406,224428.67000000412,6458.8099999999395
29717,2022-10-03 09:25:00,-503.45,230384.03000000404,224428.67000000412,5955.359999999928
29718,2022-10-03 09:30:00,-969.36,229414.67000000406,224428.67000000412,4985.999999999942
29719,2022-10-03 09:35:00,105.83,229520.50000000405,224428.67000000412,5091.829999999929
29720,2022-10-03 09:40:00,1837.0,231357.50000000405,224428.67000000412,6928.829999999929
29721,2022-10-03 09:45:00,158.64,231516.14000000406,224428.67000000412,7087.469999999943
29722,2022-10-03 09:50:00,-692.93,230823.21000000407,224428.67000000412,6394.53999999995
29723,2022-10-03 09:55:00,-707.36,230115.85000000408,224428.67000000412,5687.179999999964
29724,2022-10-03 10:00:00,105.82,230221.6700000041,224428.67000000412,5792.999999999971
29725,2022-10-03 10:05:00,-1130.07,229091.60000000408,224428.67000000412,4662.929999999964
29726,2022-10-03 10:10:00,180.15,229271.75000000407,224428.67000000412,4843.079999999958
29727,2022-10-03 10:15:00,685.23,229956.98000000409,224428.67000000412,5528.309999999969
29728,2022-10-03 10:20:00,-954.69,229002.29000000408,224428.67000000412,4573.619999999966
29729,2022-10-03 10:25:00,-1380.56,227621.73000000409,224428.67000000412,3193.0599999999686
29730,2022-10-03 10:30:00,1914.36,229536.09000000407,224428.67000000412,5107.419999999955
29731,2022-10-03 10:35:00,906.46,230442.55000000406,224428.67000000412,6013.879999999946
29732,2022-10-03 10:40:00,1639.85,232082.40000000407,224428.67000000412,7653.729999999952
29733,2022-10-03 10:45:00,-1254.03,230828.37000000407,224428.67000000412,6399.699999999953
29734,2022-10-03 10:50:00,-603.03,230225.34000000407,224428.67000000412,5796.669999999955
29735,2022-10-03 10:55:00,-1713.01,228512.33000000406,224428.67000000412,4083.6599999999453
29736,2022-10-03 11:00:00,-1518.51,226993.82000000405,224428.67000000412,2565.149999999936
29737,2022-10-03 11:05:00,1981.75,228975.57000000405,224428.67000000412,4546.899999999936
29738,2022-10-03 11:10:00,1514.53,230490.10000000405,224428.67000000412,6061.429999999935
29739,2022-10-03 11:15:00,-1979.35,228510.75000000405,224428.67000000412,4082.079999999929
29740,2022-10-03 11:20:00,1422.53,229933.28000000404,224428.67000000412,5504.609999999928
29741,2022-10-03 11:25:00,-395.31,229537.97000000405,224428.67000000412,5109.29999999993
29742,2022-10-03 11:30:00,1396.84,230934.81000000404,224428.67000000412,6506.139999999927
29743,2022-10-03 11:35:00,-555.66,230379.15000000404,224428.67000000412,5950.479999999923
29744,2022-10-03 11:40:00,1198.1,231577.25000000405,224428.67000000412,7148.579999999929
29745,2022-10-03 11:45:00,-17.94,231559.31000000404,224428.67000000412,7130.639999999927
29746,2022-10-03 11:50:00,-1121.8,230437.51000000405,224428.67000000412,6008.839999999938
29747,2022-10-03 11:55:00,1348.05,231785.56000000404,224428.67000000412,7356.889999999927
29748,2022-10-03 12:00:00,1701.17,233486.73000000406,224428.67000000412,9058.05999999994
29749,2022-10-03 12:05:00,-415.91,233070.82000000405,224428.67000000412,8642.149999999936
29750,2022-10-03 12:10:00,63.12,233133.94000000405,224428.67000000412,8705.269999999931
29751,2022-10-03 12:15:00,236.37,233370.31000000404,224428.67000000412,8941.639999999927
29752,2022-10-03 12:20:00,1990.12,235360.43000000404,224428.67000000412,10931.759999999922
29753,2022-10-03 12:25:00,1447.25,236807.68000000404,224428.67000000412,12379.009999999922
29754,2022-10-03 12:30:00,524.52,237332.20000000403,224428.67000000412,12903.529999999912
29755,2022-10-03 12:35:00,507.71,237839.91000000402,224428.67000000412,13411.239999999903
29756,2022-10-03 12:40:00,-420.28,237419.63000000402,224428.67000000412,12990.959999999905
29757,2022-10-03 12:45:00,387.69,237807.32000000402,224428.67000000412,13378.649999999907
29758,2022-10-03 12:50:00,-687.93,237119.39000000403,224428.67000000412,12690.719999999914
29759,2022-10-03 12:55:00,592.55,237711.94000000402,224428.67000000412,13283.269999999902
29760,2022-10-03 13:00:00,890.4,238602.340000004,224428.67000000412,14173.669999999896
29761,2022-10-03 13:05:00,-1828.39,236773.950000004,224428.67000000412,12345.279999999882
29762,2022-10-03 13:10:00,779.33,237553.280000004,224428.67000000412,13124.60999999987
29763,2022-10-03 13:15:00,1890.83,239444.11000000397,224428.67000000412,15015.439999999857
29764,2022-10-03 13:20:00,-436.16,239007.95000000397,224428.67000000412,14579.279999999853
29765,2022-10-03 13:25:00,809.88,239817.83000000397,224428.67000000412,15389.159999999858
29766,2022-10-03 13:30:00,-1057.17,238760.66000000396,224428.67000000412,14331.989999999845
29767,2022-10-03 13:35:00,830.77,239591.43000000395,224428.67000000412,15162.759999999835
29768,2022-10-03 13:40:00,1748.88,241340.31000000396,224428.67000000412,16911.63999999984
29769,2022-10-03 13:45:00,352.04,241692.35000000396,224428.67000000412,17263.679999999847
29770,2022-10-03 13:50:00,340.51,242032.86000000397,224428.67000000412,17604.189999999857
29771,2022-10-03 13:55:00,1191.59,243224.45000000397,224428.67000000412,18795.779999999853
29772,2022-10-03 14:00:00,330.34,243554.79000000397,224428.67000000412,19126.11999999985
29773,2022-10-03 14:05:00,1567.29,245122.08000000397,224428.67000000412,20693.409999999858
29774,2022-10-03 14:10:00,-1067.96,244054.12000000398,224428.67000000412,19625.449999999866
29775,2022-10-03 14:15:00,938.82,244992.940000004,224428.67000000412,20564.269999999873
29776,2022-10-03 14:20:00,-586.39,244406.55000000398,224428.67000000412,19977.87999999986
29777,2022-10-03 14:25:00,1107.96,245514.51000000397,224428.67000000412,21085.83999999985
29778,2022-10-03 14:30:00,1122.4,246636.91000000396,224428.67000000412,22208.239999999845
29779,2022-10-03 14:35:00,-1490.3,245146.61000000397,224428.67000000412,20717.939999999857
29780,2022-10-03 14:40:00,-57.87,245088.74000000398,224428.67000000412,20660.06999999986
29781,2022-10-03 14:45:00,884.78,245973.52000000398,224428.67000000412,21544.84999999986
29782,2022-10-03 14:50:00,1712.1,247685.62000000398,224428.67000000412,23256.949999999866
29783,2022-10-03 14:55:00,-481.27,247204.350000004,224428.67000000412,22775.679999999877
29784,2022-10-03 15:00:00,-726.66,246477.690000004,224428.67000000412,22049.019999999873
29785,2022-10-03 15:05:00,-1381.02,245096.670000004,224428.67000000412,20667.999999999884
29786,2022-10-03 15:10:00,-887.03,244209.640000004,224428.67000000412,19780.969999999885
29787,2022-10-03 15:15:00,1945.25,246154.890000004,224428.67000000412,21726.219999999885
29788,2022-10-03 15:20:00,-354.41,245800.480000004,224428.67000000412,21371.80999999988
29789,2022-10-03 15:25:00,1098.79,246899.270000004,224428.67000000412,22470.59999999989
29790,2022-10-03 15:30:00,580.8,247480.070000004,224428.67000000412,23051.399999999878
29791,2022-10-03 15:35:00,1523.92,249003.990000004,224428.67000000412,24575.31999999989
29792,2022-10-03 15:40:00,-1268.34,247735.650000004,224428.67000000412,23306.979999999894
29793,2022-10-03 15:45:00,-856.62,246879.03000000402,224428.67000000412,22450.3599999999
29794,2022-10-03 15:50:00,92.08,246971.110000004,224428.67000000412,22542.439999999886
29795,2022-10-03 15:55:00,958.2,247929.310000004,224428.67000000412,23500.639999999898
29796,2022-10-03 16:00:00,1013.18,248942.490000004,224428.67000000412,24513.81999999989
29797,2022-10-03 16:05:00,1128.94,250071.430000004,224428.67000000412,25642.759999999893
29798,2022-10-03 16:10:00,1268.76,251340.19000000402,224428.67000000412,26911.519999999902
29799,2022-10-03 16:15:00,590.84,251931.03000000402,224428.67000000412,27502.3599999999
29800,2022-10-03 16:20:00,-787.53,251143.50000000402,224428.67000000412,26714.8299999999
29801,2022-10-03 16:25:00,-494.74,250648.76000000403,224428.67000000412,26220.08999999991
29802,2022-10-03 16:30:00,566.79,251215.55000000403,224428.67000000412,26786.879999999917
29803,2022-10-03 16:35:00,1411.16,252626.71000000404,224428.67000000412,28198.03999999992
29804,2022-10-03 16:40:00,-1577.93,251048.78000000404,224428.67000000412,26620.109999999928
29805,2022-10-03 16:45:00,854.73,251903.51000000405,224428.67000000412,27474.83999999994
29806,2022-10-03 16:50:00,784.38,252687.89000000406,224428.67000000412,28259.219999999943
29807,2022-10-03 16:55:00,-996.42,251691.47000000405,224428.67000000412,27262.79999999993
29808,2022-10-04 08:00:00,-80.29,251611.18000000404,251691.47000000405,-80.29000000000815
29809,2022-10-04 08:05:00,15.49,251626.67000000403,251691.47000000405,-64.80000000001746
29810,2022-10-04 08:10:00,980.78,252607.45000000403,251691.47000000405,915.9799999999814
29811,2022-10-04 08:15:00,1811.88,254419.33000000403,251691.47000000405,2727.859999999986
29812,2022-10-04 08:20:00,-1864.75,252554.58000000403,251691.47000000405,863.109999999986
29813,2022-10-04 08:25:00,1813.63,254368.21000000404,251691.47000000405,2676.7399999999907
29814,2022-10-04 08:30:00,1919.71,256287.92000000403,251691.47000000405,4596.4499999999825
29815,2022-10-04 08:35:00,384.65,256672.57000000402,251691.47000000405,4981.099999999977
29816,2022-10-04 08:40:00,494.16,257166.73000000403,251691.47000000405,5475.25999999998
29817,2022-10-04 08:45:00,-238.87,256927.86000000403,251691.47000000405,5236.389999999985
29818,2022-10-04 08:50:00,-175.81,256752.05000000403,251691.47000000405,5060.579999999987
29819,2022-10-04 08:55:00,-1285.11,255466.94000000405,251691.47000000405,3775.470000000001
29820,2022-10-04 09:00:00,-1581.26,253885.68000000404,251691.47000000405,2194.209999999992
29821,2022-10-04 09:05:00,-1520.67,252365.01000000403,251691.47000000405,673.539999999979
29822,2022-10-04 09:10:00,1647.06,254012.07000000402,251691.47000000405,2320.5999999999767
29823,2022-10-04 09:15:00,1097.83,255109.900000004,251691.47000000405,3418.429999999964
29824,2022-10-04 09:20:00,-980.38,254129.520000004,251691.47000000405,2438.0499999999593
29825,2022-10-04 09:25:00,-1265.29,252864.230000004,251691.47000000405,1172.759999999951
29826,2022-10-04 09:30:00,-393.48,252470.750000004,251691.47000000405,779.2799999999406
29827,2022-10-04 09:35:00,-922.09,251548.660000004,251691.47000000405,-142.81000000005588
29828,2022-10-04 09:40:00,-1237.86,250310.800000004,251691.47000000405,-1380.670000000042
29829,2022-10-04 09:45:00,1937.56,252248.360000004,251691.47000000405,556.8899999999558
29830,2022-10-04 09:50:00,1579.35,253827.710000004,251691.47000000405,2136.2399999999616
29831,2022-10-04 09:55:00,-1395.89,252431.820000004,251691.47000000405,740.3499999999476
29832,2022-10-04 10:00:00,1503.96,253935.780000004,251691.47000000405,2244.3099999999395
29833,2022-10-04 10:05:00,1290.51,255226.290000004,251691.47000000405,3534.819999999949
29834,2022-10-04 10:10:00,-1090.99,254135.300000004,251691.47000000405,2443.829999999958
29835,2022-10-04 10:15:00,799.59,254934.890000004,251691.47000000405,3243.4199999999546
29836,2022-10-04 10:20:00,441.77,255376.660000004,251691.47000000405,3685.189999999944
29837,2022-10-04 10:25:00,-332.05,255044.610000004,251691.47000000405,3353.1399999999558
29838,2022-10-04 10:30:00,-1743.39,253301.220000004,251691.47000000405,1609.7499999999418
29839,2022-10-04 10:35:00,-686.65,252614.570000004,251691.47000000405,923.0999999999476
29840,2022-10-04 10:40:00,-108.97,252505.600000004,251691.47000000405,814.1299999999464
29841,2022-10-04 10:45:00,-164.73,252340.87000000398,251691.47000000405,649.399999999936
29842,2022-10-04 10:50:00,732.09,253072.96000000398,251691.47000000405,1381.4899999999325
29843,2022-10-04 10:55:00,1906.4,254979.36000000397,251691.47000000405,3287.8899999999267
29844,2022-10-04 11:00:00,1451.89,256431.250000004,251691.47000000405,4739.779999999941
29845,2022-10-04 11:05:00,580.47,257011.720000004,251691.47000000405,5320.249999999942
29846,2022-10-04 11:10:00,-418.56,256593.160000004,251691.47000000405,4901.689999999944
29847,2022-10-04 11:15:00,-1192.96,255400.200000004,251691.47000000405,3708.7299999999523
29848,2022-10-04 11:20:00,202.94,255603.140000004,251691.47000000405,3911.6699999999546
29849,2022-10-04 11:25:00,-807.88,254795.260000004,251691.47000000405,3103.78999999995
29850,2022-10-04 11:30:00,-310.89,254484.37000000398,251691.47000000405,2792.899999999936
29851,2022-10-04 11:35:00,-645.01,253839.36000000397,251691.47000000405,2147.8899999999267
29852,2022-10-04 11:40:00,-1949.65,251889.71000000398,251691.47000000405,198.23999999993248
29853,2022-10-04 11:45:00,-1687.98,250201.73000000397,251691.47000000405,-1489.740000000078
29854,2022-10-04 11:50:00,-1286.98,248914.75000000396,251691.47000000405,-2776.7200000000885
29855,2022-10-04 11:55:00,986.29,249901.04000000397,251691.47000000405,-1790.4300000000803
29856,2022-10-04 12:00:00,1304.83,251205.87000000395,251691.47000000405,-485.60000000009313
29857,2022-10-04 12:05:00,-769.31,250436.56000000396,251691.47000000405,-1254.9100000000908
29858,2022-10-04 12:10:00,1708.81,252145.37000000395,251691.47000000405,453.89999999990687
29859,2022-10-04 12:15:00,1058.92,253204.29000000397,251691.47000000405,1512.8199999999197
29860,2022-10-04 12:20:00,-478.71,252725.58000000397,251691.47000000405,1034.1099999999278
29861,2022-10-04 12:25:00,472.66,253198.24000000398,251691.47000000405,1506.7699999999313
29862,2022-10-04 12:30:00,34.97,253233.21000000398,251691.47000000405,1541.7399999999325
29863,2022-10-04 12:35:00,-532.69,252700.52000000398,251691.47000000405,1009.0499999999302
29864,2022-10-04 12:40:00,-1289.62,251410.90000000398,251691.47000000405,-280.5700000000652
29865,2022-10-04 12:45:00,-320.08,251090.820000004,251691.47000000405,-600.6500000000524
29866,2022-10-04 12:50:00,181.77,251272.59000000398,251691.47000000405,-418.88000000006286
29867,2022-10-04 12:55:00,136.46,251409.05000000398,251691.47000000405,-282.420000000071
29868,2022-10-04 13:00:00,-1139.86,250269.190000004,251691.47000000405,-1422.280000000057
29869,2022-10-04 13:05:00,1306.96,251576.15000000398,251691.47000000405,-115.32000000006519
29870,2022-10-04 13:10:00,1833.65,253409.80000000398,251691.47000000405,1718.329999999929
29871,2022-10-04 13:15:00,-107.94,253301.86000000397,251691.47000000405,1610.3899999999267
29872,2022-10-04 13:20:00,-1714.74,251587.12000000398,251691.47000000405,-104.35000000006403
29873,2022-10-04 13:25:00,1701.64,253288.760000004,251691.47000000405,1597.28999999995
29874,2022-10-04 13:30:00,1615.74,254904.500000004,251691.47000000405,3213.0299999999406
29875,2022-10-04 13:35:00,1840.93,256745.43000000398,251691.47000000405,5053.959999999934
29876,2022-10-04 13:40:00,688.07,257433.500000004,251691.47000000405,5742.029999999941
29877,2022-10-04 13:45:00,-734.32,256699.18000000398,251691.47000000405,5007.709999999934
29878,2022-10-04 13:50:00,-1817.27,254881.910000004,251691.47000000405,3190.439999999944
29879,2022-10-04 13:55:00,-1806.8,253075.110000004,251691.47000000405,1383.6399999999558
29880,2022-10-04 14:00:00,1351.13,254426.240000004,251691.47000000405,2734.7699999999604
29881,2022-10-04 14:05:00,1244.69,255670.930000004,251691.47000000405,3979.4599999999627
29882,2022-10-04 14:10:00,1103.34,256774.270000004,251691.47000000405,5082.799999999959
29883,2022-10-04 14:15:00,58.96,256833.230000004,251691.47000000405,5141.759999999951
29884,2022-10-04 14:20:00,-1945.74,254887.490000004,251691.47000000405,3196.0199999999604
29885,2022-10-04 14:25:00,1567.75,256455.240000004,251691.47000000405,4763.76999999996
29886,2022-10-04 14:30:00,1519.76,257975.00000000402,251691.47000000405,6283.52999999997
29887,2022-10-04 14:35:00,122.21,258097.210000004,251691.47000000405,6405.739999999962
29888,2022-10-04 14:40:00,273.97,258371.180000004,251691.47000000405,6679.709999999963
29889,2022-10-04 14:45:00,766.05,259137.230000004,251691.47000000405,7445.759999999951
29890,2022-10-04 14:50:00,-1166.15,257971.080000004,251691.47000000405,6279.609999999957
29891,2022-10-04 14:55:00,227.02,258198.100000004,251691.47000000405,6506.629999999946
29892,2022-10-04 15:00:00,-756.71,257441.390000004,251691.47000000405,5749.919999999955
29893,2022-10-04 15:05:00,-594.84,256846.550000004,251691.47000000405,5155.079999999958
29894,2022-10-04 15:10:00,-1811.23,255035.320000004,251691.47000000405,3343.8499999999476
29895,2022-10-04 15:15:00,1362.21,256397.530000004,251691.47000000405,4706.0599999999395
29896,2022-10-04 15:20:00,1413.84,257811.37000000398,251691.47000000405,6119.899999999936
29897,2022-10-04 15:25:00,106.95,257918.320000004,251691.47000000405,6226.849999999948
29898,2022-10-04 15:30:00,1657.83,259576.15000000398,251691.47000000405,7884.679999999935
29899,2022-10-04 15:35:00,4.0,259580.15000000398,251691.47000000405,7888.679999999935
29900,2022-10-04 15:40:00,1844.37,261424.52000000398,251691.47000000405,9733.04999999993
29901,2022-10-04 15:45:00,1916.7,263341.220000004,251691.47000000405,11649.749999999942
29902,2022-10-04 15:50:00,-1489.09,261852.130000004,251691.47000000405,10160.659999999945
29903,2022-10-04 15:55:00,-654.07,261198.06000000398,251691.47000000405,9506.589999999938
29904,2022-10-04 16:00:00,-327.39,260870.67000000397,251691.47000000405,9179.199999999924
29905,2022-10-04 16:05:00,1120.56,261991.23000000397,251691.47000000405,10299.759999999922
29906,2022-10-04 16:10:00,-1571.45,260419.78000000396,251691.47000000405,8728.30999999991
29907,2022-10-04 16:15:00,-1172.95,259246.83000000395,251691.47000000405,7555.359999999899
29908,2022-10-04 16:20:00,1005.81,260252.64000000394,251691.47000000405,8561.169999999896
29909,2022-10-04 16:25:00,-720.62,259532.02000000395,251691.47000000405,7840.549999999901
29910,2022-10-04 16:30:00,61.52,259593.54000000394,251691.47000000405,7902.069999999891
29911,2022-10-04 16:35:00,-569.13,259024.41000000393,251691.47000000405,7332.939999999886
29912,2022-10-04 16:40:00,-391.19,258633.22000000393,251691.47000000405,6941.749999999884
29913,2022-10-04 16:45:00,-371.31,258261.91000000393,251691.47000000405,6570.439999999886
29914,2022-10-04 16:50:00,-1738.43,256523.48000000394,251691.47000000405,4832.009999999893
29915,2022-10-04 16:55:00,478.46,257001.94000000393,251691.47000000405,5310.469999999885
29916,2022-10-05 08:00:00,551.08,257553.02000000392,257001.94000000393,551.0799999999872
29917,2022-10-05 08:05:00,644.46,258197.4800000039,257001.94000000393,1195.539999999979
29918,2022-10-05 08:10:00,-1340.91,256856.5700000039,257001.94000000393,-145.37000000002445
29919,2022-10-05 08:15:00,692.09,257548.6600000039,257001.94000000393,546.7199999999721
29920,2022-10-05 08:20:00,1709.3,259257.9600000039,257001.94000000393,2256.0199999999604
29921,2022-10-05 08:25:00,942.9,260200.8600000039,257001.94000000393,3198.9199999999546
29922,2022-10-05 08:30:00,800.33,261001.19000000387,257001.94000000393,3999.249999999942
29923,2022-10-05 08:35:00,806.08,261807.27000000386,257001.94000000393,4805.329999999929
29924,2022-10-05 08:40:00,42.23,261849.50000000387,257001.94000000393,4847.5599999999395
29925,2022-10-05 08:45:00,1419.63,263269.13000000385,257001.94000000393,6267.189999999915
29926,2022-10-05 08:50:00,319.37,263588.50000000384,257001.94000000393,6586.55999999991
29927,2022-10-05 08:55:00,-1003.73,262584.77000000386,257001.94000000393,5582.829999999929
29928,2022-10-05 09:00:00,-415.72,262169.0500000039,257001.94000000393,5167.109999999957
29929,2022-10-05 09:05:00,-1150.82,261018.23000000388,257001.94000000393,4016.28999999995
29930,2022-10-05 09:10:00,1239.44,262257.6700000039,257001.94000000393,5255.729999999952
29931,2022-10-05 09:15:00,161.34,262419.0100000039,257001.94000000393,5417.069999999978
29932,2022-10-05 09:20:00,1292.26,263711.2700000039,257001.94000000393,6709.329999999987
29933,2022-10-05 09:25:00,1322.63,265033.9000000039,257001.94000000393,8031.959999999992
29934,2022-10-05 09:30:00,-482.42,264551.48000000394,257001.94000000393,7549.540000000008
29935,2022-10-05 09:35:00,1986.89,266538.37000000395,257001.94000000393,9536.430000000022
29936,2022-10-05 09:40:00,1881.78,268420.150000004,257001.94000000393,11418.21000000005
29937,2022-10-05 09:45:00,-1442.23,266977.920000004,257001.94000000393,9975.980000000069
29938,2022-10-05 09:50:00,1413.12,268391.040000004,257001.94000000393,11389.100000000064
29939,2022-10-05 09:55:00,-1827.93,266563.110000004,257001.94000000393,9561.170000000071
29940,2022-10-05 10:00:00,-1243.06,265320.050000004,257001.94000000393,8318.110000000073
29941,2022-10-05 10:05:00,1203.78,266523.83000000403,257001.94000000393,9521.890000000101
29942,2022-10-05 10:10:00,-1526.22,264997.61000000406,257001.94000000393,7995.670000000129
29943,2022-10-05 10:15:00,670.43,265668.04000000405,257001.94000000393,8666.100000000122
29944,2022-10-05 10:20:00,1323.6,266991.64000000403,257001.94000000393,9989.700000000099
29945,2022-10-05 10:25:00,625.2,267616.84000000404,257001.94000000393,10614.90000000011
29946,2022-10-05 10:30:00,-990.12,266626.72000000405,257001.94000000393,9624.780000000115
29947,2022-10-05 10:35:00,752.56,267379.28000000404,257001.94000000393,10377.340000000113
29948,2022-10-05 10:40:00,1520.78,268900.0600000041,257001.94000000393,11898.12000000014
29949,2022-10-05 10:45:00,1064.87,269964.93000000407,257001.94000000393,12962.990000000136
29950,2022-10-05 10:50:00,-401.73,269563.2000000041,257001.94000000393,12561.260000000155
29951,2022-10-05 10:55:00,-871.57,268691.6300000041,257001.94000000393,11689.690000000148
29952,2022-10-05 11:00:00,754.4,269446.0300000041,257001.94000000393,12444.090000000171
29953,2022-10-05 11:05:00,-978.84,268467.1900000041,257001.94000000393,11465.250000000146
29954,2022-10-05 11:10:00,-1709.16,266758.0300000041,257001.94000000393,9756.090000000171
29955,2022-10-05 11:15:00,205.88,266963.9100000041,257001.94000000393,9961.970000000176
29956,2022-10-05 11:20:00,-806.17,266157.7400000041,257001.94000000393,9155.800000000192
29957,2022-10-05 11:25:00,1733.29,267891.0300000041,257001.94000000393,10889.090000000171
29958,2022-10-05 11:30:00,-617.3,267273.7300000041,257001.94000000393,10271.790000000183
29959,2022-10-05 11:35:00,526.19,267799.9200000041,257001.94000000393,10797.980000000185
29960,2022-10-05 11:40:00,199.89,267999.81000000413,257001.94000000393,10997.870000000199
29961,2022-10-05 11:45:00,-723.33,267276.4800000041,257001.94000000393,10274.540000000183
29962,2022-10-05 11:50:00,-1826.97,265449.51000000414,257001.94000000393,8447.57000000021
29963,2022-10-05 11:55:00,1217.06,266666.57000000414,257001.94000000393,9664.630000000208
29964,2022-10-05 12:00:00,1336.64,268003.21000000415,257001.94000000393,11001.270000000222
29965,2022-10-05 12:05:00,-1401.66,266601.5500000042,257001.94000000393,9599.610000000248
29966,2022-10-05 12:10:00,-68.18,266533.3700000042,257001.94000000393,9531.430000000255
29967,2022-10-05 12:15:00,727.02,267260.3900000042,257001.94000000393,10258.450000000274
29968,2022-10-05 12:20:00,-691.22,266569.17000000423,257001.94000000393,9567.230000000302
29969,2022-10-05 12:25:00,1605.7,268174.87000000424,257001.94000000393,11172.930000000313
29970,2022-10-05 12:30:00,-147.79,268027.08000000427,257001.94000000393,11025.140000000334
29971,2022-10-05 12:35:00,644.39,268671.4700000043,257001.94000000393,11669.530000000348
29972,2022-10-05 12:40:00,-818.53,267852.94000000425,257001.94000000393,10851.00000000032
29973,2022-10-05 12:45:00,1781.96,269634.9000000043,257001.94000000393,12632.960000000341
29974,2022-10-05 12:50:00,387.21,270022.1100000043,257001.94000000393,13020.170000000362
29975,2022-10-05 12:55:00,115.03,270137.1400000043,257001.94000000393,13135.20000000039
29976,2022-10-05 13:00:00,-9.07,270128.0700000043,257001.94000000393,13126.130000000383
29977,2022-10-05 13:05:00,455.02,270583.09000000433,257001.94000000393,13581.150000000402
29978,2022-10-05 13:10:00,-1016.78,269566.3100000043,257001.94000000393,12564.370000000374
29979,2022-10-05 13:15:00,1450.88,271017.1900000043,257001.94000000393,14015.250000000378
29980,2022-10-05 13:20:00,-1509.54,269507.65000000433,257001.94000000393,12505.7100000004
29981,2022-10-05 13:25:00,-1709.64,267798.0100000043,257001.94000000393,10796.070000000385
29982,2022-10-05 13:30:00,679.4,268477.41000000434,257001.94000000393,11475.470000000409
29983,2022-10-05 13:35:00,-339.83,268137.5800000043,257001.94000000393,11135.640000000392
29984,2022-10-05 13:40:00,-184.49,267953.09000000433,257001.94000000393,10951.150000000402
29985,2022-10-05 13:45:00,1667.16,269620.2500000043,257001.94000000393,12618.310000000376
29986,2022-10-05 13:50:00,695.41,270315.6600000043,257001.94000000393,13313.72000000035
29987,2022-10-05 13:55:00,782.83,271098.4900000043,257001.94000000393,14096.550000000367
29988,2022-10-05 14:00:00,1627.07,272725.5600000043,257001.94000000393,15723.620000000374
29989,2022-10-05 14:05:00,1745.78,274471.34000000433,257001.94000000393,17469.4000000004
29990,2022-10-05 14:10:00,1352.95,275824.29000000434,257001.94000000393,18822.350000000413
29991,2022-10-05 14:15:00,1758.51,277582.80000000435,257001.94000000393,20580.860000000423
29992,2022-10-05 14:20:00,-1223.44,276359.36000000435,257001.94000000393,19357.42000000042
29993,2022-10-05 14:25:00,240.16,276599.5200000043,257001.94000000393,19597.580000000395
29994,2022-10-05 14:30:00,401.88,277001.40000000433,257001.94000000393,19999.4600000004
29995,2022-10-05 14:35:00,-805.17,276196.23000000435,257001.94000000393,19194.290000000416
29996,2022-10-05 14:40:00,1026.38,277222.61000000435,257001.94000000393,20220.67000000042
29997,2022-10-05 14:45:00,1402.49,278625.10000000434,257001.94000000393,21623.16000000041
29998,2022-10-05 14:50:00,1705.97,280331.0700000043,257001.94000000393,23329.130000000383
29999,2022-10-05 14:55:00,-74.05,280257.0200000043,257001.94000000393,23255.080000000395
30000,2022-10-05 15:00:00,-1980.79,278276.23000000435,257001.94000000393,21274.290000000416
30001,2022-10-05 15:05:00,125.46,278401.69000000437,257001.94000000393,21399.750000000437
30002,2022-10-05 15:10:00,-1489.03,276912.66000000434,257001.94000000393,19910.72000000041
30003,2022-10-05 15:15:00,1361.33,278273.99000000436,257001.94000000393,21272.050000000425
30004,2022-10-05 15:20:00,740.61,279014.60000000434,257001.94000000393,22012.66000000041
30005,2022-10-05 15:25:00,1247.91,280262.5100000043,257001.94000000393,23260.570000000385
30006,2022-10-05 15:30:00,1532.44,281794.9500000043,257001.94000000393,24793.010000000388
30007,2022-10-05 15:35:00,-571.0,281223.9500000043,257001.94000000393,24222.010000000388
30008,2022-10-05 15:40:00,1530.41,282754.3600000043,257001.94000000393,25752.420000000362
30009,2022-10-05 15:45:00,-19.1,282735.2600000043,257001.94000000393,25733.320000000385
30010,2022-10-05 15:50:00,-1104.59,281630.6700000043,257001.94000000393,24628.73000000036
30011,2022-10-05 15:55:00,1906.6,283537.27000000427,257001.94000000393,26535.330000000336
30012,2022-10-05 16:00:00,-376.23,283161.0400000043,257001.94000000393,26159.100000000355
30013,2022-10-05 16:05:00,1125.16,284286.20000000426,257001.94000000393,27284.26000000033
30014,2022-10-05 16:10:00,619.84,284906.0400000043,257001.94000000393,27904.100000000355
30015,2022-10-05 16:15:00,-250.13,284655.9100000043,257001.94000000393,27653.97000000035
30016,2022-10-05 16:20:00,849.14,285505.0500000043,257001.94000000393,28503.110000000364
30017,2022-10-05 16:25:00,-147.56,285357.4900000043,257001.94000000393,28355.550000000367
30018,2022-10-05 16:30:00,-601.72,284755.7700000043,257001.94000000393,27753.830000000395
30019,2022-10-05 16:35:00,-1037.2,283718.5700000043,257001.94000000393,26716.630000000383
30020,2022-10-05 16:40:00,1862.89,285581.4600000043,257001.94000000393,28579.520000000397
30021,2022-10-05 16:45:00,-1464.29,284117.17000000435,257001.94000000393,27115.230000000418
30022,2022-10-05 16:50:00,-868.89,283248.28000000434,257001.94000000393,26246.340000000404
30023,2022-10-05 16:55:00,-385.82,282862.4600000043,257001.94000000393,25860.520000000397
30024,2022-10-06 08:00:00,683.37,283545.8300000043,282862.4600000043,683.3699999999953
30025,2022-10-06 08:05:00,-1177.68,282368.15000000433,282862.4600000043,-494.3099999999977
30026,2022-10-06 08:10:00,1103.26,283471.41000000434,282862.4600000043,608.9500000000116
30027,2022-10-06 08:15:00,-1273.66,282197.75000000437,282862.4600000043,-664.7099999999627
30028,2022-10-06 08:20:00,1358.86,283556.61000000435,282862.4600000043,694.1500000000233
30029,2022-10-06 08:25:00,145.07,283701.68000000436,282862.4600000043,839.2200000000303
30030,2022-10-06 08:30:00,-377.85,283323.8300000044,282862.4600000043,461.37000000005355
30031,2022-10-06 08:35:00,865.05,284188.88000000437,282862.4600000043,1326.420000000042
30032,2022-10-06 08:40:00,-281.32,283907.56000000436,282862.4600000043,1045.100000000035
30033,2022-10-06 08:45:00,-1539.87,282367.69000000437,282862.4600000043,-494.7699999999604
30034,2022-10-06 08:50:00,1137.9,283505.5900000044,282862.4600000043,643.1300000000629
30035,2022-10-06 08:55:00,-825.69,282679.9000000044,282862.4600000043,-182.55999999993946
30036,2022-10-06 09:00:00,-992.86,281687.0400000044,282862.4600000043,-1175.4199999999255
30037,2022-10-06 09:05:00,-1302.34,280384.7000000044,282862.4600000043,-2477.759999999951
30038,2022-10-06 09:10:00,430.4,280815.1000000044,282862.4600000043,-2047.3599999999278
30039,2022-10-06 09:15:00,490.3,281305.4000000044,282862.4600000043,-1557.0599999999395
30040,2022-10-06 09:20:00,1052.81,282358.2100000044,282862.4600000043,-504.2499999999418
30041,2022-10-06 09:25:00,1915.46,284273.6700000044,282862.4600000043,1411.2100000000792
30042,2022-10-06 09:30:00,-1519.97,282753.70000000444,282862.4600000043,-108.7599999998929
30043,2022-10-06 09:35:00,1049.73,283803.4300000044,282862.4600000043,940.9700000000885
30044,2022-10-06 09:40:00,-1086.37,282717.0600000044,282862.4600000043,-145.39999999990687
30045,2022-10-06 09:45:00,-1481.5,281235.5600000044,282862.4600000043,-1626.8999999999069
30046,2022-10-06 09:50:00,-1982.18,279253.3800000044,282862.4600000043,-3609.0799999999
30047,2022-10-06 09:55:00,1916.63,281170.01000000443,282862.4600000043,-1692.4499999998952
30048,2022-10-06 10:00:00,-1676.78,279493.2300000044,282862.4600000043,-3369.229999999923
30049,2022-10-06 10:05:00,-70.32,279422.9100000044,282862.4600000043,-3439.54999999993
30050,2022-10-06 10:10:00,1096.81,280519.7200000044,282862.4600000043,-2342.7399999999325
30051,2022-10-06 10:15:00,584.81,281104.5300000044,282862.4600000043,-1757.9299999999348
30052,2022-10-06 10:20:00,-992.7,280111.8300000044,282862.4600000043,-2750.6299999999464
30053,2022-10-06 10:25:00,-65.78,280046.05000000435,282862.4600000043,-2816.4099999999744
30054,2022-10-06 10:30:00,269.32,280315.37000000436,282862.4600000043,-2547.0899999999674
30055,2022-10-06 10:35:00,-869.38,279445.99000000436,282862.4600000043,-3416.469999999972
30056,2022-10-06 10:40:00,739.25,280185.24000000436,282862.4600000043,-2677.219999999972
30057,2022-10-06 10:45:00,34.87,280220.11000000435,282862.4600000043,-2642.3499999999767
30058,2022-10-06 10:50:00,-307.14,279912.97000000434,282862.4600000043,-2949.4899999999907
30059,2022-10-06 10:55:00,340.03,280253.00000000437,282862.4600000043,-2609.4599999999627
30060,2022-10-06 11:00:00,869.22,281122.22000000434,282862.4600000043,-1740.2399999999907
30061,2022-10-06 11:05:00,-1246.47,279875.75000000437,282862.4600000043,-2986.7099999999627
30062,2022-10-06 11:10:00,-1150.35,278725.4000000044,282862.4600000043,-4137.0599999999395
30063,2022-10-06 11:15:00,569.33,279294.7300000044,282862.4600000043,-3567.729999999923
30064,2022-10-06 11:20:00,-1185.31,278109.4200000044,282862.4600000043,-4753.039999999921
30065,2022-10-06 11:25:00,96.31,278205.7300000044,282862.4600000043,-4656.729999999923
30066,2022-10-06 11:30:00,689.02,278894.7500000044,282862.4600000043,-3967.7099999999045
30067,2022-10-06 11:35:00,1090.64,279985.39000000444,282862.4600000043,-2877.0699999998906
30068,2022-10-06 11:40:00,-142.64,279842.7500000044,282862.4600000043,-3019.7099999999045
30069,2022-10-06 11:45:00,1890.46,281733.21000000444,282862.4600000043,-1129.2499999998836
30070,2022-10-06 11:50:00,-1987.63,279745.58000000444,282862.4600000043,-3116.8799999998882
30071,2022-10-06 11:55:00,-1178.26,278567.32000000443,282862.4600000043,-4295.139999999898
30072,2022-10-06 12:00:00,-1704.72,276862.60000000446,282862.4600000043,-5999.85999999987
30073,2022-10-06 12:05:00,358.73,277221.33000000444,282862.4600000043,-5641.129999999888
30074,2022-10-06 12:10:00,1194.93,278416.26000000443,282862.4600000043,-4446.199999999895
30075,2022-10-06 12:15:00,-1310.3,277105.96000000444,282862.4600000043,-5756.499999999884
30076,2022-10-06 12:20:00,253.68,277359.64000000444,282862.4600000043,-5502.819999999891
30077,2022-10-06 12:25:00,476.5,277836.14000000444,282862.4600000043,-5026.319999999891
30078,2022-10-06 12:30:00,1668.34,279504.48000000446,282862.4600000043,-3357.979999999865
30079,2022-10-06 12:35:00,342.91,279847.39000000444,282862.4600000043,-3015.0699999998906
30080,2022-10-06 12:40:00,1368.65,281216.04000000446,282862.4600000043,-1646.4199999998673
30081,2022-10-06 12:45:00,1930.98,283147.02000000444,282862.4600000043,284.5600000001141
30082,2022-10-06 12:50:00,-1370.13,281776.89000000444,282862.4600000043,-1085.5699999998906
30083,2022-10-06 12:55:00,-1164.59,280612.3000000044,282862.4600000043,-2250.159999999916
30084,2022-10-06 13:00:00,323.54,280935.8400000044,282862.4600000043,-1926.6199999999371
30085,2022-10-06 13:05:00,-748.18,280187.6600000044,282862.4600000043,-2674.79999999993
30086,2022-10-06 13:10:00,-1399.95,278787.7100000044,282862.4600000043,-4074.749999999942
30087,2022-10-06 13:15:00,1386.68,280174.3900000044,282862.4600000043,-2688.069999999949
30088,2022-10-06 13:20:00,1738.36,281912.75000000437,282862.4600000043,-949.7099999999627
30089,2022-10-06 13:25:00,457.82,282370.5700000044,282862.4600000043,-491.88999999995576
30090,2022-10-06 13:30:00,1242.95,283613.5200000044,282862.4600000043,751.0600000000559
30091,2022-10-06 13:35:00,1203.26,284816.7800000044,282862.4600000043,1954.3200000000652
30092,2022-10-06 13:40:00,-748.3,284068.4800000044,282862.4600000043,1206.0200000000768
30093,2022-10-06 13:45:00,-269.63,283798.8500000044,282862.4600000043,936.3900000000722
30094,2022-10-06 13:50:00,461.55,284260.4000000044,282862.4600000043,1397.9400000000605
30095,2022-10-06 13:55:00,-338.63,283921.7700000044,282862.4600000043,1059.3100000000559
30096,2022-10-06 14:00:00,-1273.77,282648.00000000437,282862.4600000043,-214.45999999996275
30097,2022-10-06 14:05:00,1077.02,283725.0200000044,282862.4600000043,862.5600000000559
30098,2022-10-06 14:10:00,-879.36,282845.6600000044,282862.4600000043,-16.79999999993015
30099,2022-10-06 14:15:00,-1074.26,281771.4000000044,282862.4600000043,-1091.0599999999395
30100,2022-10-06 14:20:00,-1252.16,280519.2400000044,282862.4600000043,-2343.219999999914
30101,2022-10-06 14:25:00,-1707.67,278811.57000000443,282862.4600000043,-4050.8899999998976
30102,2022-10-06 14:30:00,1735.92,280547.4900000044,282862.4600000043,-2314.969999999914
30103,2022-10-06 14:35:00,-831.59,279715.9000000044,282862.4600000043,-3146.5599999999395
30104,2022-10-06 14:40:00,-411.25,279304.6500000044,282862.4600000043,-3557.8099999999395
30105,2022-10-06 14:45:00,608.16,279912.81000000436,282862.4600000043,-2949.649999999965
30106,2022-10-06 14:50:00,1107.36,281020.17000000435,282862.4600000043,-1842.289999999979
30107,2022-10-06 14:55:00,191.83,281212.00000000437,282862.4600000043,-1650.4599999999627
30108,2022-10-06 15:00:00,19.56,281231.56000000436,282862.4600000043,-1630.899999999965
30109,2022-10-06 15:05:00,-585.62,280645.94000000437,282862.4600000043,-2216.5199999999604
30110,2022-10-06 15:10:00,-799.44,279846.50000000437,282862.4600000043,-3015.9599999999627
30111,2022-10-06 15:15:00,-1796.74,278049.7600000044,282862.4600000043,-4812.699999999953
30112,2022-10-06 15:20:00,-1994.6,276055.1600000044,282862.4600000043,-6807.29999999993
30113,2022-10-06 15:25:00,-1205.74,274849.4200000044,282862.4600000043,-8013.039999999921
30114,2022-10-06 15:30:00,-693.09,274156.3300000044,282862.4600000043,-8706.129999999946
30115,2022-10-06 15:35:00,-1701.61,272454.7200000044,282862.4600000043,-10407.739999999932
30116,2022-10-06 15:40:00,-1452.79,271001.9300000044,282862.4600000043,-11860.529999999912
30117,2022-10-06 15:45:00,184.67,271186.6000000044,282862.4600000043,-11675.859999999928
30118,2022-10-06 15:50:00,1775.7,272962.3000000044,282862.4600000043,-9900.159999999916
30119,2022-10-06 15:55:00,86.96,273049.26000000443,282862.4600000043,-9813.199999999895
30120,2022-10-06 16:00:00,-1637.74,271411.52000000444,282862.4600000043,-11450.939999999886
30121,2022-10-06 16:05:00,939.72,272351.2400000044,282862.4600000043,-10511.219999999914
30122,2022-10-06 16:10:00,-857.96,271493.2800000044,282862.4600000043,-11369.179999999935
30123,2022-10-06 16:15:00,-674.28,270819.00000000437,282862.4600000043,-12043.459999999963
30124,2022-10-06 16:20:00,569.38,271388.38000000437,282862.4600000043,-11474.079999999958
30125,2022-10-06 16:25:00,-438.44,270949.94000000437,282862.4600000043,-11912.51999999996
30126,2022-10-06 16:30:00,1236.64,272186.5800000044,282862.4600000043,-10675.879999999946
30127,2022-10-06 16:35:00,-512.14,271674.44000000437,282862.4600000043,-11188.01999999996
30128,2022-10-06 16:40:00,1270.02,272944.4600000044,282862.4600000043,-9917.999999999942
30129,2022-10-06 16:45:00,1708.58,274653.0400000044,282862.4600000043,-8209.419999999925
30130,2022-10-06 16:50:00,1599.7,276252.7400000044,282862.4600000043,-6609.719999999914
30131,2022-10-06 16:55:00,-1398.64,274854.1000000044,282862.4600000043,-8008.359999999928
30132,2022-10-07 08:00:00,-1975.49,272878.6100000044,274854.1000000044,-1975.4899999999907
30133,2022-10-07 08:05:00,283.68,273162.2900000044,274854.1000000044,-1691.8099999999977
30134,2022-10-07 08:10:00,1387.22,274549.5100000044,274854.1000000044,-304.5900000000256
30135,2022-10-07 08:15:00,-1616.97,272932.5400000044,274854.1000000044,-1921.5599999999977
30136,2022-10-07 08:20:00,311.86,273244.4000000044,274854.1000000044,-1609.7000000000116
30137,2022-10-07 08:25:00,698.4,273942.8000000044,274854.1000000044,-911.2999999999884
30138,2022-10-07 08:30:00,1879.92,275822.7200000044,274854.1000000044,968.6199999999953
30139,2022-10-07 08:35:00,-993.69,274829.0300000044,274854.1000000044,-25.070000000006985
30140,2022-10-07 08:40:00,1632.74,276461.7700000044,274854.1000000044,1607.6699999999837
30141,2022-10-07 08:45:00,433.06,276894.8300000044,274854.1000000044,2040.7299999999814
30142,2022-10-07 08:50:00,633.88,277528.7100000044,274854.1000000044,2674.609999999986
30143,2022-10-07 08:55:00,-10.82,277517.8900000044,274854.1000000044,2663.789999999979
30144,2022-10-07 09:00:00,-1906.32,275611.5700000044,274854.1000000044,757.4699999999721
30145,2022-10-07 09:05:00,513.53,276125.1000000044,274854.1000000044,1271.0
30146,2022-10-07 09:10:00,-1444.9,274680.2000000044,274854.1000000044,-173.90000000002328
30147,2022-10-07 09:15:00,-1229.46,273450.74000000436,274854.1000000044,-1403.3600000000442
30148,2022-10-07 09:20:00,1921.61,275372.35000000434,274854.1000000044,518.2499999999418
30149,2022-10-07 09:25:00,1909.83,277282.18000000436,274854.1000000044,2428.079999999958
30150,2022-10-07 09:30:00,-515.92,276766.2600000044,274854.1000000044,1912.1599999999744
30151,2022-10-07 09:35:00,-780.17,275986.0900000044,274854.1000000044,1131.9899999999907
30152,2022-10-07 09:40:00,-674.4,275311.69000000437,274854.1000000044,457.5899999999674
30153,2022-10-07 09:45:00,-1853.32,273458.37000000436,274854.1000000044,-1395.7300000000396
30154,2022-10-07 09:50:00,959.1,274417.47000000434,274854.1000000044,-436.63000000006286
30155,2022-10-07 09:55:00,-1712.69,272704.78000000434,274854.1000000044,-2149.320000000065
30156,2022-10-07 10:00:00,1039.98,273744.7600000043,274854.1000000044,-1109.3400000000838
30157,2022-10-07 10:05:00,-1678.82,272065.9400000043,274854.1000000044,-2788.160000000091
30158,2022-10-07 10:10:00,1977.32,274043.2600000043,274854.1000000044,-810.8400000000838
30159,2022-10-07 10:15:00,292.4,274335.66000000434,274854.1000000044,-518.4400000000605
30160,2022-10-07 10:20:00,953.05,275288.7100000043,274854.1000000044,434.6099999999278
30161,2022-10-07 10:25:00,-932.0,274356.7100000043,274854.1000000044,-497.3900000000722
30162,2022-10-07 10:30:00,13.04,274369.7500000043,274854.1000000044,-484.35000000009313
30163,2022-10-07 10:35:00,1450.12,275819.8700000043,274854.1000000044,965.7699999999022
30164,2022-10-07 10:40:00,-1501.14,274318.7300000043,274854.1000000044,-535.3700000001118
30165,2022-10-07 10:45:00,1165.51,275484.2400000043,274854.1000000044,630.1399999998976
30166,2022-10-07 10:50:00,836.57,276320.8100000043,274854.1000000044,1466.7099999999045
30167,2022-10-07 10:55:00,-1088.93,275231.8800000043,274854.1000000044,377.7799999999115
30168,2022-10-07 11:00:00,-460.84,274771.0400000043,274854.1000000044,-83.06000000011409
30169,2022-10-07 11:05:00,-568.32,274202.7200000043,274854.1000000044,-651.3800000001211
30170,2022-10-07 11:10:00,961.11,275163.83000000427,274854.1000000044,309.72999999986496
30171,2022-10-07 11:15:00,872.72,276036.55000000424,274854.1000000044,1182.449999999837
30172,2022-10-07 11:20:00,-313.31,275723.24000000424,274854.1000000044,869.1399999998393
30173,2022-10-07 11:25:00,-731.06,274992.18000000424,274854.1000000044,138.07999999984168
30174,2022-10-07 11:30:00,-1046.82,273945.36000000424,274854.1000000044,-908.7400000001653
30175,2022-10-07 11:35:00,-1900.32,272045.0400000042,274854.1000000044,-2809.0600000001723
30176,2022-10-07 11:40:00,1007.69,273052.73000000423,274854.1000000044,-1801.37000000017
30177,2022-10-07 11:45:00,-768.53,272284.2000000042,274854.1000000044,-2569.900000000198
30178,2022-10-07 11:50:00,-1774.73,270509.4700000042,274854.1000000044,-4344.630000000179
30179,2022-10-07 11:55:00,880.1,271389.5700000042,274854.1000000044,-3464.5300000002026
30180,2022-10-07 12:00:00,-164.75,271224.8200000042,274854.1000000044,-3629.2800000002026
30181,2022-10-07 12:05:00,1609.41,272834.2300000042,274854.1000000044,-2019.8700000002282
30182,2022-10-07 12:10:00,-1488.08,271346.15000000416,274854.1000000044,-3507.9500000002445
30183,2022-10-07 12:15:00,-299.19,271046.96000000415,274854.1000000044,-3807.140000000247
30184,2022-10-07 12:20:00,1353.16,272400.1200000041,274854.1000000044,-2453.9800000002724
30185,2022-10-07 12:25:00,-1432.56,270967.56000000413,274854.1000000044,-3886.54000000027
30186,2022-10-07 12:30:00,-1057.87,269909.69000000414,274854.1000000044,-4944.410000000265
30187,2022-10-07 12:35:00,-102.84,269806.8500000041,274854.1000000044,-5047.250000000291
30188,2022-10-07 12:40:00,1734.44,271541.2900000041,274854.1000000044,-3312.8100000002887
30189,2022-10-07 12:45:00,1418.7,272959.9900000041,274854.1000000044,-1894.110000000277
30190,2022-10-07 12:50:00,400.65,273360.64000000415,274854.1000000044,-1493.4600000002538
30191,2022-10-07 12:55:00,44.85,273405.4900000041,274854.1000000044,-1448.610000000277
30192,2022-10-07 13:00:00,-642.91,272762.58000000415,274854.1000000044,-2091.5200000002515
30193,2022-10-07 13:05:00,1594.14,274356.72000000416,274854.1000000044,-497.3800000002375
30194,2022-10-07 13:10:00,-1969.76,272386.96000000415,274854.1000000044,-2467.140000000247
30195,2022-10-07 13:15:00,1347.88,273734.84000000416,274854.1000000044,-1119.2600000002421
30196,2022-10-07 13:20:00,-214.48,273520.3600000042,274854.1000000044,-1333.7400000002235
30197,2022-10-07 13:25:00,-754.19,272766.1700000042,274854.1000000044,-2087.930000000226
30198,2022-10-07 13:30:00,-430.45,272335.72000000416,274854.1000000044,-2518.3800000002375
30199,2022-10-07 13:35:00,-66.04,272269.6800000042,274854.1000000044,-2584.4200000002165
30200,2022-10-07 13:40:00,-1075.72,271193.9600000042,274854.1000000044,-3660.1400000001886
30201,2022-10-07 13:45:00,1743.73,272937.6900000042,274854.1000000044,-1916.4100000002072
30202,2022-10-07 13:50:00,428.98,273366.6700000042,274854.1000000044,-1487.4300000002258
30203,2022-10-07 13:55:00,-809.94,272556.7300000042,274854.1000000044,-2297.370000000228
30204,2022-10-07 14:00:00,406.41,272963.14000000415,274854.1000000044,-1890.9600000002538
30205,2022-10-07 14:05:00,-197.85,272765.29000000417,274854.1000000044,-2088.8100000002305
30206,2022-10-07 14:10:00,-1639.77,271125.52000000415,274854.1000000044,-3728.580000000249
30207,2022-10-07 14:15:00,-1354.76,269770.76000000414,274854.1000000044,-5083.340000000258
30208,2022-10-07 14:20:00,837.56,270608.32000000414,274854.1000000044,-4245.780000000261
30209,2022-10-07 14:25:00,1422.3,272030.6200000041,274854.1000000044,-2823.4800000002724
30210,2022-10-07 14:30:00,-1924.17,270106.45000000414,274854.1000000044,-4747.650000000256
30211,2022-10-07 14:35:00,1928.41,272034.8600000041,274854.1000000044,-2819.2400000002817
30212,2022-10-07 14:40:00,1916.12,273950.9800000041,274854.1000000044,-903.1200000002864
30213,2022-10-07 14:45:00,-1981.31,271969.6700000041,274854.1000000044,-2884.430000000284
30214,2022-10-07 14:50:00,1169.38,273139.0500000041,274854.1000000044,-1715.0500000002794
30215,2022-10-07 14:55:00,1415.39,274554.44000000414,274854.1000000044,-299.6600000002654
30216,2022-10-07 15:00:00,-827.58,273726.8600000041,274854.1000000044,-1127.2400000002817
30217,2022-10-07 15:05:00,560.51,274287.3700000041,274854.1000000044,-566.7300000002724
30218,2022-10-07 15:10:00,-738.14,273549.2300000041,274854.1000000044,-1304.8700000002864
30219,2022-10-07 15:15:00,-1282.27,272266.9600000041,274854.1000000044,-2587.140000000305
30220,2022-10-07 15:20:00,-913.1,271353.8600000041,274854.1000000044,-3500.2400000002817
30221,2022-10-07 15:25:00,-1458.18,269895.6800000041,274854.1000000044,-4958.420000000275
30222,2022-10-07 15:30:00,176.06,270071.7400000041,274854.1000000044,-4782.360000000277
30223,2022-10-07 15:35:00,1554.83,271626.57000000414,274854.1000000044,-3227.5300000002608
30224,2022-10-07 15:40:00,1460.56,273087.13000000414,274854.1000000044,-1766.970000000263
30225,2022-10-07 15:45:00,-697.21,272389.9200000041,274854.1000000044,-2464.180000000284
30226,2022-10-07 15:50:00,217.99,272607.9100000041,274854.1000000044,-2246.1900000002934
30227,2022-10-07 15:55:00,-743.57,271864.3400000041,274854.1000000044,-2989.7600000003004
30228,2022-10-07 16:00:00,813.24,272677.5800000041,274854.1000000044,-2176.5200000003097
30229,2022-10-07 16:05:00,-859.91,271817.6700000041,274854.1000000044,-3036.430000000284
30230,2022-10-07 16:10:00,1063.03,272880.70000000414,274854.1000000044,-1973.4000000002561
30231,2022-10-07 16:15:00,-1332.29,271548.41000000417,274854.1000000044,-3305.690000000235
30232,2022-10-07 16:20:00,1762.48,273310.89000000415,274854.1000000044,-1543.2100000002538
30233,2022-10-07 16:25:00,723.94,274034.83000000415,274854.1000000044,-819.2700000002515
30234,2022-10-07 16:30:00,-1926.86,272107.97000000416,274854.1000000044,-2746.1300000002375
30235,2022-10-07 16:35:00,-1357.86,270750.1100000042,274854.1000000044,-4103.9900000002235
30236,2022-10-07 16:40:00,-1361.33,269388.78000000416,274854.1000000044,-5465.32000000024
30237,2022-10-07 16:45:00,1706.69,271095.47000000416,274854.1000000044,-3758.6300000002375
30238,2022-10-07 16:50:00,835.26,271930.7300000042,274854.1000000044,-2923.370000000228
30239,2022-10-07 16:55:00,1442.32,273373.0500000042,274854.1000000044,-1481.0500000002212
30240,2022-10-08 08:00:00,541.96,273915.0100000042,273373.0500000042,541.960000000021
30241,2022-10-08 08:05:00,-1398.63,272516.3800000042,273373.0500000042,-856.6699999999837
30242,2022-10-08 08:10:00,198.31,272714.6900000042,273373.0500000042,-658.359999999986
30243,2022-10-08 08:15:00,-860.96,271853.7300000042,273373.0500000042,-1519.320000000007
30244,2022-10-08 08:20:00,-293.04,271560.6900000042,273373.0500000042,-1812.359999999986
30245,2022-10-08 08:25:00,-1310.19,270250.5000000042,273373.0500000042,-3122.5499999999884
30246,2022-10-08 08:30:00,-403.02,269847.4800000042,273373.0500000042,-3525.570000000007
30247,2022-10-08 08:35:00,-368.92,269478.5600000042,273373.0500000042,-3894.4899999999907
30248,2022-10-08 08:40:00,-1719.74,267758.8200000042,273373.0500000042,-5614.229999999981
30249,2022-10-08 08:45:00,757.8,268516.6200000042,273373.0500000042,-4856.429999999993
30250,2022-10-08 08:50:00,-931.42,267585.2000000042,273373.0500000042,-5787.849999999977
30251,2022-10-08 08:55:00,-1825.99,265759.2100000042,273373.0500000042,-7613.839999999967
30252,2022-10-08 09:00:00,-835.89,264923.3200000042,273373.0500000042,-8449.729999999981
30253,2022-10-08 09:05:00,1765.89,266689.2100000042,273373.0500000042,-6683.839999999967
30254,2022-10-08 09:10:00,-1382.64,265306.5700000042,273373.0500000042,-8066.479999999981
30255,2022-10-08 09:15:00,910.45,266217.0200000042,273373.0500000042,-7156.02999999997
30256,2022-10-08 09:20:00,-1859.02,264358.0000000042,273373.0500000042,-9015.049999999988
30257,2022-10-08 09:25:00,-1204.24,263153.7600000042,273373.0500000042,-10219.289999999979
30258,2022-10-08 09:30:00,-338.16,262815.6000000042,273373.0500000042,-10557.449999999953
30259,2022-10-08 09:35:00,724.25,263539.8500000042,273373.0500000042,-9833.199999999953
30260,2022-10-08 09:40:00,-523.86,263015.99000000424,273373.0500000042,-10357.05999999994
30261,2022-10-08 09:45:00,809.68,263825.67000000423,273373.0500000042,-9547.379999999946
30262,2022-10-08 09:50:00,-810.43,263015.24000000424,273373.0500000042,-10357.80999999994
30263,2022-10-08 09:55:00,-726.75,262288.49000000424,273373.0500000042,-11084.55999999994
30264,2022-10-08 10:00:00,434.3,262722.7900000042,273373.0500000042,-10650.259999999951
30265,2022-10-08 10:05:00,-1301.84,261420.95000000423,273373.0500000042,-11952.099999999948
30266,2022-10-08 10:10:00,719.24,262140.19000000422,273373.0500000042,-11232.859999999957
30267,2022-10-08 10:15:00,-236.79,261903.4000000042,273373.0500000042,-11469.649999999965
30268,2022-10-08 10:20:00,-829.53,261073.87000000422,273373.0500000042,-12299.179999999964
30269,2022-10-08 10:25:00,-378.71,260695.16000000422,273373.0500000042,-12677.889999999956
30270,2022-10-08 10:30:00,-1432.99,259262.17000000423,273373.0500000042,-14110.879999999946
30271,2022-10-08 10:35:00,-1978.78,257283.39000000423,273373.0500000042,-16089.659999999945
30272,2022-10-08 10:40:00,1904.4,259187.79000000423,273373.0500000042,-14185.259999999951
30273,2022-10-08 10:45:00,-1655.14,257532.6500000042,273373.0500000042,-15840.399999999965
30274,2022-10-08 10:50:00,-1883.8,255648.85000000423,273373.0500000042,-17724.199999999953
30275,2022-10-08 10:55:00,98.45,255747.30000000424,273373.0500000042,-17625.74999999994
30276,2022-10-08 11:00:00,1008.87,256756.17000000423,273373.0500000042,-16616.879999999946
30277,2022-10-08 11:05:00,-488.14,256268.03000000422,273373.0500000042,-17105.01999999996
30278,2022-10-08 11:10:00,71.84,256339.87000000422,273373.0500000042,-17033.179999999964
30279,2022-10-08 11:15:00,1762.95,258102.82000000423,273373.0500000042,-15270.229999999952
30280,2022-10-08 11:20:00,1691.73,259794.55000000424,273373.0500000042,-13578.499999999942
30281,2022-10-08 11:25:00,-1351.9,258442.65000000424,273373.0500000042,-14930.399999999936
30282,2022-10-08 11:30:00,1089.62,259532.27000000424,273373.0500000042,-13840.77999999994
30283,2022-10-08 11:35:00,275.28,259807.55000000424,273373.0500000042,-13565.499999999942
30284,2022-10-08 11:40:00,240.6,260048.15000000424,273373.0500000042,-13324.899999999936
30285,2022-10-08 11:45:00,-292.6,259755.55000000424,273373.0500000042,-13617.499999999942
30286,2022-10-08 11:50:00,1205.4,260960.95000000423,273373.0500000042,-12412.099999999948
30287,2022-10-08 11:55:00,-1309.21,259651.74000000424,273373.0500000042,-13721.30999999994
30288,2022-10-08 12:00:00,-321.03,259330.71000000424,273373.0500000042,-14042.339999999938
30289,2022-10-08 12:05:00,-1364.91,257965.80000000424,273373.0500000042,-15407.249999999942
30290,2022-10-08 12:10:00,-721.74,257244.06000000425,273373.0500000042,-16128.989999999932
30291,2022-10-08 12:15:00,867.77,258111.83000000424,273373.0500000042,-15261.219999999943
30292,2022-10-08 12:20:00,-1145.68,256966.15000000424,273373.0500000042,-16406.899999999936
30293,2022-10-08 12:25:00,-1296.2,255669.95000000423,273373.0500000042,-17703.099999999948
30294,2022-10-08 12:30:00,-1474.06,254195.89000000423,273373.0500000042,-19177.159999999945
30295,2022-10-08 12:35:00,885.95,255081.84000000425,273373.0500000042,-18291.209999999934
30296,2022-10-08 12:40:00,-45.45,255036.39000000423,273373.0500000042,-18336.659999999945
30297,2022-10-08 12:45:00,-1975.28,253061.11000000424,273373.0500000042,-20311.939999999944
30298,2022-10-08 12:50:00,1179.6,254240.71000000424,273373.0500000042,-19132.33999999994
30299,2022-10-08 12:55:00,769.64,255010.35000000425,273373.0500000042,-18362.699999999924
30300,2022-10-08 13:00:00,-132.96,254877.39000000426,273373.0500000042,-18495.659999999916
30301,2022-10-08 13:05:00,110.02,254987.41000000425,273373.0500000042,-18385.639999999927
30302,2022-10-08 13:10:00,451.96,255439.37000000424,273373.0500000042,-17933.679999999935
30303,2022-10-08 13:15:00,-401.96,255037.41000000425,273373.0500000042,-18335.639999999927
30304,2022-10-08 13:20:00,803.27,255840.68000000424,273373.0500000042,-17532.369999999937
30305,2022-10-08 13:25:00,-1605.89,254234.79000000423,273373.0500000042,-19138.25999999995
30306,2022-10-08 13:30:00,-1573.85,252660.94000000422,273373.0500000042,-20712.109999999957
30307,2022-10-08 13:35:00,-1567.03,251093.91000000422,273373.0500000042,-22279.139999999956
30308,2022-10-08 13:40:00,-1037.17,250056.7400000042,273373.0500000042,-23316.30999999997
30309,2022-10-08 13:45:00,-1994.51,248062.2300000042,273373.0500000042,-25310.819999999978
30310,2022-10-08 13:50:00,-1265.04,246797.1900000042,273373.0500000042,-26575.859999999986
30311,2022-10-08 13:55:00,1241.09,248038.2800000042,273373.0500000042,-25334.76999999999
30312,2022-10-08 14:00:00,-1536.69,246501.5900000042,273373.0500000042,-26871.459999999992
30313,2022-10-08 14:05:00,-1688.64,244812.95000000417,273373.0500000042,-28560.100000000006
30314,2022-10-08 14:10:00,1790.86,246603.81000000416,273373.0500000042,-26769.24000000002
30315,2022-10-08 14:15:00,-881.34,245722.47000000416,273373.0500000042,-27650.580000000016
30316,2022-10-08 14:20:00,24.68,245747.15000000416,273373.0500000042,-27625.900000000023
30317,2022-10-08 14:25:00,-1203.83,244543.32000000417,273373.0500000042,-28829.73000000001
30318,2022-10-08 14:30:00,-245.87,244297.45000000417,273373.0500000042,-29075.600000000006
30319,2022-10-08 14:35:00,-971.09,243326.36000000418,273373.0500000042,-30046.690000000002
30320,2022-10-08 14:40:00,-1134.63,242191.73000000417,273373.0500000042,-31181.320000000007
30321,2022-10-08 14:45:00,1495.25,243686.98000000417,273373.0500000042,-29686.070000000007
30322,2022-10-08 14:50:00,425.33,244112.31000000416,273373.0500000042,-29260.74000000002
30323,2022-10-08 14:55:00,1571.13,245683.44000000416,273373.0500000042,-27689.610000000015
30324,2022-10-08 15:00:00,-917.8,244765.64000000418,273373.0500000042,-28607.410000000003
30325,2022-10-08 15:05:00,863.71,245629.35000000417,273373.0500000042,-27743.70000000001
30326,2022-10-08 15:10:00,-961.24,244668.11000000418,273373.0500000042,-28704.940000000002
30327,2022-10-08 15:15:00,1364.44,246032.55000000418,273373.0500000042,-27340.5
30328,2022-10-08 15:20:00,-470.21,245562.3400000042,273373.0500000042,-27810.709999999992
30329,2022-10-08 15:25:00,1028.33,246590.67000000417,273373.0500000042,-26782.380000000005
30330,2022-10-08 15:30:00,-1312.5,245278.17000000417,273373.0500000042,-28094.880000000005
30331,2022-10-08 15:35:00,1003.13,246281.30000000418,273373.0500000042,-27091.75
30332,2022-10-08 15:40:00,1865.74,248147.04000000417,273373.0500000042,-25226.01000000001
30333,2022-10-08 15:45:00,1889.34,250036.38000000417,273373.0500000042,-23336.670000000013
30334,2022-10-08 15:50:00,1274.27,251310.65000000416,273373.0500000042,-22062.400000000023
30335,2022-10-08 15:55:00,-672.98,250637.67000000415,273373.0500000042,-22735.380000000034
30336,2022-10-08 16:00:00,-1499.81,249137.86000000415,273373.0500000042,-24235.19000000003
30337,2022-10-08 16:05:00,-1412.21,247725.65000000416,273373.0500000042,-25647.400000000023
30338,2022-10-08 16:10:00,-1054.48,246671.17000000415,273373.0500000042,-26701.880000000034
30339,2022-10-08 16:15:00,1420.95,248092.12000000416,273373.0500000042,-25280.930000000022
30340,2022-10-08 16:20:00,-126.54,247965.58000000415,273373.0500000042,-25407.47000000003
30341,2022-10-08 16:25:00,1559.48,249525.06000000416,273373.0500000042,-23847.99000000002
30342,2022-10-08 16:30:00,-728.82,248796.24000000415,273373.0500000042,-24576.810000000027
30343,2022-10-08 16:35:00,-908.83,247887.41000000417,273373.0500000042,-25485.640000000014
30344,2022-10-08 16:40:00,1481.24,249368.65000000416,273373.0500000042,-24004.400000000023
30345,2022-10-08 16:45:00,-352.22,249016.43000000415,273373.0500000042,-24356.620000000024
30346,2022-10-08 16:50:00,-1171.53,247844.90000000416,273373.0500000042,-25528.150000000023
30347,2022-10-08 16:55:00,-3.76,247841.14000000415,273373.0500000042,-25531.910000000033
30348,2022-10-09 08:00:00,491.63,248332.77000000415,247841.14000000415,491.63000000000466
30349,2022-10-09 08:05:00,-1525.58,246807.19000000416,247841.14000000415,-1033.9499999999825
30350,2022-10-09 08:10:00,-170.27,246636.92000000417,247841.14000000415,-1204.219999999972
30351,2022-10-09 08:15:00,-1685.58,244951.3400000042,247841.14000000415,-2889.7999999999593
30352,2022-10-09 08:20:00,1156.3,246107.64000000418,247841.14000000415,-1733.499999999971
30353,2022-10-09 08:25:00,913.23,247020.8700000042,247841.14000000415,-820.2699999999604
30354,2022-10-09 08:30:00,1454.35,248475.2200000042,247841.14000000415,634.0800000000454
30355,2022-10-09 08:35:00,1185.73,249660.9500000042,247841.14000000415,1819.8100000000559
30356,2022-10-09 08:40:00,856.61,250517.5600000042,247841.14000000415,2676.420000000042
30357,2022-10-09 08:45:00,134.81,250652.3700000042,247841.14000000415,2811.2300000000396
30358,2022-10-09 08:50:00,-1712.8,248939.5700000042,247841.14000000415,1098.4300000000512
30359,2022-10-09 08:55:00,-1667.65,247271.9200000042,247841.14000000415,-569.219999999943
30360,2022-10-09 09:00:00,1941.54,249213.4600000042,247841.14000000415,1372.3200000000652
30361,2022-10-09 09:05:00,-528.42,248685.0400000042,247841.14000000415,843.9000000000524
30362,2022-10-09 09:10:00,-1655.51,247029.5300000042,247841.14000000415,-811.6099999999569
30363,2022-10-09 09:15:00,-628.02,246401.5100000042,247841.14000000415,-1439.6299999999464
30364,2022-10-09 09:20:00,1382.64,247784.1500000042,247841.14000000415,-56.98999999993248
30365,2022-10-09 09:25:00,-1199.24,246584.91000000422,247841.14000000415,-1256.2299999999232
30366,2022-10-09 09:30:00,910.37,247495.28000000422,247841.14000000415,-345.8599999999278
30367,2022-10-09 09:35:00,-1056.61,246438.67000000423,247841.14000000415,-1402.4699999999139
30368,2022-10-09 09:40:00,1131.25,247569.92000000423,247841.14000000415,-271.21999999991385
30369,2022-10-09 09:45:00,136.79,247706.71000000424,247841.14000000415,-134.4299999999057
30370,2022-10-09 09:50:00,285.3,247992.01000000423,247841.14000000415,150.87000000008265
30371,2022-10-09 09:55:00,1109.37,249101.38000000422,247841.14000000415,1260.240000000078
30372,2022-10-09 10:00:00,-1895.09,247206.29000000423,247841.14000000415,-634.8499999999185
30373,2022-10-09 10:05:00,-1090.06,246116.23000000423,247841.14000000415,-1724.9099999999162
30374,2022-10-09 10:10:00,-1320.48,244795.75000000422,247841.14000000415,-3045.3899999999267
30375,2022-10-09 10:15:00,-175.23,244620.5200000042,247841.14000000415,-3220.619999999937
30376,2022-10-09 10:20:00,-811.11,243809.41000000422,247841.14000000415,-4031.729999999923
30377,2022-10-09 10:25:00,845.31,244654.72000000422,247841.14000000415,-3186.4199999999255
30378,2022-10-09 10:30:00,611.6,245266.32000000423,247841.14000000415,-2574.8199999999197
30379,2022-10-09 10:35:00,1889.51,247155.83000000424,247841.14000000415,-685.3099999999104
30380,2022-10-09 10:40:00,1093.5,248249.33000000424,247841.14000000415,408.19000000008964
30381,2022-10-09 10:45:00,750.02,248999.35000000423,247841.14000000415,1158.2100000000792
30382,2022-10-09 10:50:00,-912.52,248086.83000000424,247841.14000000415,245.69000000008964
30383,2022-10-09 10:55:00,-78.58,248008.25000000425,247841.14000000415,167.11000000010245
30384,2022-10-09 11:00:00,1959.7,249967.95000000426,247841.14000000415,2126.810000000114
30385,2022-10-09 11:05:00,-239.34,249728.61000000426,247841.14000000415,1887.4700000001176
30386,2022-10-09 11:10:00,1712.41,251441.02000000427,247841.14000000415,3599.880000000121
30387,2022-10-09 11:15:00,-173.76,251267.26000000426,247841.14000000415,3426.1200000001118
30388,2022-10-09 11:20:00,1110.06,252377.32000000426,247841.14000000415,4536.180000000109
30389,2022-10-09 11:25:00,-185.27,252192.05000000427,247841.14000000415,4350.91000000012
30390,2022-10-09 11:30:00,-1796.51,250395.54000000426,247841.14000000415,2554.4000000001106
30391,2022-10-09 11:35:00,409.3,250804.84000000425,247841.14000000415,2963.700000000099
30392,2022-10-09 11:40:00,1640.88,252445.72000000425,247841.14000000415,4604.580000000104
30393,2022-10-09 11:45:00,-49.31,252396.41000000425,247841.14000000415,4555.270000000106
30394,2022-10-09 11:50:00,-1886.66,250509.75000000425,247841.14000000415,2668.6100000001024
30395,2022-10-09 11:55:00,1659.27,252169.02000000424,247841.14000000415,4327.880000000092
30396,2022-10-09 12:00:00,1546.27,253715.29000000423,247841.14000000415,5874.1500000000815
30397,2022-10-09 12:05:00,1837.01,255552.30000000424,247841.14000000415,7711.160000000091
30398,2022-10-09 12:10:00,778.22,256330.52000000424,247841.14000000415,8489.380000000092
30399,2022-10-09 12:15:00,1827.31,258157.83000000424,247841.14000000415,10316.69000000009
30400,2022-10-09 12:20:00,1582.65,259740.48000000423,247841.14000000415,11899.340000000084
30401,2022-10-09 12:25:00,1839.42,261579.90000000424,247841.14000000415,13738.760000000097
30402,2022-10-09 12:30:00,-1088.76,260491.14000000423,247841.14000000415,12650.000000000087
30403,2022-10-09 12:35:00,-529.85,259961.29000000423,247841.14000000415,12120.150000000081
30404,2022-10-09 12:40:00,-417.26,259544.03000000422,247841.14000000415,11702.890000000072
30405,2022-10-09 12:45:00,1733.89,261277.92000000423,247841.14000000415,13436.780000000086
30406,2022-10-09 12:50:00,-917.42,260360.50000000422,247841.14000000415,12519.360000000073
30407,2022-10-09 12:55:00,-1672.16,258688.34000000422,247841.14000000415,10847.20000000007
30408,2022-10-09 13:00:00,-1593.79,257094.5500000042,247841.14000000415,9253.410000000062
30409,2022-10-09 13:05:00,-718.69,256375.8600000042,247841.14000000415,8534.72000000006
30410,2022-10-09 13:10:00,495.17,256871.03000000422,247841.14000000415,9029.890000000072
30411,2022-10-09 13:15:00,-267.75,256603.28000000422,247841.14000000415,8762.140000000072
30412,2022-10-09 13:20:00,-24.51,256578.7700000042,247841.14000000415,8737.630000000063
30413,2022-10-09 13:25:00,1794.59,258373.3600000042,247841.14000000415,10532.22000000006
30414,2022-10-09 13:30:00,100.7,258474.06000000422,247841.14000000415,10632.920000000071
30415,2022-10-09 13:35:00,659.43,259133.4900000042,247841.14000000415,11292.350000000064
30416,2022-10-09 13:40:00,792.06,259925.5500000042,247841.14000000415,12084.410000000062
30417,2022-10-09 13:45:00,-1036.81,258888.7400000042,247841.14000000415,11047.600000000064
30418,2022-10-09 13:50:00,-117.27,258771.47000000422,247841.14000000415,10930.330000000075
30419,2022-10-09 13:55:00,-753.81,258017.66000000422,247841.14000000415,10176.520000000077
30420,2022-10-09 14:00:00,-1440.21,256577.45000000423,247841.14000000415,8736.310000000085
30421,2022-10-09 14:05:00,-1840.99,254736.46000000424,247841.14000000415,6895.320000000094
30422,2022-10-09 14:10:00,614.96,255351.42000000423,247841.14000000415,7510.280000000086
30423,2022-10-09 14:15:00,1821.4,257172.82000000423,247841.14000000415,9331.68000000008
30424,2022-10-09 14:20:00,-194.89,256977.9300000042,247841.14000000415,9136.790000000066
30425,2022-10-09 14:25:00,926.5,257904.4300000042,247841.14000000415,10063.290000000066
30426,2022-10-09 14:30:00,307.18,258211.6100000042,247841.14000000415,10370.47000000006
30427,2022-10-09 14:35:00,1655.72,259867.3300000042,247841.14000000415,12026.19000000006
30428,2022-10-09 14:40:00,-1268.79,258598.5400000042,247841.14000000415,10757.400000000052
30429,2022-10-09 14:45:00,-46.31,258552.2300000042,247841.14000000415,10711.090000000055
30430,2022-10-09 14:50:00,-1761.76,256790.4700000042,247841.14000000415,8949.330000000045
30431,2022-10-09 14:55:00,-320.29,256470.18000000418,247841.14000000415,8629.040000000037
30432,2022-10-09 15:00:00,-234.3,256235.8800000042,247841.14000000415,8394.740000000049
30433,2022-10-09 15:05:00,720.57,256956.4500000042,247841.14000000415,9115.310000000056
30434,2022-10-09 15:10:00,1734.65,258691.1000000042,247841.14000000415,10849.96000000005
30435,2022-10-09 15:15:00,-263.53,258427.5700000042,247841.14000000415,10586.430000000051
30436,2022-10-09 15:20:00,1340.89,259768.4600000042,247841.14000000415,11927.320000000065
30437,2022-10-09 15:25:00,-1897.57,257870.8900000042,247841.14000000415,10029.750000000058
30438,2022-10-09 15:30:00,1766.88,259637.7700000042,247841.14000000415,11796.630000000063
30439,2022-10-09 15:35:00,850.5,260488.2700000042,247841.14000000415,12647.130000000063
30440,2022-10-09 15:40:00,964.99,261453.2600000042,247841.14000000415,13612.120000000054
30441,2022-10-09 15:45:00,-995.5,260457.7600000042,247841.14000000415,12616.620000000054
30442,2022-10-09 15:50:00,-238.76,260219.0000000042,247841.14000000415,12377.860000000044
30443,2022-10-09 15:55:00,411.6,260630.6000000042,247841.14000000415,12789.46000000005
30444,2022-10-09 16:00:00,529.53,261160.1300000042,247841.14000000415,13318.990000000049
30445,2022-10-09 16:05:00,-1723.14,259436.99000000418,247841.14000000415,11595.850000000035
30446,2022-10-09 16:10:00,1118.88,260555.8700000042,247841.14000000415,12714.73000000004
30447,2022-10-09 16:15:00,1674.71,262230.5800000042,247841.14000000415,14389.44000000006
30448,2022-10-09 16:20:00,-72.4,262158.1800000042,247841.14000000415,14317.040000000037
30449,2022-10-09 16:25:00,605.97,262764.15000000416,247841.14000000415,14923.01000000001
30450,2022-10-09 16:30:00,-103.17,262660.9800000042,247841.14000000415,14819.840000000026
30451,2022-10-09 16:35:00,-451.64,262209.34000000416,247841.14000000415,14368.200000000012
30452,2022-10-09 16:40:00,1286.06,263495.40000000416,247841.14000000415,15654.26000000001
30453,2022-10-09 16:45:00,775.07,264270.47000000416,247841.14000000415,16429.330000000016
30454,2022-10-09 16:50:00,1745.56,266016.03000000416,247841.14000000415,18174.890000000014
30455,2022-10-09 16:55:00,1655.61,267671.64000000415,247841.14000000415,19830.5
30456,2022-10-10 08:00:00,-85.36,267586.28000000416,267671.64000000415,-85.35999999998603
30457,2022-10-10 08:05:00,1540.63,269126.91000000417,267671.64000000415,1455.2700000000186
30458,2022-10-10 08:10:00,1070.12,270197.03000000416,267671.64000000415,2525.390000000014
30459,2022-10-10 08:15:00,-1202.35,268994.6800000042,267671.64000000415,1323.0400000000373
30460,2022-10-10 08:20:00,-1701.51,267293.1700000042,267671.64000000415,-378.46999999997206
30461,2022-10-10 08:25:00,-1166.09,266127.08000000415,267671.64000000415,-1544.5599999999977
30462,2022-10-10 08:30:00,-1557.29,264569.79000000417,267671.64000000415,-3101.8499999999767
30463,2022-10-10 08:35:00,-484.27,264085.52000000415,267671.64000000415,-3586.1199999999953
30464,2022-10-10 08:40:00,-146.02,263939.50000000413,267671.64000000415,-3732.140000000014
30465,2022-10-10 08:45:00,-1435.41,262504.09000000416,267671.64000000415,-5167.549999999988
30466,2022-10-10 08:50:00,810.09,263314.1800000042,267671.64000000415,-4357.459999999963
30467,2022-10-10 08:55:00,836.27,264150.4500000042,267671.64000000415,-3521.189999999944
30468,2022-10-10 09:00:00,306.77,264457.2200000042,267671.64000000415,-3214.4199999999255
30469,2022-10-10 09:05:00,-528.38,263928.8400000042,267671.64000000415,-3742.79999999993
30470,2022-10-10 09:10:00,-1301.76,262627.0800000042,267671.64000000415,-5044.5599999999395
30471,2022-10-10 09:15:00,-16.05,262611.0300000042,267671.64000000415,-5060.609999999928
30472,2022-10-10 09:20:00,-22.92,262588.11000000424,267671.64000000415,-5083.5299999999115
30473,2022-10-10 09:25:00,-1569.77,261018.34000000425,267671.64000000415,-6653.299999999901
30474,2022-10-10 09:30:00,56.23,261074.57000000426,267671.64000000415,-6597.069999999891
30475,2022-10-10 09:35:00,-1969.35,259105.22000000425,267671.64000000415,-8566.419999999896
30476,2022-10-10 09:40:00,540.77,259645.99000000424,267671.64000000415,-8025.649999999907
30477,2022-10-10 09:45:00,-1464.55,258181.44000000425,267671.64000000415,-9490.199999999895
30478,2022-10-10 09:50:00,874.72,259056.16000000425,267671.64000000415,-8615.479999999894
30479,2022-10-10 09:55:00,234.22,259290.38000000425,267671.64000000415,-8381.259999999893
30480,2022-10-10 10:00:00,630.95,259921.33000000427,267671.64000000415,-7750.309999999881
30481,2022-10-10 10:05:00,-1888.53,258032.80000000427,267671.64000000415,-9638.83999999988
30482,2022-10-10 10:10:00,1818.33,259851.13000000425,267671.64000000415,-7820.509999999893
30483,2022-10-10 10:15:00,-597.47,259253.66000000425,267671.64000000415,-8417.979999999894
30484,2022-10-10 10:20:00,684.92,259938.58000000427,267671.64000000415,-7733.059999999881
30485,2022-10-10 10:25:00,-1181.33,258757.25000000428,267671.64000000415,-8914.389999999868
30486,2022-10-10 10:30:00,-1743.37,257013.88000000428,267671.64000000415,-10657.759999999864
30487,2022-10-10 10:35:00,-261.89,256751.99000000427,267671.64000000415,-10919.649999999878
30488,2022-10-10 10:40:00,-738.64,256013.35000000425,267671.64000000415,-11658.289999999892
30489,2022-10-10 10:45:00,1544.08,257557.43000000424,267671.64000000415,-10114.209999999905
30490,2022-10-10 10:50:00,237.1,257794.53000000425,267671.64000000415,-9877.109999999899
30491,2022-10-10 10:55:00,227.86,258022.39000000423,267671.64000000415,-9649.249999999913
30492,2022-10-10 11:00:00,1783.29,259805.68000000424,267671.64000000415,-7865.9599999999045
30493,2022-10-10 11:05:00,-1463.07,258342.61000000424,267671.64000000415,-9329.029999999912
30494,2022-10-10 11:10:00,-1006.01,257336.60000000423,267671.64000000415,-10335.03999999992
30495,2022-10-10 11:15:00,-104.01,257232.59000000422,267671.64000000415,-10439.04999999993
30496,2022-10-10 11:20:00,1446.56,258679.1500000042,267671.64000000415,-8992.489999999932
30497,2022-10-10 11:25:00,1926.27,260605.4200000042,267671.64000000415,-7066.219999999943
30498,2022-10-10 11:30:00,841.02,261446.4400000042,267671.64000000415,-6225.199999999953
30499,2022-10-10 11:35:00,1379.21,262825.6500000042,267671.64000000415,-4845.9899999999325
30500,2022-10-10 11:40:00,1542.32,264367.9700000042,267671.64000000415,-3303.6699999999255
30501,2022-10-10 11:45:00,-265.79,264102.18000000424,267671.64000000415,-3569.4599999999045
30502,2022-10-10 11:50:00,-1497.18,262605.00000000425,267671.64000000415,-5066.639999999898
30503,2022-10-10 11:55:00,-1257.31,261347.69000000425,267671.64000000415,-6323.949999999895
30504,2022-10-10 12:00:00,108.66,261456.35000000425,267671.64000000415,-6215.289999999892
30505,2022-10-10 12:05:00,1570.42,263026.77000000427,267671.64000000415,-4644.869999999879
30506,2022-10-10 12:10:00,89.2,263115.9700000043,267671.64000000415,-4555.669999999867
30507,2022-10-10 12:15:00,1699.84,264815.8100000043,267671.64000000415,-2855.8299999998417
30508,2022-10-10 12:20:00,1965.16,266780.9700000043,267671.64000000415,-890.6699999998673
30509,2022-10-10 12:25:00,-1651.23,265129.7400000043,267671.64000000415,-2541.8999999998487
30510,2022-10-10 12:30:00,-1070.8,264058.9400000043,267671.64000000415,-3612.699999999837
30511,2022-10-10 12:35:00,1153.22,265212.1600000043,267671.64000000415,-2459.479999999865
30512,2022-10-10 12:40:00,-928.06,264284.1000000043,267671.64000000415,-3387.5399999998626
30513,2022-10-10 12:45:00,-749.45,263534.6500000043,267671.64000000415,-4136.989999999874
30514,2022-10-10 12:50:00,-99.29,263435.3600000043,267671.64000000415,-4236.279999999853
30515,2022-10-10 12:55:00,-1264.1,262171.2600000043,267671.64000000415,-5500.37999999983
30516,2022-10-10 13:00:00,-1710.54,260460.7200000043,267671.64000000415,-7210.919999999838
30517,2022-10-10 13:05:00,-973.98,259486.7400000043,267671.64000000415,-8184.899999999849
30518,2022-10-10 13:10:00,1133.46,260620.2000000043,267671.64000000415,-7051.439999999857
30519,2022-10-10 13:15:00,1228.53,261848.7300000043,267671.64000000415,-5822.909999999858
30520,2022-10-10 13:20:00,-158.1,261690.63000000428,267671.64000000415,-5981.009999999864
30521,2022-10-10 13:25:00,1065.02,262755.6500000043,267671.64000000415,-4915.989999999874
30522,2022-10-10 13:30:00,943.91,263699.56000000425,267671.64000000415,-3972.0799999999
30523,2022-10-10 13:35:00,1870.25,265569.81000000425,267671.64000000415,-2101.8299999999
30524,2022-10-10 13:40:00,1355.02,266924.83000000427,267671.64000000415,-746.8099999998813
30525,2022-10-10 13:45:00,1529.28,268454.1100000043,267671.64000000415,782.4700000001467
30526,2022-10-10 13:50:00,-1459.69,266994.4200000043,267671.64000000415,-677.2199999998556
30527,2022-10-10 13:55:00,-549.1,266445.3200000043,267671.64000000415,-1226.3199999998324
30528,2022-10-10 14:00:00,-884.44,265560.8800000043,267671.64000000415,-2110.7599999998347
30529,2022-10-10 14:05:00,801.27,266362.15000000433,267671.64000000415,-1309.489999999816
30530,2022-10-10 14:10:00,1313.03,267675.18000000436,267671.64000000415,3.540000000211876
30531,2022-10-10 14:15:00,216.01,267891.19000000437,267671.64000000415,219.5500000002212
30532,2022-10-10 14:20:00,1330.28,269221.4700000044,267671.64000000415,1549.8300000002491
30533,2022-10-10 14:25:00,911.24,270132.7100000044,267671.64000000415,2461.07000000024
30534,2022-10-10 14:30:00,824.79,270957.50000000437,267671.64000000415,3285.860000000219
30535,2022-10-10 14:35:00,-477.54,270479.9600000044,267671.64000000415,2808.32000000024
30536,2022-10-10 14:40:00,10.92,270490.88000000437,267671.64000000415,2819.2400000002235
30537,2022-10-10 14:45:00,1802.21,272293.0900000044,267671.64000000415,4621.4500000002445
30538,2022-10-10 14:50:00,1021.25,273314.3400000044,267671.64000000415,5642.7000000002445
30539,2022-10-10 14:55:00,1121.95,274436.2900000044,267671.64000000415,6764.650000000256
30540,2022-10-10 15:00:00,1561.55,275997.8400000044,267671.64000000415,8326.200000000244
30541,2022-10-10 15:05:00,558.63,276556.4700000044,267671.64000000415,8884.83000000025
30542,2022-10-10 15:10:00,-918.78,275637.69000000437,267671.64000000415,7966.050000000221
30543,2022-10-10 15:15:00,-138.93,275498.7600000044,267671.64000000415,7827.120000000228
30544,2022-10-10 15:20:00,-1293.53,274205.23000000435,267671.64000000415,6533.5900000002
30545,2022-10-10 15:25:00,-695.04,273510.19000000437,267671.64000000415,5838.550000000221
30546,2022-10-10 15:30:00,-694.9,272815.29000000434,267671.64000000415,5143.650000000198
30547,2022-10-10 15:35:00,1631.17,274446.4600000043,267671.64000000415,6774.820000000182
30548,2022-10-10 15:40:00,-833.17,273613.29000000434,267671.64000000415,5941.650000000198
30549,2022-10-10 15:45:00,740.45,274353.74000000436,267671.64000000415,6682.10000000021
30550,2022-10-10 15:50:00,1862.84,276216.5800000044,267671.64000000415,8544.940000000235
30551,2022-10-10 15:55:00,-998.87,275217.7100000044,267671.64000000415,7546.07000000024
30552,2022-10-10 16:00:00,-302.07,274915.6400000044,267671.64000000415,7244.000000000233
30553,2022-10-10 16:05:00,1549.72,276465.36000000435,267671.64000000415,8793.720000000205
30554,2022-10-10 16:10:00,1152.42,277617.78000000434,267671.64000000415,9946.140000000189
30555,2022-10-10 16:15:00,1769.9,279387.68000000436,267671.64000000415,11716.040000000212
30556,2022-10-10 16:20:00,1650.5,281038.18000000436,267671.64000000415,13366.540000000212
30557,2022-10-10 16:25:00,588.83,281627.0100000044,267671.64000000415,13955.370000000228
30558,2022-10-10 16:30:00,584.01,282211.0200000044,267671.64000000415,14539.380000000237
30559,2022-10-10 16:35:00,20.66,282231.68000000436,267671.64000000415,14560.040000000212
30560,2022-10-10 16:40:00,522.95,282754.63000000437,267671.64000000415,15082.990000000224
30561,2022-10-10 16:45:00,-45.94,282708.69000000437,267671.64000000415,15037.050000000221
30562,2022-10-10 16:50:00,502.96,283211.6500000044,267671.64000000415,15540.010000000242
30563,2022-10-10 16:55:00,691.58,283903.2300000044,267671.64000000415,16231.590000000258
30564,2022-10-11 08:00:00,1840.97,285744.2000000044,283903.2300000044,1840.969999999972
30565,2022-10-11 08:05:00,1887.08,287631.2800000044,283903.2300000044,3728.0499999999884
30566,2022-10-11 08:10:00,454.07,288085.3500000044,283903.2300000044,4182.119999999995
30567,2022-10-11 08:15:00,-1594.03,286491.3200000044,283903.2300000044,2588.0899999999674
30568,2022-10-11 08:20:00,1209.99,287701.31000000436,283903.2300000044,3798.079999999958
30569,2022-10-11 08:25:00,1968.04,289669.35000000434,283903.2300000044,5766.119999999937
30570,2022-10-11 08:30:00,-824.96,288844.3900000043,283903.2300000044,4941.159999999916
30571,2022-10-11 08:35:00,1322.63,290167.0200000043,283903.2300000044,6263.789999999921
30572,2022-10-11 08:40:00,-33.79,290133.23000000435,283903.2300000044,6229.999999999942
30573,2022-10-11 08:45:00,-1290.26,288842.97000000434,283903.2300000044,4939.7399999999325
30574,2022-10-11 08:50:00,1730.41,290573.3800000043,283903.2300000044,6670.149999999907
30575,2022-10-11 08:55:00,1741.55,292314.9300000043,283903.2300000044,8411.699999999895
30576,2022-10-11 09:00:00,721.77,293036.7000000043,283903.2300000044,9133.469999999914
30577,2022-10-11 09:05:00,1685.01,294721.7100000043,283903.2300000044,10818.479999999923
30578,2022-10-11 09:10:00,-712.5,294009.2100000043,283903.2300000044,10105.979999999923
30579,2022-10-11 09:15:00,-1270.61,292738.60000000434,283903.2300000044,8835.369999999937
30580,2022-10-11 09:20:00,1627.12,294365.72000000434,283903.2300000044,10462.489999999932
30581,2022-10-11 09:25:00,-354.82,294010.90000000433,283903.2300000044,10107.669999999925
30582,2022-10-11 09:30:00,-681.49,293329.41000000434,283903.2300000044,9426.179999999935
30583,2022-10-11 09:35:00,1985.67,295315.0800000043,283903.2300000044,11411.849999999919
30584,2022-10-11 09:40:00,865.18,296180.2600000043,283903.2300000044,12277.029999999912
30585,2022-10-11 09:45:00,398.72,296578.9800000043,283903.2300000044,12675.749999999884
30586,2022-10-11 09:50:00,1243.6,297822.58000000427,283903.2300000044,13919.34999999986
30587,2022-10-11 09:55:00,1657.89,299480.4700000043,283903.2300000044,15577.239999999874
30588,2022-10-11 10:00:00,-870.41,298610.0600000043,283903.2300000044,14706.8299999999
30589,2022-10-11 10:05:00,-373.81,298236.2500000043,283903.2300000044,14333.019999999902
30590,2022-10-11 10:10:00,873.26,299109.5100000043,283903.2300000044,15206.279999999912
30591,2022-10-11 10:15:00,-509.65,298599.8600000043,283903.2300000044,14696.629999999888
30592,2022-10-11 10:20:00,-1602.18,296997.6800000043,283903.2300000044,13094.449999999895
30593,2022-10-11 10:25:00,-824.17,296173.5100000043,283903.2300000044,12270.279999999912
30594,2022-10-11 10:30:00,-63.25,296110.2600000043,283903.2300000044,12207.029999999912
30595,2022-10-11 10:35:00,968.13,297078.3900000043,283903.2300000044,13175.159999999916
30596,2022-10-11 10:40:00,835.62,297914.0100000043,283903.2300000044,14010.779999999912
30597,2022-10-11 10:45:00,-1202.87,296711.1400000043,283903.2300000044,12807.909999999916
30598,2022-10-11 10:50:00,1322.09,298033.23000000435,283903.2300000044,14129.999999999942
30599,2022-10-11 10:55:00,1729.51,299762.74000000436,283903.2300000044,15859.509999999951
30600,2022-10-11 11:00:00,-1978.56,297784.18000000436,283903.2300000044,13880.949999999953
30601,2022-10-11 11:05:00,-1792.69,295991.49000000436,283903.2300000044,12088.259999999951
30602,2022-10-11 11:10:00,1074.82,297066.31000000436,283903.2300000044,13163.079999999958
30603,2022-10-11 11:15:00,576.22,297642.53000000434,283903.2300000044,13739.29999999993
30604,2022-10-11 11:20:00,1495.67,299138.2000000043,283903.2300000044,15234.969999999914
30605,2022-10-11 11:25:00,-1949.43,297188.7700000043,283903.2300000044,13285.53999999992
30606,2022-10-11 11:30:00,-128.0,297060.7700000043,283903.2300000044,13157.53999999992
30607,2022-10-11 11:35:00,1888.14,298948.91000000434,283903.2300000044,15045.679999999935
30608,2022-10-11 11:40:00,-1012.04,297936.87000000436,283903.2300000044,14033.639999999956
30609,2022-10-11 11:45:00,-1093.24,296843.63000000437,283903.2300000044,12940.399999999965
30610,2022-10-11 11:50:00,1033.05,297876.68000000436,283903.2300000044,13973.449999999953
30611,2022-10-11 11:55:00,-666.43,297210.25000000437,283903.2300000044,13307.01999999996
30612,2022-10-11 12:00:00,1701.87,298912.12000000436,283903.2300000044,15008.889999999956
30613,2022-10-11 12:05:00,-1834.85,297077.2700000044,283903.2300000044,13174.039999999979
30614,2022-10-11 12:10:00,1620.99,298698.2600000044,283903.2300000044,14795.02999999997
30615,2022-10-11 12:15:00,389.6,299087.86000000435,283903.2300000044,15184.629999999946
30616,2022-10-11 12:20:00,-1338.31,297749.55000000435,283903.2300000044,13846.319999999949
30617,2022-10-11 12:25:00,-307.61,297441.94000000437,283903.2300000044,13538.709999999963
30618,2022-10-11 12:30:00,-1712.25,295729.69000000437,283903.2300000044,11826.459999999963
30619,2022-10-11 12:35:00,-1945.89,293783.80000000435,283903.2300000044,9880.569999999949
30620,2022-10-11 12:40:00,1863.58,295647.38000000437,283903.2300000044,11744.149999999965
30621,2022-10-11 12:45:00,233.74,295881.12000000436,283903.2300000044,11977.889999999956
30622,2022-10-11 12:50:00,-1095.76,294785.36000000435,283903.2300000044,10882.129999999946
30623,2022-10-11 12:55:00,-948.51,293836.85000000434,283903.2300000044,9933.619999999937
30624,2022-10-11 13:00:00,1330.33,295167.18000000436,283903.2300000044,11263.949999999953
30625,2022-10-11 13:05:00,1973.85,297141.03000000434,283903.2300000044,13237.79999999993
30626,2022-10-11 13:10:00,-332.56,296808.47000000434,283903.2300000044,12905.239999999932
30627,2022-10-11 13:15:00,-1547.06,295261.41000000434,283903.2300000044,11358.179999999935
30628,2022-10-11 13:20:00,-1196.5,294064.91000000434,283903.2300000044,10161.679999999935
30629,2022-10-11 13:25:00,1872.21,295937.12000000436,283903.2300000044,12033.889999999956
30630,2022-10-11 13:30:00,668.86,296605.98000000435,283903.2300000044,12702.749999999942
30631,2022-10-11 13:35:00,87.53,296693.5100000044,283903.2300000044,12790.27999999997
30632,2022-10-11 13:40:00,655.42,297348.93000000436,283903.2300000044,13445.699999999953
30633,2022-10-11 13:45:00,377.18,297726.11000000435,283903.2300000044,13822.879999999946
30634,2022-10-11 13:50:00,-481.24,297244.87000000436,283903.2300000044,13341.639999999956
30635,2022-10-11 13:55:00,1868.69,299113.56000000436,283903.2300000044,15210.329999999958
30636,2022-10-11 14:00:00,-1749.61,297363.9500000044,283903.2300000044,13460.719999999972
30637,2022-10-11 14:05:00,1796.15,299160.1000000044,283903.2300000044,15256.869999999995
30638,2022-10-11 14:10:00,1606.88,300766.9800000044,283903.2300000044,16863.75
30639,2022-10-11 14:15:00,1546.07,302313.0500000044,283903.2300000044,18409.820000000007
30640,2022-10-11 14:20:00,838.58,303151.6300000044,283903.2300000044,19248.400000000023
30641,2022-10-11 14:25:00,1458.23,304609.8600000044,283903.2300000044,20706.630000000005
30642,2022-10-11 14:30:00,200.48,304810.3400000044,283903.2300000044,20907.109999999986
30643,2022-10-11 14:35:00,-1828.35,302981.9900000044,283903.2300000044,19078.76000000001
30644,2022-10-11 14:40:00,-812.16,302169.83000000444,283903.2300000044,18266.600000000035
30645,2022-10-11 14:45:00,-60.13,302109.70000000444,283903.2300000044,18206.47000000003
30646,2022-10-11 14:50:00,227.09,302336.79000000446,283903.2300000044,18433.560000000056
30647,2022-10-11 14:55:00,-1003.41,301333.3800000045,283903.2300000044,17430.15000000008
30648,2022-10-11 15:00:00,-1543.0,299790.3800000045,283903.2300000044,15887.150000000081
30649,2022-10-11 15:05:00,1744.02,301534.4000000045,283903.2300000044,17631.1700000001
30650,2022-10-11 15:10:00,-148.01,301386.3900000045,283903.2300000044,17483.16000000009
30651,2022-10-11 15:15:00,-827.63,300558.7600000045,283903.2300000044,16655.530000000086
30652,2022-10-11 15:20:00,-1860.6,298698.1600000045,283903.2300000044,14794.93000000011
30653,2022-10-11 15:25:00,423.89,299122.0500000045,283903.2300000044,15218.820000000123
30654,2022-10-11 15:30:00,1363.26,300485.31000000454,283903.2300000044,16582.080000000133
30655,2022-10-11 15:35:00,155.49,300640.8000000045,283903.2300000044,16737.570000000123
30656,2022-10-11 15:40:00,-931.69,299709.1100000045,283903.2300000044,15805.880000000121
30657,2022-10-11 15:45:00,-1497.42,298211.69000000454,283903.2300000044,14308.460000000137
30658,2022-10-11 15:50:00,-1157.53,297054.1600000045,283903.2300000044,13150.93000000011
30659,2022-10-11 15:55:00,-1263.45,295790.7100000045,283903.2300000044,11887.480000000098
30660,2022-10-11 16:00:00,612.57,296403.2800000045,283903.2300000044,12500.050000000105
30661,2022-10-11 16:05:00,1116.59,297519.87000000454,283903.2300000044,13616.64000000013
30662,2022-10-11 16:10:00,-1529.23,295990.64000000455,283903.2300000044,12087.410000000149
30663,2022-10-11 16:15:00,-382.56,295608.08000000456,283903.2300000044,11704.850000000151
30664,2022-10-11 16:20:00,-253.12,295354.96000000456,283903.2300000044,11451.730000000156
30665,2022-10-11 16:25:00,1649.26,297004.22000000457,283903.2300000044,13100.990000000165
30666,2022-10-11 16:30:00,1127.98,298132.20000000455,283903.2300000044,14228.970000000147
30667,2022-10-11 16:35:00,-1001.15,297131.0500000045,283903.2300000044,13227.820000000123
30668,2022-10-11 16:40:00,1316.72,298447.7700000045,283903.2300000044,14544.540000000095
30669,2022-10-11 16:45:00,2.76,298450.5300000045,283903.2300000044,14547.300000000105
30670,2022-10-11 16:50:00,-624.18,297826.3500000045,283903.2300000044,13923.120000000112
30671,2022-10-11 16:55:00,-653.67,297172.68000000453,283903.2300000044,13269.450000000128
30672,2022-10-12 08:00:00,1676.29,298848.9700000045,297172.68000000453,1676.289999999979
30673,2022-10-12 08:05:00,-420.55,298428.4200000045,297172.68000000453,1255.7399999999907
30674,2022-10-12 08:10:00,1157.13,299585.5500000045,297172.68000000453,2412.8699999999953
30675,2022-10-12 08:15:00,-79.81,299505.74000000453,297172.68000000453,2333.0599999999977
30676,2022-10-12 08:20:00,-1308.07,298197.6700000045,297172.68000000453,1024.9899999999907
30677,2022-10-12 08:25:00,-1916.68,296280.99000000453,297172.68000000453,-891.6900000000023
30678,2022-10-12 08:30:00,198.66,296479.6500000045,297172.68000000453,-693.0300000000279
30679,2022-10-12 08:35:00,-1558.71,294920.9400000045,297172.68000000453,-2251.740000000049
30680,2022-10-12 08:40:00,-880.88,294040.0600000045,297172.68000000453,-3132.6200000000536
30681,2022-10-12 08:45:00,1418.28,295458.3400000045,297172.68000000453,-1714.3400000000256
30682,2022-10-12 08:50:00,-1013.02,294445.3200000045,297172.68000000453,-2727.3600000000442
30683,2022-10-12 08:55:00,-1877.68,292567.6400000045,297172.68000000453,-4605.040000000037
30684,2022-10-12 09:00:00,-1404.79,291162.8500000045,297172.68000000453,-6009.830000000016
30685,2022-10-12 09:05:00,1137.27,292300.12000000454,297172.68000000453,-4872.559999999998
30686,2022-10-12 09:10:00,1281.19,293581.31000000454,297172.68000000453,-3591.3699999999953
30687,2022-10-12 09:15:00,-930.67,292650.64000000455,297172.68000000453,-4522.039999999979
30688,2022-10-12 09:20:00,-1349.8,291300.84000000457,297172.68000000453,-5871.839999999967
30689,2022-10-12 09:25:00,300.73,291601.57000000455,297172.68000000453,-5571.109999999986
30690,2022-10-12 09:30:00,1133.92,292735.49000000453,297172.68000000453,-4437.190000000002
30691,2022-10-12 09:35:00,206.55,292942.0400000045,297172.68000000453,-4230.640000000014
30692,2022-10-12 09:40:00,-733.91,292208.13000000454,297172.68000000453,-4964.549999999988
30693,2022-10-12 09:45:00,-1389.03,290819.1000000045,297172.68000000453,-6353.580000000016
30694,2022-10-12 09:50:00,1359.14,292178.24000000453,297172.68000000453,-4994.440000000002
30695,2022-10-12 09:55:00,1206.2,293384.44000000454,297172.68000000453,-3788.2399999999907
30696,2022-10-12 10:00:00,-1382.47,292001.97000000457,297172.68000000453,-5170.709999999963
30697,2022-10-12 10:05:00,852.4,292854.3700000046,297172.68000000453,-4318.3099999999395
30698,2022-10-12 10:10:00,1968.41,294822.78000000457,297172.68000000453,-2349.899999999965
30699,2022-10-12 10:15:00,851.89,295674.6700000046,297172.68000000453,-1498.009999999951
30700,2022-10-12 10:20:00,-1293.39,294381.28000000457,297172.68000000453,-2791.399999999965
30701,2022-10-12 10:25:00,-1673.29,292707.9900000046,297172.68000000453,-4464.689999999944
30702,2022-10-12 10:30:00,1688.52,294396.5100000046,297172.68000000453,-2776.1699999999255
30703,2022-10-12 10:35:00,-104.99,294291.5200000046,297172.68000000453,-2881.159999999916
30704,2022-10-12 10:40:00,1908.74,296200.2600000046,297172.68000000453,-972.4199999999255
30705,2022-10-12 10:45:00,-701.55,295498.7100000046,297172.68000000453,-1673.9699999999139
30706,2022-10-12 10:50:00,1853.12,297351.8300000046,297172.68000000453,179.1500000000815
30707,2022-10-12 10:55:00,754.34,298106.17000000464,297172.68000000453,933.4900000001071
30708,2022-10-12 11:00:00,1405.66,299511.8300000046,297172.68000000453,2339.1500000000815
30709,2022-10-12 11:05:00,-1536.47,297975.36000000464,297172.68000000453,802.6800000001094
30710,2022-10-12 11:10:00,931.03,298906.39000000467,297172.68000000453,1733.7100000001374
30711,2022-10-12 11:15:00,-28.66,298877.7300000047,297172.68000000453,1705.050000000163
30712,2022-10-12 11:20:00,-187.44,298690.2900000047,297172.68000000453,1517.6100000001607
30713,2022-10-12 11:25:00,11.65,298701.9400000047,297172.68000000453,1529.260000000184
30714,2022-10-12 11:30:00,-310.35,298391.59000000474,297172.68000000453,1218.9100000002072
30715,2022-10-12 11:35:00,761.98,299153.5700000047,297172.68000000453,1980.8900000001886
30716,2022-10-12 11:40:00,877.4,300030.97000000475,297172.68000000453,2858.290000000212
30717,2022-10-12 11:45:00,-1706.89,298324.08000000473,297172.68000000453,1151.400000000198
30718,2022-10-12 11:50:00,544.63,298868.71000000474,297172.68000000453,1696.0300000002026
30719,2022-10-12 11:55:00,-1368.92,297499.79000000475,297172.68000000453,327.11000000021886
30720,2022-10-12 12:00:00,-710.85,296788.9400000048,297172.68000000453,-383.73999999975786
30721,2022-10-12 12:05:00,1790.05,298578.99000000476,297172.68000000453,1406.3100000002305
30722,2022-10-12 12:10:00,-1435.16,297143.8300000048,297172.68000000453,-28.849999999743886
30723,2022-10-12 12:15:00,479.9,297623.7300000048,297172.68000000453,451.0500000002794
30724,2022-10-12 12:20:00,424.36,298048.0900000048,297172.68000000453,875.4100000002654
30725,2022-10-12 12:25:00,1776.19,299824.2800000048,297172.68000000453,2651.6000000002678
30726,2022-10-12 12:30:00,1001.81,300826.0900000048,297172.68000000453,3653.4100000002654
30727,2022-10-12 12:35:00,-1868.29,298957.8000000048,297172.68000000453,1785.1200000002864
30728,2022-10-12 12:40:00,-992.64,297965.1600000048,297172.68000000453,792.4800000002724
30729,2022-10-12 12:45:00,-1211.77,296753.3900000048,297172.68000000453,-419.2899999997462
30730,2022-10-12 12:50:00,-1270.26,295483.1300000048,297172.68000000453,-1689.5499999997555
30731,2022-10-12 12:55:00,1929.51,297412.6400000048,297172.68000000453,239.96000000025379
30732,2022-10-12 13:00:00,511.19,297923.8300000048,297172.68000000453,751.1500000002561
30733,2022-10-12 13:05:00,-1200.55,296723.2800000048,297172.68000000453,-449.39999999973224
30734,2022-10-12 13:10:00,-617.87,296105.4100000048,297172.68000000453,-1067.2699999997276
30735,2022-10-12 13:15:00,-427.97,295677.44000000483,297172.68000000453,-1495.2399999996996
30736,2022-10-12 13:20:00,1562.84,297240.28000000486,297172.68000000453,67.60000000032596
30737,2022-10-12 13:25:00,1259.15,298499.4300000049,297172.68000000453,1326.7500000003492
30738,2022-10-12 13:30:00,155.86,298655.29000000487,297172.68000000453,1482.6100000003353
30739,2022-10-12 13:35:00,-358.81,298296.48000000487,297172.68000000453,1123.8000000003376
30740,2022-10-12 13:40:00,1002.46,299298.9400000049,297172.68000000453,2126.2600000003586
30741,2022-10-12 13:45:00,-1666.82,297632.1200000049,297172.68000000453,459.4400000003516
30742,2022-10-12 13:50:00,-315.89,297316.23000000487,297172.68000000453,143.5500000003376
30743,2022-10-12 13:55:00,1066.01,298382.2400000049,297172.68000000453,1209.560000000347
30744,2022-10-12 14:00:00,893.54,299275.78000000486,297172.68000000453,2103.100000000326
30745,2022-10-12 14:05:00,1423.7,300699.48000000487,297172.68000000453,3526.8000000003376
30746,2022-10-12 14:10:00,986.08,301685.5600000049,297172.68000000453,4512.880000000354
30747,2022-10-12 14:15:00,-438.97,301246.5900000049,297172.68000000453,4073.910000000382
30748,2022-10-12 14:20:00,1638.68,302885.2700000049,297172.68000000453,5712.590000000375
30749,2022-10-12 14:25:00,632.66,303517.9300000049,297172.68000000453,6345.250000000349
30750,2022-10-12 14:30:00,98.13,303616.0600000049,297172.68000000453,6443.380000000354
30751,2022-10-12 14:35:00,-1338.64,302277.4200000049,297172.68000000453,5104.74000000034
30752,2022-10-12 14:40:00,-712.64,301564.78000000486,297172.68000000453,4392.100000000326
30753,2022-10-12 14:45:00,1370.46,302935.2400000049,297172.68000000453,5762.560000000347
30754,2022-10-12 14:50:00,58.46,302993.7000000049,297172.68000000453,5821.020000000368
30755,2022-10-12 14:55:00,-207.83,302785.8700000049,297172.68000000453,5613.190000000352
30756,2022-10-12 15:00:00,-1151.46,301634.41000000486,297172.68000000453,4461.730000000331
30757,2022-10-12 15:05:00,-824.89,300809.52000000485,297172.68000000453,3636.8400000003166
30758,2022-10-12 15:10:00,-909.7,299899.82000000484,297172.68000000453,2727.140000000305
30759,2022-10-12 15:15:00,-958.71,298941.1100000048,297172.68000000453,1768.430000000284
30760,2022-10-12 15:20:00,582.66,299523.7700000048,297172.68000000453,2351.0900000002584
30761,2022-10-12 15:25:00,883.2,300406.9700000048,297172.68000000453,3234.29000000027
30762,2022-10-12 15:30:00,131.46,300538.4300000048,297172.68000000453,3365.750000000291
30763,2022-10-12 15:35:00,-725.86,299812.57000000484,297172.68000000453,2639.890000000305
30764,2022-10-12 15:40:00,1989.73,301802.3000000048,297172.68000000453,4629.620000000286
30765,2022-10-12 15:45:00,-174.84,301627.4600000048,297172.68000000453,4454.780000000261
30766,2022-10-12 15:50:00,-479.37,301148.0900000048,297172.68000000453,3975.4100000002654
30767,2022-10-12 15:55:00,736.0,301884.0900000048,297172.68000000453,4711.410000000265
30768,2022-10-12 16:00:00,1741.26,303625.3500000048,297172.68000000453,6452.670000000275
30769,2022-10-12 16:05:00,137.53,303762.88000000484,297172.68000000453,6590.200000000303
30770,2022-10-12 16:10:00,-1040.77,302722.1100000048,297172.68000000453,5549.430000000284
30771,2022-10-12 16:15:00,1714.56,304436.6700000048,297172.68000000453,7263.990000000282
30772,2022-10-12 16:20:00,-1362.09,303074.5800000048,297172.68000000453,5901.900000000256
30773,2022-10-12 16:25:00,911.16,303985.74000000476,297172.68000000453,6813.0600000002305
30774,2022-10-12 16:30:00,-781.72,303204.0200000048,297172.68000000453,6031.340000000258
30775,2022-10-12 16:35:00,1353.33,304557.3500000048,297172.68000000453,7384.670000000275
30776,2022-10-12 16:40:00,1932.46,306489.8100000048,297172.68000000453,9317.130000000296
30777,2022-10-12 16:45:00,-1539.7,304950.1100000048,297172.68000000453,7777.430000000284
30778,2022-10-12 16:50:00,-1999.43,302950.6800000048,297172.68000000453,5778.000000000291
30779,2022-10-12 16:55:00,1973.75,304924.4300000048,297172.68000000453,7751.750000000291
30780,2022-10-13 08:00:00,-1097.55,303826.88000000484,304924.4300000048,-1097.5499999999884
30781,2022-10-13 08:05:00,495.25,304322.13000000484,304924.4300000048,-602.2999999999884
30782,2022-10-13 08:10:00,-918.61,303403.52000000485,304924.4300000048,-1520.9099999999744
30783,2022-10-13 08:15:00,201.8,303605.32000000484,304924.4300000048,-1319.109999999986
30784,2022-10-13 08:20:00,-1703.49,301901.83000000485,304924.4300000048,-3022.5999999999767
30785,2022-10-13 08:25:00,-523.99,301377.84000000486,304924.4300000048,-3546.5899999999674
30786,2022-10-13 08:30:00,1354.58,302732.4200000049,304924.4300000048,-2192.009999999951
30787,2022-10-13 08:35:00,-1322.26,301410.16000000486,304924.4300000048,-3514.2699999999604
30788,2022-10-13 08:40:00,1543.57,302953.73000000487,304924.4300000048,-1970.6999999999534
30789,2022-10-13 08:45:00,-531.66,302422.0700000049,304924.4300000048,-2502.359999999928
30790,2022-10-13 08:50:00,-1595.71,300826.3600000049,304924.4300000048,-4098.069999999949
30791,2022-10-13 08:55:00,-40.32,300786.04000000487,304924.4300000048,-4138.389999999956
30792,2022-10-13 09:00:00,1925.34,302711.3800000049,304924.4300000048,-2213.04999999993
30793,2022-10-13 09:05:00,-816.86,301894.5200000049,304924.4300000048,-3029.909999999916
30794,2022-10-13 09:10:00,1823.32,303717.8400000049,304924.4300000048,-1206.5899999999092
30795,2022-10-13 09:15:00,-1851.96,301865.8800000049,304924.4300000048,-3058.54999999993
30796,2022-10-13 09:20:00,757.37,302623.2500000049,304924.4300000048,-2301.179999999935
30797,2022-10-13 09:25:00,957.05,303580.3000000049,304924.4300000048,-1344.1299999999464
30798,2022-10-13 09:30:00,1693.38,305273.6800000049,304924.4300000048,349.2500000000582
30799,2022-10-13 09:35:00,-523.09,304750.59000000486,304924.4300000048,-173.8399999999674
30800,2022-10-13 09:40:00,-1683.62,303066.97000000486,304924.4300000048,-1857.4599999999627
30801,2022-10-13 09:45:00,358.19,303425.16000000486,304924.4300000048,-1499.2699999999604
30802,2022-10-13 09:50:00,1088.7,304513.8600000049,304924.4300000048,-410.5699999999488
30803,2022-10-13 09:55:00,-1332.06,303181.8000000049,304924.4300000048,-1742.6299999999464
30804,2022-10-13 10:00:00,1262.8,304444.60000000487,304924.4300000048,-479.8299999999581
30805,2022-10-13 10:05:00,670.45,305115.0500000049,304924.4300000048,190.62000000005355
30806,2022-10-13 10:10:00,1993.75,307108.8000000049,304924.4300000048,2184.3700000000536
30807,2022-10-13 10:15:00,904.16,308012.96000000485,304924.4300000048,3088.530000000028
30808,2022-10-13 10:20:00,1292.92,309305.88000000484,304924.4300000048,4381.450000000012
30809,2022-10-13 10:25:00,-1906.25,307399.63000000484,304924.4300000048,2475.2000000000116
30810,2022-10-13 10:30:00,1079.93,308479.5600000048,304924.4300000048,3555.1300000000047
30811,2022-10-13 10:35:00,-723.48,307756.08000000485,304924.4300000048,2831.6500000000233
30812,2022-10-13 10:40:00,213.44,307969.52000000485,304924.4300000048,3045.0900000000256
30813,2022-10-13 10:45:00,-1535.67,306433.85000000487,304924.4300000048,1509.420000000042
30814,2022-10-13 10:50:00,-1439.9,304993.95000000484,304924.4300000048,69.52000000001863
30815,2022-10-13 10:55:00,1176.26,306170.21000000485,304924.4300000048,1245.780000000028
30816,2022-10-13 11:00:00,1879.31,308049.52000000485,304924.4300000048,3125.0900000000256
30817,2022-10-13 11:05:00,1583.23,309632.75000000483,304924.4300000048,4708.320000000007
30818,2022-10-13 11:10:00,305.07,309937.82000000484,304924.4300000048,5013.390000000014
30819,2022-10-13 11:15:00,1566.43,311504.25000000483,304924.4300000048,6579.820000000007
30820,2022-10-13 11:20:00,534.55,312038.8000000048,304924.4300000048,7114.369999999995
30821,2022-10-13 11:25:00,125.99,312164.7900000048,304924.4300000048,7240.359999999986
30822,2022-10-13 11:30:00,-496.2,311668.5900000048,304924.4300000048,6744.159999999974
30823,2022-10-13 11:35:00,1784.14,313452.7300000048,304924.4300000048,8528.299999999988
30824,2022-10-13 11:40:00,1051.88,314504.6100000048,304924.4300000048,9580.179999999993
30825,2022-10-13 11:45:00,752.89,315257.50000000483,304924.4300000048,10333.070000000007
30826,2022-10-13 11:50:00,-1818.13,313439.3700000048,304924.4300000048,8514.940000000002
30827,2022-10-13 11:55:00,283.67,313723.0400000048,304924.4300000048,8798.609999999986
30828,2022-10-13 12:00:00,1156.6,314879.6400000048,304924.4300000048,9955.209999999963
30829,2022-10-13 12:05:00,143.09,315022.7300000048,304924.4300000048,10098.299999999988
30830,2022-10-13 12:10:00,1262.16,316284.8900000048,304924.4300000048,11360.459999999963
30831,2022-10-13 12:15:00,-914.17,315370.7200000048,304924.4300000048,10446.289999999979
30832,2022-10-13 12:20:00,-735.91,314634.8100000048,304924.4300000048,9710.380000000005
30833,2022-10-13 12:25:00,1183.0,315817.8100000048,304924.4300000048,10893.380000000005
30834,2022-10-13 12:30:00,1696.45,317514.26000000484,304924.4300000048,12589.830000000016
30835,2022-10-13 12:35:00,1052.31,318566.57000000484,304924.4300000048,13642.140000000014
30836,2022-10-13 12:40:00,-1421.79,317144.78000000486,304924.4300000048,12220.350000000035
30837,2022-10-13 12:45:00,1238.28,318383.0600000049,304924.4300000048,13458.630000000063
30838,2022-10-13 12:50:00,-1951.49,316431.5700000049,304924.4300000048,11507.140000000072
30839,2022-10-13 12:55:00,-563.58,315867.9900000049,304924.4300000048,10943.560000000056
30840,2022-10-13 13:00:00,84.16,315952.15000000485,304924.4300000048,11027.72000000003
30841,2022-10-13 13:05:00,947.07,316899.22000000486,304924.4300000048,11974.790000000037
30842,2022-10-13 13:10:00,404.76,317303.98000000487,304924.4300000048,12379.550000000047
30843,2022-10-13 13:15:00,480.8,317784.78000000486,304924.4300000048,12860.350000000035
30844,2022-10-13 13:20:00,-1768.71,316016.07000000484,304924.4300000048,11091.640000000014
30845,2022-10-13 13:25:00,1230.44,317246.51000000484,304924.4300000048,12322.080000000016
30846,2022-10-13 13:30:00,-946.24,316300.27000000485,304924.4300000048,11375.840000000026
30847,2022-10-13 13:35:00,1284.89,317585.16000000486,304924.4300000048,12660.73000000004
30848,2022-10-13 13:40:00,1253.94,318839.10000000487,304924.4300000048,13914.670000000042
30849,2022-10-13 13:45:00,1622.84,320461.9400000049,304924.4300000048,15537.510000000068
30850,2022-10-13 13:50:00,-119.44,320342.5000000049,304924.4300000048,15418.070000000065
30851,2022-10-13 13:55:00,-1025.79,319316.7100000049,304924.4300000048,14392.280000000086
30852,2022-10-13 14:00:00,1759.06,321075.7700000049,304924.4300000048,16151.340000000084
30853,2022-10-13 14:05:00,-633.94,320441.8300000049,304924.4300000048,15517.400000000081
30854,2022-10-13 14:10:00,-361.09,320080.7400000049,304924.4300000048,15156.310000000056
30855,2022-10-13 14:15:00,-705.73,319375.0100000049,304924.4300000048,14450.580000000075
30856,2022-10-13 14:20:00,-1515.08,317859.9300000049,304924.4300000048,12935.500000000058
30857,2022-10-13 14:25:00,-532.99,317326.9400000049,304924.4300000048,12402.510000000068
30858,2022-10-13 14:30:00,-1408.47,315918.4700000049,304924.4300000048,10994.040000000095
30859,2022-10-13 14:35:00,1743.85,317662.3200000049,304924.4300000048,12737.890000000072
30860,2022-10-13 14:40:00,1234.08,318896.4000000049,304924.4300000048,13971.970000000088
30861,2022-10-13 14:45:00,1091.45,319987.8500000049,304924.4300000048,15063.4200000001
30862,2022-10-13 14:50:00,1631.31,321619.1600000049,304924.4300000048,16694.730000000098
30863,2022-10-13 14:55:00,1704.11,323323.2700000049,304924.4300000048,18398.840000000084
30864,2022-10-13 15:00:00,-1534.29,321788.9800000049,304924.4300000048,16864.550000000105
30865,2022-10-13 15:05:00,888.89,322677.87000000494,304924.4300000048,17753.44000000012
30866,2022-10-13 15:10:00,-644.63,322033.24000000494,304924.4300000048,17108.810000000114
30867,2022-10-13 15:15:00,-606.77,321426.4700000049,304924.4300000048,16502.040000000095
30868,2022-10-13 15:20:00,-322.75,321103.7200000049,304924.4300000048,16179.290000000095
30869,2022-10-13 15:25:00,1573.9,322677.62000000494,304924.4300000048,17753.19000000012
30870,2022-10-13 15:30:00,584.7,323262.32000000495,304924.4300000048,18337.89000000013
30871,2022-10-13 15:35:00,1480.71,324743.030000005,304924.4300000048,19818.60000000015
30872,2022-10-13 15:40:00,-1943.15,322799.88000000495,304924.4300000048,17875.450000000128
30873,2022-10-13 15:45:00,1860.13,324660.01000000496,304924.4300000048,19735.580000000133
30874,2022-10-13 15:50:00,-1185.53,323474.4800000049,304924.4300000048,18550.050000000105
30875,2022-10-13 15:55:00,-435.78,323038.7000000049,304924.4300000048,18114.270000000077
30876,2022-10-13 16:00:00,-1261.07,321777.6300000049,304924.4300000048,16853.20000000007
30877,2022-10-13 16:05:00,457.48,322235.1100000049,304924.4300000048,17310.68000000005
30878,2022-10-13 16:10:00,1332.24,323567.35000000487,304924.4300000048,18642.920000000042
30879,2022-10-13 16:15:00,901.54,324468.89000000485,304924.4300000048,19544.46000000002
30880,2022-10-13 16:20:00,245.32,324714.21000000485,304924.4300000048,19789.780000000028
30881,2022-10-13 16:25:00,158.48,324872.69000000483,304924.4300000048,19948.26000000001
30882,2022-10-13 16:30:00,-1628.86,323243.83000000485,304924.4300000048,18319.400000000023
30883,2022-10-13 16:35:00,377.31,323621.14000000485,304924.4300000048,18696.71000000002
30884,2022-10-13 16:40:00,-896.85,322724.29000000487,304924.4300000048,17799.860000000044
30885,2022-10-13 16:45:00,-1088.21,321636.08000000485,304924.4300000048,16711.650000000023
30886,2022-10-13 16:50:00,-162.98,321473.10000000487,304924.4300000048,16548.670000000042
30887,2022-10-13 16:55:00,-710.06,320763.04000000487,304924.4300000048,15838.610000000044
30888,2022-10-14 08:00:00,-196.8,320566.2400000049,320763.04000000487,-196.79999999998836
30889,2022-10-14 08:05:00,1261.51,321827.7500000049,320763.04000000487,1064.710000000021
30890,2022-10-14 08:10:00,-1278.82,320548.9300000049,320763.04000000487,-214.10999999998603
30891,2022-10-14 08:15:00,-357.34,320191.59000000486,320763.04000000487,-571.4500000000116
30892,2022-10-14 08:20:00,1152.15,321343.7400000049,320763.04000000487,580.7000000000116
30893,2022-10-14 08:25:00,-1181.26,320162.48000000487,320763.04000000487,-600.5599999999977
30894,2022-10-14 08:30:00,-1879.55,318282.9300000049,320763.04000000487,-2480.109999999986
30895,2022-10-14 08:35:00,-1286.56,316996.3700000049,320763.04000000487,-3766.6699999999837
30896,2022-10-14 08:40:00,-1003.83,315992.54000000487,320763.04000000487,-4770.5
30897,2022-10-14 08:45:00,-562.16,315430.3800000049,320763.04000000487,-5332.659999999974
30898,2022-10-14 08:50:00,1707.06,317137.4400000049,320763.04000000487,-3625.5999999999767
30899,2022-10-14 08:55:00,869.88,318007.3200000049,320763.04000000487,-2755.719999999972
30900,2022-10-14 09:00:00,390.17,318397.4900000049,320763.04000000487,-2365.5499999999884
30901,2022-10-14 09:05:00,955.73,319353.22000000486,320763.04000000487,-1409.820000000007
30902,2022-10-14 09:10:00,490.9,319844.1200000049,320763.04000000487,-918.9199999999837
30903,2022-10-14 09:15:00,218.42,320062.54000000487,320763.04000000487,-700.5
30904,2022-10-14 09:20:00,-1375.44,318687.10000000487,320763.04000000487,-2075.9400000000023
30905,2022-10-14 09:25:00,1336.19,320023.29000000487,320763.04000000487,-739.75
30906,2022-10-14 09:30:00,-1792.53,318230.76000000484,320763.04000000487,-2532.280000000028
30907,2022-10-14 09:35:00,-1201.76,317029.00000000483,320763.04000000487,-3734.0400000000373
30908,2022-10-14 09:40:00,-1275.77,315753.2300000048,320763.04000000487,-5009.810000000056
30909,2022-10-14 09:45:00,-1180.67,314572.5600000048,320763.04000000487,-6190.48000000004
30910,2022-10-14 09:50:00,1862.24,316434.8000000048,320763.04000000487,-4328.240000000049
30911,2022-10-14 09:55:00,113.55,316548.3500000048,320763.04000000487,-4214.6900000000605
30912,2022-10-14 10:00:00,457.52,317005.8700000048,320763.04000000487,-3757.170000000042
30913,2022-10-14 10:05:00,1468.74,318474.6100000048,320763.04000000487,-2288.430000000051
30914,2022-10-14 10:10:00,-989.19,317485.4200000048,320763.04000000487,-3277.6200000000536
30915,2022-10-14 10:15:00,650.78,318136.20000000484,320763.04000000487,-2626.8400000000256
30916,2022-10-14 10:20:00,-303.69,317832.51000000484,320763.04000000487,-2930.530000000028
30917,2022-10-14 10:25:00,-283.31,317549.20000000484,320763.04000000487,-3213.8400000000256
30918,2022-10-14 10:30:00,-1710.53,315838.6700000048,320763.04000000487,-4924.370000000054
30919,2022-10-14 10:35:00,-816.28,315022.3900000048,320763.04000000487,-5740.6500000000815
30920,2022-10-14 10:40:00,1822.59,316844.9800000048,320763.04000000487,-3918.060000000056
30921,2022-10-14 10:45:00,1762.23,318607.2100000048,320763.04000000487,-2155.8300000000745
30922,2022-10-14 10:50:00,-230.01,318377.2000000048,320763.04000000487,-2385.840000000084
30923,2022-10-14 10:55:00,1356.25,319733.4500000048,320763.04000000487,-1029.5900000000838
30924,2022-10-14 11:00:00,-1462.19,318271.2600000048,320763.04000000487,-2491.780000000086
30925,2022-10-14 11:05:00,-1336.93,316934.3300000048,320763.04000000487,-3828.710000000079
30926,2022-10-14 11:10:00,-1277.76,315656.5700000048,320763.04000000487,-5106.4700000000885
30927,2022-10-14 11:15:00,-1683.92,313972.6500000048,320763.04000000487,-6790.390000000072
30928,2022-10-14 11:20:00,1154.66,315127.31000000477,320763.04000000487,-5635.730000000098
30929,2022-10-14 11:25:00,583.79,315711.10000000475,320763.04000000487,-5051.940000000119
30930,2022-10-14 11:30:00,1768.23,317479.33000000473,320763.04000000487,-3283.7100000001374
30931,2022-10-14 11:35:00,55.3,317534.6300000047,320763.04000000487,-3228.410000000149
30932,2022-10-14 11:40:00,1980.81,319515.4400000047,320763.04000000487,-1247.6000000001513
30933,2022-10-14 11:45:00,798.2,320313.6400000047,320763.04000000487,-449.4000000001397
30934,2022-10-14 11:50:00,1068.67,321382.3100000047,320763.04000000487,619.269999999844
30935,2022-10-14 11:55:00,1196.54,322578.8500000047,320763.04000000487,1815.809999999823
30936,2022-10-14 12:00:00,137.84,322716.6900000047,320763.04000000487,1953.6499999998487
30937,2022-10-14 12:05:00,-1085.26,321631.4300000047,320763.04000000487,868.3899999998393
30938,2022-10-14 12:10:00,-1990.64,319640.7900000047,320763.04000000487,-1122.2500000001746
30939,2022-10-14 12:15:00,544.43,320185.2200000047,320763.04000000487,-577.8200000001816
30940,2022-10-14 12:20:00,-859.38,319325.8400000047,320763.04000000487,-1437.2000000001863
30941,2022-10-14 12:25:00,-585.6,318740.2400000047,320763.04000000487,-2022.800000000163
30942,2022-10-14 12:30:00,-1095.98,317644.2600000047,320763.04000000487,-3118.7800000001444
30943,2022-10-14 12:35:00,-826.54,316817.72000000475,320763.04000000487,-3945.3200000001234
30944,2022-10-14 12:40:00,-1864.98,314952.74000000476,320763.04000000487,-5810.300000000105
30945,2022-10-14 12:45:00,-1787.68,313165.06000000477,320763.04000000487,-7597.980000000098
30946,2022-10-14 12:50:00,-109.17,313055.8900000048,320763.04000000487,-7707.1500000000815
30947,2022-10-14 12:55:00,-585.43,312470.4600000048,320763.04000000487,-8292.580000000075
30948,2022-10-14 13:00:00,-588.34,311882.12000000477,320763.04000000487,-8880.9200000001
30949,2022-10-14 13:05:00,-1122.73,310759.3900000048,320763.04000000487,-10003.650000000081
30950,2022-10-14 13:10:00,1528.13,312287.5200000048,320763.04000000487,-8475.520000000077
30951,2022-10-14 13:15:00,35.61,312323.1300000048,320763.04000000487,-8439.91000000009
30952,2022-10-14 13:20:00,-1908.11,310415.0200000048,320763.04000000487,-10348.020000000077
30953,2022-10-14 13:25:00,771.3,311186.3200000048,320763.04000000487,-9576.720000000088
30954,2022-10-14 13:30:00,1329.14,312515.4600000048,320763.04000000487,-8247.580000000075
30955,2022-10-14 13:35:00,-1420.65,311094.81000000477,320763.04000000487,-9668.230000000098
30956,2022-10-14 13:40:00,-180.49,310914.3200000048,320763.04000000487,-9848.720000000088
30957,2022-10-14 13:45:00,1610.37,312524.6900000048,320763.04000000487,-8238.350000000093
30958,2022-10-14 13:50:00,-710.43,311814.2600000048,320763.04000000487,-8948.780000000086
30959,2022-10-14 13:55:00,-1900.71,309913.55000000476,320763.04000000487,-10849.490000000107
30960,2022-10-14 14:00:00,98.36,310011.91000000475,320763.04000000487,-10751.130000000121
30961,2022-10-14 14:05:00,953.35,310965.2600000047,320763.04000000487,-9797.780000000144
30962,2022-10-14 14:10:00,-481.71,310483.5500000047,320763.04000000487,-10279.490000000165
30963,2022-10-14 14:15:00,-1664.49,308819.0600000047,320763.04000000487,-11943.980000000156
30964,2022-10-14 14:20:00,1236.09,310055.15000000474,320763.04000000487,-10707.89000000013
30965,2022-10-14 14:25:00,-522.93,309532.22000000475,320763.04000000487,-11230.820000000123
30966,2022-10-14 14:30:00,-1667.17,307865.05000000476,320763.04000000487,-12897.990000000107
30967,2022-10-14 14:35:00,1460.17,309325.22000000475,320763.04000000487,-11437.820000000123
30968,2022-10-14 14:40:00,-1097.59,308227.6300000047,320763.04000000487,-12535.410000000149
30969,2022-10-14 14:45:00,-812.78,307414.8500000047,320763.04000000487,-13348.190000000177
30970,2022-10-14 14:50:00,1857.72,309272.57000000466,320763.04000000487,-11490.470000000205
30971,2022-10-14 14:55:00,-1906.54,307366.0300000047,320763.04000000487,-13397.010000000184
30972,2022-10-14 15:00:00,-897.45,306468.5800000047,320763.04000000487,-14294.460000000196
30973,2022-10-14 15:05:00,1686.59,308155.1700000047,320763.04000000487,-12607.87000000017
30974,2022-10-14 15:10:00,-373.69,307781.4800000047,320763.04000000487,-12981.560000000172
30975,2022-10-14 15:15:00,1554.24,309335.7200000047,320763.04000000487,-11427.320000000182
30976,2022-10-14 15:20:00,-263.8,309071.9200000047,320763.04000000487,-11691.12000000017
30977,2022-10-14 15:25:00,-1988.23,307083.6900000047,320763.04000000487,-13679.350000000151
30978,2022-10-14 15:30:00,594.64,307678.33000000473,320763.04000000487,-13084.710000000137
30979,2022-10-14 15:35:00,590.03,308268.36000000476,320763.04000000487,-12494.68000000011
30980,2022-10-14 15:40:00,-662.18,307606.18000000477,320763.04000000487,-13156.860000000102
30981,2022-10-14 15:45:00,-1082.09,306524.09000000474,320763.04000000487,-14238.950000000128
30982,2022-10-14 15:50:00,1027.87,307551.96000000474,320763.04000000487,-13211.080000000133
30983,2022-10-14 15:55:00,360.46,307912.42000000476,320763.04000000487,-12850.620000000112
30984,2022-10-14 16:00:00,-491.04,307421.3800000048,320763.04000000487,-13341.66000000009
30985,2022-10-14 16:05:00,-526.07,306895.31000000477,320763.04000000487,-13867.730000000098
30986,2022-10-14 16:10:00,876.8,307772.11000000476,320763.04000000487,-12990.93000000011
30987,2022-10-14 16:15:00,156.86,307928.97000000475,320763.04000000487,-12834.070000000123
30988,2022-10-14 16:20:00,-128.45,307800.52000000473,320763.04000000487,-12962.520000000135
30989,2022-10-14 16:25:00,1623.54,309424.0600000047,320763.04000000487,-11338.980000000156
30990,2022-10-14 16:30:00,-162.16,309261.90000000474,320763.04000000487,-11501.14000000013
30991,2022-10-14 16:35:00,743.63,310005.53000000474,320763.04000000487,-10757.510000000126
30992,2022-10-14 16:40:00,-602.53,309403.0000000047,320763.04000000487,-11360.040000000154
30993,2022-10-14 16:45:00,1551.6,310954.6000000047,320763.04000000487,-9808.440000000177
30994,2022-10-14 16:50:00,-1349.9,309604.70000000467,320763.04000000487,-11158.3400000002
30995,2022-10-14 16:55:00,-422.7,309182.00000000466,320763.04000000487,-11581.040000000212
30996,2022-10-15 08:00:00,-629.01,308552.99000000465,309182.00000000466,-629.0100000000093
30997,2022-10-15 08:05:00,-320.03,308232.9600000046,309182.00000000466,-949.0400000000373
30998,2022-10-15 08:10:00,-139.11,308093.85000000463,309182.00000000466,-1088.1500000000233
30999,2022-10-15 08:15:00,626.12,308719.9700000046,309182.00000000466,-462.03000000002794
31000,2022-10-15 08:20:00,147.39,308867.36000000464,309182.00000000466,-314.64000000001397
31001,2022-10-15 08:25:00,728.13,309595.49000000465,309182.00000000466,413.4899999999907
31002,2022-10-15 08:30:00,541.03,310136.5200000047,309182.00000000466,954.5200000000186
31003,2022-10-15 08:35:00,7.07,310143.5900000047,309182.00000000466,961.5900000000256
31004,2022-10-15 08:40:00,-1926.69,308216.9000000047,309182.00000000466,-965.0999999999767
31005,2022-10-15 08:45:00,-829.06,307387.8400000047,309182.00000000466,-1794.1599999999744
31006,2022-10-15 08:50:00,791.1,308178.94000000466,309182.00000000466,-1003.0599999999977
31007,2022-10-15 08:55:00,-791.88,307387.06000000465,309182.00000000466,-1794.9400000000023
31008,2022-10-15 09:00:00,-1754.3,305632.76000000467,309182.00000000466,-3549.2399999999907
31009,2022-10-15 09:05:00,97.33,305730.0900000047,309182.00000000466,-3451.9099999999744
31010,2022-10-15 09:10:00,1716.17,307446.26000000467,309182.00000000466,-1735.7399999999907
31011,2022-10-15 09:15:00,673.88,308120.14000000467,309182.00000000466,-1061.859999999986
31012,2022-10-15 09:20:00,1166.57,309286.7100000047,309182.00000000466,104.71000000002095
31013,2022-10-15 09:25:00,-102.0,309184.7100000047,309182.00000000466,2.7100000000209548
31014,2022-10-15 09:30:00,-460.07,308724.64000000467,309182.00000000466,-457.35999999998603
31015,2022-10-15 09:35:00,-517.06,308207.5800000047,309182.00000000466,-974.4199999999837
31016,2022-10-15 09:40:00,-1808.37,306399.2100000047,309182.00000000466,-2782.789999999979
31017,2022-10-15 09:45:00,-655.01,305744.20000000467,309182.00000000466,-3437.7999999999884
31018,2022-10-15 09:50:00,1594.97,307339.17000000464,309182.00000000466,-1842.8300000000163
31019,2022-10-15 09:55:00,239.52,307578.69000000466,309182.00000000466,-1603.3099999999977
31020,2022-10-15 10:00:00,-1504.23,306074.4600000047,309182.00000000466,-3107.539999999979
31021,2022-10-15 10:05:00,-197.71,305876.75000000466,309182.00000000466,-3305.25
31022,2022-10-15 10:10:00,1324.87,307201.62000000465,309182.00000000466,-1980.3800000000047
31023,2022-10-15 10:15:00,848.19,308049.81000000465,309182.00000000466,-1132.1900000000023
31024,2022-10-15 10:20:00,-1187.49,306862.32000000466,309182.00000000466,-2319.679999999993
31025,2022-10-15 10:25:00,-1481.17,305381.1500000047,309182.00000000466,-3800.8499999999767
31026,2022-10-15 10:30:00,1861.08,307242.2300000047,309182.00000000466,-1939.7699999999604
31027,2022-10-15 10:35:00,862.23,308104.4600000047,309182.00000000466,-1077.539999999979
31028,2022-10-15 10:40:00,1341.31,309445.7700000047,309182.00000000466,263.7700000000186
31029,2022-10-15 10:45:00,1208.99,310654.76000000467,309182.00000000466,1472.7600000000093
31030,2022-10-15 10:50:00,354.42,311009.18000000465,309182.00000000466,1827.179999999993
31031,2022-10-15 10:55:00,-1203.55,309805.63000000466,309182.00000000466,623.6300000000047
31032,2022-10-15 11:00:00,1787.9,311593.5300000047,309182.00000000466,2411.530000000028
31033,2022-10-15 11:05:00,-1871.24,309722.2900000047,309182.00000000466,540.2900000000373
31034,2022-10-15 11:10:00,1024.14,310746.4300000047,309182.00000000466,1564.4300000000512
31035,2022-10-15 11:15:00,-1814.03,308932.4000000047,309182.00000000466,-249.59999999997672
31036,2022-10-15 11:20:00,-682.16,308250.2400000047,309182.00000000466,-931.7599999999511
31037,2022-10-15 11:25:00,-658.33,307591.9100000047,309182.00000000466,-1590.0899999999674
31038,2022-10-15 11:30:00,-694.79,306897.1200000047,309182.00000000466,-2284.8799999999464
31039,2022-10-15 11:35:00,-1192.32,305704.8000000047,309182.00000000466,-3477.1999999999534
31040,2022-10-15 11:40:00,-1956.76,303748.0400000047,309182.00000000466,-5433.959999999963
31041,2022-10-15 11:45:00,1340.84,305088.8800000047,309182.00000000466,-4093.119999999937
31042,2022-10-15 11:50:00,-1364.98,303723.90000000474,309182.00000000466,-5458.0999999999185
31043,2022-10-15 11:55:00,521.99,304245.8900000047,309182.00000000466,-4936.109999999928
31044,2022-10-15 12:00:00,987.43,305233.3200000047,309182.00000000466,-3948.679999999935
31045,2022-10-15 12:05:00,573.22,305806.5400000047,309182.00000000466,-3375.4599999999627
31046,2022-10-15 12:10:00,1348.31,307154.8500000047,309182.00000000466,-2027.149999999965
31047,2022-10-15 12:15:00,1789.46,308944.3100000047,309182.00000000466,-237.68999999994412
31048,2022-10-15 12:20:00,225.33,309169.6400000047,309182.00000000466,-12.359999999927823
31049,2022-10-15 12:25:00,73.03,309242.67000000476,309182.00000000466,60.67000000010012
31050,2022-10-15 12:30:00,548.37,309791.04000000475,309182.00000000466,609.0400000000955
31051,2022-10-15 12:35:00,-573.97,309217.0700000048,309182.00000000466,35.0700000001234
31052,2022-10-15 12:40:00,-190.45,309026.62000000477,309182.00000000466,-155.37999999988824
31053,2022-10-15 12:45:00,1907.34,310933.9600000048,309182.00000000466,1751.9600000001374
31054,2022-10-15 12:50:00,1505.98,312439.9400000048,309182.00000000466,3257.9400000001187
31055,2022-10-15 12:55:00,-609.26,311830.68000000477,309182.00000000466,2648.6800000001094
31056,2022-10-15 13:00:00,682.58,312513.2600000048,309182.00000000466,3331.2600000001257
31057,2022-10-15 13:05:00,-635.11,311878.1500000048,309182.00000000466,2696.1500000001397
31058,2022-10-15 13:10:00,-950.35,310927.8000000048,309182.00000000466,1745.800000000163
31059,2022-10-15 13:15:00,-263.7,310664.1000000048,309182.00000000466,1482.1000000001513
31060,2022-10-15 13:20:00,1684.45,312348.5500000048,309182.00000000466,3166.550000000163
31061,2022-10-15 13:25:00,1167.44,313515.9900000048,309182.00000000466,4333.990000000165
31062,2022-10-15 13:30:00,-202.24,313313.75000000483,309182.00000000466,4131.750000000175
31063,2022-10-15 13:35:00,-958.53,312355.2200000048,309182.00000000466,3173.2200000001467
31064,2022-10-15 13:40:00,-412.01,311943.2100000048,309182.00000000466,2761.2100000001374
31065,2022-10-15 13:45:00,-1072.45,310870.7600000048,309182.00000000466,1688.7600000001257
31066,2022-10-15 13:50:00,1540.25,312411.0100000048,309182.00000000466,3229.0100000001257
31067,2022-10-15 13:55:00,-263.7,312147.31000000477,309182.00000000466,2965.310000000114
31068,2022-10-15 14:00:00,-673.44,311473.87000000477,309182.00000000466,2291.8700000001118
31069,2022-10-15 14:05:00,-360.88,311112.99000000476,309182.00000000466,1930.990000000107
31070,2022-10-15 14:10:00,-797.6,310315.3900000048,309182.00000000466,1133.3900000001304
31071,2022-10-15 14:15:00,1370.5,311685.8900000048,309182.00000000466,2503.8900000001304
31072,2022-10-15 14:20:00,701.78,312387.6700000048,309182.00000000466,3205.6700000001583
31073,2022-10-15 14:25:00,-153.04,312234.63000000484,309182.00000000466,3052.6300000001793
31074,2022-10-15 14:30:00,-1912.3,310322.33000000485,309182.00000000466,1140.330000000191
31075,2022-10-15 14:35:00,660.98,310983.3100000048,309182.00000000466,1801.3100000001723
31076,2022-10-15 14:40:00,1481.24,312464.5500000048,309182.00000000466,3282.550000000163
31077,2022-10-15 14:45:00,1951.74,314416.2900000048,309182.00000000466,5234.290000000154
31078,2022-10-15 14:50:00,-34.61,314381.6800000048,309182.00000000466,5199.680000000168
31079,2022-10-15 14:55:00,1051.67,315433.3500000048,309182.00000000466,6251.350000000151
31080,2022-10-15 15:00:00,-906.89,314526.4600000048,309182.00000000466,5344.460000000137
31081,2022-10-15 15:05:00,-1931.93,312594.5300000048,309182.00000000466,3412.5300000001444
31082,2022-10-15 15:10:00,-273.79,312320.7400000048,309182.00000000466,3138.7400000001653
31083,2022-10-15 15:15:00,1809.54,314130.2800000048,309182.00000000466,4948.280000000144
31084,2022-10-15 15:20:00,-445.62,313684.6600000048,309182.00000000466,4502.660000000149
31085,2022-10-15 15:25:00,-81.59,313603.0700000048,309182.00000000466,4421.070000000123
31086,2022-10-15 15:30:00,115.15,313718.2200000048,309182.00000000466,4536.220000000147
31087,2022-10-15 15:35:00,791.4,314509.6200000048,309182.00000000466,5327.62000000017
31088,2022-10-15 15:40:00,-1834.48,312675.14000000485,309182.00000000466,3493.1400000001886
31089,2022-10-15 15:45:00,-737.91,311937.23000000487,309182.00000000466,2755.230000000214
31090,2022-10-15 15:50:00,1386.58,313323.8100000049,309182.00000000466,4141.8100000002305
31091,2022-10-15 15:55:00,977.92,314301.73000000487,309182.00000000466,5119.730000000214
31092,2022-10-15 16:00:00,1444.51,315746.2400000049,309182.00000000466,6564.2400000002235
31093,2022-10-15 16:05:00,-786.11,314960.1300000049,309182.00000000466,5778.1300000002375
31094,2022-10-15 16:10:00,1700.67,316660.8000000049,309182.00000000466,7478.800000000221
31095,2022-10-15 16:15:00,-841.86,315818.9400000049,309182.00000000466,6636.940000000235
31096,2022-10-15 16:20:00,-1604.99,314213.9500000049,309182.00000000466,5031.9500000002445
31097,2022-10-15 16:25:00,-775.95,313438.0000000049,309182.00000000466,4256.000000000233
31098,2022-10-15 16:30:00,-889.56,312548.4400000049,309182.00000000466,3366.440000000235
31099,2022-10-15 16:35:00,1387.09,313935.5300000049,309182.00000000466,4753.530000000261
31100,2022-10-15 16:40:00,-373.78,313561.7500000049,309182.00000000466,4379.750000000233
31101,2022-10-15 16:45:00,-857.79,312703.9600000049,309182.00000000466,3521.960000000254
31102,2022-10-15 16:50:00,1479.56,314183.5200000049,309182.00000000466,5001.5200000002515
31103,2022-10-15 16:55:00,-1539.16,312644.36000000493,309182.00000000466,3462.360000000277
31104,2022-10-16 08:00:00,1381.8,314026.1600000049,312644.36000000493,1381.7999999999884
31105,2022-10-16 08:05:00,-1754.96,312271.2000000049,312644.36000000493,-373.1600000000326
31106,2022-10-16 08:10:00,1511.77,313782.9700000049,312644.36000000493,1138.609999999986
31107,2022-10-16 08:15:00,-779.01,313003.9600000049,312644.36000000493,359.5999999999767
31108,2022-10-16 08:20:00,1398.47,314402.4300000049,312644.36000000493,1758.0699999999488
31109,2022-10-16 08:25:00,-302.87,314099.5600000049,312644.36000000493,1455.1999999999534
31110,2022-10-16 08:30:00,72.77,314172.3300000049,312644.36000000493,1527.969999999972
31111,2022-10-16 08:35:00,-591.02,313581.3100000049,312644.36000000493,936.9499999999534
31112,2022-10-16 08:40:00,-1220.48,312360.8300000049,312644.36000000493,-283.53000000002794
31113,2022-10-16 08:45:00,-153.02,312207.8100000049,312644.36000000493,-436.55000000004657
31114,2022-10-16 08:50:00,-1609.81,310598.0000000049,312644.36000000493,-2046.3600000000442
31115,2022-10-16 08:55:00,691.56,311289.5600000049,312644.36000000493,-1354.8000000000466
31116,2022-10-16 09:00:00,-295.42,310994.1400000049,312644.36000000493,-1650.2200000000303
31117,2022-10-16 09:05:00,-1280.78,309713.3600000049,312644.36000000493,-2931.000000000058
31118,2022-10-16 09:10:00,-998.49,308714.8700000049,312644.36000000493,-3929.490000000049
31119,2022-10-16 09:15:00,-252.08,308462.79000000487,312644.36000000493,-4181.570000000065
31120,2022-10-16 09:20:00,-1781.07,306681.72000000486,312644.36000000493,-5962.640000000072
31121,2022-10-16 09:25:00,846.0,307527.72000000486,312644.36000000493,-5116.640000000072
31122,2022-10-16 09:30:00,1703.4,309231.1200000049,312644.36000000493,-3413.240000000049
31123,2022-10-16 09:35:00,-75.06,309156.0600000049,312644.36000000493,-3488.3000000000466
31124,2022-10-16 09:40:00,-1017.43,308138.6300000049,312644.36000000493,-4505.73000000004
31125,2022-10-16 09:45:00,-832.39,307306.2400000049,312644.36000000493,-5338.120000000054
31126,2022-10-16 09:50:00,86.97,307393.21000000485,312644.36000000493,-5251.1500000000815
31127,2022-10-16 09:55:00,-1431.98,305961.23000000487,312644.36000000493,-6683.130000000063
31128,2022-10-16 10:00:00,1852.7,307813.9300000049,312644.36000000493,-4830.430000000051
31129,2022-10-16 10:05:00,850.87,308664.8000000049,312644.36000000493,-3979.560000000056
31130,2022-10-16 10:10:00,191.82,308856.6200000049,312644.36000000493,-3787.740000000049
31131,2022-10-16 10:15:00,-1734.04,307122.5800000049,312644.36000000493,-5521.780000000028
31132,2022-10-16 10:20:00,1593.56,308716.1400000049,312644.36000000493,-3928.2200000000303
31133,2022-10-16 10:25:00,-1450.77,307265.3700000049,312644.36000000493,-5378.990000000049
31134,2022-10-16 10:30:00,1381.25,308646.6200000049,312644.36000000493,-3997.740000000049
31135,2022-10-16 10:35:00,-791.86,307854.7600000049,312644.36000000493,-4789.600000000035
31136,2022-10-16 10:40:00,-675.49,307179.2700000049,312644.36000000493,-5465.090000000026
31137,2022-10-16 10:45:00,-1705.22,305474.05000000494,312644.36000000493,-7170.309999999998
31138,2022-10-16 10:50:00,-215.75,305258.30000000494,312644.36000000493,-7386.059999999998
31139,2022-10-16 10:55:00,-1032.69,304225.61000000493,312644.36000000493,-8418.75
31140,2022-10-16 11:00:00,-513.06,303712.55000000494,312644.36000000493,-8931.809999999998
31141,2022-10-16 11:05:00,-1243.93,302468.62000000494,312644.36000000493,-10175.73999999999
31142,2022-10-16 11:10:00,113.69,302582.31000000495,312644.36000000493,-10062.049999999988
31143,2022-10-16 11:15:00,-1538.51,301043.80000000494,312644.36000000493,-11600.559999999998
31144,2022-10-16 11:20:00,-1544.22,299499.58000000496,312644.36000000493,-13144.77999999997
31145,2022-10-16 11:25:00,423.02,299922.600000005,312644.36000000493,-12721.759999999951
31146,2022-10-16 11:30:00,-180.03,299742.57000000495,312644.36000000493,-12901.789999999979
31147,2022-10-16 11:35:00,-12.53,299730.0400000049,312644.36000000493,-12914.320000000007
31148,2022-10-16 11:40:00,-863.6,298866.44000000495,312644.36000000493,-13777.919999999984
31149,2022-10-16 11:45:00,-320.72,298545.720000005,312644.36000000493,-14098.639999999956
31150,2022-10-16 11:50:00,341.05,298886.77000000497,312644.36000000493,-13757.589999999967
31151,2022-10-16 11:55:00,1628.31,300515.08000000496,312644.36000000493,-12129.27999999997
31152,2022-10-16 12:00:00,-1035.67,299479.410000005,312644.36000000493,-13164.949999999953
31153,2022-10-16 12:05:00,1775.13,301254.540000005,312644.36000000493,-11389.819999999949
31154,2022-10-16 12:10:00,1192.63,302447.170000005,312644.36000000493,-10197.189999999944
31155,2022-10-16 12:15:00,-834.83,301612.340000005,312644.36000000493,-11032.01999999996
31156,2022-10-16 12:20:00,1251.98,302864.32000000495,312644.36000000493,-9780.039999999979
31157,2022-10-16 12:25:00,156.64,303020.96000000497,312644.36000000493,-9623.399999999965
31158,2022-10-16 12:30:00,-313.42,302707.540000005,312644.36000000493,-9936.819999999949
31159,2022-10-16 12:35:00,-404.25,302303.290000005,312644.36000000493,-10341.069999999949
31160,2022-10-16 12:40:00,938.07,303241.360000005,312644.36000000493,-9402.999999999942
31161,2022-10-16 12:45:00,-1112.11,302129.250000005,312644.36000000493,-10515.109999999928
31162,2022-10-16 12:50:00,-1160.63,300968.620000005,312644.36000000493,-11675.739999999932
31163,2022-10-16 12:55:00,462.81,301431.430000005,312644.36000000493,-11212.929999999935
31164,2022-10-16 13:00:00,-104.71,301326.720000005,312644.36000000493,-11317.639999999956
31165,2022-10-16 13:05:00,384.17,301710.89000000496,312644.36000000493,-10933.469999999972
31166,2022-10-16 13:10:00,1753.9,303464.790000005,312644.36000000493,-9179.569999999949
31167,2022-10-16 13:15:00,-466.23,302998.560000005,312644.36000000493,-9645.79999999993
31168,2022-10-16 13:20:00,-342.66,302655.90000000503,312644.36000000493,-9988.459999999905
31169,2022-10-16 13:25:00,216.81,302872.710000005,312644.36000000493,-9771.649999999907
31170,2022-10-16 13:30:00,-945.74,301926.97000000504,312644.36000000493,-10717.389999999898
31171,2022-10-16 13:35:00,291.74,302218.710000005,312644.36000000493,-10425.649999999907
31172,2022-10-16 13:40:00,1308.25,303526.960000005,312644.36000000493,-9117.399999999907
31173,2022-10-16 13:45:00,130.22,303657.180000005,312644.36000000493,-8987.179999999935
31174,2022-10-16 13:50:00,1154.58,304811.760000005,312644.36000000493,-7832.5999999999185
31175,2022-10-16 13:55:00,-1481.86,303329.90000000503,312644.36000000493,-9314.459999999905
31176,2022-10-16 14:00:00,-341.85,302988.05000000505,312644.36000000493,-9656.309999999881
31177,2022-10-16 14:05:00,574.38,303562.43000000506,312644.36000000493,-9081.929999999877
31178,2022-10-16 14:10:00,-180.66,303381.7700000051,312644.36000000493,-9262.589999999851
31179,2022-10-16 14:15:00,-798.91,302582.8600000051,312644.36000000493,-10061.499999999825
31180,2022-10-16 14:20:00,-919.19,301663.6700000051,312644.36000000493,-10980.689999999828
31181,2022-10-16 14:25:00,-902.22,300761.45000000513,312644.36000000493,-11882.9099999998
31182,2022-10-16 14:30:00,1458.52,302219.97000000515,312644.36000000493,-10424.389999999781
31183,2022-10-16 14:35:00,1062.69,303282.66000000515,312644.36000000493,-9361.699999999779
31184,2022-10-16 14:40:00,-716.32,302566.34000000515,312644.36000000493,-10078.019999999786
31185,2022-10-16 14:45:00,-1892.45,300673.89000000514,312644.36000000493,-11970.469999999797
31186,2022-10-16 14:50:00,-869.85,299804.04000000516,312644.36000000493,-12840.319999999774
31187,2022-10-16 14:55:00,-1369.36,298434.6800000052,312644.36000000493,-14209.67999999976
31188,2022-10-16 15:00:00,-1650.07,296784.61000000517,312644.36000000493,-15859.749999999767
31189,2022-10-16 15:05:00,882.34,297666.9500000052,312644.36000000493,-14977.409999999742
31190,2022-10-16 15:10:00,74.64,297741.5900000052,312644.36000000493,-14902.769999999728
31191,2022-10-16 15:15:00,461.92,298203.5100000052,312644.36000000493,-14440.849999999744
31192,2022-10-16 15:20:00,-1208.75,296994.7600000052,312644.36000000493,-15649.599999999744
31193,2022-10-16 15:25:00,1797.67,298792.4300000052,312644.36000000493,-13851.92999999976
31194,2022-10-16 15:30:00,255.41,299047.84000000515,312644.36000000493,-13596.519999999786
31195,2022-10-16 15:35:00,-1426.74,297621.10000000516,312644.36000000493,-15023.259999999776
31196,2022-10-16 15:40:00,1080.65,298701.7500000052,312644.36000000493,-13942.609999999753
31197,2022-10-16 15:45:00,286.83,298988.5800000052,312644.36000000493,-13655.779999999737
31198,2022-10-16 15:50:00,-1525.6,297462.9800000052,312644.36000000493,-15181.379999999714
31199,2022-10-16 15:55:00,392.17,297855.1500000052,312644.36000000493,-14789.20999999973
31200,2022-10-16 16:00:00,559.5,298414.6500000052,312644.36000000493,-14229.70999999973
31201,2022-10-16 16:05:00,-1448.88,296965.7700000052,312644.36000000493,-15678.589999999735
31202,2022-10-16 16:10:00,-1839.45,295126.3200000052,312644.36000000493,-17518.039999999746
31203,2022-10-16 16:15:00,100.66,295226.98000000516,312644.36000000493,-17417.379999999772
31204,2022-10-16 16:20:00,1605.88,296832.86000000517,312644.36000000493,-15811.499999999767
31205,2022-10-16 16:25:00,703.57,297536.4300000052,312644.36000000493,-15107.92999999976
31206,2022-10-16 16:30:00,1432.62,298969.05000000517,312644.36000000493,-13675.309999999765
31207,2022-10-16 16:35:00,1097.29,300066.34000000515,312644.36000000493,-12578.019999999786
31208,2022-10-16 16:40:00,-1114.63,298951.71000000514,312644.36000000493,-13692.64999999979
31209,2022-10-16 16:45:00,585.36,299537.07000000513,312644.36000000493,-13107.289999999804
31210,2022-10-16 16:50:00,-1466.18,298070.89000000514,312644.36000000493,-14573.469999999797
31211,2022-10-16 16:55:00,-1527.32,296543.57000000513,312644.36000000493,-16100.789999999804
31212,2022-10-17 08:00:00,-711.88,295831.6900000051,296543.57000000513,-711.8800000000047
31213,2022-10-17 08:05:00,-213.52,295618.1700000051,296543.57000000513,-925.4000000000233
31214,2022-10-17 08:10:00,-1340.59,294277.5800000051,296543.57000000513,-2265.990000000049
31215,2022-10-17 08:15:00,1054.79,295332.37000000506,296543.57000000513,-1211.2000000000698
31216,2022-10-17 08:20:00,-648.33,294684.04000000504,296543.57000000513,-1859.5300000000861
31217,2022-10-17 08:25:00,-1028.38,293655.66000000504,296543.57000000513,-2887.910000000091
31218,2022-10-17 08:30:00,-1026.16,292629.50000000506,296543.57000000513,-3914.070000000065
31219,2022-10-17 08:35:00,-1598.89,291030.61000000505,296543.57000000513,-5512.960000000079
31220,2022-10-17 08:40:00,465.27,291495.88000000507,296543.57000000513,-5047.6900000000605
31221,2022-10-17 08:45:00,1801.6,293297.48000000505,296543.57000000513,-3246.090000000084
31222,2022-10-17 08:50:00,259.01,293556.49000000505,296543.57000000513,-2987.0800000000745
31223,2022-10-17 08:55:00,-236.76,293319.73000000505,296543.57000000513,-3223.840000000084
31224,2022-10-17 09:00:00,586.57,293906.30000000505,296543.57000000513,-2637.270000000077
31225,2022-10-17 09:05:00,1615.92,295522.22000000504,296543.57000000513,-1021.3500000000931
31226,2022-10-17 09:10:00,1907.3,297429.520000005,296543.57000000513,885.9499999998952
31227,2022-10-17 09:15:00,1409.82,298839.34000000503,296543.57000000513,2295.769999999902
31228,2022-10-17 09:20:00,1659.11,300498.450000005,296543.57000000513,3954.8799999998882
31229,2022-10-17 09:25:00,764.29,301262.740000005,296543.57000000513,4719.169999999867
31230,2022-10-17 09:30:00,1704.52,302967.260000005,296543.57000000513,6423.689999999886
31231,2022-10-17 09:35:00,-1914.13,301053.130000005,296543.57000000513,4509.559999999881
31232,2022-10-17 09:40:00,1959.37,303012.500000005,296543.57000000513,6468.929999999877
31233,2022-10-17 09:45:00,414.95,303427.450000005,296543.57000000513,6883.879999999888
31234,2022-10-17 09:50:00,1802.85,305230.300000005,296543.57000000513,8686.729999999865
31235,2022-10-17 09:55:00,-83.38,305146.920000005,296543.57000000513,8603.34999999986
31236,2022-10-17 10:00:00,-1831.98,303314.940000005,296543.57000000513,6771.369999999879
31237,2022-10-17 10:05:00,-1429.39,301885.550000005,296543.57000000513,5341.979999999865
31238,2022-10-17 10:10:00,-1316.62,300568.930000005,296543.57000000513,4025.3599999998696
31239,2022-10-17 10:15:00,1242.14,301811.070000005,296543.57000000513,5267.499999999884
31240,2022-10-17 10:20:00,1885.63,303696.700000005,296543.57000000513,7153.129999999888
31241,2022-10-17 10:25:00,1266.94,304963.640000005,296543.57000000513,8420.06999999989
31242,2022-10-17 10:30:00,1378.1,306341.740000005,296543.57000000513,9798.169999999867
31243,2022-10-17 10:35:00,-927.7,305414.040000005,296543.57000000513,8870.469999999856
31244,2022-10-17 10:40:00,698.14,306112.180000005,296543.57000000513,9568.60999999987
31245,2022-10-17 10:45:00,343.75,306455.930000005,296543.57000000513,9912.35999999987
31246,2022-10-17 10:50:00,-287.6,306168.330000005,296543.57000000513,9624.759999999893
31247,2022-10-17 10:55:00,-360.34,305807.990000005,296543.57000000513,9264.419999999867
31248,2022-10-17 11:00:00,-1196.36,304611.630000005,296543.57000000513,8068.059999999881
31249,2022-10-17 11:05:00,-1878.73,302732.90000000503,296543.57000000513,6189.3299999999
31250,2022-10-17 11:10:00,634.53,303367.43000000506,296543.57000000513,6823.859999999928
31251,2022-10-17 11:15:00,1170.79,304538.22000000504,296543.57000000513,7994.649999999907
31252,2022-10-17 11:20:00,1886.19,306424.41000000504,296543.57000000513,9880.83999999991
31253,2022-10-17 11:25:00,629.59,307054.00000000506,296543.57000000513,10510.429999999935
31254,2022-10-17 11:30:00,757.88,307811.88000000507,296543.57000000513,11268.30999999994
31255,2022-10-17 11:35:00,114.41,307926.29000000504,296543.57000000513,11382.719999999914
31256,2022-10-17 11:40:00,-1060.12,306866.17000000505,296543.57000000513,10322.599999999919
31257,2022-10-17 11:45:00,-959.16,305907.0100000051,296543.57000000513,9363.439999999944
31258,2022-10-17 11:50:00,-791.73,305115.2800000051,296543.57000000513,8571.709999999963
31259,2022-10-17 11:55:00,1496.84,306612.1200000051,296543.57000000513,10068.549999999988
31260,2022-10-17 12:00:00,289.05,306901.1700000051,296543.57000000513,10357.599999999977
31261,2022-10-17 12:05:00,705.56,307606.7300000051,296543.57000000513,11063.159999999974
31262,2022-10-17 12:10:00,-1785.81,305820.9200000051,296543.57000000513,9277.349999999977
31263,2022-10-17 12:15:00,44.78,305865.70000000513,296543.57000000513,9322.130000000005
31264,2022-10-17 12:20:00,-1120.14,304745.5600000051,296543.57000000513,8201.98999999999
31265,2022-10-17 12:25:00,905.98,305651.5400000051,296543.57000000513,9107.969999999972
31266,2022-10-17 12:30:00,1063.1,306714.6400000051,296543.57000000513,10171.069999999949
31267,2022-10-17 12:35:00,-953.5,305761.1400000051,296543.57000000513,9217.569999999949
31268,2022-10-17 12:40:00,1093.31,306854.4500000051,296543.57000000513,10310.879999999946
31269,2022-10-17 12:45:00,-478.1,306376.3500000051,296543.57000000513,9832.77999999997
31270,2022-10-17 12:50:00,342.41,306718.7600000051,296543.57000000513,10175.189999999944
31271,2022-10-17 12:55:00,-1431.23,305287.5300000051,296543.57000000513,8743.959999999963
31272,2022-10-17 13:00:00,440.76,305728.2900000051,296543.57000000513,9184.719999999972
31273,2022-10-17 13:05:00,-201.28,305527.0100000051,296543.57000000513,8983.439999999944
31274,2022-10-17 13:10:00,385.57,305912.5800000051,296543.57000000513,9369.009999999951
31275,2022-10-17 13:15:00,-1250.77,304661.81000000506,296543.57000000513,8118.2399999999325
31276,2022-10-17 13:20:00,423.46,305085.2700000051,296543.57000000513,8541.699999999953
31277,2022-10-17 13:25:00,1131.49,306216.7600000051,296543.57000000513,9673.189999999944
31278,2022-10-17 13:30:00,-423.32,305793.44000000507,296543.57000000513,9249.869999999937
31279,2022-10-17 13:35:00,-1120.1,304673.3400000051,296543.57000000513,8129.76999999996
31280,2022-10-17 13:40:00,1474.92,306148.2600000051,296543.57000000513,9604.689999999944
31281,2022-10-17 13:45:00,-1023.96,305124.30000000505,296543.57000000513,8580.729999999923
31282,2022-10-17 13:50:00,-490.24,304634.06000000506,296543.57000000513,8090.4899999999325
31283,2022-10-17 13:55:00,-1746.02,302888.04000000504,296543.57000000513,6344.469999999914
31284,2022-10-17 14:00:00,-1450.54,301437.50000000506,296543.57000000513,4893.929999999935
31285,2022-10-17 14:05:00,600.68,302038.18000000506,296543.57000000513,5494.609999999928
31286,2022-10-17 14:10:00,-1322.78,300715.40000000503,296543.57000000513,4171.8299999999
31287,2022-10-17 14:15:00,-670.13,300045.270000005,296543.57000000513,3501.699999999895
31288,2022-10-17 14:20:00,-1836.69,298208.580000005,296543.57000000513,1665.009999999893
31289,2022-10-17 14:25:00,-232.81,297975.770000005,296543.57000000513,1432.1999999998952
31290,2022-10-17 14:30:00,1465.74,299441.510000005,296543.57000000513,2897.939999999886
31291,2022-10-17 14:35:00,964.87,300406.380000005,296543.57000000513,3862.8099999998813
31292,2022-10-17 14:40:00,1968.96,302375.34000000503,296543.57000000513,5831.769999999902
31293,2022-10-17 14:45:00,1671.85,304047.190000005,296543.57000000513,7503.619999999879
31294,2022-10-17 14:50:00,462.37,304509.560000005,296543.57000000513,7965.989999999874
31295,2022-10-17 14:55:00,30.43,304539.990000005,296543.57000000513,7996.419999999867
31296,2022-10-17 15:00:00,-1219.4,303320.590000005,296543.57000000513,6777.019999999844
31297,2022-10-17 15:05:00,-1467.82,301852.77000000497,296543.57000000513,5309.199999999837
31298,2022-10-17 15:10:00,1103.47,302956.24000000494,296543.57000000513,6412.669999999809
31299,2022-10-17 15:15:00,-406.63,302549.61000000493,296543.57000000513,6006.039999999804
31300,2022-10-17 15:20:00,1664.43,304214.0400000049,296543.57000000513,7670.469999999797
31301,2022-10-17 15:25:00,470.8,304684.8400000049,296543.57000000513,8141.269999999786
31302,2022-10-17 15:30:00,-176.13,304508.7100000049,296543.57000000513,7965.139999999781
31303,2022-10-17 15:35:00,-77.77,304430.9400000049,296543.57000000513,7887.3699999997625
31304,2022-10-17 15:40:00,585.02,305015.9600000049,296543.57000000513,8472.389999999781
31305,2022-10-17 15:45:00,419.24,305435.2000000049,296543.57000000513,8891.629999999772
31306,2022-10-17 15:50:00,-309.35,305125.8500000049,296543.57000000513,8582.279999999795
31307,2022-10-17 15:55:00,-323.29,304802.56000000495,296543.57000000513,8258.989999999816
31308,2022-10-17 16:00:00,-927.4,303875.1600000049,296543.57000000513,7331.589999999793
31309,2022-10-17 16:05:00,-92.67,303782.49000000494,296543.57000000513,7238.919999999809
31310,2022-10-17 16:10:00,1373.3,305155.7900000049,296543.57000000513,8612.219999999797
31311,2022-10-17 16:15:00,770.58,305926.37000000494,296543.57000000513,9382.799999999814
31312,2022-10-17 16:20:00,51.1,305977.4700000049,296543.57000000513,9433.89999999979
31313,2022-10-17 16:25:00,-171.19,305806.2800000049,296543.57000000513,9262.709999999788
31314,2022-10-17 16:30:00,1486.83,307293.11000000493,296543.57000000513,10749.539999999804
31315,2022-10-17 16:35:00,-569.07,306724.0400000049,296543.57000000513,10180.469999999797
31316,2022-10-17 16:40:00,-1574.18,305149.86000000493,296543.57000000513,8606.289999999804
31317,2022-10-17 16:45:00,-1580.04,303569.82000000495,296543.57000000513,7026.249999999825
31318,2022-10-17 16:50:00,-1073.51,302496.31000000495,296543.57000000513,5952.739999999816
31319,2022-10-17 16:55:00,55.67,302551.9800000049,296543.57000000513,6008.4099999998
31320,2022-10-18 08:00:00,1124.68,303676.6600000049,302551.9800000049,1124.679999999993
31321,2022-10-18 08:05:00,474.01,304150.67000000493,302551.9800000049,1598.6900000000023
31322,2022-10-18 08:10:00,-1132.12,303018.55000000494,302551.9800000049,466.570000000007
31323,2022-10-18 08:15:00,-961.61,302056.94000000495,302551.9800000049,-495.03999999997905
31324,2022-10-18 08:20:00,-1043.95,301012.99000000494,302551.9800000049,-1538.9899999999907
31325,2022-10-18 08:25:00,-1928.36,299084.63000000495,302551.9800000049,-3467.3499999999767
31326,2022-10-18 08:30:00,-1878.08,297206.55000000494,302551.9800000049,-5345.429999999993
31327,2022-10-18 08:35:00,1701.39,298907.94000000495,302551.9800000049,-3644.039999999979
31328,2022-10-18 08:40:00,1432.16,300340.1000000049,302551.9800000049,-2211.8800000000047
31329,2022-10-18 08:45:00,-151.96,300188.1400000049,302551.9800000049,-2363.8400000000256
31330,2022-10-18 08:50:00,654.58,300842.7200000049,302551.9800000049,-1709.2600000000093
31331,2022-10-18 08:55:00,801.77,301644.49000000494,302551.9800000049,-907.4899999999907
31332,2022-10-18 09:00:00,1087.28,302731.77000000497,302551.9800000049,179.79000000003725
31333,2022-10-18 09:05:00,811.19,303542.96000000497,302551.9800000049,990.9800000000396
31334,2022-10-18 09:10:00,213.74,303756.70000000496,302551.9800000049,1204.7200000000303
31335,2022-10-18 09:15:00,807.67,304564.37000000494,302551.9800000049,2012.390000000014
31336,2022-10-18 09:20:00,993.66,305558.0300000049,302551.9800000049,3006.0499999999884
31337,2022-10-18 09:25:00,410.21,305968.24000000494,302551.9800000049,3416.2600000000093
31338,2022-10-18 09:30:00,1753.48,307721.7200000049,302551.9800000049,5169.739999999991
31339,2022-10-18 09:35:00,-162.56,307559.1600000049,302551.9800000049,5007.179999999993
31340,2022-10-18 09:40:00,691.74,308250.9000000049,302551.9800000049,5698.919999999984
31341,2022-10-18 09:45:00,1550.67,309801.5700000049,302551.9800000049,7249.589999999967
31342,2022-10-18 09:50:00,1146.75,310948.3200000049,302551.9800000049,8396.339999999967
31343,2022-10-18 09:55:00,1550.55,312498.8700000049,302551.9800000049,9946.889999999956
31344,2022-10-18 10:00:00,1736.8,314235.6700000049,302551.9800000049,11683.689999999944
31345,2022-10-18 10:05:00,281.62,314517.29000000487,302551.9800000049,11965.30999999994
31346,2022-10-18 10:10:00,-166.23,314351.0600000049,302551.9800000049,11799.079999999958
31347,2022-10-18 10:15:00,-902.15,313448.91000000486,302551.9800000049,10896.929999999935
31348,2022-10-18 10:20:00,-1212.67,312236.2400000049,302551.9800000049,9684.259999999951
31349,2022-10-18 10:25:00,-1753.65,310482.59000000486,302551.9800000049,7930.609999999928
31350,2022-10-18 10:30:00,-1043.71,309438.88000000484,302551.9800000049,6886.899999999907
31351,2022-10-18 10:35:00,1082.12,310521.00000000483,302551.9800000049,7969.019999999902
31352,2022-10-18 10:40:00,1765.38,312286.38000000484,302551.9800000049,9734.399999999907
31353,2022-10-18 10:45:00,1163.39,313449.77000000485,302551.9800000049,10897.78999999992
31354,2022-10-18 10:50:00,1293.14,314742.91000000486,302551.9800000049,12190.929999999935
31355,2022-10-18 10:55:00,540.75,315283.66000000486,302551.9800000049,12731.679999999935
31356,2022-10-18 11:00:00,-1794.39,313489.27000000485,302551.9800000049,10937.28999999992
31357,2022-10-18 11:05:00,-1537.94,311951.33000000485,302551.9800000049,9399.349999999919
31358,2022-10-18 11:10:00,1104.65,313055.98000000487,302551.9800000049,10503.999999999942
31359,2022-10-18 11:15:00,-1087.66,311968.3200000049,302551.9800000049,9416.339999999967
31360,2022-10-18 11:20:00,81.62,312049.9400000049,302551.9800000049,9497.959999999963
31361,2022-10-18 11:25:00,171.95,312221.8900000049,302551.9800000049,9669.909999999974
31362,2022-10-18 11:30:00,1137.14,313359.0300000049,302551.9800000049,10807.049999999988
31363,2022-10-18 11:35:00,1506.8,314865.8300000049,302551.9800000049,12313.849999999977
31364,2022-10-18 11:40:00,-707.04,314158.7900000049,302551.9800000049,11606.809999999998
31365,2022-10-18 11:45:00,1132.0,315290.7900000049,302551.9800000049,12738.809999999998
31366,2022-10-18 11:50:00,-1524.94,313765.8500000049,302551.9800000049,11213.869999999995
31367,2022-10-18 11:55:00,-1858.64,311907.2100000049,302551.9800000049,9355.229999999981
31368,2022-10-18 12:00:00,-1262.92,310644.2900000049,302551.9800000049,8092.309999999998
31369,2022-10-18 12:05:00,1333.69,311977.9800000049,302551.9800000049,9426.0
31370,2022-10-18 12:10:00,-490.98,311487.00000000495,302551.9800000049,8935.020000000019
31371,2022-10-18 12:15:00,-477.51,311009.49000000494,302551.9800000049,8457.51000000001
31372,2022-10-18 12:20:00,-25.42,310984.07000000495,302551.9800000049,8432.090000000026
31373,2022-10-18 12:25:00,701.45,311685.52000000497,302551.9800000049,9133.540000000037
31374,2022-10-18 12:30:00,-693.21,310992.31000000495,302551.9800000049,8440.330000000016
31375,2022-10-18 12:35:00,78.0,311070.31000000495,302551.9800000049,8518.330000000016
31376,2022-10-18 12:40:00,1034.8,312105.11000000493,302551.9800000049,9553.130000000005
31377,2022-10-18 12:45:00,-847.62,311257.49000000494,302551.9800000049,8705.51000000001
31378,2022-10-18 12:50:00,-1878.1,309379.39000000496,302551.9800000049,6827.410000000033
31379,2022-10-18 12:55:00,-597.57,308781.82000000495,302551.9800000049,6229.840000000026
31380,2022-10-18 13:00:00,159.53,308941.350000005,302551.9800000049,6389.370000000054
31381,2022-10-18 13:05:00,-660.38,308280.970000005,302551.9800000049,5728.990000000049
31382,2022-10-18 13:10:00,1108.58,309389.550000005,302551.9800000049,6837.570000000065
31383,2022-10-18 13:15:00,-748.03,308641.52000000497,302551.9800000049,6089.540000000037
31384,2022-10-18 13:20:00,-1589.48,307052.040000005,302551.9800000049,4500.060000000056
31385,2022-10-18 13:25:00,-121.73,306930.310000005,302551.9800000049,4378.3300000000745
31386,2022-10-18 13:30:00,651.53,307581.84000000503,302551.9800000049,5029.860000000102
31387,2022-10-18 13:35:00,1551.82,309133.66000000504,302551.9800000049,6581.680000000109
31388,2022-10-18 13:40:00,-459.82,308673.84000000503,302551.9800000049,6121.860000000102
31389,2022-10-18 13:45:00,-1974.65,306699.190000005,302551.9800000049,4147.210000000079
31390,2022-10-18 13:50:00,-90.75,306608.440000005,302551.9800000049,4056.460000000079
31391,2022-10-18 13:55:00,-413.68,306194.760000005,302551.9800000049,3642.780000000086
31392,2022-10-18 14:00:00,401.66,306596.420000005,302551.9800000049,4044.4400000000605
31393,2022-10-18 14:05:00,1871.81,308468.230000005,302551.9800000049,5916.250000000058
31394,2022-10-18 14:10:00,1133.69,309601.920000005,302551.9800000049,7049.9400000000605
31395,2022-10-18 14:15:00,1817.01,311418.930000005,302551.9800000049,8866.95000000007
31396,2022-10-18 14:20:00,-1464.17,309954.760000005,302551.9800000049,7402.780000000086
31397,2022-10-18 14:25:00,873.89,310828.65000000503,302551.9800000049,8276.6700000001
31398,2022-10-18 14:30:00,999.01,311827.66000000504,302551.9800000049,9275.68000000011
31399,2022-10-18 14:35:00,-523.94,311303.72000000504,302551.9800000049,8751.740000000107
31400,2022-10-18 14:40:00,273.52,311577.24000000505,302551.9800000049,9025.260000000126
31401,2022-10-18 14:45:00,-837.12,310740.12000000506,302551.9800000049,8188.14000000013
31402,2022-10-18 14:50:00,-1984.09,308756.03000000503,302551.9800000049,6204.050000000105
31403,2022-10-18 14:55:00,1028.41,309784.440000005,302551.9800000049,7232.460000000079
31404,2022-10-18 15:00:00,-1638.84,308145.600000005,302551.9800000049,5593.620000000054
31405,2022-10-18 15:05:00,567.09,308712.690000005,302551.9800000049,6160.710000000079
31406,2022-10-18 15:10:00,1486.36,310199.050000005,302551.9800000049,7647.070000000065
31407,2022-10-18 15:15:00,-151.33,310047.720000005,302551.9800000049,7495.740000000049
31408,2022-10-18 15:20:00,1823.76,311871.480000005,302551.9800000049,9319.500000000058
31409,2022-10-18 15:25:00,1114.35,312985.83000000496,302551.9800000049,10433.850000000035
31410,2022-10-18 15:30:00,-215.16,312770.670000005,302551.9800000049,10218.69000000006
31411,2022-10-18 15:35:00,159.08,312929.750000005,302551.9800000049,10377.770000000077
31412,2022-10-18 15:40:00,1321.86,314251.610000005,302551.9800000049,11699.630000000063
31413,2022-10-18 15:45:00,510.16,314761.77000000497,302551.9800000049,12209.790000000037
31414,2022-10-18 15:50:00,573.98,315335.75000000495,302551.9800000049,12783.770000000019
31415,2022-10-18 15:55:00,414.15,315749.900000005,302551.9800000049,13197.920000000042
31416,2022-10-18 16:00:00,-920.05,314829.850000005,302551.9800000049,12277.870000000054
31417,2022-10-18 16:05:00,401.69,315231.540000005,302551.9800000049,12679.560000000056
31418,2022-10-18 16:10:00,1337.06,316568.600000005,302551.9800000049,14016.620000000054
31419,2022-10-18 16:15:00,1146.75,317715.350000005,302551.9800000049,15163.370000000054
31420,2022-10-18 16:20:00,-1267.53,316447.82000000495,302551.9800000049,13895.840000000026
31421,2022-10-18 16:25:00,-1032.16,315415.660000005,302551.9800000049,12863.680000000051
31422,2022-10-18 16:30:00,854.92,316270.58000000496,302551.9800000049,13718.600000000035
31423,2022-10-18 16:35:00,228.38,316498.96000000497,302551.9800000049,13946.98000000004
31424,2022-10-18 16:40:00,1352.39,317851.350000005,302551.9800000049,15299.370000000054
31425,2022-10-18 16:45:00,-1508.62,316342.730000005,302551.9800000049,13790.750000000058
31426,2022-10-18 16:50:00,-1328.5,315014.230000005,302551.9800000049,12462.250000000058
31427,2022-10-18 16:55:00,519.04,315533.27000000497,302551.9800000049,12981.290000000037
31428,2022-10-19 08:00:00,-1973.07,313560.20000000496,315533.27000000497,-1973.070000000007
31429,2022-10-19 08:05:00,-551.16,313009.040000005,315533.27000000497,-2524.2299999999814
31430,2022-10-19 08:10:00,1816.6,314825.64000000496,315533.27000000497,-707.6300000000047
31431,2022-10-19 08:15:00,-1489.02,313336.62000000494,315533.27000000497,-2196.6500000000233
31432,2022-10-19 08:20:00,784.2,314120.82000000495,315533.27000000497,-1412.4500000000116
31433,2022-10-19 08:25:00,-1496.89,312623.93000000494,315533.27000000497,-2909.3400000000256
31434,2022-10-19 08:30:00,57.33,312681.26000000496,315533.27000000497,-2852.0100000000093
31435,2022-10-19 08:35:00,-1989.61,310691.650000005,315533.27000000497,-4841.619999999995
31436,2022-10-19 08:40:00,-1669.91,309021.740000005,315533.27000000497,-6511.52999999997
31437,2022-10-19 08:45:00,542.87,309564.610000005,315533.27000000497,-5968.659999999974
31438,2022-10-19 08:50:00,1484.6,311049.21000000497,315533.27000000497,-4484.059999999998
31439,2022-10-19 08:55:00,1034.8,312084.01000000496,315533.27000000497,-3449.2600000000093
31440,2022-10-19 09:00:00,747.66,312831.67000000493,315533.27000000497,-2701.600000000035
31441,2022-10-19 09:05:00,-1581.64,311250.0300000049,315533.27000000497,-4283.240000000049
31442,2022-10-19 09:10:00,1695.41,312945.4400000049,315533.27000000497,-2587.8300000000745
31443,2022-10-19 09:15:00,1252.55,314197.9900000049,315533.27000000497,-1335.2800000000861
31444,2022-10-19 09:20:00,-55.59,314142.40000000485,315533.27000000497,-1390.8700000001118
31445,2022-10-19 09:25:00,1213.09,315355.4900000049,315533.27000000497,-177.78000000008615
31446,2022-10-19 09:30:00,-808.04,314547.4500000049,315533.27000000497,-985.8200000000652
31447,2022-10-19 09:35:00,-1998.48,312548.9700000049,315533.27000000497,-2984.3000000000466
31448,2022-10-19 09:40:00,-1250.37,311298.6000000049,315533.27000000497,-4234.670000000042
31449,2022-10-19 09:45:00,-185.87,311112.7300000049,315533.27000000497,-4420.540000000037
31450,2022-10-19 09:50:00,1331.63,312444.36000000493,315533.27000000497,-3088.9100000000326
31451,2022-10-19 09:55:00,619.75,313064.11000000493,315533.27000000497,-2469.1600000000326
31452,2022-10-19 10:00:00,-1319.62,311744.49000000494,315533.27000000497,-3788.780000000028
31453,2022-10-19 10:05:00,-1959.07,309785.42000000493,315533.27000000497,-5747.850000000035
31454,2022-10-19 10:10:00,915.76,310701.18000000494,315533.27000000497,-4832.090000000026
31455,2022-10-19 10:15:00,597.75,311298.93000000494,315533.27000000497,-4234.340000000026
31456,2022-10-19 10:20:00,533.74,311832.67000000493,315533.27000000497,-3700.600000000035
31457,2022-10-19 10:25:00,1763.79,313596.4600000049,315533.27000000497,-1936.8100000000559
31458,2022-10-19 10:30:00,77.1,313673.5600000049,315533.27000000497,-1859.7100000000792
31459,2022-10-19 10:35:00,1858.2,315531.7600000049,315533.27000000497,-1.5100000000675209
31460,2022-10-19 10:40:00,-999.78,314531.98000000487,315533.27000000497,-1001.2900000000955
31461,2022-10-19 10:45:00,925.39,315457.3700000049,315533.27000000497,-75.90000000008149
31462,2022-10-19 10:50:00,1268.21,316725.5800000049,315533.27000000497,1192.3099999999395
31463,2022-10-19 10:55:00,580.17,317305.7500000049,315533.27000000497,1772.4799999999232
31464,2022-10-19 11:00:00,-1471.71,315834.04000000487,315533.27000000497,300.7699999999022
31465,2022-10-19 11:05:00,678.71,316512.7500000049,315533.27000000497,979.4799999999232
31466,2022-10-19 11:10:00,-437.84,316074.91000000486,315533.27000000497,541.6399999998976
31467,2022-10-19 11:15:00,-1506.97,314567.9400000049,315533.27000000497,-965.3300000000745
31468,2022-10-19 11:20:00,1586.41,316154.35000000487,315533.27000000497,621.0799999998999
31469,2022-10-19 11:25:00,1049.62,317203.97000000486,315533.27000000497,1670.6999999998952
31470,2022-10-19 11:30:00,62.17,317266.14000000485,315533.27000000497,1732.869999999879
31471,2022-10-19 11:35:00,-1037.08,316229.0600000048,315533.27000000497,695.7899999998626
31472,2022-10-19 11:40:00,869.11,317098.1700000048,315533.27000000497,1564.8999999998487
31473,2022-10-19 11:45:00,1568.89,318667.0600000048,315533.27000000497,3133.7899999998626
31474,2022-10-19 11:50:00,-1736.76,316930.3000000048,315533.27000000497,1397.0299999998533
31475,2022-10-19 11:55:00,-1895.36,315034.94000000483,315533.27000000497,-498.3300000001327
31476,2022-10-19 12:00:00,-361.53,314673.4100000048,315533.27000000497,-859.8600000001607
31477,2022-10-19 12:05:00,855.24,315528.6500000048,315533.27000000497,-4.620000000169966
31478,2022-10-19 12:10:00,404.85,315933.5000000048,315533.27000000497,400.22999999980675
31479,2022-10-19 12:15:00,-1341.97,314591.5300000048,315533.27000000497,-941.7400000001653
31480,2022-10-19 12:20:00,-331.34,314260.1900000048,315533.27000000497,-1273.080000000191
31481,2022-10-19 12:25:00,-1904.83,312355.36000000476,315533.27000000497,-3177.910000000207
31482,2022-10-19 12:30:00,-443.03,311912.33000000473,315533.27000000497,-3620.940000000235
31483,2022-10-19 12:35:00,1828.7,313741.03000000474,315533.27000000497,-1792.2400000002235
31484,2022-10-19 12:40:00,1111.32,314852.35000000475,315533.27000000497,-680.9200000002165
31485,2022-10-19 12:45:00,112.99,314965.34000000474,315533.27000000497,-567.9300000002258
31486,2022-10-19 12:50:00,1660.42,316625.7600000047,315533.27000000497,1092.4899999997579
31487,2022-10-19 12:55:00,446.19,317071.9500000047,315533.27000000497,1538.6799999997602
31488,2022-10-19 13:00:00,-1390.59,315681.3600000047,315533.27000000497,148.08999999973457
31489,2022-10-19 13:05:00,-1612.57,314068.7900000047,315533.27000000497,-1464.4800000002724
31490,2022-10-19 13:10:00,481.66,314550.45000000467,315533.27000000497,-982.820000000298
31491,2022-10-19 13:15:00,-1365.31,313185.14000000467,315533.27000000497,-2348.1300000002957
31492,2022-10-19 13:20:00,618.17,313803.31000000465,315533.27000000497,-1729.960000000312
31493,2022-10-19 13:25:00,-174.87,313628.44000000466,315533.27000000497,-1904.8300000003073
31494,2022-10-19 13:30:00,-491.42,313137.0200000047,315533.27000000497,-2396.250000000291
31495,2022-10-19 13:35:00,711.92,313848.94000000466,315533.27000000497,-1684.3300000003073
31496,2022-10-19 13:40:00,-1998.09,311850.85000000463,315533.27000000497,-3682.420000000333
31497,2022-10-19 13:45:00,-1569.14,310281.7100000046,315533.27000000497,-5251.560000000347
31498,2022-10-19 13:50:00,-1353.59,308928.1200000046,315533.27000000497,-6605.1500000003725
31499,2022-10-19 13:55:00,806.45,309734.5700000046,315533.27000000497,-5798.700000000361
31500,2022-10-19 14:00:00,-1627.0,308107.5700000046,315533.27000000497,-7425.700000000361
31501,2022-10-19 14:05:00,1067.96,309175.5300000046,315533.27000000497,-6357.74000000034
31502,2022-10-19 14:10:00,1765.58,310941.11000000464,315533.27000000497,-4592.160000000324
31503,2022-10-19 14:15:00,1769.05,312710.16000000463,315533.27000000497,-2823.1100000003353
31504,2022-10-19 14:20:00,-111.89,312598.2700000046,315533.27000000497,-2935.0000000003492
31505,2022-10-19 14:25:00,-256.07,312342.2000000046,315533.27000000497,-3191.0700000003562
31506,2022-10-19 14:30:00,-909.22,311432.98000000464,315533.27000000497,-4100.290000000328
31507,2022-10-19 14:35:00,-1488.87,309944.11000000464,315533.27000000497,-5589.160000000324
31508,2022-10-19 14:40:00,-1101.71,308842.4000000046,315533.27000000497,-6690.870000000345
31509,2022-10-19 14:45:00,-1267.35,307575.05000000464,315533.27000000497,-7958.220000000321
31510,2022-10-19 14:50:00,-150.78,307424.2700000046,315533.27000000497,-8109.000000000349
31511,2022-10-19 14:55:00,-671.28,306752.9900000046,315533.27000000497,-8780.280000000377
31512,2022-10-19 15:00:00,108.54,306861.53000000457,315533.27000000497,-8671.740000000398
31513,2022-10-19 15:05:00,-1206.02,305655.51000000455,315533.27000000497,-9877.760000000417
31514,2022-10-19 15:10:00,1899.36,307554.87000000454,315533.27000000497,-7978.400000000431
31515,2022-10-19 15:15:00,331.97,307886.8400000045,315533.27000000497,-7646.430000000459
31516,2022-10-19 15:20:00,1353.32,309240.1600000045,315533.27000000497,-6293.110000000452
31517,2022-10-19 15:25:00,1718.23,310958.3900000045,315533.27000000497,-4574.88000000047
31518,2022-10-19 15:30:00,-1028.8,309929.5900000045,315533.27000000497,-5603.680000000459
31519,2022-10-19 15:35:00,1492.13,311421.7200000045,315533.27000000497,-4111.550000000454
31520,2022-10-19 15:40:00,570.04,311991.7600000045,315533.27000000497,-3541.510000000475
31521,2022-10-19 15:45:00,-261.76,311730.0000000045,315533.27000000497,-3803.2700000004843
31522,2022-10-19 15:50:00,-1917.93,309812.0700000045,315533.27000000497,-5721.200000000477
31523,2022-10-19 15:55:00,-295.25,309516.8200000045,315533.27000000497,-6016.450000000477
31524,2022-10-19 16:00:00,-449.14,309067.6800000045,315533.27000000497,-6465.590000000491
31525,2022-10-19 16:05:00,-1655.89,307411.79000000446,315533.27000000497,-8121.480000000505
31526,2022-10-19 16:10:00,269.54,307681.33000000444,315533.27000000497,-7851.940000000526
31527,2022-10-19 16:15:00,-1366.16,306315.17000000447,315533.27000000497,-9218.1000000005
31528,2022-10-19 16:20:00,-753.24,305561.9300000045,315533.27000000497,-9971.340000000491
31529,2022-10-19 16:25:00,1740.69,307302.6200000045,315533.27000000497,-8230.650000000489
31530,2022-10-19 16:30:00,904.69,308207.3100000045,315533.27000000497,-7325.960000000487
31531,2022-10-19 16:35:00,477.98,308685.29000000446,315533.27000000497,-6847.980000000505
31532,2022-10-19 16:40:00,1841.05,310526.34000000445,315533.27000000497,-5006.930000000517
31533,2022-10-19 16:45:00,-1498.14,309028.20000000444,315533.27000000497,-6505.070000000531
31534,2022-10-19 16:50:00,302.97,309331.1700000044,315533.27000000497,-6202.100000000559
31535,2022-10-19 16:55:00,-1833.99,307497.1800000044,315533.27000000497,-8036.0900000005495
31536,2022-10-20 08:00:00,1023.56,308520.7400000044,307497.1800000044,1023.5599999999977
31537,2022-10-20 08:05:00,-1803.96,306716.7800000044,307497.1800000044,-780.4000000000233
31538,2022-10-20 08:10:00,210.1,306926.88000000437,307497.1800000044,-570.3000000000466
31539,2022-10-20 08:15:00,403.54,307330.42000000435,307497.1800000044,-166.76000000006752
31540,2022-10-20 08:20:00,580.65,307911.0700000044,307497.1800000044,413.88999999995576
31541,2022-10-20 08:25:00,1120.44,309031.5100000044,307497.1800000044,1534.329999999958
31542,2022-10-20 08:30:00,1137.04,310168.55000000435,307497.1800000044,2671.369999999937
31543,2022-10-20 08:35:00,1311.39,311479.94000000437,307497.1800000044,3982.759999999951
31544,2022-10-20 08:40:00,-47.45,311432.49000000436,307497.1800000044,3935.3099999999395
31545,2022-10-20 08:45:00,890.89,312323.38000000437,307497.1800000044,4826.199999999953
31546,2022-10-20 08:50:00,1730.56,314053.94000000437,307497.1800000044,6556.759999999951
31547,2022-10-20 08:55:00,1795.52,315849.4600000044,307497.1800000044,8352.27999999997
31548,2022-10-20 09:00:00,651.65,316501.1100000044,307497.1800000044,9003.929999999993
31549,2022-10-20 09:05:00,-239.03,316262.0800000044,307497.1800000044,8764.899999999965
31550,2022-10-20 09:10:00,795.77,317057.8500000044,307497.1800000044,9560.669999999984
31551,2022-10-20 09:15:00,-1994.05,315063.8000000044,307497.1800000044,7566.619999999995
31552,2022-10-20 09:20:00,-1423.99,313639.8100000044,307497.1800000044,6142.630000000005
31553,2022-10-20 09:25:00,-1284.49,312355.32000000443,307497.1800000044,4858.140000000014
31554,2022-10-20 09:30:00,-1431.75,310923.57000000443,307497.1800000044,3426.390000000014
31555,2022-10-20 09:35:00,-981.97,309941.60000000446,307497.1800000044,2444.420000000042
31556,2022-10-20 09:40:00,1207.23,311148.83000000444,307497.1800000044,3651.6500000000233
31557,2022-10-20 09:45:00,1956.47,313105.3000000044,307497.1800000044,5608.119999999995
31558,2022-10-20 09:50:00,-515.36,312589.9400000044,307497.1800000044,5092.760000000009
31559,2022-10-20 09:55:00,1951.18,314541.1200000044,307497.1800000044,7043.940000000002
31560,2022-10-20 10:00:00,420.71,314961.83000000444,307497.1800000044,7464.650000000023
31561,2022-10-20 10:05:00,-1491.14,313470.6900000044,307497.1800000044,5973.510000000009
31562,2022-10-20 10:10:00,-239.15,313231.5400000044,307497.1800000044,5734.359999999986
31563,2022-10-20 10:15:00,1131.1,314362.6400000044,307497.1800000044,6865.459999999963
31564,2022-10-20 10:20:00,-1796.24,312566.4000000044,307497.1800000044,5069.219999999972
31565,2022-10-20 10:25:00,-1936.03,310630.37000000436,307497.1800000044,3133.189999999944
31566,2022-10-20 10:30:00,-1979.3,308651.0700000044,307497.1800000044,1153.8899999999558
31567,2022-10-20 10:35:00,319.96,308971.0300000044,307497.1800000044,1473.8499999999767
31568,2022-10-20 10:40:00,1504.35,310475.38000000437,307497.1800000044,2978.1999999999534
31569,2022-10-20 10:45:00,600.52,311075.9000000044,307497.1800000044,3578.719999999972
31570,2022-10-20 10:50:00,-1685.23,309390.6700000044,307497.1800000044,1893.4899999999907
31571,2022-10-20 10:55:00,1092.17,310482.8400000044,307497.1800000044,2985.6599999999744
31572,2022-10-20 11:00:00,-1354.74,309128.1000000044,307497.1800000044,1630.9199999999837
31573,2022-10-20 11:05:00,1781.38,310909.4800000044,307497.1800000044,3412.2999999999884
31574,2022-10-20 11:10:00,758.41,311667.8900000044,307497.1800000044,4170.709999999963
31575,2022-10-20 11:15:00,-917.14,310750.75000000437,307497.1800000044,3253.569999999949
31576,2022-10-20 11:20:00,195.1,310945.85000000434,307497.1800000044,3448.6699999999255
31577,2022-10-20 11:25:00,1913.9,312859.75000000437,307497.1800000044,5362.569999999949
31578,2022-10-20 11:30:00,88.04,312947.79000000434,307497.1800000044,5450.609999999928
31579,2022-10-20 11:35:00,-1598.81,311348.98000000435,307497.1800000044,3851.79999999993
31580,2022-10-20 11:40:00,-90.9,311258.0800000043,307497.1800000044,3760.899999999907
31581,2022-10-20 11:45:00,922.33,312180.41000000434,307497.1800000044,4683.229999999923
31582,2022-10-20 11:50:00,1559.35,313739.7600000043,307497.1800000044,6242.5799999999
31583,2022-10-20 11:55:00,663.13,314402.8900000043,307497.1800000044,6905.7099999999045
31584,2022-10-20 12:00:00,-90.79,314312.10000000434,307497.1800000044,6814.9199999999255
31585,2022-10-20 12:05:00,-1433.55,312878.55000000435,307497.1800000044,5381.369999999937
31586,2022-10-20 12:10:00,-1878.06,311000.49000000436,307497.1800000044,3503.3099999999395
31587,2022-10-20 12:15:00,1666.35,312666.84000000433,307497.1800000044,5169.659999999916
31588,2022-10-20 12:20:00,209.62,312876.4600000043,307497.1800000044,5379.2799999999115
31589,2022-10-20 12:25:00,899.58,313776.04000000434,307497.1800000044,6278.859999999928
31590,2022-10-20 12:30:00,-1499.41,312276.63000000437,307497.1800000044,4779.449999999953
31591,2022-10-20 12:35:00,-836.83,311439.80000000435,307497.1800000044,3942.619999999937
31592,2022-10-20 12:40:00,-1317.23,310122.5700000044,307497.1800000044,2625.3899999999558
31593,2022-10-20 12:45:00,558.87,310681.44000000437,307497.1800000044,3184.259999999951
31594,2022-10-20 12:50:00,552.49,311233.93000000436,307497.1800000044,3736.749999999942
31595,2022-10-20 12:55:00,464.66,311698.59000000433,307497.1800000044,4201.409999999916
31596,2022-10-20 13:00:00,-1763.04,309935.55000000435,307497.1800000044,2438.369999999937
31597,2022-10-20 13:05:00,-1794.45,308141.10000000434,307497.1800000044,643.9199999999255
31598,2022-10-20 13:10:00,368.66,308509.7600000043,307497.1800000044,1012.5799999998999
31599,2022-10-20 13:15:00,-757.47,307752.29000000434,307497.1800000044,255.10999999992782
31600,2022-10-20 13:20:00,-237.13,307515.16000000434,307497.1800000044,17.979999999923166
31601,2022-10-20 13:25:00,1167.76,308682.92000000435,307497.1800000044,1185.7399999999325
31602,2022-10-20 13:30:00,859.02,309541.94000000437,307497.1800000044,2044.759999999951
31603,2022-10-20 13:35:00,1359.38,310901.3200000044,307497.1800000044,3404.1399999999558
31604,2022-10-20 13:40:00,1426.28,312327.6000000044,307497.1800000044,4830.419999999984
31605,2022-10-20 13:45:00,1584.12,313911.7200000044,307497.1800000044,6414.539999999979
31606,2022-10-20 13:50:00,-352.86,313558.8600000044,307497.1800000044,6061.679999999993
31607,2022-10-20 13:55:00,1251.74,314810.6000000044,307497.1800000044,7313.419999999984
31608,2022-10-20 14:00:00,938.82,315749.4200000044,307497.1800000044,8252.23999999999
31609,2022-10-20 14:05:00,-332.1,315417.32000000443,307497.1800000044,7920.140000000014
31610,2022-10-20 14:10:00,-980.0,314437.32000000443,307497.1800000044,6940.140000000014
31611,2022-10-20 14:15:00,-598.09,313839.2300000044,307497.1800000044,6342.049999999988
31612,2022-10-20 14:20:00,831.19,314670.4200000044,307497.1800000044,7173.239999999991
31613,2022-10-20 14:25:00,-1459.4,313211.0200000044,307497.1800000044,5713.839999999967
31614,2022-10-20 14:30:00,-1591.71,311619.31000000436,307497.1800000044,4122.129999999946
31615,2022-10-20 14:35:00,1557.1,313176.41000000434,307497.1800000044,5679.229999999923
31616,2022-10-20 14:40:00,1510.88,314687.29000000434,307497.1800000044,7190.109999999928
31617,2022-10-20 14:45:00,-789.49,313897.80000000435,307497.1800000044,6400.619999999937
31618,2022-10-20 14:50:00,1788.11,315685.91000000434,307497.1800000044,8188.729999999923
31619,2022-10-20 14:55:00,1591.37,317277.28000000434,307497.1800000044,9780.099999999919
31620,2022-10-20 15:00:00,1769.58,319046.86000000435,307497.1800000044,11549.679999999935
31621,2022-10-20 15:05:00,-429.74,318617.12000000436,307497.1800000044,11119.939999999944
31622,2022-10-20 15:10:00,-1843.96,316773.16000000434,307497.1800000044,9275.979999999923
31623,2022-10-20 15:15:00,107.44,316880.60000000434,307497.1800000044,9383.419999999925
31624,2022-10-20 15:20:00,-1956.7,314923.90000000433,307497.1800000044,7426.719999999914
31625,2022-10-20 15:25:00,847.42,315771.3200000043,307497.1800000044,8274.139999999898
31626,2022-10-20 15:30:00,-111.19,315660.1300000043,307497.1800000044,8162.949999999895
31627,2022-10-20 15:35:00,1341.66,317001.7900000043,307497.1800000044,9504.60999999987
31628,2022-10-20 15:40:00,1872.59,318874.3800000043,307497.1800000044,11377.199999999895
31629,2022-10-20 15:45:00,-1560.47,317313.91000000434,307497.1800000044,9816.729999999923
31630,2022-10-20 15:50:00,-390.64,316923.2700000043,307497.1800000044,9426.08999999991
31631,2022-10-20 15:55:00,1179.73,318103.0000000043,307497.1800000044,10605.81999999989
31632,2022-10-20 16:00:00,1898.23,320001.2300000043,307497.1800000044,12504.049999999872
31633,2022-10-20 16:05:00,1133.36,321134.5900000043,307497.1800000044,13637.409999999858
31634,2022-10-20 16:10:00,86.65,321221.2400000043,307497.1800000044,13724.059999999881
31635,2022-10-20 16:15:00,1416.38,322637.6200000043,307497.1800000044,15140.439999999886
31636,2022-10-20 16:20:00,-144.17,322493.4500000043,307497.1800000044,14996.269999999902
31637,2022-10-20 16:25:00,1518.44,324011.8900000043,307497.1800000044,16514.709999999905
31638,2022-10-20 16:30:00,1753.81,325765.7000000043,307497.1800000044,18268.519999999902
31639,2022-10-20 16:35:00,1109.13,326874.8300000043,307497.1800000044,19377.649999999907
31640,2022-10-20 16:40:00,811.48,327686.3100000043,307497.1800000044,20189.12999999989
31641,2022-10-20 16:45:00,-839.49,326846.8200000043,307497.1800000044,19349.639999999898
31642,2022-10-20 16:50:00,521.31,327368.1300000043,307497.1800000044,19870.949999999895
31643,2022-10-20 16:55:00,-257.6,327110.53000000434,307497.1800000044,19613.34999999992
31644,2022-10-21 08:00:00,522.98,327633.5100000043,327110.53000000434,522.9799999999814
31645,2022-10-21 08:05:00,856.66,328490.1700000043,327110.53000000434,1379.6399999999558
31646,2022-10-21 08:10:00,1691.44,330181.6100000043,327110.53000000434,3071.079999999958
31647,2022-10-21 08:15:00,-1883.48,328298.1300000043,327110.53000000434,1187.5999999999767
31648,2022-10-21 08:20:00,-908.16,327389.97000000434,327110.53000000434,279.4400000000023
31649,2022-10-21 08:25:00,697.65,328087.62000000436,327110.53000000434,977.0900000000256
31650,2022-10-21 08:30:00,-1912.56,326175.06000000436,327110.53000000434,-935.4699999999721
31651,2022-10-21 08:35:00,883.82,327058.88000000437,327110.53000000434,-51.649999999965075
31652,2022-10-21 08:40:00,-446.63,326612.25000000437,327110.53000000434,-498.27999999996973
31653,2022-10-21 08:45:00,-321.13,326291.12000000436,327110.53000000434,-819.4099999999744
31654,2022-10-21 08:50:00,-332.23,325958.8900000044,327110.53000000434,-1151.6399999999558
31655,2022-10-21 08:55:00,-840.48,325118.4100000044,327110.53000000434,-1992.1199999999371
31656,2022-10-21 09:00:00,-85.79,325032.6200000044,327110.53000000434,-2077.909999999916
31657,2022-10-21 09:05:00,1834.1,326866.7200000044,327110.53000000434,-243.80999999993946
31658,2022-10-21 09:10:00,-457.12,326409.6000000044,327110.53000000434,-700.9299999999348
31659,2022-10-21 09:15:00,-1064.83,325344.7700000044,327110.53000000434,-1765.759999999951
31660,2022-10-21 09:20:00,-1241.8,324102.9700000044,327110.53000000434,-3007.5599999999395
31661,2022-10-21 09:25:00,-121.52,323981.4500000044,327110.53000000434,-3129.079999999958
31662,2022-10-21 09:30:00,-644.39,323337.06000000436,327110.53000000434,-3773.469999999972
31663,2022-10-21 09:35:00,-1987.69,321349.37000000436,327110.53000000434,-5761.159999999974
31664,2022-10-21 09:40:00,-1286.22,320063.1500000044,327110.53000000434,-7047.379999999946
31665,2022-10-21 09:45:00,1372.77,321435.9200000044,327110.53000000434,-5674.609999999928
31666,2022-10-21 09:50:00,619.34,322055.26000000443,327110.53000000434,-5055.269999999902
31667,2022-10-21 09:55:00,-1544.04,320511.22000000445,327110.53000000434,-6599.309999999881
31668,2022-10-21 10:00:00,596.98,321108.20000000444,327110.53000000434,-6002.3299999999
31669,2022-10-21 10:05:00,1251.08,322359.28000000445,327110.53000000434,-4751.249999999884
31670,2022-10-21 10:10:00,255.26,322614.54000000446,327110.53000000434,-4495.989999999874
31671,2022-10-21 10:15:00,-1976.52,320638.02000000444,327110.53000000434,-6472.509999999893
31672,2022-10-21 10:20:00,-107.57,320530.45000000444,327110.53000000434,-6580.0799999999
31673,2022-10-21 10:25:00,-303.34,320227.1100000044,327110.53000000434,-6883.4199999999255
31674,2022-10-21 10:30:00,-1900.38,318326.7300000044,327110.53000000434,-8783.79999999993
31675,2022-10-21 10:35:00,-224.82,318101.9100000044,327110.53000000434,-9008.619999999937
31676,2022-10-21 10:40:00,-1112.51,316989.4000000044,327110.53000000434,-10121.129999999946
31677,2022-10-21 10:45:00,-1228.15,315761.25000000437,327110.53000000434,-11349.27999999997
31678,2022-10-21 10:50:00,544.19,316305.44000000437,327110.53000000434,-10805.089999999967
31679,2022-10-21 10:55:00,1354.72,317660.16000000434,327110.53000000434,-9450.369999999995
31680,2022-10-21 11:00:00,-364.4,317295.7600000043,327110.53000000434,-9814.770000000019
31681,2022-10-21 11:05:00,-1162.62,316133.1400000043,327110.53000000434,-10977.390000000014
31682,2022-10-21 11:10:00,-575.63,315557.5100000043,327110.53000000434,-11553.020000000019
31683,2022-10-21 11:15:00,-1208.05,314349.4600000043,327110.53000000434,-12761.070000000007
31684,2022-10-21 11:20:00,-216.98,314132.48000000435,327110.53000000434,-12978.049999999988
31685,2022-10-21 11:25:00,758.57,314891.05000000435,327110.53000000434,-12219.479999999981
31686,2022-10-21 11:30:00,237.92,315128.97000000434,327110.53000000434,-11981.559999999998
31687,2022-10-21 11:35:00,1034.53,316163.50000000437,327110.53000000434,-10947.02999999997
31688,2022-10-21 11:40:00,-1035.05,315128.4500000044,327110.53000000434,-11982.079999999958
31689,2022-10-21 11:45:00,1280.99,316409.44000000437,327110.53000000434,-10701.089999999967
31690,2022-10-21 11:50:00,-1189.07,315220.37000000436,327110.53000000434,-11890.159999999974
31691,2022-10-21 11:55:00,-1572.42,313647.9500000044,327110.53000000434,-13462.579999999958
31692,2022-10-21 12:00:00,-1813.14,311834.81000000436,327110.53000000434,-15275.719999999972
31693,2022-10-21 12:05:00,691.44,312526.25000000437,327110.53000000434,-14584.27999999997
31694,2022-10-21 12:10:00,-1661.39,310864.86000000435,327110.53000000434,-16245.669999999984
31695,2022-10-21 12:15:00,1594.73,312459.59000000433,327110.53000000434,-14650.940000000002
31696,2022-10-21 12:20:00,-815.75,311643.84000000433,327110.53000000434,-15466.690000000002
31697,2022-10-21 12:25:00,938.34,312582.18000000436,327110.53000000434,-14528.349999999977
31698,2022-10-21 12:30:00,-172.07,312410.11000000435,327110.53000000434,-14700.419999999984
31699,2022-10-21 12:35:00,-1510.83,310899.28000000434,327110.53000000434,-16211.25
31700,2022-10-21 12:40:00,1131.25,312030.53000000434,327110.53000000434,-15080.0
31701,2022-10-21 12:45:00,1629.37,313659.90000000433,327110.53000000434,-13450.630000000005
31702,2022-10-21 12:50:00,631.46,314291.36000000435,327110.53000000434,-12819.169999999984
31703,2022-10-21 12:55:00,1765.17,316056.53000000434,327110.53000000434,-11054.0
31704,2022-10-21 13:00:00,-1499.22,314557.31000000436,327110.53000000434,-12553.219999999972
31705,2022-10-21 13:05:00,-401.86,314155.4500000044,327110.53000000434,-12955.079999999958
31706,2022-10-21 13:10:00,-115.94,314039.5100000044,327110.53000000434,-13071.01999999996
31707,2022-10-21 13:15:00,1514.0,315553.5100000044,327110.53000000434,-11557.01999999996
31708,2022-10-21 13:20:00,-1769.78,313783.73000000435,327110.53000000434,-13326.799999999988
31709,2022-10-21 13:25:00,-962.47,312821.2600000044,327110.53000000434,-14289.26999999996
31710,2022-10-21 13:30:00,-1891.96,310929.30000000435,327110.53000000434,-16181.229999999981
31711,2022-10-21 13:35:00,1911.73,312841.03000000434,327110.53000000434,-14269.5
31712,2022-10-21 13:40:00,263.58,313104.61000000435,327110.53000000434,-14005.919999999984
31713,2022-10-21 13:45:00,1092.53,314197.1400000044,327110.53000000434,-12913.389999999956
31714,2022-10-21 13:50:00,1627.08,315824.2200000044,327110.53000000434,-11286.30999999994
31715,2022-10-21 13:55:00,405.26,316229.4800000044,327110.53000000434,-10881.04999999993
31716,2022-10-21 14:00:00,1672.59,317902.07000000443,327110.53000000434,-9208.459999999905
31717,2022-10-21 14:05:00,-1350.48,316551.59000000445,327110.53000000434,-10558.939999999886
31718,2022-10-21 14:10:00,-348.47,316203.1200000045,327110.53000000434,-10907.409999999858
31719,2022-10-21 14:15:00,-1157.67,315045.4500000045,327110.53000000434,-12065.079999999842
31720,2022-10-21 14:20:00,1502.79,316548.2400000045,327110.53000000434,-10562.289999999863
31721,2022-10-21 14:25:00,-30.62,316517.6200000045,327110.53000000434,-10592.909999999858
31722,2022-10-21 14:30:00,88.18,316605.80000000447,327110.53000000434,-10504.729999999865
31723,2022-10-21 14:35:00,1240.91,317846.71000000444,327110.53000000434,-9263.81999999989
31724,2022-10-21 14:40:00,-198.19,317648.52000000444,327110.53000000434,-9462.009999999893
31725,2022-10-21 14:45:00,1516.49,319165.01000000443,327110.53000000434,-7945.519999999902
31726,2022-10-21 14:50:00,-1660.85,317504.16000000446,327110.53000000434,-9606.369999999879
31727,2022-10-21 14:55:00,567.85,318072.01000000443,327110.53000000434,-9038.519999999902
31728,2022-10-21 15:00:00,-1539.42,316532.59000000445,327110.53000000434,-10577.939999999886
31729,2022-10-21 15:05:00,-1785.99,314746.60000000446,327110.53000000434,-12363.929999999877
31730,2022-10-21 15:10:00,72.19,314818.79000000446,327110.53000000434,-12291.739999999874
31731,2022-10-21 15:15:00,-1464.73,313354.0600000045,327110.53000000434,-13756.469999999856
31732,2022-10-21 15:20:00,1626.93,314980.9900000045,327110.53000000434,-12129.539999999863
31733,2022-10-21 15:25:00,184.35,315165.34000000445,327110.53000000434,-11945.189999999886
31734,2022-10-21 15:30:00,566.03,315731.3700000045,327110.53000000434,-11379.159999999858
31735,2022-10-21 15:35:00,1697.37,317428.7400000045,327110.53000000434,-9681.789999999863
31736,2022-10-21 15:40:00,1211.21,318639.9500000045,327110.53000000434,-8470.579999999842
31737,2022-10-21 15:45:00,700.46,319340.4100000045,327110.53000000434,-7770.119999999821
31738,2022-10-21 15:50:00,881.07,320221.4800000045,327110.53000000434,-6889.049999999814
31739,2022-10-21 15:55:00,432.85,320654.3300000045,327110.53000000434,-6456.199999999837
31740,2022-10-21 16:00:00,-1788.18,318866.1500000045,327110.53000000434,-8244.37999999983
31741,2022-10-21 16:05:00,-98.57,318767.5800000045,327110.53000000434,-8342.949999999837
31742,2022-10-21 16:10:00,899.46,319667.0400000045,327110.53000000434,-7443.489999999816
31743,2022-10-21 16:15:00,716.34,320383.38000000454,327110.53000000434,-6727.14999999979
31744,2022-10-21 16:20:00,-462.87,319920.51000000455,327110.53000000434,-7190.019999999786
31745,2022-10-21 16:25:00,1982.99,321903.50000000454,327110.53000000434,-5207.029999999795
31746,2022-10-21 16:30:00,-547.61,321355.89000000455,327110.53000000434,-5754.639999999781
31747,2022-10-21 16:35:00,1487.01,322842.90000000456,327110.53000000434,-4267.629999999772
31748,2022-10-21 16:40:00,847.15,323690.0500000046,327110.53000000434,-3420.4799999997485
31749,2022-10-21 16:45:00,853.91,324543.96000000456,327110.53000000434,-2566.569999999774
31750,2022-10-21 16:50:00,1162.56,325706.52000000456,327110.53000000434,-1404.0099999997765
31751,2022-10-21 16:55:00,18.84,325725.3600000046,327110.53000000434,-1385.1699999997509
31752,2022-10-22 08:00:00,-274.73,325450.6300000046,325725.3600000046,-274.7299999999814
31753,2022-10-22 08:05:00,-297.78,325152.8500000046,325725.3600000046,-572.5100000000093
31754,2022-10-22 08:10:00,-1366.04,323786.8100000046,325725.3600000046,-1938.5499999999884
31755,2022-10-22 08:15:00,1242.45,325029.2600000046,325725.3600000046,-696.0999999999767
31756,2022-10-22 08:20:00,-1903.41,323125.85000000463,325725.3600000046,-2599.509999999951
31757,2022-10-22 08:25:00,-172.44,322953.41000000463,325725.3600000046,-2771.9499999999534
31758,2022-10-22 08:30:00,1672.22,324625.6300000046,325725.3600000046,-1099.7299999999814
31759,2022-10-22 08:35:00,799.4,325425.0300000046,325725.3600000046,-300.3299999999581
31760,2022-10-22 08:40:00,-672.77,324752.2600000046,325725.3600000046,-973.0999999999767
31761,2022-10-22 08:45:00,-1330.27,323421.9900000046,325725.3600000046,-2303.3699999999953
31762,2022-10-22 08:50:00,1846.65,325268.6400000046,325725.3600000046,-456.71999999997206
31763,2022-10-22 08:55:00,908.1,326176.7400000046,325725.3600000046,451.38000000000466
31764,2022-10-22 09:00:00,-143.57,326033.1700000046,325725.3600000046,307.8099999999977
31765,2022-10-22 09:05:00,-172.19,325860.9800000046,325725.3600000046,135.61999999999534
31766,2022-10-22 09:10:00,1378.92,327239.90000000456,325725.3600000046,1514.539999999979
31767,2022-10-22 09:15:00,45.84,327285.7400000046,325725.3600000046,1560.3800000000047
31768,2022-10-22 09:20:00,-1991.33,325294.4100000046,325725.3600000046,-430.95000000001164
31769,2022-10-22 09:25:00,-365.11,324929.3000000046,325725.3600000046,-796.0599999999977
31770,2022-10-22 09:30:00,-1436.21,323493.09000000457,325725.3600000046,-2232.2700000000186
31771,2022-10-22 09:35:00,-1066.71,322426.38000000454,325725.3600000046,-3298.9800000000396
31772,2022-10-22 09:40:00,202.69,322629.07000000455,325725.3600000046,-3096.2900000000373
31773,2022-10-22 09:45:00,-17.3,322611.77000000456,325725.3600000046,-3113.5900000000256
31774,2022-10-22 09:50:00,-1290.43,321321.34000000457,325725.3600000046,-4404.020000000019
31775,2022-10-22 09:55:00,1306.4,322627.7400000046,325725.3600000046,-3097.6199999999953
31776,2022-10-22 10:00:00,1706.83,324334.5700000046,325725.3600000046,-1390.789999999979
31777,2022-10-22 10:05:00,1566.23,325900.8000000046,325725.3600000046,175.44000000000233
31778,2022-10-22 10:10:00,182.01,326082.8100000046,325725.3600000046,357.45000000001164
31779,2022-10-22 10:15:00,-632.42,325450.3900000046,325725.3600000046,-274.96999999997206
31780,2022-10-22 10:20:00,-1398.88,324051.5100000046,325725.3600000046,-1673.8499999999767
31781,2022-10-22 10:25:00,493.68,324545.1900000046,325725.3600000046,-1180.1699999999837
31782,2022-10-22 10:30:00,-1112.99,323432.2000000046,325725.3600000046,-2293.1599999999744
31783,2022-10-22 10:35:00,-1389.41,322042.79000000464,325725.3600000046,-3682.569999999949
31784,2022-10-22 10:40:00,-849.18,321193.61000000464,325725.3600000046,-4531.749999999942
31785,2022-10-22 10:45:00,-1521.09,319672.5200000046,325725.3600000046,-6052.839999999967
31786,2022-10-22 10:50:00,762.66,320435.1800000046,325725.3600000046,-5290.179999999993
31787,2022-10-22 10:55:00,1691.65,322126.8300000046,325725.3600000046,-3598.5299999999697
31788,2022-10-22 11:00:00,-1789.01,320337.8200000046,325725.3600000046,-5387.539999999979
31789,2022-10-22 11:05:00,-1032.19,319305.6300000046,325725.3600000046,-6419.729999999981
31790,2022-10-22 11:10:00,-1156.56,318149.0700000046,325725.3600000046,-7576.289999999979
31791,2022-10-22 11:15:00,463.77,318612.8400000046,325725.3600000046,-7112.51999999996
31792,2022-10-22 11:20:00,-1927.9,316684.9400000046,325725.3600000046,-9040.419999999984
31793,2022-10-22 11:25:00,-640.34,316044.6000000046,325725.3600000046,-9680.76000000001
31794,2022-10-22 11:30:00,-1496.28,314548.32000000455,325725.3600000046,-11177.040000000037
31795,2022-10-22 11:35:00,558.87,315107.19000000454,325725.3600000046,-10618.170000000042
31796,2022-10-22 11:40:00,10.31,315117.50000000454,325725.3600000046,-10607.860000000044
31797,2022-10-22 11:45:00,-1117.05,314000.45000000455,325725.3600000046,-11724.910000000033
31798,2022-10-22 11:50:00,427.04,314427.49000000453,325725.3600000046,-11297.870000000054
31799,2022-10-22 11:55:00,-314.38,314113.1100000045,325725.3600000046,-11612.250000000058
31800,2022-10-22 12:00:00,1784.97,315898.0800000045,325725.3600000046,-9827.280000000086
31801,2022-10-22 12:05:00,-501.41,315396.6700000045,325725.3600000046,-10328.69000000006
31802,2022-10-22 12:10:00,207.22,315603.8900000045,325725.3600000046,-10121.470000000088
31803,2022-10-22 12:15:00,767.69,316371.5800000045,325725.3600000046,-9353.780000000086
31804,2022-10-22 12:20:00,-579.57,315792.0100000045,325725.3600000046,-9933.350000000093
31805,2022-10-22 12:25:00,1198.89,316990.9000000045,325725.3600000046,-8734.46000000008
31806,2022-10-22 12:30:00,-1128.53,315862.3700000045,325725.3600000046,-9862.990000000107
31807,2022-10-22 12:35:00,-604.56,315257.8100000045,325725.3600000046,-10467.550000000105
31808,2022-10-22 12:40:00,794.52,316052.3300000045,325725.3600000046,-9673.030000000086
31809,2022-10-22 12:45:00,1415.85,317468.1800000045,325725.3600000046,-8257.18000000011
31810,2022-10-22 12:50:00,-107.93,317360.2500000045,325725.3600000046,-8365.110000000102
31811,2022-10-22 12:55:00,-124.58,317235.67000000447,325725.3600000046,-8489.690000000119
31812,2022-10-22 13:00:00,509.12,317744.79000000446,325725.3600000046,-7980.570000000123
31813,2022-10-22 13:05:00,1698.02,319442.8100000045,325725.3600000046,-6282.550000000105
31814,2022-10-22 13:10:00,1957.85,321400.66000000446,325725.3600000046,-4324.700000000128
31815,2022-10-22 13:15:00,-1497.24,319903.42000000447,325725.3600000046,-5821.940000000119
31816,2022-10-22 13:20:00,1014.97,320918.39000000444,325725.3600000046,-4806.970000000147
31817,2022-10-22 13:25:00,-1356.34,319562.0500000044,325725.3600000046,-6163.310000000172
31818,2022-10-22 13:30:00,901.59,320463.64000000444,325725.3600000046,-5261.720000000147
31819,2022-10-22 13:35:00,-1559.75,318903.89000000444,325725.3600000046,-6821.470000000147
31820,2022-10-22 13:40:00,1933.39,320837.28000000445,325725.3600000046,-4888.080000000133
31821,2022-10-22 13:45:00,-671.45,320165.83000000444,325725.3600000046,-5559.530000000144
31822,2022-10-22 13:50:00,1669.04,321834.8700000044,325725.3600000046,-3890.4900000001653
31823,2022-10-22 13:55:00,1513.85,323348.7200000044,325725.3600000046,-2376.6400000001886
31824,2022-10-22 14:00:00,666.71,324015.4300000044,325725.3600000046,-1709.9300000001676
31825,2022-10-22 14:05:00,1702.2,325717.6300000044,325725.3600000046,-7.7300000001559965
31826,2022-10-22 14:10:00,-1970.76,323746.8700000044,325725.3600000046,-1978.4900000001653
31827,2022-10-22 14:15:00,1660.09,325406.96000000444,325725.3600000046,-318.4000000001397
31828,2022-10-22 14:20:00,1450.99,326857.95000000444,325725.3600000046,1132.589999999851
31829,2022-10-22 14:25:00,-565.27,326292.6800000044,325725.3600000046,567.3199999998324
31830,2022-10-22 14:30:00,743.44,327036.1200000044,325725.3600000046,1310.7599999998347
31831,2022-10-22 14:35:00,-1715.09,325321.0300000044,325725.3600000046,-404.3300000001909
31832,2022-10-22 14:40:00,-76.71,325244.3200000044,325725.3600000046,-481.0400000002119
31833,2022-10-22 14:45:00,-491.4,324752.92000000435,325725.3600000046,-972.4400000002352
31834,2022-10-22 14:50:00,-37.13,324715.79000000434,325725.3600000046,-1009.5700000002398
31835,2022-10-22 14:55:00,1510.33,326226.12000000436,325725.3600000046,500.7599999997765
31836,2022-10-22 15:00:00,-543.85,325682.2700000044,325725.3600000046,-43.090000000200234
31837,2022-10-22 15:05:00,458.61,326140.88000000437,325725.3600000046,415.5199999997858
31838,2022-10-22 15:10:00,-1046.69,325094.19000000437,325725.3600000046,-631.1700000002165
31839,2022-10-22 15:15:00,815.43,325909.62000000436,325725.3600000046,184.25999999977648
31840,2022-10-22 15:20:00,-166.88,325742.74000000436,325725.3600000046,17.379999999771826
31841,2022-10-22 15:25:00,1954.35,327697.09000000433,325725.3600000046,1971.7299999997485
31842,2022-10-22 15:30:00,-1499.15,326197.9400000043,325725.3600000046,472.57999999972526
31843,2022-10-22 15:35:00,-39.78,326158.1600000043,325725.3600000046,432.7999999996973
31844,2022-10-22 15:40:00,-1390.39,324767.77000000427,325725.3600000046,-957.5900000003166
31845,2022-10-22 15:45:00,1077.51,325845.2800000043,325725.3600000046,119.91999999969266
31846,2022-10-22 15:50:00,561.02,326406.3000000043,325725.3600000046,680.9399999997113
31847,2022-10-22 15:55:00,-1944.76,324461.5400000043,325725.3600000046,-1263.820000000298
31848,2022-10-22 16:00:00,-1703.91,322757.6300000043,325725.3600000046,-2967.7300000002724
31849,2022-10-22 16:05:00,776.68,323534.3100000043,325725.3600000046,-2191.0500000002794
31850,2022-10-22 16:10:00,-484.35,323049.9600000043,325725.3600000046,-2675.400000000256
31851,2022-10-22 16:15:00,1499.75,324549.7100000043,325725.3600000046,-1175.6500000002561
31852,2022-10-22 16:20:00,-1574.29,322975.42000000435,325725.3600000046,-2749.940000000235
31853,2022-10-22 16:25:00,244.33,323219.75000000437,325725.3600000046,-2505.610000000219
31854,2022-10-22 16:30:00,1718.84,324938.5900000044,325725.3600000046,-786.7700000001932
31855,2022-10-22 16:35:00,1981.7,326920.2900000044,325725.3600000046,1194.9299999998184
31856,2022-10-22 16:40:00,-39.38,326880.9100000044,325725.3600000046,1155.5499999998137
31857,2022-10-22 16:45:00,1244.42,328125.3300000044,325725.3600000046,2399.9699999997974
31858,2022-10-22 16:50:00,173.37,328298.7000000044,325725.3600000046,2573.339999999793
31859,2022-10-22 16:55:00,-1338.82,326959.88000000437,325725.3600000046,1234.5199999997858
31860,2022-10-23 08:00:00,-1574.83,325385.05000000435,326959.88000000437,-1574.8300000000163
31861,2022-10-23 08:05:00,-1018.84,324366.2100000043,326959.88000000437,-2593.670000000042
31862,2022-10-23 08:10:00,-803.16,323563.05000000435,326959.88000000437,-3396.8300000000163
31863,2022-10-23 08:15:00,-1070.33,322492.72000000434,326959.88000000437,-4467.160000000033
31864,2022-10-23 08:20:00,1926.29,324419.0100000043,326959.88000000437,-2540.8700000000536
31865,2022-10-23 08:25:00,14.65,324433.66000000434,326959.88000000437,-2526.2200000000303
31866,2022-10-23 08:30:00,806.97,325240.6300000043,326959.88000000437,-1719.2500000000582
31867,2022-10-23 08:35:00,-568.73,324671.90000000433,326959.88000000437,-2287.9800000000396
31868,2022-10-23 08:40:00,1804.87,326476.7700000043,326959.88000000437,-483.11000000004424
31869,2022-10-23 08:45:00,-556.61,325920.16000000434,326959.88000000437,-1039.7200000000303
31870,2022-10-23 08:50:00,1418.61,327338.7700000043,326959.88000000437,378.88999999995576
31871,2022-10-23 08:55:00,682.16,328020.9300000043,326959.88000000437,1061.0499999999302
31872,2022-10-23 09:00:00,893.89,328914.8200000043,326959.88000000437,1954.9399999999441
31873,2022-10-23 09:05:00,317.45,329232.2700000043,326959.88000000437,2272.3899999999558
31874,2022-10-23 09:10:00,-405.78,328826.4900000043,326959.88000000437,1866.6099999999278
31875,2022-10-23 09:15:00,1358.82,330185.3100000043,326959.88000000437,3225.429999999935
31876,2022-10-23 09:20:00,-921.04,329264.2700000043,326959.88000000437,2304.3899999999558
31877,2022-10-23 09:25:00,1924.98,331189.2500000043,326959.88000000437,4229.369999999937
31878,2022-10-23 09:30:00,1432.26,332621.5100000043,326959.88000000437,5661.629999999946
31879,2022-10-23 09:35:00,-520.41,332101.10000000434,326959.88000000437,5141.219999999972
31880,2022-10-23 09:40:00,-203.19,331897.91000000434,326959.88000000437,4938.02999999997
31881,2022-10-23 09:45:00,562.78,332460.69000000437,326959.88000000437,5500.809999999998
31882,2022-10-23 09:50:00,60.24,332520.93000000436,326959.88000000437,5561.049999999988
31883,2022-10-23 09:55:00,385.1,332906.03000000434,326959.88000000437,5946.149999999965
31884,2022-10-23 10:00:00,-713.6,332192.43000000436,326959.88000000437,5232.549999999988
31885,2022-10-23 10:05:00,-1859.45,330332.98000000435,326959.88000000437,3373.0999999999767
31886,2022-10-23 10:10:00,-516.28,329816.7000000043,326959.88000000437,2856.819999999949
31887,2022-10-23 10:15:00,560.25,330376.9500000043,326959.88000000437,3417.069999999949
31888,2022-10-23 10:20:00,-1650.17,328726.78000000434,326959.88000000437,1766.899999999965
31889,2022-10-23 10:25:00,393.64,329120.42000000435,326959.88000000437,2160.539999999979
31890,2022-10-23 10:30:00,1468.34,330588.7600000044,326959.88000000437,3628.8800000000047
31891,2022-10-23 10:35:00,-1287.77,329300.99000000436,326959.88000000437,2341.109999999986
31892,2022-10-23 10:40:00,519.08,329820.0700000044,326959.88000000437,2860.1900000000023
31893,2022-10-23 10:45:00,-1797.54,328022.5300000044,326959.88000000437,1062.6500000000233
31894,2022-10-23 10:50:00,-1278.02,326744.5100000044,326959.88000000437,-215.36999999999534
31895,2022-10-23 10:55:00,1820.49,328565.00000000437,326959.88000000437,1605.1199999999953
31896,2022-10-23 11:00:00,-1708.91,326856.0900000044,326959.88000000437,-103.78999999997905
31897,2022-10-23 11:05:00,-1482.13,325373.9600000044,326959.88000000437,-1585.9199999999837
31898,2022-10-23 11:10:00,1895.99,327269.9500000044,326959.88000000437,310.070000000007
31899,2022-10-23 11:15:00,595.57,327865.5200000044,326959.88000000437,905.640000000014
31900,2022-10-23 11:20:00,261.15,328126.6700000044,326959.88000000437,1166.7900000000373
31901,2022-10-23 11:25:00,-883.45,327243.2200000044,326959.88000000437,283.3400000000256
31902,2022-10-23 11:30:00,-1301.73,325941.4900000044,326959.88000000437,-1018.3899999999558
31903,2022-10-23 11:35:00,667.25,326608.7400000044,326959.88000000437,-351.13999999995576
31904,2022-10-23 11:40:00,228.4,326837.14000000444,326959.88000000437,-122.73999999993248
31905,2022-10-23 11:45:00,-759.69,326077.45000000444,326959.88000000437,-882.4299999999348
31906,2022-10-23 11:50:00,616.02,326693.47000000445,326959.88000000437,-266.4099999999162
31907,2022-10-23 11:55:00,-1597.3,325096.17000000447,326959.88000000437,-1863.7099999999045
31908,2022-10-23 12:00:00,-1373.67,323722.5000000045,326959.88000000437,-3237.3799999998882
31909,2022-10-23 12:05:00,-163.04,323559.4600000045,326959.88000000437,-3400.4199999998673
31910,2022-10-23 12:10:00,-335.51,323223.9500000045,326959.88000000437,-3735.9299999998766
31911,2022-10-23 12:15:00,313.61,323537.5600000045,326959.88000000437,-3422.3199999998906
31912,2022-10-23 12:20:00,117.56,323655.1200000045,326959.88000000437,-3304.759999999893
31913,2022-10-23 12:25:00,1670.09,325325.2100000045,326959.88000000437,-1634.6699999998673
31914,2022-10-23 12:30:00,-1628.01,323697.2000000045,326959.88000000437,-3262.6799999998766
31915,2022-10-23 12:35:00,-72.99,323624.2100000045,326959.88000000437,-3335.6699999998673
31916,2022-10-23 12:40:00,588.73,324212.9400000045,326959.88000000437,-2746.939999999886
31917,2022-10-23 12:45:00,-1231.93,322981.0100000045,326959.88000000437,-3978.869999999879
31918,2022-10-23 12:50:00,-1512.77,321468.2400000045,326959.88000000437,-5491.639999999898
31919,2022-10-23 12:55:00,-872.19,320596.05000000447,326959.88000000437,-6363.8299999999
31920,2022-10-23 13:00:00,1439.57,322035.6200000045,326959.88000000437,-4924.259999999893
31921,2022-10-23 13:05:00,-1628.49,320407.1300000045,326959.88000000437,-6552.749999999884
31922,2022-10-23 13:10:00,-1851.12,318556.0100000045,326959.88000000437,-8403.869999999879
31923,2022-10-23 13:15:00,-1151.82,317404.1900000045,326959.88000000437,-9555.689999999886
31924,2022-10-23 13:20:00,-1601.53,315802.66000000446,326959.88000000437,-11157.219999999914
31925,2022-10-23 13:25:00,1757.6,317560.26000000443,326959.88000000437,-9399.619999999937
31926,2022-10-23 13:30:00,1391.39,318951.65000000445,326959.88000000437,-8008.229999999923
31927,2022-10-23 13:35:00,1942.51,320894.16000000446,326959.88000000437,-6065.719999999914
31928,2022-10-23 13:40:00,1362.1,322256.26000000443,326959.88000000437,-4703.619999999937
31929,2022-10-23 13:45:00,-1958.0,320298.26000000443,326959.88000000437,-6661.619999999937
31930,2022-10-23 13:50:00,1902.49,322200.7500000044,326959.88000000437,-4759.129999999946
31931,2022-10-23 13:55:00,1603.45,323804.20000000444,326959.88000000437,-3155.679999999935
31932,2022-10-23 14:00:00,-1900.63,321903.57000000443,326959.88000000437,-5056.3099999999395
31933,2022-10-23 14:05:00,-1493.83,320409.7400000044,326959.88000000437,-6550.139999999956
31934,2022-10-23 14:10:00,218.2,320627.9400000044,326959.88000000437,-6331.939999999944
31935,2022-10-23 14:15:00,-1066.3,319561.64000000444,326959.88000000437,-7398.2399999999325
31936,2022-10-23 14:20:00,630.7,320192.34000000445,326959.88000000437,-6767.539999999921
31937,2022-10-23 14:25:00,-78.27,320114.07000000443,326959.88000000437,-6845.8099999999395
31938,2022-10-23 14:30:00,1587.5,321701.57000000443,326959.88000000437,-5258.3099999999395
31939,2022-10-23 14:35:00,-954.25,320747.32000000443,326959.88000000437,-6212.5599999999395
31940,2022-10-23 14:40:00,618.53,321365.85000000446,326959.88000000437,-5594.0299999999115
31941,2022-10-23 14:45:00,1126.99,322492.84000000445,326959.88000000437,-4467.039999999921
31942,2022-10-23 14:50:00,-1736.36,320756.48000000446,326959.88000000437,-6203.399999999907
31943,2022-10-23 14:55:00,-456.23,320300.2500000045,326959.88000000437,-6659.629999999888
31944,2022-10-23 15:00:00,1046.76,321347.0100000045,326959.88000000437,-5612.869999999879
31945,2022-10-23 15:05:00,728.65,322075.6600000045,326959.88000000437,-4884.219999999856
31946,2022-10-23 15:10:00,369.17,322444.8300000045,326959.88000000437,-4515.049999999872
31947,2022-10-23 15:15:00,1063.44,323508.2700000045,326959.88000000437,-3451.6099999998696
31948,2022-10-23 15:20:00,1066.21,324574.4800000045,326959.88000000437,-2385.3999999998487
31949,2022-10-23 15:25:00,492.91,325067.3900000045,326959.88000000437,-1892.4899999998743
31950,2022-10-23 15:30:00,256.11,325323.5000000045,326959.88000000437,-1636.3799999998882
31951,2022-10-23 15:35:00,134.58,325458.0800000045,326959.88000000437,-1501.799999999872
31952,2022-10-23 15:40:00,1.69,325459.7700000045,326959.88000000437,-1500.1099999998696
31953,2022-10-23 15:45:00,-1726.35,323733.4200000045,326959.88000000437,-3226.4599999998463
31954,2022-10-23 15:50:00,1920.2,325653.62000000454,326959.88000000437,-1306.2599999998347
31955,2022-10-23 15:55:00,-1517.48,324136.14000000455,326959.88000000437,-2823.739999999816
31956,2022-10-23 16:00:00,284.16,324420.3000000045,326959.88000000437,-2539.5799999998417
31957,2022-10-23 16:05:00,-1479.53,322940.7700000045,326959.88000000437,-4019.1099999998696
31958,2022-10-23 16:10:00,1278.49,324219.2600000045,326959.88000000437,-2740.619999999879
31959,2022-10-23 16:15:00,334.37,324553.6300000045,326959.88000000437,-2406.2499999998836
31960,2022-10-23 16:20:00,44.86,324598.4900000045,326959.88000000437,-2361.3899999998976
31961,2022-10-23 16:25:00,-638.2,323960.29000000446,326959.88000000437,-2999.589999999909
31962,2022-10-23 16:30:00,767.09,324727.3800000045,326959.88000000437,-2232.4999999998836
31963,2022-10-23 16:35:00,-1896.67,322830.7100000045,326959.88000000437,-4129.169999999867
31964,2022-10-23 16:40:00,-1617.68,321213.0300000045,326959.88000000437,-5746.84999999986
31965,2022-10-23 16:45:00,1719.1,322932.1300000045,326959.88000000437,-4027.7499999998836
31966,2022-10-23 16:50:00,-1593.16,321338.9700000045,326959.88000000437,-5620.909999999858
31967,2022-10-23 16:55:00,1419.18,322758.1500000045,326959.88000000437,-4201.729999999865
31968,2022-10-24 08:00:00,-1069.23,321688.9200000045,322758.1500000045,-1069.2299999999814
31969,2022-10-24 08:05:00,-1620.45,320068.4700000045,322758.1500000045,-2689.679999999993
31970,2022-10-24 08:10:00,-389.43,319679.0400000045,322758.1500000045,-3079.109999999986
31971,2022-10-24 08:15:00,-1003.56,318675.4800000045,322758.1500000045,-4082.6699999999837
31972,2022-10-24 08:20:00,1516.81,320192.2900000045,322758.1500000045,-2565.859999999986
31973,2022-10-24 08:25:00,978.18,321170.4700000045,322758.1500000045,-1587.679999999993
31974,2022-10-24 08:30:00,-1349.21,319821.2600000045,322758.1500000045,-2936.890000000014
31975,2022-10-24 08:35:00,434.23,320255.4900000045,322758.1500000045,-2502.6600000000326
31976,2022-10-24 08:40:00,-1289.04,318966.4500000045,322758.1500000045,-3791.7000000000116
31977,2022-10-24 08:45:00,670.29,319636.7400000045,322758.1500000045,-3121.4100000000326
31978,2022-10-24 08:50:00,203.67,319840.41000000446,322758.1500000045,-2917.740000000049
31979,2022-10-24 08:55:00,1732.88,321573.29000000446,322758.1500000045,-1184.8600000000442
31980,2022-10-24 09:00:00,1037.83,322611.1200000045,322758.1500000045,-147.03000000002794
31981,2022-10-24 09:05:00,-1753.17,320857.9500000045,322758.1500000045,-1900.2000000000116
31982,2022-10-24 09:10:00,1743.56,322601.5100000045,322758.1500000045,-156.64000000001397
31983,2022-10-24 09:15:00,1324.08,323925.5900000045,322758.1500000045,1167.4400000000023
31984,2022-10-24 09:20:00,304.4,324229.99000000453,322758.1500000045,1471.8400000000256
31985,2022-10-24 09:25:00,-244.26,323985.7300000045,322758.1500000045,1227.5800000000163
31986,2022-10-24 09:30:00,375.87,324361.6000000045,322758.1500000045,1603.4500000000116
31987,2022-10-24 09:35:00,1872.32,326233.9200000045,322758.1500000045,3475.7700000000186
31988,2022-10-24 09:40:00,1199.54,327433.4600000045,322758.1500000045,4675.309999999998
31989,2022-10-24 09:45:00,-696.72,326736.74000000453,322758.1500000045,3978.5900000000256
31990,2022-10-24 09:50:00,65.73,326802.4700000045,322758.1500000045,4044.320000000007
31991,2022-10-24 09:55:00,1009.31,327811.7800000045,322758.1500000045,5053.630000000005
31992,2022-10-24 10:00:00,-955.3,326856.4800000045,322758.1500000045,4098.330000000016
31993,2022-10-24 10:05:00,649.41,327505.8900000045,322758.1500000045,4747.739999999991
31994,2022-10-24 10:10:00,270.89,327776.7800000045,322758.1500000045,5018.630000000005
31995,2022-10-24 10:15:00,-969.76,326807.0200000045,322758.1500000045,4048.8699999999953
31996,2022-10-24 10:20:00,1757.21,328564.2300000045,322758.1500000045,5806.080000000016
31997,2022-10-24 10:25:00,147.17,328711.4000000045,322758.1500000045,5953.25
31998,2022-10-24 10:30:00,1555.24,330266.6400000045,322758.1500000045,7508.489999999991
31999,2022-10-24 10:35:00,1345.67,331612.3100000045,322758.1500000045,8854.159999999974
32000,2022-10-24 10:40:00,1833.1,333445.41000000446,322758.1500000045,10687.259999999951
32001,2022-10-24 10:45:00,1696.24,335141.65000000445,322758.1500000045,12383.499999999942
32002,2022-10-24 10:50:00,-1374.83,333766.82000000443,322758.1500000045,11008.669999999925
32003,2022-10-24 10:55:00,-1219.38,332547.4400000044,322758.1500000045,9789.28999999992
32004,2022-10-24 11:00:00,-976.06,331571.3800000044,322758.1500000045,8813.229999999923
32005,2022-10-24 11:05:00,-1935.29,329636.09000000445,322758.1500000045,6877.939999999944
32006,2022-10-24 11:10:00,-655.48,328980.61000000447,322758.1500000045,6222.459999999963
32007,2022-10-24 11:15:00,901.89,329882.5000000045,322758.1500000045,7124.349999999977
32008,2022-10-24 11:20:00,1253.88,331136.3800000045,322758.1500000045,8378.229999999981
32009,2022-10-24 11:25:00,-1433.02,329703.36000000447,322758.1500000045,6945.209999999963
32010,2022-10-24 11:30:00,1388.4,331091.7600000045,322758.1500000045,8333.609999999986
32011,2022-10-24 11:35:00,-1166.55,329925.2100000045,322758.1500000045,7167.059999999998
32012,2022-10-24 11:40:00,409.81,330335.0200000045,322758.1500000045,7576.869999999995
32013,2022-10-24 11:45:00,1027.94,331362.9600000045,322758.1500000045,8604.809999999998
32014,2022-10-24 11:50:00,-1663.55,329699.4100000045,322758.1500000045,6941.260000000009
32015,2022-10-24 11:55:00,-1007.78,328691.6300000045,322758.1500000045,5933.479999999981
32016,2022-10-24 12:00:00,-649.84,328041.79000000446,322758.1500000045,5283.639999999956
32017,2022-10-24 12:05:00,-946.42,327095.3700000045,322758.1500000045,4337.219999999972
32018,2022-10-24 12:10:00,1078.45,328173.8200000045,322758.1500000045,5415.669999999984
32019,2022-10-24 12:15:00,-435.36,327738.4600000045,322758.1500000045,4980.309999999998
32020,2022-10-24 12:20:00,-1930.3,325808.1600000045,322758.1500000045,3050.0100000000093
32021,2022-10-24 12:25:00,1833.97,327642.1300000045,322758.1500000045,4883.979999999981
32022,2022-10-24 12:30:00,1444.12,329086.2500000045,322758.1500000045,6328.099999999977
32023,2022-10-24 12:35:00,1062.64,330148.8900000045,322758.1500000045,7390.739999999991
32024,2022-10-24 12:40:00,-576.86,329572.0300000045,322758.1500000045,6813.880000000005
32025,2022-10-24 12:45:00,1711.77,331283.8000000045,322758.1500000045,8525.650000000023
32026,2022-10-24 12:50:00,-1590.28,329693.5200000045,322758.1500000045,6935.369999999995
32027,2022-10-24 12:55:00,1884.3,331577.8200000045,322758.1500000045,8819.669999999984
32028,2022-10-24 13:00:00,673.71,332251.5300000045,322758.1500000045,9493.380000000005
32029,2022-10-24 13:05:00,913.63,333165.1600000045,322758.1500000045,10407.01000000001
32030,2022-10-24 13:10:00,-1018.16,332147.00000000454,322758.1500000045,9388.850000000035
32031,2022-10-24 13:15:00,-1915.56,330231.44000000454,322758.1500000045,7473.290000000037
32032,2022-10-24 13:20:00,-1807.12,328424.32000000455,322758.1500000045,5666.170000000042
32033,2022-10-24 13:25:00,-569.1,327855.22000000457,322758.1500000045,5097.070000000065
32034,2022-10-24 13:30:00,27.4,327882.6200000046,322758.1500000045,5124.4700000000885
32035,2022-10-24 13:35:00,-629.23,327253.3900000046,322758.1500000045,4495.240000000107
32036,2022-10-24 13:40:00,-1966.71,325286.6800000046,322758.1500000045,2528.530000000086
32037,2022-10-24 13:45:00,104.52,325391.2000000046,322758.1500000045,2633.050000000105
32038,2022-10-24 13:50:00,-612.88,324778.3200000046,322758.1500000045,2020.1700000001001
32039,2022-10-24 13:55:00,-423.25,324355.0700000046,322758.1500000045,1596.9200000001001
32040,2022-10-24 14:00:00,1221.53,325576.60000000463,322758.1500000045,2818.450000000128
32041,2022-10-24 14:05:00,1552.25,327128.85000000463,322758.1500000045,4370.700000000128
32042,2022-10-24 14:10:00,-1514.1,325614.75000000466,322758.1500000045,2856.6000000001513
32043,2022-10-24 14:15:00,-1971.06,323643.69000000466,322758.1500000045,885.5400000001537
32044,2022-10-24 14:20:00,-1105.17,322538.5200000047,322758.1500000045,-219.62999999983003
32045,2022-10-24 14:25:00,574.74,323113.26000000467,322758.1500000045,355.11000000016065
32046,2022-10-24 14:30:00,-21.72,323091.5400000047,322758.1500000045,333.3900000001886
32047,2022-10-24 14:35:00,1514.23,324605.7700000047,322758.1500000045,1847.62000000017
32048,2022-10-24 14:40:00,761.57,325367.3400000047,322758.1500000045,2609.190000000177
32049,2022-10-24 14:45:00,977.13,326344.4700000047,322758.1500000045,3586.3200000001816
32050,2022-10-24 14:50:00,-1439.81,324904.6600000047,322758.1500000045,2146.510000000184
32051,2022-10-24 14:55:00,-950.83,323953.8300000047,322758.1500000045,1195.6800000001676
32052,2022-10-24 15:00:00,1072.63,325026.4600000047,322758.1500000045,2268.3100000001723
32053,2022-10-24 15:05:00,-899.97,324126.4900000047,322758.1500000045,1368.3400000002002
32054,2022-10-24 15:10:00,1416.29,325542.7800000047,322758.1500000045,2784.6300000001793
32055,2022-10-24 15:15:00,882.31,326425.0900000047,322758.1500000045,3666.940000000177
32056,2022-10-24 15:20:00,-1116.5,325308.5900000047,322758.1500000045,2550.440000000177
32057,2022-10-24 15:25:00,-1628.2,323680.39000000467,322758.1500000045,922.2400000001653
32058,2022-10-24 15:30:00,1341.55,325021.94000000466,322758.1500000045,2263.7900000001537
32059,2022-10-24 15:35:00,-1538.08,323483.86000000464,322758.1500000045,725.7100000001374
32060,2022-10-24 15:40:00,-1225.81,322258.05000000464,322758.1500000045,-500.0999999998603
32061,2022-10-24 15:45:00,219.53,322477.5800000047,322758.1500000045,-280.56999999983236
32062,2022-10-24 15:50:00,978.58,323456.1600000047,322758.1500000045,698.0100000001839
32063,2022-10-24 15:55:00,1796.34,325252.5000000047,322758.1500000045,2494.3500000002095
32064,2022-10-24 16:00:00,-1456.51,323795.9900000047,322758.1500000045,1037.8400000002002
32065,2022-10-24 16:05:00,-1434.22,322361.77000000473,322758.1500000045,-396.3799999997718
32066,2022-10-24 16:10:00,1714.53,324076.30000000476,322758.1500000045,1318.1500000002561
32067,2022-10-24 16:15:00,-38.3,324038.0000000048,322758.1500000045,1279.8500000002678
32068,2022-10-24 16:20:00,-1847.77,322190.23000000475,322758.1500000045,-567.9199999997509
32069,2022-10-24 16:25:00,-957.03,321233.2000000047,322758.1500000045,-1524.9499999997788
32070,2022-10-24 16:30:00,-859.11,320374.09000000474,322758.1500000045,-2384.059999999765
32071,2022-10-24 16:35:00,-626.98,319747.11000000476,322758.1500000045,-3011.039999999746
32072,2022-10-24 16:40:00,1044.88,320791.99000000476,322758.1500000045,-1966.1599999997416
32073,2022-10-24 16:45:00,-420.16,320371.8300000048,322758.1500000045,-2386.319999999716
32074,2022-10-24 16:50:00,55.14,320426.9700000048,322758.1500000045,-2331.179999999702
32075,2022-10-24 16:55:00,-1160.83,319266.1400000048,322758.1500000045,-3492.0099999997183
32076,2022-10-25 08:00:00,-1145.52,318120.62000000477,319266.1400000048,-1145.5200000000186
32077,2022-10-25 08:05:00,-1149.89,316970.73000000475,319266.1400000048,-2295.4100000000326
32078,2022-10-25 08:10:00,-287.9,316682.83000000473,319266.1400000048,-2583.310000000056
32079,2022-10-25 08:15:00,-1805.81,314877.02000000473,319266.1400000048,-4389.120000000054
32080,2022-10-25 08:20:00,1323.1,316200.1200000047,319266.1400000048,-3066.020000000077
32081,2022-10-25 08:25:00,1699.88,317900.0000000047,319266.1400000048,-1366.1400000000722
32082,2022-10-25 08:30:00,-582.2,317317.8000000047,319266.1400000048,-1948.3400000000838
32083,2022-10-25 08:35:00,1831.89,319149.6900000047,319266.1400000048,-116.45000000006985
32084,2022-10-25 08:40:00,1112.63,320262.3200000047,319266.1400000048,996.1799999999348
32085,2022-10-25 08:45:00,-465.05,319797.27000000473,319266.1400000048,531.1299999999464
32086,2022-10-25 08:50:00,1638.2,321435.47000000475,319266.1400000048,2169.329999999958
32087,2022-10-25 08:55:00,1640.07,323075.54000000475,319266.1400000048,3809.399999999965
32088,2022-10-25 09:00:00,981.86,324057.40000000474,319266.1400000048,4791.259999999951
32089,2022-10-25 09:05:00,349.42,324406.8200000047,319266.1400000048,5140.679999999935
32090,2022-10-25 09:10:00,534.1,324940.9200000047,319266.1400000048,5674.7799999999115
32091,2022-10-25 09:15:00,-1951.01,322989.9100000047,319266.1400000048,3723.769999999902
32092,2022-10-25 09:20:00,1587.04,324576.95000000467,319266.1400000048,5310.809999999881
32093,2022-10-25 09:25:00,1366.75,325943.70000000467,319266.1400000048,6677.559999999881
32094,2022-10-25 09:30:00,-768.41,325175.2900000047,319266.1400000048,5909.149999999907
32095,2022-10-25 09:35:00,-1039.6,324135.6900000047,319266.1400000048,4869.54999999993
32096,2022-10-25 09:40:00,574.98,324710.6700000047,319266.1400000048,5444.5299999999115
32097,2022-10-25 09:45:00,-506.58,324204.0900000047,319266.1400000048,4937.949999999895
32098,2022-10-25 09:50:00,-1517.8,322686.2900000047,319266.1400000048,3420.149999999907
32099,2022-10-25 09:55:00,268.87,322955.1600000047,319266.1400000048,3689.019999999902
32100,2022-10-25 10:00:00,-1712.45,321242.7100000047,319266.1400000048,1976.5699999998906
32101,2022-10-25 10:05:00,168.74,321411.45000000467,319266.1400000048,2145.3099999998813
32102,2022-10-25 10:10:00,-138.58,321272.87000000465,319266.1400000048,2006.729999999865
32103,2022-10-25 10:15:00,1771.27,323044.14000000467,319266.1400000048,3777.9999999998836
32104,2022-10-25 10:20:00,-462.53,322581.61000000464,319266.1400000048,3315.4699999998556
32105,2022-10-25 10:25:00,-131.28,322450.3300000046,319266.1400000048,3184.1899999998277
32106,2022-10-25 10:30:00,-737.62,321712.7100000046,319266.1400000048,2446.5699999998324
32107,2022-10-25 10:35:00,144.08,321856.79000000464,319266.1400000048,2590.6499999998487
32108,2022-10-25 10:40:00,-540.08,321316.7100000046,319266.1400000048,2050.5699999998324
32109,2022-10-25 10:45:00,-790.41,320526.30000000464,319266.1400000048,1260.159999999858
32110,2022-10-25 10:50:00,-279.05,320247.25000000466,319266.1400000048,981.1099999998696
32111,2022-10-25 10:55:00,-833.61,319413.64000000467,319266.1400000048,147.49999999988358
32112,2022-10-25 11:00:00,-1286.26,318127.38000000466,319266.1400000048,-1138.7600000001257
32113,2022-10-25 11:05:00,1580.92,319708.30000000464,319266.1400000048,442.159999999858
32114,2022-10-25 11:10:00,-99.13,319609.17000000464,319266.1400000048,343.0299999998533
32115,2022-10-25 11:15:00,108.43,319717.60000000463,319266.1400000048,451.45999999984633
32116,2022-10-25 11:20:00,1552.1,321269.7000000046,319266.1400000048,2003.559999999823
32117,2022-10-25 11:25:00,39.13,321308.8300000046,319266.1400000048,2042.6899999998277
32118,2022-10-25 11:30:00,1591.53,322900.36000000464,319266.1400000048,3634.2199999998556
32119,2022-10-25 11:35:00,363.82,323264.18000000465,319266.1400000048,3998.0399999998626
32120,2022-10-25 11:40:00,1443.6,324707.7800000046,319266.1400000048,5441.639999999839
32121,2022-10-25 11:45:00,931.22,325639.0000000046,319266.1400000048,6372.859999999811
32122,2022-10-25 11:50:00,-1906.08,323732.9200000046,319266.1400000048,4466.779999999795
32123,2022-10-25 11:55:00,211.52,323944.4400000046,319266.1400000048,4678.299999999814
32124,2022-10-25 12:00:00,-374.18,323570.2600000046,319266.1400000048,4304.119999999821
32125,2022-10-25 12:05:00,1069.58,324639.8400000046,319266.1400000048,5373.699999999837
32126,2022-10-25 12:10:00,1229.73,325869.5700000046,319266.1400000048,6603.429999999818
32127,2022-10-25 12:15:00,1433.23,327302.8000000046,319266.1400000048,8036.6599999998
32128,2022-10-25 12:20:00,-147.64,327155.1600000046,319266.1400000048,7889.019999999786
32129,2022-10-25 12:25:00,-768.75,326386.4100000046,319266.1400000048,7120.269999999786
32130,2022-10-25 12:30:00,1195.54,327581.95000000455,319266.1400000048,8315.809999999765
32131,2022-10-25 12:35:00,-1267.03,326314.9200000045,319266.1400000048,7048.779999999737
32132,2022-10-25 12:40:00,-1965.98,324348.94000000454,319266.1400000048,5082.7999999997555
32133,2022-10-25 12:45:00,-546.26,323802.68000000453,319266.1400000048,4536.539999999746
32134,2022-10-25 12:50:00,915.63,324718.31000000454,319266.1400000048,5452.169999999751
32135,2022-10-25 12:55:00,1475.23,326193.5400000045,319266.1400000048,6927.399999999732
32136,2022-10-25 13:00:00,1708.88,327902.4200000045,319266.1400000048,8636.279999999737
32137,2022-10-25 13:05:00,1125.48,329027.9000000045,319266.1400000048,9761.759999999718
32138,2022-10-25 13:10:00,1230.65,330258.5500000045,319266.1400000048,10992.409999999742
32139,2022-10-25 13:15:00,131.45,330390.00000000454,319266.1400000048,11123.859999999753
32140,2022-10-25 13:20:00,1688.53,332078.53000000457,319266.1400000048,12812.389999999781
32141,2022-10-25 13:25:00,1347.84,333426.3700000046,319266.1400000048,14160.229999999807
32142,2022-10-25 13:30:00,674.98,334101.3500000046,319266.1400000048,14835.209999999788
32143,2022-10-25 13:35:00,-1564.03,332537.32000000455,319266.1400000048,13271.17999999976
32144,2022-10-25 13:40:00,1073.86,333611.18000000453,319266.1400000048,14345.039999999746
32145,2022-10-25 13:45:00,1768.88,335380.06000000454,319266.1400000048,16113.91999999975
32146,2022-10-25 13:50:00,1423.34,336803.40000000456,319266.1400000048,17537.259999999776
32147,2022-10-25 13:55:00,-1976.55,334826.8500000046,319266.1400000048,15560.709999999788
32148,2022-10-25 14:00:00,-970.58,333856.27000000456,319266.1400000048,14590.129999999772
32149,2022-10-25 14:05:00,-968.01,332888.26000000455,319266.1400000048,13622.119999999763
32150,2022-10-25 14:10:00,-458.17,332430.09000000457,319266.1400000048,13163.949999999779
32151,2022-10-25 14:15:00,1929.81,334359.90000000456,319266.1400000048,15093.759999999776
32152,2022-10-25 14:20:00,-1463.36,332896.5400000046,319266.1400000048,13630.39999999979
32153,2022-10-25 14:25:00,-1846.68,331049.8600000046,319266.1400000048,11783.719999999797
32154,2022-10-25 14:30:00,-812.69,330237.1700000046,319266.1400000048,10971.029999999795
32155,2022-10-25 14:35:00,1954.3,332191.47000000457,319266.1400000048,12925.329999999783
32156,2022-10-25 14:40:00,-188.61,332002.8600000046,319266.1400000048,12736.719999999797
32157,2022-10-25 14:45:00,33.04,332035.90000000456,319266.1400000048,12769.759999999776
32158,2022-10-25 14:50:00,1981.79,334017.69000000454,319266.1400000048,14751.549999999756
32159,2022-10-25 14:55:00,-1834.5,332183.19000000454,319266.1400000048,12917.049999999756
32160,2022-10-25 15:00:00,-376.72,331806.47000000457,319266.1400000048,12540.329999999783
32161,2022-10-25 15:05:00,-610.46,331196.01000000455,319266.1400000048,11929.869999999763
32162,2022-10-25 15:10:00,34.82,331230.83000000456,319266.1400000048,11964.68999999977
32163,2022-10-25 15:15:00,855.28,332086.1100000046,319266.1400000048,12819.969999999797
32164,2022-10-25 15:20:00,-1733.88,330352.2300000046,319266.1400000048,11086.089999999793
32165,2022-10-25 15:25:00,1413.67,331765.90000000456,319266.1400000048,12499.759999999776
32166,2022-10-25 15:30:00,-840.21,330925.69000000454,319266.1400000048,11659.549999999756
32167,2022-10-25 15:35:00,707.16,331632.8500000045,319266.1400000048,12366.70999999973
32168,2022-10-25 15:40:00,525.69,332158.5400000045,319266.1400000048,12892.399999999732
32169,2022-10-25 15:45:00,1017.41,333175.9500000045,319266.1400000048,13909.809999999707
32170,2022-10-25 15:50:00,-612.2,332563.7500000045,319266.1400000048,13297.609999999695
32171,2022-10-25 15:55:00,437.52,333001.2700000045,319266.1400000048,13735.129999999714
32172,2022-10-25 16:00:00,-796.21,332205.0600000045,319266.1400000048,12938.919999999693
32173,2022-10-25 16:05:00,1993.29,334198.35000000446,319266.1400000048,14932.209999999672
32174,2022-10-25 16:10:00,1178.81,335377.16000000446,319266.1400000048,16111.01999999967
32175,2022-10-25 16:15:00,1795.08,337172.2400000045,319266.1400000048,17906.099999999686
32176,2022-10-25 16:20:00,581.44,337753.6800000045,319266.1400000048,18487.539999999688
32177,2022-10-25 16:25:00,1465.58,339219.2600000045,319266.1400000048,19953.119999999704
32178,2022-10-25 16:30:00,1088.64,340307.9000000045,319266.1400000048,21041.75999999972
32179,2022-10-25 16:35:00,687.63,340995.5300000045,319266.1400000048,21729.389999999723
32180,2022-10-25 16:40:00,478.54,341474.0700000045,319266.1400000048,22207.929999999702
32181,2022-10-25 16:45:00,-1079.45,340394.6200000045,319266.1400000048,21128.47999999969
32182,2022-10-25 16:50:00,409.75,340804.3700000045,319266.1400000048,21538.22999999969
32183,2022-10-25 16:55:00,1306.61,342110.98000000446,319266.1400000048,22844.839999999676
32184,2022-10-26 08:00:00,-841.33,341269.65000000445,342110.98000000446,-841.3300000000163
32185,2022-10-26 08:05:00,719.1,341988.7500000044,342110.98000000446,-122.23000000003958
32186,2022-10-26 08:10:00,-103.76,341884.9900000044,342110.98000000446,-225.9900000000489
32187,2022-10-26 08:15:00,1428.32,343313.3100000044,342110.98000000446,1202.329999999958
32188,2022-10-26 08:20:00,1435.43,344748.7400000044,342110.98000000446,2637.759999999951
32189,2022-10-26 08:25:00,1308.02,346056.76000000443,342110.98000000446,3945.7799999999697
32190,2022-10-26 08:30:00,-901.11,345155.65000000445,342110.98000000446,3044.6699999999837
32191,2022-10-26 08:35:00,310.68,345466.33000000444,342110.98000000446,3355.3499999999767
32192,2022-10-26 08:40:00,1884.27,347350.60000000446,342110.98000000446,5239.619999999995
32193,2022-10-26 08:45:00,-1394.35,345956.2500000045,342110.98000000446,3845.2700000000186
32194,2022-10-26 08:50:00,1325.97,347282.22000000445,342110.98000000446,5171.239999999991
32195,2022-10-26 08:55:00,-399.24,346882.98000000446,342110.98000000446,4772.0
32196,2022-10-26 09:00:00,152.52,347035.5000000045,342110.98000000446,4924.520000000019
32197,2022-10-26 09:05:00,-1378.85,345656.6500000045,342110.98000000446,3545.670000000042
32198,2022-10-26 09:10:00,-468.25,345188.4000000045,342110.98000000446,3077.420000000042
32199,2022-10-26 09:15:00,-567.29,344621.1100000045,342110.98000000446,2510.130000000063
32200,2022-10-26 09:20:00,126.25,344747.3600000045,342110.98000000446,2636.380000000063
32201,2022-10-26 09:25:00,1386.1,346133.4600000045,342110.98000000446,4022.4800000000396
32202,2022-10-26 09:30:00,1480.12,347613.5800000045,342110.98000000446,5502.600000000035
32203,2022-10-26 09:35:00,455.57,348069.1500000045,342110.98000000446,5958.170000000042
32204,2022-10-26 09:40:00,1414.73,349483.8800000045,342110.98000000446,7372.900000000023
32205,2022-10-26 09:45:00,1327.92,350811.80000000447,342110.98000000446,8700.820000000007
32206,2022-10-26 09:50:00,-1829.86,348981.9400000045,342110.98000000446,6870.960000000021
32207,2022-10-26 09:55:00,-356.77,348625.17000000447,342110.98000000446,6514.190000000002
32208,2022-10-26 10:00:00,1272.58,349897.7500000045,342110.98000000446,7786.770000000019
32209,2022-10-26 10:05:00,-149.14,349748.61000000447,342110.98000000446,7637.630000000005
32210,2022-10-26 10:10:00,1210.54,350959.15000000445,342110.98000000446,8848.169999999984
32211,2022-10-26 10:15:00,-1841.34,349117.8100000044,342110.98000000446,7006.829999999958
32212,2022-10-26 10:20:00,1668.45,350786.26000000443,342110.98000000446,8675.27999999997
32213,2022-10-26 10:25:00,1937.22,352723.4800000044,342110.98000000446,10612.499999999942
32214,2022-10-26 10:30:00,-262.61,352460.8700000044,342110.98000000446,10349.889999999956
32215,2022-10-26 10:35:00,-1014.18,351446.6900000044,342110.98000000446,9335.709999999963
32216,2022-10-26 10:40:00,-1470.96,349975.7300000044,342110.98000000446,7864.749999999942
32217,2022-10-26 10:45:00,-888.1,349087.6300000044,342110.98000000446,6976.649999999965
32218,2022-10-26 10:50:00,-469.98,348617.65000000445,342110.98000000446,6506.669999999984
32219,2022-10-26 10:55:00,162.11,348779.76000000443,342110.98000000446,6668.77999999997
32220,2022-10-26 11:00:00,1615.95,350395.71000000444,342110.98000000446,8284.729999999981
32221,2022-10-26 11:05:00,-786.36,349609.35000000446,342110.98000000446,7498.369999999995
32222,2022-10-26 11:10:00,515.39,350124.7400000045,342110.98000000446,8013.760000000009
32223,2022-10-26 11:15:00,368.31,350493.05000000447,342110.98000000446,8382.070000000007
32224,2022-10-26 11:20:00,-1483.98,349009.0700000045,342110.98000000446,6898.090000000026
32225,2022-10-26 11:25:00,798.34,349807.4100000045,342110.98000000446,7696.430000000051
32226,2022-10-26 11:30:00,730.44,350537.8500000045,342110.98000000446,8426.870000000054
32227,2022-10-26 11:35:00,960.48,351498.3300000045,342110.98000000446,9387.350000000035
32228,2022-10-26 11:40:00,-96.71,351401.6200000045,342110.98000000446,9290.640000000014
32229,2022-10-26 11:45:00,751.92,352153.54000000446,342110.98000000446,10042.559999999998
32230,2022-10-26 11:50:00,-1632.87,350520.67000000447,342110.98000000446,8409.690000000002
32231,2022-10-26 11:55:00,740.31,351260.98000000446,342110.98000000446,9150.0
32232,2022-10-26 12:00:00,1210.86,352471.84000000445,342110.98000000446,10360.859999999986
32233,2022-10-26 12:05:00,591.98,353063.82000000443,342110.98000000446,10952.839999999967
32234,2022-10-26 12:10:00,-1432.94,351630.8800000044,342110.98000000446,9519.899999999965
32235,2022-10-26 12:15:00,1125.52,352756.40000000445,342110.98000000446,10645.419999999984
32236,2022-10-26 12:20:00,-243.47,352512.9300000045,342110.98000000446,10401.950000000012
32237,2022-10-26 12:25:00,-1997.65,350515.28000000445,342110.98000000446,8404.299999999988
32238,2022-10-26 12:30:00,-1248.07,349267.21000000444,342110.98000000446,7156.229999999981
32239,2022-10-26 12:35:00,-491.67,348775.54000000446,342110.98000000446,6664.559999999998
32240,2022-10-26 12:40:00,1624.22,350399.76000000443,342110.98000000446,8288.77999999997
32241,2022-10-26 12:45:00,-1611.5,348788.26000000443,342110.98000000446,6677.27999999997
32242,2022-10-26 12:50:00,1381.35,350169.6100000044,342110.98000000446,8058.629999999946
32243,2022-10-26 12:55:00,-571.82,349597.7900000044,342110.98000000446,7486.8099999999395
32244,2022-10-26 13:00:00,-62.91,349534.8800000044,342110.98000000446,7423.899999999965
32245,2022-10-26 13:05:00,1130.84,350665.72000000445,342110.98000000446,8554.73999999999
32246,2022-10-26 13:10:00,-782.97,349882.7500000045,342110.98000000446,7771.770000000019
32247,2022-10-26 13:15:00,682.28,350565.0300000045,342110.98000000446,8454.050000000047
32248,2022-10-26 13:20:00,-1144.09,349420.9400000045,342110.98000000446,7309.960000000021
32249,2022-10-26 13:25:00,-218.64,349202.30000000447,342110.98000000446,7091.320000000007
32250,2022-10-26 13:30:00,1128.01,350330.3100000045,342110.98000000446,8219.330000000016
32251,2022-10-26 13:35:00,-941.84,349388.47000000445,342110.98000000446,7277.489999999991
32252,2022-10-26 13:40:00,1751.2,351139.67000000447,342110.98000000446,9028.690000000002
32253,2022-10-26 13:45:00,579.51,351719.1800000045,342110.98000000446,9608.200000000012
32254,2022-10-26 13:50:00,-512.99,351206.1900000045,342110.98000000446,9095.210000000021
32255,2022-10-26 13:55:00,947.7,352153.8900000045,342110.98000000446,10042.910000000033
32256,2022-10-26 14:00:00,1976.15,354130.0400000045,342110.98000000446,12019.060000000056
32257,2022-10-26 14:05:00,-1850.78,352279.2600000045,342110.98000000446,10168.280000000028
32258,2022-10-26 14:10:00,-1615.02,350664.2400000045,342110.98000000446,8553.26000000001
32259,2022-10-26 14:15:00,858.66,351522.90000000445,342110.98000000446,9411.919999999984
32260,2022-10-26 14:20:00,1528.74,353051.64000000444,342110.98000000446,10940.659999999974
32261,2022-10-26 14:25:00,991.2,354042.84000000445,342110.98000000446,11931.859999999986
32262,2022-10-26 14:30:00,1261.26,355304.10000000446,342110.98000000446,13193.119999999995
32263,2022-10-26 14:35:00,1397.57,356701.67000000447,342110.98000000446,14590.690000000002
32264,2022-10-26 14:40:00,1201.28,357902.9500000045,342110.98000000446,15791.97000000003
32265,2022-10-26 14:45:00,-1211.58,356691.3700000045,342110.98000000446,14580.390000000014
32266,2022-10-26 14:50:00,-1854.66,354836.7100000045,342110.98000000446,12725.73000000004
32267,2022-10-26 14:55:00,-770.4,354066.3100000045,342110.98000000446,11955.330000000016
32268,2022-10-26 15:00:00,1237.19,355303.5000000045,342110.98000000446,13192.520000000019
32269,2022-10-26 15:05:00,297.88,355601.3800000045,342110.98000000446,13490.400000000023
32270,2022-10-26 15:10:00,-648.43,354952.9500000045,342110.98000000446,12841.97000000003
32271,2022-10-26 15:15:00,-975.12,353977.8300000045,342110.98000000446,11866.850000000035
32272,2022-10-26 15:20:00,335.52,354313.3500000045,342110.98000000446,12202.370000000054
32273,2022-10-26 15:25:00,361.46,354674.81000000454,342110.98000000446,12563.830000000075
32274,2022-10-26 15:30:00,1925.52,356600.33000000456,342110.98000000446,14489.350000000093
32275,2022-10-26 15:35:00,138.65,356738.9800000046,342110.98000000446,14628.000000000116
32276,2022-10-26 15:40:00,377.97,357116.95000000455,342110.98000000446,15005.970000000088
32277,2022-10-26 15:45:00,1269.46,358386.4100000046,342110.98000000446,16275.43000000011
32278,2022-10-26 15:50:00,-1363.31,357023.1000000046,342110.98000000446,14912.120000000112
32279,2022-10-26 15:55:00,1643.93,358667.03000000457,342110.98000000446,16556.050000000105
32280,2022-10-26 16:00:00,-902.72,357764.3100000046,342110.98000000446,15653.330000000133
32281,2022-10-26 16:05:00,578.43,358342.7400000046,342110.98000000446,16231.760000000126
32282,2022-10-26 16:10:00,-663.25,357679.4900000046,342110.98000000446,15568.510000000126
32283,2022-10-26 16:15:00,-1903.85,355775.6400000046,342110.98000000446,13664.660000000149
32284,2022-10-26 16:20:00,1694.43,357470.0700000046,342110.98000000446,15359.090000000142
32285,2022-10-26 16:25:00,-1181.28,356288.7900000046,342110.98000000446,14177.810000000114
32286,2022-10-26 16:30:00,-1789.23,354499.5600000046,342110.98000000446,12388.580000000133
32287,2022-10-26 16:35:00,1403.52,355903.0800000046,342110.98000000446,13792.100000000151
32288,2022-10-26 16:40:00,-856.62,355046.4600000046,342110.98000000446,12935.480000000156
32289,2022-10-26 16:45:00,-1880.92,353165.54000000464,342110.98000000446,11054.560000000172
32290,2022-10-26 16:50:00,1048.77,354214.31000000465,342110.98000000446,12103.330000000191
32291,2022-10-26 16:55:00,428.48,354642.79000000464,342110.98000000446,12531.810000000172
32292,2022-10-27 08:00:00,1242.42,355885.2100000046,354642.79000000464,1242.4199999999837
32293,2022-10-27 08:05:00,-1695.76,354189.4500000046,354642.79000000464,-453.3400000000256
32294,2022-10-27 08:10:00,-1359.32,352830.1300000046,354642.79000000464,-1812.6600000000326
32295,2022-10-27 08:15:00,-1592.24,351237.8900000046,354642.79000000464,-3404.9000000000233
32296,2022-10-27 08:20:00,1939.69,353177.5800000046,354642.79000000464,-1465.210000000021
32297,2022-10-27 08:25:00,-1537.73,351639.85000000463,354642.79000000464,-3002.9400000000023
32298,2022-10-27 08:30:00,174.32,351814.17000000464,354642.79000000464,-2828.6199999999953
32299,2022-10-27 08:35:00,999.16,352813.3300000046,354642.79000000464,-1829.460000000021
32300,2022-10-27 08:40:00,-329.9,352483.4300000046,354642.79000000464,-2159.3600000000442
32301,2022-10-27 08:45:00,-410.07,352073.3600000046,354642.79000000464,-2569.430000000051
32302,2022-10-27 08:50:00,680.96,352754.3200000046,354642.79000000464,-1888.4700000000303
32303,2022-10-27 08:55:00,1236.37,353990.6900000046,354642.79000000464,-652.1000000000349
32304,2022-10-27 09:00:00,677.31,354668.0000000046,354642.79000000464,25.209999999962747
32305,2022-10-27 09:05:00,1738.35,356406.3500000046,354642.79000000464,1763.5599999999395
32306,2022-10-27 09:10:00,1399.12,357805.47000000457,354642.79000000464,3162.679999999935
32307,2022-10-27 09:15:00,790.78,358596.2500000046,354642.79000000464,3953.4599999999627
32308,2022-10-27 09:20:00,-545.71,358050.5400000046,354642.79000000464,3407.749999999942
32309,2022-10-27 09:25:00,-878.15,357172.39000000455,354642.79000000464,2529.5999999999185
32310,2022-10-27 09:30:00,1087.4,358259.7900000046,354642.79000000464,3616.999999999942
32311,2022-10-27 09:35:00,295.88,358555.6700000046,354642.79000000464,3912.8799999999464
32312,2022-10-27 09:40:00,-226.74,358328.9300000046,354642.79000000464,3686.1399999999558
32313,2022-10-27 09:45:00,144.76,358473.6900000046,354642.79000000464,3830.899999999965
32314,2022-10-27 09:50:00,1477.65,359951.3400000046,354642.79000000464,5308.549999999988
32315,2022-10-27 09:55:00,235.63,360186.9700000046,354642.79000000464,5544.179999999993
32316,2022-10-27 10:00:00,923.27,361110.24000000465,354642.79000000464,6467.450000000012
32317,2022-10-27 10:05:00,1088.79,362199.0300000046,354642.79000000464,7556.239999999991
32318,2022-10-27 10:10:00,-346.66,361852.37000000465,354642.79000000464,7209.580000000016
32319,2022-10-27 10:15:00,657.39,362509.76000000467,354642.79000000464,7866.97000000003
32320,2022-10-27 10:20:00,-27.39,362482.37000000465,354642.79000000464,7839.580000000016
32321,2022-10-27 10:25:00,1269.4,363751.7700000047,354642.79000000464,9108.98000000004
32322,2022-10-27 10:30:00,-1532.13,362219.64000000467,354642.79000000464,7576.850000000035
32323,2022-10-27 10:35:00,810.95,363030.5900000047,354642.79000000464,8387.800000000047
32324,2022-10-27 10:40:00,-1351.99,361678.6000000047,354642.79000000464,7035.810000000056
32325,2022-10-27 10:45:00,-341.16,361337.4400000047,354642.79000000464,6694.6500000000815
32326,2022-10-27 10:50:00,-1722.55,359614.8900000047,354642.79000000464,4972.100000000093
32327,2022-10-27 10:55:00,1975.4,361590.29000000475,354642.79000000464,6947.500000000116
32328,2022-10-27 11:00:00,1653.13,363243.42000000476,354642.79000000464,8600.630000000121
32329,2022-10-27 11:05:00,434.58,363678.0000000048,354642.79000000464,9035.210000000137
32330,2022-10-27 11:10:00,-976.98,362701.0200000048,354642.79000000464,8058.230000000156
32331,2022-10-27 11:15:00,-874.76,361826.2600000048,354642.79000000464,7183.470000000147
32332,2022-10-27 11:20:00,1422.51,363248.7700000048,354642.79000000464,8605.980000000156
32333,2022-10-27 11:25:00,-1930.6,361318.1700000048,354642.79000000464,6675.380000000179
32334,2022-10-27 11:30:00,-1478.73,359839.44000000483,354642.79000000464,5196.650000000198
32335,2022-10-27 11:35:00,466.51,360305.95000000484,354642.79000000464,5663.160000000207
32336,2022-10-27 11:40:00,-50.61,360255.34000000486,354642.79000000464,5612.550000000221
32337,2022-10-27 11:45:00,33.8,360289.14000000485,354642.79000000464,5646.35000000021
32338,2022-10-27 11:50:00,790.81,361079.95000000484,354642.79000000464,6437.160000000207
32339,2022-10-27 11:55:00,1867.22,362947.1700000048,354642.79000000464,8304.38000000018
32340,2022-10-27 12:00:00,22.63,362969.8000000048,354642.79000000464,8327.010000000184
32341,2022-10-27 12:05:00,-511.35,362458.45000000484,354642.79000000464,7815.660000000207
32342,2022-10-27 12:10:00,-436.66,362021.79000000487,354642.79000000464,7379.000000000233
32343,2022-10-27 12:15:00,847.72,362869.51000000484,354642.79000000464,8226.720000000205
32344,2022-10-27 12:20:00,1925.55,364795.0600000048,354642.79000000464,10152.270000000193
32345,2022-10-27 12:25:00,1190.65,365985.71000000485,354642.79000000464,11342.920000000217
32346,2022-10-27 12:30:00,1070.78,367056.4900000049,354642.79000000464,12413.700000000244
32347,2022-10-27 12:35:00,497.45,367553.9400000049,354642.79000000464,12911.150000000256
32348,2022-10-27 12:40:00,-475.81,367078.1300000049,354642.79000000464,12435.340000000258
32349,2022-10-27 12:45:00,787.93,367866.0600000049,354642.79000000464,13223.270000000251
32350,2022-10-27 12:50:00,1993.99,369860.0500000049,354642.79000000464,15217.260000000242
32351,2022-10-27 12:55:00,-1537.26,368322.79000000487,354642.79000000464,13680.000000000233
32352,2022-10-27 13:00:00,634.89,368957.6800000049,354642.79000000464,14314.890000000247
32353,2022-10-27 13:05:00,-1748.62,367209.0600000049,354642.79000000464,12566.270000000251
32354,2022-10-27 13:10:00,1027.09,368236.1500000049,354642.79000000464,13593.360000000277
32355,2022-10-27 13:15:00,-850.45,367385.7000000049,354642.79000000464,12742.910000000265
32356,2022-10-27 13:20:00,380.18,367765.8800000049,354642.79000000464,13123.090000000258
32357,2022-10-27 13:25:00,-495.33,367270.5500000049,354642.79000000464,12627.760000000242
32358,2022-10-27 13:30:00,1426.42,368696.97000000486,354642.79000000464,14054.180000000226
32359,2022-10-27 13:35:00,-419.58,368277.39000000485,354642.79000000464,13634.60000000021
32360,2022-10-27 13:40:00,-76.94,368200.45000000484,354642.79000000464,13557.660000000207
32361,2022-10-27 13:45:00,6.62,368207.07000000484,354642.79000000464,13564.280000000203
32362,2022-10-27 13:50:00,1548.68,369755.75000000483,354642.79000000464,15112.960000000196
32363,2022-10-27 13:55:00,954.49,370710.2400000048,354642.79000000464,16067.450000000186
32364,2022-10-27 14:00:00,377.85,371088.0900000048,354642.79000000464,16445.300000000163
32365,2022-10-27 14:05:00,-850.47,370237.6200000048,354642.79000000464,15594.830000000191
32366,2022-10-27 14:10:00,-380.56,369857.0600000048,354642.79000000464,15214.270000000193
32367,2022-10-27 14:15:00,-1185.27,368671.7900000048,354642.79000000464,14029.000000000175
32368,2022-10-27 14:20:00,-398.94,368272.8500000048,354642.79000000464,13630.060000000172
32369,2022-10-27 14:25:00,939.99,369212.8400000048,354642.79000000464,14570.050000000163
32370,2022-10-27 14:30:00,-902.56,368310.2800000048,354642.79000000464,13667.490000000165
32371,2022-10-27 14:35:00,-1340.18,366970.1000000048,354642.79000000464,12327.310000000172
32372,2022-10-27 14:40:00,374.29,367344.3900000048,354642.79000000464,12701.600000000151
32373,2022-10-27 14:45:00,1770.09,369114.4800000048,354642.79000000464,14471.690000000177
32374,2022-10-27 14:50:00,-151.79,368962.69000000483,354642.79000000464,14319.900000000198
32375,2022-10-27 14:55:00,-1044.83,367917.8600000048,354642.79000000464,13275.070000000182
32376,2022-10-27 15:00:00,-275.36,367642.50000000483,354642.79000000464,12999.710000000196
32377,2022-10-27 15:05:00,-1395.9,366246.6000000048,354642.79000000464,11603.810000000172
32378,2022-10-27 15:10:00,-776.12,365470.4800000048,354642.79000000464,10827.690000000177
32379,2022-10-27 15:15:00,-675.04,364795.44000000483,354642.79000000464,10152.650000000198
32380,2022-10-27 15:20:00,-1230.99,363564.45000000484,354642.79000000464,8921.660000000207
32381,2022-10-27 15:25:00,-944.58,362619.8700000048,354642.79000000464,7977.080000000191
32382,2022-10-27 15:30:00,-1396.12,361223.75000000483,354642.79000000464,6580.960000000196
32383,2022-10-27 15:35:00,-581.09,360642.6600000048,354642.79000000464,5999.87000000017
32384,2022-10-27 15:40:00,-1498.03,359144.6300000048,354642.79000000464,4501.840000000142
32385,2022-10-27 15:45:00,-1487.76,357656.87000000477,354642.79000000464,3014.0800000001327
32386,2022-10-27 15:50:00,496.23,358153.10000000475,354642.79000000464,3510.310000000114
32387,2022-10-27 15:55:00,-290.63,357862.47000000475,354642.79000000464,3219.6800000001094
32388,2022-10-27 16:00:00,-186.75,357675.72000000475,354642.79000000464,3032.9300000001094
32389,2022-10-27 16:05:00,-135.15,357540.5700000047,354642.79000000464,2897.780000000086
32390,2022-10-27 16:10:00,1836.12,359376.6900000047,354642.79000000464,4733.9000000000815
32391,2022-10-27 16:15:00,818.65,360195.34000000474,354642.79000000464,5552.550000000105
32392,2022-10-27 16:20:00,-1561.21,358634.1300000047,354642.79000000464,3991.340000000084
32393,2022-10-27 16:25:00,-410.43,358223.7000000047,354642.79000000464,3580.910000000091
32394,2022-10-27 16:30:00,988.32,359212.02000000473,354642.79000000464,4569.230000000098
32395,2022-10-27 16:35:00,950.47,360162.4900000047,354642.79000000464,5519.70000000007
32396,2022-10-27 16:40:00,1794.79,361957.2800000047,354642.79000000464,7314.490000000049
32397,2022-10-27 16:45:00,1162.24,363119.5200000047,354642.79000000464,8476.73000000004
32398,2022-10-27 16:50:00,-1484.26,361635.26000000467,354642.79000000464,6992.47000000003
32399,2022-10-27 16:55:00,1384.21,363019.4700000047,354642.79000000464,8376.680000000051
32400,2022-10-28 08:00:00,1602.4,364621.8700000047,363019.4700000047,1602.4000000000233
32401,2022-10-28 08:05:00,273.77,364895.6400000047,363019.4700000047,1876.170000000042
32402,2022-10-28 08:10:00,-1742.73,363152.91000000475,363019.4700000047,133.44000000006054
32403,2022-10-28 08:15:00,1672.49,364825.40000000474,363019.4700000047,1805.9300000000512
32404,2022-10-28 08:20:00,1430.52,366255.92000000476,363019.4700000047,3236.45000000007
32405,2022-10-28 08:25:00,-721.47,365534.4500000048,363019.4700000047,2514.980000000098
32406,2022-10-28 08:30:00,1469.95,367004.4000000048,363019.4700000047,3984.9300000001094
32407,2022-10-28 08:35:00,116.46,367120.8600000048,363019.4700000047,4101.39000000013
32408,2022-10-28 08:40:00,844.26,367965.1200000048,363019.4700000047,4945.65000000014
32409,2022-10-28 08:45:00,-73.78,367891.3400000048,363019.4700000047,4871.870000000112
32410,2022-10-28 08:50:00,-488.69,367402.6500000048,363019.4700000047,4383.180000000109
32411,2022-10-28 08:55:00,236.1,367638.7500000048,363019.4700000047,4619.280000000086
32412,2022-10-28 09:00:00,-656.13,366982.62000000477,363019.4700000047,3963.1500000000815
32413,2022-10-28 09:05:00,-1116.71,365865.91000000475,363019.4700000047,2846.4400000000605
32414,2022-10-28 09:10:00,1185.01,367050.92000000476,363019.4700000047,4031.45000000007
32415,2022-10-28 09:15:00,1015.69,368066.61000000476,363019.4700000047,5047.140000000072
32416,2022-10-28 09:20:00,-505.06,367561.55000000476,363019.4700000047,4542.0800000000745
32417,2022-10-28 09:25:00,1765.27,369326.8200000048,363019.4700000047,6307.350000000093
32418,2022-10-28 09:30:00,991.21,370318.0300000048,363019.4700000047,7298.560000000114
32419,2022-10-28 09:35:00,368.82,370686.8500000048,363019.4700000047,7667.380000000121
32420,2022-10-28 09:40:00,-199.29,370487.5600000048,363019.4700000047,7468.090000000142
32421,2022-10-28 09:45:00,89.49,370577.0500000048,363019.4700000047,7557.580000000133
32422,2022-10-28 09:50:00,969.15,371546.20000000484,363019.4700000047,8526.730000000156
32423,2022-10-28 09:55:00,-1923.22,369622.98000000487,363019.4700000047,6603.510000000184
32424,2022-10-28 10:00:00,661.5,370284.48000000487,363019.4700000047,7265.010000000184
32425,2022-10-28 10:05:00,1449.31,371733.79000000487,363019.4700000047,8714.320000000182
32426,2022-10-28 10:10:00,-1593.36,370140.4300000049,363019.4700000047,7120.960000000196
32427,2022-10-28 10:15:00,169.05,370309.48000000487,363019.4700000047,7290.010000000184
32428,2022-10-28 10:20:00,-1042.93,369266.5500000049,363019.4700000047,6247.080000000191
32429,2022-10-28 10:25:00,-302.73,368963.8200000049,363019.4700000047,5944.35000000021
32430,2022-10-28 10:30:00,-544.49,368419.3300000049,363019.4700000047,5399.860000000219
32431,2022-10-28 10:35:00,-1432.15,366987.1800000049,363019.4700000047,3967.7100000001956
32432,2022-10-28 10:40:00,-1947.34,365039.84000000486,363019.4700000047,2020.37000000017
32433,2022-10-28 10:45:00,-685.08,364354.76000000484,363019.4700000047,1335.2900000001537
32434,2022-10-28 10:50:00,754.23,365108.9900000048,363019.4700000047,2089.520000000135
32435,2022-10-28 10:55:00,-694.96,364414.0300000048,363019.4700000047,1394.560000000114
32436,2022-10-28 11:00:00,-338.2,364075.8300000048,363019.4700000047,1056.3600000001024
32437,2022-10-28 11:05:00,-189.99,363885.8400000048,363019.4700000047,866.3700000001118
32438,2022-10-28 11:10:00,-1865.88,362019.9600000048,363019.4700000047,-999.5099999998929
32439,2022-10-28 11:15:00,-369.89,361650.0700000048,363019.4700000047,-1369.3999999999069
32440,2022-10-28 11:20:00,1679.88,363329.9500000048,363019.4700000047,310.4800000000978
32441,2022-10-28 11:25:00,-799.06,362530.8900000048,363019.4700000047,-488.5799999998999
32442,2022-10-28 11:30:00,553.9,363084.7900000048,363019.4700000047,65.3200000001234
32443,2022-10-28 11:35:00,793.9,363878.69000000483,363019.4700000047,859.2200000001467
32444,2022-10-28 11:40:00,-1800.22,362078.47000000486,363019.4700000047,-940.9999999998254
32445,2022-10-28 11:45:00,625.91,362704.38000000484,363019.4700000047,-315.089999999851
32446,2022-10-28 11:50:00,-100.55,362603.83000000485,363019.4700000047,-415.63999999983935
32447,2022-10-28 11:55:00,293.35,362897.1800000048,363019.4700000047,-122.28999999986263
32448,2022-10-28 12:00:00,-977.11,361920.07000000484,363019.4700000047,-1099.3999999998487
32449,2022-10-28 12:05:00,-611.69,361308.38000000484,363019.4700000047,-1711.089999999851
32450,2022-10-28 12:10:00,-1392.54,359915.84000000486,363019.4700000047,-3103.62999999983
32451,2022-10-28 12:15:00,-1237.79,358678.0500000049,363019.4700000047,-4341.419999999809
32452,2022-10-28 12:20:00,1429.06,360107.1100000049,363019.4700000047,-2912.3599999998114
32453,2022-10-28 12:25:00,-1856.58,358250.53000000486,363019.4700000047,-4768.939999999828
32454,2022-10-28 12:30:00,8.05,358258.58000000485,363019.4700000047,-4760.889999999839
32455,2022-10-28 12:35:00,-1710.7,356547.88000000484,363019.4700000047,-6471.589999999851
32456,2022-10-28 12:40:00,689.37,357237.25000000483,363019.4700000047,-5782.219999999856
32457,2022-10-28 12:45:00,1290.41,358527.6600000048,363019.4700000047,-4491.809999999881
32458,2022-10-28 12:50:00,-1958.24,356569.4200000048,363019.4700000047,-6450.049999999872
32459,2022-10-28 12:55:00,-1197.28,355372.1400000048,363019.4700000047,-7647.3299999999
32460,2022-10-28 13:00:00,-356.5,355015.6400000048,363019.4700000047,-8003.8299999999
32461,2022-10-28 13:05:00,206.39,355222.0300000048,363019.4700000047,-7797.439999999886
32462,2022-10-28 13:10:00,1036.75,356258.7800000048,363019.4700000047,-6760.689999999886
32463,2022-10-28 13:15:00,-680.26,355578.5200000048,363019.4700000047,-7440.949999999895
32464,2022-10-28 13:20:00,875.86,356454.3800000048,363019.4700000047,-6565.089999999909
32465,2022-10-28 13:25:00,882.99,357337.37000000477,363019.4700000047,-5682.0999999999185
32466,2022-10-28 13:30:00,-1454.61,355882.7600000048,363019.4700000047,-7136.7099999999045
32467,2022-10-28 13:35:00,-930.47,354952.2900000048,363019.4700000047,-8067.179999999877
32468,2022-10-28 13:40:00,1818.45,356770.7400000048,363019.4700000047,-6248.729999999865
32469,2022-10-28 13:45:00,684.65,357455.39000000485,363019.4700000047,-5564.079999999842
32470,2022-10-28 13:50:00,-1774.57,355680.82000000484,363019.4700000047,-7338.649999999849
32471,2022-10-28 13:55:00,1322.16,357002.9800000048,363019.4700000047,-6016.489999999874
32472,2022-10-28 14:00:00,62.2,357065.1800000048,363019.4700000047,-5954.289999999863
32473,2022-10-28 14:05:00,-597.83,356467.3500000048,363019.4700000047,-6552.119999999879
32474,2022-10-28 14:10:00,-1275.84,355191.5100000048,363019.4700000047,-7827.9599999999045
32475,2022-10-28 14:15:00,1293.47,356484.98000000475,363019.4700000047,-6534.4899999999325
32476,2022-10-28 14:20:00,52.86,356537.84000000474,363019.4700000047,-6481.629999999946
32477,2022-10-28 14:25:00,84.58,356622.42000000476,363019.4700000047,-6397.04999999993
32478,2022-10-28 14:30:00,-822.25,355800.17000000476,363019.4700000047,-7219.29999999993
32479,2022-10-28 14:35:00,-1393.06,354407.11000000476,363019.4700000047,-8612.359999999928
32480,2022-10-28 14:40:00,-678.05,353729.06000000477,363019.4700000047,-9290.409999999916
32481,2022-10-28 14:45:00,-730.71,352998.35000000475,363019.4700000047,-10021.119999999937
32482,2022-10-28 14:50:00,1198.25,354196.60000000475,363019.4700000047,-8822.869999999937
32483,2022-10-28 14:55:00,-57.9,354138.7000000047,363019.4700000047,-8880.76999999996
32484,2022-10-28 15:00:00,-1101.4,353037.3000000047,363019.4700000047,-9982.169999999984
32485,2022-10-28 15:05:00,1628.1,354665.4000000047,363019.4700000047,-8354.070000000007
32486,2022-10-28 15:10:00,1091.25,355756.6500000047,363019.4700000047,-7262.820000000007
32487,2022-10-28 15:15:00,-433.55,355323.1000000047,363019.4700000047,-7696.369999999995
32488,2022-10-28 15:20:00,1129.92,356453.0200000047,363019.4700000047,-6566.450000000012
32489,2022-10-28 15:25:00,722.98,357176.00000000466,363019.4700000047,-5843.47000000003
32490,2022-10-28 15:30:00,-1160.26,356015.74000000465,363019.4700000047,-7003.73000000004
32491,2022-10-28 15:35:00,1040.72,357056.4600000046,363019.4700000047,-5963.0100000000675
32492,2022-10-28 15:40:00,1710.72,358767.1800000046,363019.4700000047,-4252.2900000000955
32493,2022-10-28 15:45:00,-1209.02,357558.1600000046,363019.4700000047,-5461.310000000114
32494,2022-10-28 15:50:00,1178.95,358737.1100000046,363019.4700000047,-4282.360000000102
32495,2022-10-28 15:55:00,-1137.62,357599.4900000046,363019.4700000047,-5419.980000000098
32496,2022-10-28 16:00:00,1699.7,359299.1900000046,363019.4700000047,-3720.280000000086
32497,2022-10-28 16:05:00,-430.37,358868.8200000046,363019.4700000047,-4150.6500000000815
32498,2022-10-28 16:10:00,-1829.03,357039.7900000046,363019.4700000047,-5979.680000000109
32499,2022-10-28 16:15:00,1703.28,358743.0700000046,363019.4700000047,-4276.4000000000815
32500,2022-10-28 16:20:00,-778.62,357964.4500000046,363019.4700000047,-5055.020000000077
32501,2022-10-28 16:25:00,-484.2,357480.2500000046,363019.4700000047,-5539.2200000000885
32502,2022-10-28 16:30:00,271.58,357751.8300000046,363019.4700000047,-5267.640000000072
32503,2022-10-28 16:35:00,-1622.3,356129.5300000046,363019.4700000047,-6889.9400000000605
32504,2022-10-28 16:40:00,753.05,356882.5800000046,363019.4700000047,-6136.890000000072
32505,2022-10-28 16:45:00,-617.68,356264.9000000046,363019.4700000047,-6754.570000000065
32506,2022-10-28 16:50:00,-359.43,355905.4700000046,363019.4700000047,-7114.000000000058
32507,2022-10-28 16:55:00,-360.88,355544.5900000046,363019.4700000047,-7474.880000000063
32508,2022-10-29 08:00:00,1184.15,356728.74000000465,355544.5900000046,1184.1500000000233
32509,2022-10-29 08:05:00,-767.6,355961.14000000467,355544.5900000046,416.55000000004657
32510,2022-10-29 08:10:00,-1423.21,354537.93000000465,355544.5900000046,-1006.6599999999744
32511,2022-10-29 08:15:00,-1051.85,353486.0800000047,355544.5900000046,-2058.509999999951
32512,2022-10-29 08:20:00,275.33,353761.4100000047,355544.5900000046,-1783.1799999999348
32513,2022-10-29 08:25:00,-1927.28,351834.13000000466,355544.5900000046,-3710.4599999999627
32514,2022-10-29 08:30:00,-890.39,350943.74000000465,355544.5900000046,-4600.849999999977
32515,2022-10-29 08:35:00,-1710.0,349233.74000000465,355544.5900000046,-6310.849999999977
32516,2022-10-29 08:40:00,85.09,349318.8300000047,355544.5900000046,-6225.759999999951
32517,2022-10-29 08:45:00,-1103.94,348214.89000000467,355544.5900000046,-7329.699999999953
32518,2022-10-29 08:50:00,76.79,348291.68000000465,355544.5900000046,-7252.909999999974
32519,2022-10-29 08:55:00,-635.75,347655.93000000465,355544.5900000046,-7888.659999999974
32520,2022-10-29 09:00:00,102.53,347758.4600000047,355544.5900000046,-7786.129999999946
32521,2022-10-29 09:05:00,517.97,348276.43000000465,355544.5900000046,-7268.159999999974
32522,2022-10-29 09:10:00,481.63,348758.06000000465,355544.5900000046,-6786.52999999997
32523,2022-10-29 09:15:00,651.28,349409.3400000047,355544.5900000046,-6135.249999999942
32524,2022-10-29 09:20:00,-1338.84,348070.50000000466,355544.5900000046,-7474.089999999967
32525,2022-10-29 09:25:00,701.04,348771.54000000464,355544.5900000046,-6773.049999999988
32526,2022-10-29 09:30:00,-347.27,348424.2700000046,355544.5900000046,-7120.320000000007
32527,2022-10-29 09:35:00,816.7,349240.9700000046,355544.5900000046,-6303.619999999995
32528,2022-10-29 09:40:00,383.19,349624.16000000463,355544.5900000046,-5920.429999999993
32529,2022-10-29 09:45:00,-1837.65,347786.5100000046,355544.5900000046,-7758.080000000016
32530,2022-10-29 09:50:00,1052.73,348839.2400000046,355544.5900000046,-6705.350000000035
32531,2022-10-29 09:55:00,-253.63,348585.6100000046,355544.5900000046,-6958.98000000004
32532,2022-10-29 10:00:00,778.87,349364.4800000046,355544.5900000046,-6180.110000000044
32533,2022-10-29 10:05:00,-1839.72,347524.7600000046,355544.5900000046,-8019.830000000016
32534,2022-10-29 10:10:00,-1188.69,346336.0700000046,355544.5900000046,-9208.520000000019
32535,2022-10-29 10:15:00,-482.22,345853.85000000463,355544.5900000046,-9690.73999999999
32536,2022-10-29 10:20:00,254.11,346107.9600000046,355544.5900000046,-9436.630000000005
32537,2022-10-29 10:25:00,1094.13,347202.0900000046,355544.5900000046,-8342.5
32538,2022-10-29 10:30:00,-1290.0,345912.0900000046,355544.5900000046,-9632.5
32539,2022-10-29 10:35:00,1041.29,346953.3800000046,355544.5900000046,-8591.210000000021
32540,2022-10-29 10:40:00,126.29,347079.6700000046,355544.5900000046,-8464.920000000042
32541,2022-10-29 10:45:00,824.57,347904.2400000046,355544.5900000046,-7640.350000000035
32542,2022-10-29 10:50:00,1576.01,349480.2500000046,355544.5900000046,-6064.340000000026
32543,2022-10-29 10:55:00,-702.39,348777.8600000046,355544.5900000046,-6766.73000000004
32544,2022-10-29 11:00:00,1308.69,350086.5500000046,355544.5900000046,-5458.040000000037
32545,2022-10-29 11:05:00,1280.74,351367.2900000046,355544.5900000046,-4177.300000000047
32546,2022-10-29 11:10:00,1182.99,352550.28000000457,355544.5900000046,-2994.310000000056
32547,2022-10-29 11:15:00,1300.09,353850.3700000046,355544.5900000046,-1694.2200000000303
32548,2022-10-29 11:20:00,325.21,354175.5800000046,355544.5900000046,-1369.0100000000093
32549,2022-10-29 11:25:00,1018.72,355194.3000000046,355544.5900000046,-350.29000000003725
32550,2022-10-29 11:30:00,375.53,355569.8300000046,355544.5900000046,25.239999999990687
32551,2022-10-29 11:35:00,-1167.4,354402.4300000046,355544.5900000046,-1142.1600000000326
32552,2022-10-29 11:40:00,-1981.25,352421.1800000046,355544.5900000046,-3123.4100000000326
32553,2022-10-29 11:45:00,1639.81,354060.9900000046,355544.5900000046,-1483.600000000035
32554,2022-10-29 11:50:00,-853.64,353207.3500000046,355544.5900000046,-2337.240000000049
32555,2022-10-29 11:55:00,721.76,353929.1100000046,355544.5900000046,-1615.4800000000396
32556,2022-10-29 12:00:00,1323.1,355252.21000000456,355544.5900000046,-292.38000000006286
32557,2022-10-29 12:05:00,-1475.62,353776.59000000457,355544.5900000046,-1768.0000000000582
32558,2022-10-29 12:10:00,-1340.27,352436.32000000455,355544.5900000046,-3108.270000000077
32559,2022-10-29 12:15:00,1549.17,353985.49000000453,355544.5900000046,-1559.1000000000931
32560,2022-10-29 12:20:00,-1636.45,352349.0400000045,355544.5900000046,-3195.550000000105
32561,2022-10-29 12:25:00,-1946.95,350402.0900000045,355544.5900000046,-5142.500000000116
32562,2022-10-29 12:30:00,-476.68,349925.4100000045,355544.5900000046,-5619.180000000109
32563,2022-10-29 12:35:00,-414.22,349511.19000000454,355544.5900000046,-6033.4000000000815
32564,2022-10-29 12:40:00,-1634.36,347876.83000000456,355544.5900000046,-7667.7600000000675
32565,2022-10-29 12:45:00,-932.41,346944.4200000046,355544.5900000046,-8600.170000000042
32566,2022-10-29 12:50:00,1796.79,348741.21000000456,355544.5900000046,-6803.380000000063
32567,2022-10-29 12:55:00,-1690.94,347050.27000000456,355544.5900000046,-8494.320000000065
32568,2022-10-29 13:00:00,-1477.79,345572.4800000046,355544.5900000046,-9972.110000000044
32569,2022-10-29 13:05:00,-1360.61,344211.8700000046,355544.5900000046,-11332.72000000003
32570,2022-10-29 13:10:00,-287.12,343924.7500000046,355544.5900000046,-11619.840000000026
32571,2022-10-29 13:15:00,752.27,344677.0200000046,355544.5900000046,-10867.570000000007
32572,2022-10-29 13:20:00,-831.49,343845.5300000046,355544.5900000046,-11699.059999999998
32573,2022-10-29 13:25:00,81.55,343927.0800000046,355544.5900000046,-11617.51000000001
32574,2022-10-29 13:30:00,1001.33,344928.41000000463,355544.5900000046,-10616.179999999993
32575,2022-10-29 13:35:00,1802.4,346730.81000000465,355544.5900000046,-8813.77999999997
32576,2022-10-29 13:40:00,-387.64,346343.17000000464,355544.5900000046,-9201.419999999984
32577,2022-10-29 13:45:00,1836.04,348179.2100000046,355544.5900000046,-7365.380000000005
32578,2022-10-29 13:50:00,1463.84,349643.05000000464,355544.5900000046,-5901.539999999979
32579,2022-10-29 13:55:00,-1175.03,348468.0200000046,355544.5900000046,-7076.570000000007
32580,2022-10-29 14:00:00,728.02,349196.04000000464,355544.5900000046,-6348.549999999988
32581,2022-10-29 14:05:00,713.18,349909.2200000046,355544.5900000046,-5635.369999999995
32582,2022-10-29 14:10:00,-554.12,349355.10000000463,355544.5900000046,-6189.489999999991
32583,2022-10-29 14:15:00,1259.05,350614.1500000046,355544.5900000046,-4930.440000000002
32584,2022-10-29 14:20:00,-334.19,350279.9600000046,355544.5900000046,-5264.630000000005
32585,2022-10-29 14:25:00,1488.13,351768.0900000046,355544.5900000046,-3776.5
32586,2022-10-29 14:30:00,1152.88,352920.9700000046,355544.5900000046,-2623.6199999999953
32587,2022-10-29 14:35:00,-1522.04,351398.93000000465,355544.5900000046,-4145.659999999974
32588,2022-10-29 14:40:00,1584.88,352983.81000000465,355544.5900000046,-2560.7799999999697
32589,2022-10-29 14:45:00,1617.78,354601.5900000047,355544.5900000046,-942.9999999999418
32590,2022-10-29 14:50:00,1583.34,356184.9300000047,355544.5900000046,640.3400000000838
32591,2022-10-29 14:55:00,664.44,356849.3700000047,355544.5900000046,1304.7800000000861
32592,2022-10-29 15:00:00,697.05,357546.4200000047,355544.5900000046,2001.8300000000745
32593,2022-10-29 15:05:00,-286.36,357260.0600000047,355544.5900000046,1715.4700000000885
32594,2022-10-29 15:10:00,1740.95,359001.0100000047,355544.5900000046,3456.4200000001
32595,2022-10-29 15:15:00,369.17,359370.1800000047,355544.5900000046,3825.590000000084
32596,2022-10-29 15:20:00,-402.68,358967.5000000047,355544.5900000046,3422.910000000091
32597,2022-10-29 15:25:00,333.36,359300.8600000047,355544.5900000046,3756.270000000077
32598,2022-10-29 15:30:00,-1586.68,357714.1800000047,355544.5900000046,2169.590000000084
32599,2022-10-29 15:35:00,-1457.24,356256.9400000047,355544.5900000046,712.3500000000931
32600,2022-10-29 15:40:00,-1446.44,354810.5000000047,355544.5900000046,-734.0899999999092
32601,2022-10-29 15:45:00,-420.67,354389.83000000473,355544.5900000046,-1154.759999999893
32602,2022-10-29 15:50:00,-516.32,353873.5100000047,355544.5900000046,-1671.0799999998999
32603,2022-10-29 15:55:00,646.15,354519.66000000475,355544.5900000046,-1024.9299999998766
32604,2022-10-29 16:00:00,134.54,354654.2000000047,355544.5900000046,-890.3899999998976
32605,2022-10-29 16:05:00,-132.42,354521.78000000474,355544.5900000046,-1022.8099999998813
32606,2022-10-29 16:10:00,515.2,355036.98000000475,355544.5900000046,-507.6099999998696
32607,2022-10-29 16:15:00,74.54,355111.52000000473,355544.5900000046,-433.06999999989057
32608,2022-10-29 16:20:00,1237.89,356349.41000000475,355544.5900000046,804.8200000001234
32609,2022-10-29 16:25:00,1896.84,358246.2500000048,355544.5900000046,2701.660000000149
32610,2022-10-29 16:30:00,-669.3,357576.9500000048,355544.5900000046,2032.3600000001607
32611,2022-10-29 16:35:00,1513.26,359090.2100000048,355544.5900000046,3545.62000000017
32612,2022-10-29 16:40:00,-115.83,358974.3800000048,355544.5900000046,3429.7900000001537
32613,2022-10-29 16:45:00,1146.11,360120.49000000476,355544.5900000046,4575.90000000014
32614,2022-10-29 16:50:00,1794.47,361914.96000000474,355544.5900000046,6370.370000000112
32615,2022-10-29 16:55:00,1961.03,363875.99000000476,355544.5900000046,8331.40000000014
32616,2022-10-30 08:00:00,-227.58,363648.41000000475,363875.99000000476,-227.5800000000163
32617,2022-10-30 08:05:00,1750.45,365398.86000000476,363875.99000000476,1522.8699999999953
32618,2022-10-30 08:10:00,489.04,365887.90000000474,363875.99000000476,2011.9099999999744
32619,2022-10-30 08:15:00,845.31,366733.21000000474,363875.99000000476,2857.219999999972
32620,2022-10-30 08:20:00,-1886.11,364847.10000000475,363875.99000000476,971.109999999986
32621,2022-10-30 08:25:00,267.3,365114.40000000474,363875.99000000476,1238.4099999999744
32622,2022-10-30 08:30:00,-822.55,364291.85000000475,363875.99000000476,415.85999999998603
32623,2022-10-30 08:35:00,1438.3,365730.15000000474,363875.99000000476,1854.1599999999744
32624,2022-10-30 08:40:00,485.62,366215.77000000473,363875.99000000476,2339.7799999999697
32625,2022-10-30 08:45:00,426.23,366642.0000000047,363875.99000000476,2766.009999999951
32626,2022-10-30 08:50:00,1998.16,368640.1600000047,363875.99000000476,4764.1699999999255
32627,2022-10-30 08:55:00,1814.55,370454.7100000047,363875.99000000476,6578.719999999914
32628,2022-10-30 09:00:00,1531.9,371986.6100000047,363875.99000000476,8110.619999999937
32629,2022-10-30 09:05:00,-1119.54,370867.0700000047,363875.99000000476,6991.079999999958
32630,2022-10-30 09:10:00,1180.5,372047.5700000047,363875.99000000476,8171.579999999958
32631,2022-10-30 09:15:00,720.53,372768.10000000475,363875.99000000476,8892.109999999986
32632,2022-10-30 09:20:00,219.38,372987.48000000475,363875.99000000476,9111.48999999999
32633,2022-10-30 09:25:00,-330.55,372656.93000000477,363875.99000000476,8780.940000000002
32634,2022-10-30 09:30:00,1531.68,374188.61000000476,363875.99000000476,10312.619999999995
32635,2022-10-30 09:35:00,-902.8,373285.81000000477,363875.99000000476,9409.820000000007
32636,2022-10-30 09:40:00,-1100.91,372184.9000000048,363875.99000000476,8308.910000000033
32637,2022-10-30 09:45:00,-1332.43,370852.4700000048,363875.99000000476,6976.48000000004
32638,2022-10-30 09:50:00,-1899.12,368953.3500000048,363875.99000000476,5077.360000000044
32639,2022-10-30 09:55:00,1169.71,370123.0600000048,363875.99000000476,6247.070000000065
32640,2022-10-30 10:00:00,1995.54,372118.6000000048,363875.99000000476,8242.610000000044
32641,2022-10-30 10:05:00,807.26,372925.8600000048,363875.99000000476,9049.870000000054
32642,2022-10-30 10:10:00,803.91,373729.7700000048,363875.99000000476,9853.780000000028
32643,2022-10-30 10:15:00,1338.44,375068.2100000048,363875.99000000476,11192.22000000003
32644,2022-10-30 10:20:00,688.87,375757.0800000048,363875.99000000476,11881.090000000026
32645,2022-10-30 10:25:00,848.53,376605.6100000048,363875.99000000476,12729.620000000054
32646,2022-10-30 10:30:00,-495.62,376109.9900000048,363875.99000000476,12234.000000000058
32647,2022-10-30 10:35:00,388.53,376498.52000000485,363875.99000000476,12622.530000000086
32648,2022-10-30 10:40:00,-1399.07,375099.45000000484,363875.99000000476,11223.46000000008
32649,2022-10-30 10:45:00,-399.12,374700.33000000485,363875.99000000476,10824.340000000084
32650,2022-10-30 10:50:00,1876.98,376577.3100000048,363875.99000000476,12701.320000000065
32651,2022-10-30 10:55:00,286.3,376863.6100000048,363875.99000000476,12987.620000000054
32652,2022-10-30 11:00:00,-1234.26,375629.3500000048,363875.99000000476,11753.360000000044
32653,2022-10-30 11:05:00,-1760.99,373868.3600000048,363875.99000000476,9992.370000000054
32654,2022-10-30 11:10:00,-1448.21,372420.1500000048,363875.99000000476,8544.160000000033
32655,2022-10-30 11:15:00,-157.64,372262.5100000048,363875.99000000476,8386.520000000019
32656,2022-10-30 11:20:00,-1860.91,370401.6000000048,363875.99000000476,6525.610000000044
32657,2022-10-30 11:25:00,81.71,370483.3100000048,363875.99000000476,6607.320000000065
32658,2022-10-30 11:30:00,-1674.23,368809.08000000485,363875.99000000476,4933.090000000084
32659,2022-10-30 11:35:00,-1573.03,367236.0500000048,363875.99000000476,3360.060000000056
32660,2022-10-30 11:40:00,-35.44,367200.6100000048,363875.99000000476,3324.6200000000536
32661,2022-10-30 11:45:00,984.8,368185.4100000048,363875.99000000476,4309.420000000042
32662,2022-10-30 11:50:00,-1152.41,367033.00000000483,363875.99000000476,3157.0100000000675
32663,2022-10-30 11:55:00,-650.99,366382.01000000484,363875.99000000476,2506.020000000077
32664,2022-10-30 12:00:00,429.26,366811.27000000485,363875.99000000476,2935.280000000086
32665,2022-10-30 12:05:00,-973.04,365838.23000000487,363875.99000000476,1962.240000000107
32666,2022-10-30 12:10:00,1072.34,366910.5700000049,363875.99000000476,3034.5800000001327
32667,2022-10-30 12:15:00,1022.65,367933.2200000049,363875.99000000476,4057.230000000156
32668,2022-10-30 12:20:00,-182.21,367751.0100000049,363875.99000000476,3875.020000000135
32669,2022-10-30 12:25:00,1529.84,369280.8500000049,363875.99000000476,5404.860000000161
32670,2022-10-30 12:30:00,1292.04,370572.8900000049,363875.99000000476,6696.90000000014
32671,2022-10-30 12:35:00,1285.3,371858.1900000049,363875.99000000476,7982.200000000128
32672,2022-10-30 12:40:00,1412.67,373270.8600000049,363875.99000000476,9394.870000000112
32673,2022-10-30 12:45:00,1221.15,374492.0100000049,363875.99000000476,10616.020000000135
32674,2022-10-30 12:50:00,1515.79,376007.8000000049,363875.99000000476,12131.810000000114
32675,2022-10-30 12:55:00,-1771.38,374236.4200000049,363875.99000000476,10360.43000000011
32676,2022-10-30 13:00:00,-1066.52,373169.90000000485,363875.99000000476,9293.91000000009
32677,2022-10-30 13:05:00,1995.96,375165.8600000049,363875.99000000476,11289.870000000112
32678,2022-10-30 13:10:00,1893.42,377059.28000000486,363875.99000000476,13183.290000000095
32679,2022-10-30 13:15:00,-508.38,376550.90000000485,363875.99000000476,12674.91000000009
32680,2022-10-30 13:20:00,-241.34,376309.5600000048,363875.99000000476,12433.570000000065
32681,2022-10-30 13:25:00,-1925.34,374384.2200000048,363875.99000000476,10508.23000000004
32682,2022-10-30 13:30:00,646.95,375031.1700000048,363875.99000000476,11155.180000000051
32683,2022-10-30 13:35:00,433.03,375464.20000000484,363875.99000000476,11588.21000000008
32684,2022-10-30 13:40:00,-1870.91,373593.29000000487,363875.99000000476,9717.300000000105
32685,2022-10-30 13:45:00,-1562.27,372031.02000000485,363875.99000000476,8155.030000000086
32686,2022-10-30 13:50:00,-897.13,371133.89000000485,363875.99000000476,7257.9000000000815
32687,2022-10-30 13:55:00,1611.6,372745.4900000048,363875.99000000476,8869.500000000058
32688,2022-10-30 14:00:00,-234.73,372510.76000000484,363875.99000000476,8634.770000000077
32689,2022-10-30 14:05:00,-1987.26,370523.50000000483,363875.99000000476,6647.5100000000675
32690,2022-10-30 14:10:00,1190.01,371713.51000000484,363875.99000000476,7837.520000000077
32691,2022-10-30 14:15:00,-1915.88,369797.63000000484,363875.99000000476,5921.640000000072
32692,2022-10-30 14:20:00,1416.18,371213.8100000048,363875.99000000476,7337.820000000065
32693,2022-10-30 14:25:00,556.91,371770.7200000048,363875.99000000476,7894.73000000004
32694,2022-10-30 14:30:00,-210.2,371560.5200000048,363875.99000000476,7684.530000000028
32695,2022-10-30 14:35:00,-298.12,371262.4000000048,363875.99000000476,7386.410000000033
32696,2022-10-30 14:40:00,-703.57,370558.8300000048,363875.99000000476,6682.840000000026
32697,2022-10-30 14:45:00,-332.44,370226.3900000048,363875.99000000476,6350.400000000023
32698,2022-10-30 14:50:00,-158.96,370067.43000000477,363875.99000000476,6191.440000000002
32699,2022-10-30 14:55:00,-1781.28,368286.15000000474,363875.99000000476,4410.159999999974
32700,2022-10-30 15:00:00,-1681.11,366605.04000000475,363875.99000000476,2729.0499999999884
32701,2022-10-30 15:05:00,1979.72,368584.7600000047,363875.99000000476,4708.76999999996
32702,2022-10-30 15:10:00,1118.75,369703.5100000047,363875.99000000476,5827.51999999996
32703,2022-10-30 15:15:00,151.18,369854.6900000047,363875.99000000476,5978.699999999953
32704,2022-10-30 15:20:00,-899.53,368955.1600000047,363875.99000000476,5079.1699999999255
32705,2022-10-30 15:25:00,934.77,369889.9300000047,363875.99000000476,6013.939999999944
32706,2022-10-30 15:30:00,-947.88,368942.0500000047,363875.99000000476,5066.0599999999395
32707,2022-10-30 15:35:00,752.16,369694.2100000047,363875.99000000476,5818.219999999914
32708,2022-10-30 15:40:00,-1103.41,368590.8000000047,363875.99000000476,4714.8099999999395
32709,2022-10-30 15:45:00,-1659.22,366931.58000000473,363875.99000000476,3055.5899999999674
32710,2022-10-30 15:50:00,1028.81,367960.3900000047,363875.99000000476,4084.399999999965
32711,2022-10-30 15:55:00,1220.44,369180.83000000473,363875.99000000476,5304.839999999967
32712,2022-10-30 16:00:00,-1708.68,367472.15000000474,363875.99000000476,3596.1599999999744
32713,2022-10-30 16:05:00,194.32,367666.47000000475,363875.99000000476,3790.4799999999814
32714,2022-10-30 16:10:00,939.26,368605.73000000475,363875.99000000476,4729.739999999991
32715,2022-10-30 16:15:00,1695.62,370301.35000000475,363875.99000000476,6425.359999999986
32716,2022-10-30 16:20:00,566.41,370867.7600000047,363875.99000000476,6991.76999999996
32717,2022-10-30 16:25:00,1848.83,372716.59000000474,363875.99000000476,8840.599999999977
32718,2022-10-30 16:30:00,-1754.05,370962.54000000475,363875.99000000476,7086.549999999988
32719,2022-10-30 16:35:00,-820.92,370141.62000000477,363875.99000000476,6265.630000000005
32720,2022-10-30 16:40:00,-383.78,369757.84000000474,363875.99000000476,5881.849999999977
32721,2022-10-30 16:45:00,1315.36,371073.2000000047,363875.99000000476,7197.209999999963
32722,2022-10-30 16:50:00,469.86,371543.0600000047,363875.99000000476,7667.069999999949
32723,2022-10-30 16:55:00,-89.94,371453.1200000047,363875.99000000476,7577.129999999946
32724,2022-10-31 08:00:00,-1357.88,370095.2400000047,371453.1200000047,-1357.8800000000047
32725,2022-10-31 08:05:00,1800.89,371896.1300000047,371453.1200000047,443.0100000000093
32726,2022-10-31 08:10:00,-677.61,371218.52000000473,371453.1200000047,-234.59999999997672
32727,2022-10-31 08:15:00,1435.18,372653.7000000047,371453.1200000047,1200.5800000000163
32728,2022-10-31 08:20:00,-755.17,371898.53000000474,371453.1200000047,445.4100000000326
32729,2022-10-31 08:25:00,-1120.71,370777.8200000047,371453.1200000047,-675.2999999999884
32730,2022-10-31 08:30:00,-886.11,369891.71000000474,371453.1200000047,-1561.4099999999744
32731,2022-10-31 08:35:00,-1722.67,368169.04000000475,371453.1200000047,-3284.079999999958
32732,2022-10-31 08:40:00,-1030.42,367138.62000000477,371453.1200000047,-4314.499999999942
32733,2022-10-31 08:45:00,780.12,367918.74000000476,371453.1200000047,-3534.3799999999464
32734,2022-10-31 08:50:00,-0.32,367918.42000000476,371453.1200000047,-3534.6999999999534
32735,2022-10-31 08:55:00,-274.08,367644.34000000474,371453.1200000047,-3808.7799999999697
32736,2022-10-31 09:00:00,628.01,368272.35000000475,371453.1200000047,-3180.7699999999604
32737,2022-10-31 09:05:00,1009.27,369281.62000000477,371453.1200000047,-2171.499999999942
32738,2022-10-31 09:10:00,-1854.62,367427.0000000048,371453.1200000047,-4026.119999999937
32739,2022-10-31 09:15:00,-1042.67,366384.3300000048,371453.1200000047,-5068.789999999921
32740,2022-10-31 09:20:00,474.95,366859.2800000048,371453.1200000047,-4593.839999999909
32741,2022-10-31 09:25:00,-1255.63,365603.6500000048,371453.1200000047,-5849.469999999914
32742,2022-10-31 09:30:00,-114.87,365488.7800000048,371453.1200000047,-5964.339999999909
32743,2022-10-31 09:35:00,56.15,365544.9300000048,371453.1200000047,-5908.189999999886
32744,2022-10-31 09:40:00,-1234.25,364310.6800000048,371453.1200000047,-7142.439999999886
32745,2022-10-31 09:45:00,1190.87,365501.5500000048,371453.1200000047,-5951.569999999891
32746,2022-10-31 09:50:00,-166.51,365335.0400000048,371453.1200000047,-6118.0799999999
32747,2022-10-31 09:55:00,-98.67,365236.3700000048,371453.1200000047,-6216.749999999884
32748,2022-10-31 10:00:00,1516.32,366752.69000000483,371453.1200000047,-4700.429999999877
32749,2022-10-31 10:05:00,-1712.93,365039.76000000484,371453.1200000047,-6413.35999999987
32750,2022-10-31 10:10:00,-1138.52,363901.2400000048,371453.1200000047,-7551.879999999888
32751,2022-10-31 10:15:00,-476.58,363424.6600000048,371453.1200000047,-8028.4599999999045
32752,2022-10-31 10:20:00,101.33,363525.9900000048,371453.1200000047,-7927.129999999888
32753,2022-10-31 10:25:00,-1144.63,362381.3600000048,371453.1200000047,-9071.759999999893
32754,2022-10-31 10:30:00,202.19,362583.5500000048,371453.1200000047,-8869.56999999989
32755,2022-10-31 10:35:00,-785.04,361798.51000000484,371453.1200000047,-9654.60999999987
32756,2022-10-31 10:40:00,-433.73,361364.78000000486,371453.1200000047,-10088.339999999851
32757,2022-10-31 10:45:00,1856.49,363221.27000000485,371453.1200000047,-8231.84999999986
32758,2022-10-31 10:50:00,-263.68,362957.59000000486,371453.1200000047,-8495.529999999853
32759,2022-10-31 10:55:00,-1985.53,360972.0600000048,371453.1200000047,-10481.059999999881
32760,2022-10-31 11:00:00,876.19,361848.25000000483,371453.1200000047,-9604.869999999879
32761,2022-10-31 11:05:00,1909.08,363757.33000000485,371453.1200000047,-7695.789999999863
32762,2022-10-31 11:10:00,-1174.98,362582.35000000487,371453.1200000047,-8870.769999999844
32763,2022-10-31 11:15:00,971.26,363553.6100000049,371453.1200000047,-7899.509999999835
32764,2022-10-31 11:20:00,1411.16,364964.77000000485,371453.1200000047,-6488.34999999986
32765,2022-10-31 11:25:00,-12.16,364952.6100000049,371453.1200000047,-6500.509999999835
32766,2022-10-31 11:30:00,119.44,365072.0500000049,371453.1200000047,-6381.069999999832
32767,2022-10-31 11:35:00,433.07,365505.1200000049,371453.1200000047,-5947.999999999825
32768,2022-10-31 11:40:00,-1597.91,363907.2100000049,371453.1200000047,-7545.9099999998
32769,2022-10-31 11:45:00,-648.84,363258.3700000049,371453.1200000047,-8194.749999999825
32770,2022-10-31 11:50:00,-1420.55,361837.8200000049,371453.1200000047,-9615.299999999814
32771,2022-10-31 11:55:00,-1826.64,360011.1800000049,371453.1200000047,-11441.939999999828
32772,2022-10-31 12:00:00,-198.97,359812.2100000049,371453.1200000047,-11640.9099999998
32773,2022-10-31 12:05:00,-696.08,359116.1300000049,371453.1200000047,-12336.989999999816
32774,2022-10-31 12:10:00,1062.92,360179.0500000049,371453.1200000047,-11274.069999999832
32775,2022-10-31 12:15:00,1802.77,361981.8200000049,371453.1200000047,-9471.299999999814
32776,2022-10-31 12:20:00,-1709.44,360272.3800000049,371453.1200000047,-11180.739999999816
32777,2022-10-31 12:25:00,1935.24,362207.6200000049,371453.1200000047,-9245.499999999825
32778,2022-10-31 12:30:00,-1790.05,360417.5700000049,371453.1200000047,-11035.549999999814
32779,2022-10-31 12:35:00,1411.69,361829.2600000049,371453.1200000047,-9623.859999999811
32780,2022-10-31 12:40:00,138.09,361967.3500000049,371453.1200000047,-9485.769999999786
32781,2022-10-31 12:45:00,-1607.28,360360.0700000049,371453.1200000047,-11093.049999999814
32782,2022-10-31 12:50:00,-915.02,359445.0500000049,371453.1200000047,-12008.069999999832
32783,2022-10-31 12:55:00,1661.3,361106.35000000487,371453.1200000047,-10346.769999999844
32784,2022-10-31 13:00:00,-87.58,361018.77000000485,371453.1200000047,-10434.34999999986
32785,2022-10-31 13:05:00,-1872.84,359145.9300000048,371453.1200000047,-12307.189999999886
32786,2022-10-31 13:10:00,-1911.31,357234.6200000048,371453.1200000047,-14218.499999999884
32787,2022-10-31 13:15:00,1170.43,358405.0500000048,371453.1200000047,-13048.06999999989
32788,2022-10-31 13:20:00,996.97,359402.0200000048,371453.1200000047,-12051.099999999919
32789,2022-10-31 13:25:00,1249.59,360651.6100000048,371453.1200000047,-10801.509999999893
32790,2022-10-31 13:30:00,-1901.54,358750.07000000484,371453.1200000047,-12703.049999999872
32791,2022-10-31 13:35:00,-1534.38,357215.69000000483,371453.1200000047,-14237.429999999877
32792,2022-10-31 13:40:00,1611.84,358827.53000000486,371453.1200000047,-12625.589999999851
32793,2022-10-31 13:45:00,56.11,358883.64000000485,371453.1200000047,-12569.479999999865
32794,2022-10-31 13:50:00,-717.83,358165.8100000048,371453.1200000047,-13287.309999999881
32795,2022-10-31 13:55:00,490.14,358655.95000000484,371453.1200000047,-12797.169999999867
32796,2022-10-31 14:00:00,50.26,358706.21000000485,371453.1200000047,-12746.909999999858
32797,2022-10-31 14:05:00,-94.13,358612.08000000485,371453.1200000047,-12841.039999999863
32798,2022-10-31 14:10:00,906.9,359518.98000000487,371453.1200000047,-11934.13999999984
32799,2022-10-31 14:15:00,-886.82,358632.16000000486,371453.1200000047,-12820.959999999846
32800,2022-10-31 14:20:00,1883.74,360515.90000000485,371453.1200000047,-10937.219999999856
32801,2022-10-31 14:25:00,-787.56,359728.34000000486,371453.1200000047,-11724.779999999853
32802,2022-10-31 14:30:00,1191.0,360919.34000000486,371453.1200000047,-10533.779999999853
32803,2022-10-31 14:35:00,-1158.97,359760.3700000049,371453.1200000047,-11692.749999999825
32804,2022-10-31 14:40:00,-1626.44,358133.9300000049,371453.1200000047,-13319.189999999828
32805,2022-10-31 14:45:00,625.81,358759.7400000049,371453.1200000047,-12693.37999999983
32806,2022-10-31 14:50:00,1422.09,360181.8300000049,371453.1200000047,-11271.289999999804
32807,2022-10-31 14:55:00,191.05,360372.8800000049,371453.1200000047,-11080.239999999816
32808,2022-10-31 15:00:00,-55.25,360317.6300000049,371453.1200000047,-11135.489999999816
32809,2022-10-31 15:05:00,987.75,361305.3800000049,371453.1200000047,-10147.739999999816
32810,2022-10-31 15:10:00,1547.52,362852.9000000049,371453.1200000047,-8600.219999999797
32811,2022-10-31 15:15:00,1969.94,364822.8400000049,371453.1200000047,-6630.279999999795
32812,2022-10-31 15:20:00,-729.16,364093.68000000494,371453.1200000047,-7359.4399999997695
32813,2022-10-31 15:25:00,1615.44,365709.12000000494,371453.1200000047,-5743.999999999767
32814,2022-10-31 15:30:00,1629.1,367338.2200000049,371453.1200000047,-4114.89999999979
32815,2022-10-31 15:35:00,-1735.26,365602.9600000049,371453.1200000047,-5850.1599999998
32816,2022-10-31 15:40:00,-558.23,365044.7300000049,371453.1200000047,-6408.389999999781
32817,2022-10-31 15:45:00,649.59,365694.32000000495,371453.1200000047,-5758.7999999997555
32818,2022-10-31 15:50:00,150.01,365844.33000000496,371453.1200000047,-5608.789999999746
32819,2022-10-31 15:55:00,1495.01,367339.340000005,371453.1200000047,-4113.779999999737
32820,2022-10-31 16:00:00,1138.84,368478.180000005,371453.1200000047,-2974.9399999997113
32821,2022-10-31 16:05:00,-1347.95,367130.230000005,371453.1200000047,-4322.889999999723
32822,2022-10-31 16:10:00,255.68,367385.910000005,371453.1200000047,-4067.20999999973
32823,2022-10-31 16:15:00,1758.71,369144.620000005,371453.1200000047,-2308.499999999709
32824,2022-10-31 16:20:00,-449.27,368695.350000005,371453.1200000047,-2757.7699999997276
32825,2022-10-31 16:25:00,-508.48,368186.870000005,371453.1200000047,-3266.249999999709
32826,2022-10-31 16:30:00,-110.04,368076.830000005,371453.1200000047,-3376.289999999688
32827,2022-10-31 16:35:00,383.54,368460.370000005,371453.1200000047,-2992.749999999709
32828,2022-10-31 16:40:00,-1624.11,366836.260000005,371453.1200000047,-4616.859999999695
32829,2022-10-31 16:45:00,-1060.78,365775.480000005,371453.1200000047,-5677.639999999723
32830,2022-10-31 16:50:00,854.38,366629.860000005,371453.1200000047,-4823.259999999718
32831,2022-10-31 16:55:00,757.8,367387.660000005,371453.1200000047,-4065.45999999973
32832,2022-11-01 08:00:00,220.56,367608.220000005,367387.660000005,220.55999999999767
32833,2022-11-01 08:05:00,30.44,367638.660000005,367387.660000005,251.0
32834,2022-11-01 08:10:00,-1868.67,365769.990000005,367387.660000005,-1617.6699999999837
32835,2022-11-01 08:15:00,-856.72,364913.270000005,367387.660000005,-2474.3899999999558
32836,2022-11-01 08:20:00,-1524.46,363388.810000005,367387.660000005,-3998.8499999999767
32837,2022-11-01 08:25:00,953.62,364342.430000005,367387.660000005,-3045.2299999999814
32838,2022-11-01 08:30:00,919.97,365262.400000005,367387.660000005,-2125.2600000000093
32839,2022-11-01 08:35:00,-1620.66,363641.740000005,367387.660000005,-3745.9199999999837
32840,2022-11-01 08:40:00,1519.89,365161.630000005,367387.660000005,-2226.0299999999697
32841,2022-11-01 08:45:00,811.96,365973.59000000503,367387.660000005,-1414.0699999999488
32842,2022-11-01 08:50:00,-1123.21,364850.380000005,367387.660000005,-2537.2799999999697
32843,2022-11-01 08:55:00,769.34,365619.72000000504,367387.660000005,-1767.9399999999441
32844,2022-11-01 09:00:00,-1258.2,364361.520000005,367387.660000005,-3026.1399999999558
32845,2022-11-01 09:05:00,-1470.67,362890.85000000504,367387.660000005,-4496.8099999999395
32846,2022-11-01 09:10:00,-1106.84,361784.010000005,367387.660000005,-5603.649999999965
32847,2022-11-01 09:15:00,-1221.26,360562.750000005,367387.660000005,-6824.909999999974
32848,2022-11-01 09:20:00,1510.7,362073.450000005,367387.660000005,-5314.209999999963
32849,2022-11-01 09:25:00,1923.11,363996.560000005,367387.660000005,-3391.0999999999767
32850,2022-11-01 09:30:00,-632.9,363363.660000005,367387.660000005,-4024.0
32851,2022-11-01 09:35:00,1391.77,364755.430000005,367387.660000005,-2632.2299999999814
32852,2022-11-01 09:40:00,-699.39,364056.040000005,367387.660000005,-3331.6199999999953
32853,2022-11-01 09:45:00,-1976.18,362079.860000005,367387.660000005,-5307.799999999988
32854,2022-11-01 09:50:00,1933.61,364013.470000005,367387.660000005,-3374.1900000000023
32855,2022-11-01 09:55:00,-990.94,363022.530000005,367387.660000005,-4365.130000000005
32856,2022-11-01 10:00:00,-1569.41,361453.120000005,367387.660000005,-5934.539999999979
32857,2022-11-01 10:05:00,-1776.65,359676.470000005,367387.660000005,-7711.190000000002
32858,2022-11-01 10:10:00,892.06,360568.530000005,367387.660000005,-6819.130000000005
32859,2022-11-01 10:15:00,531.41,361099.94000000495,367387.660000005,-6287.72000000003
32860,2022-11-01 10:20:00,84.92,361184.86000000493,367387.660000005,-6202.800000000047
32861,2022-11-01 10:25:00,-382.57,360802.2900000049,367387.660000005,-6585.370000000054
32862,2022-11-01 10:30:00,-778.93,360023.36000000493,367387.660000005,-7364.300000000047
32863,2022-11-01 10:35:00,1742.83,361766.19000000495,367387.660000005,-5621.47000000003
32864,2022-11-01 10:40:00,-1659.28,360106.9100000049,367387.660000005,-7280.750000000058
32865,2022-11-01 10:45:00,1678.4,361785.31000000495,367387.660000005,-5602.350000000035
32866,2022-11-01 10:50:00,362.72,362148.0300000049,367387.660000005,-5239.630000000063
32867,2022-11-01 10:55:00,1057.0,363205.0300000049,367387.660000005,-4182.630000000063
32868,2022-11-01 11:00:00,-1809.03,361396.0000000049,367387.660000005,-5991.660000000091
32869,2022-11-01 11:05:00,-279.93,361116.0700000049,367387.660000005,-6271.590000000084
32870,2022-11-01 11:10:00,-769.37,360346.7000000049,367387.660000005,-7040.960000000079
32871,2022-11-01 11:15:00,-1273.47,359073.2300000049,367387.660000005,-8314.430000000051
32872,2022-11-01 11:20:00,-709.95,358363.2800000049,367387.660000005,-9024.380000000063
32873,2022-11-01 11:25:00,-1981.37,356381.9100000049,367387.660000005,-11005.750000000058
32874,2022-11-01 11:30:00,-516.23,355865.68000000494,367387.660000005,-11521.98000000004
32875,2022-11-01 11:35:00,-1631.81,354233.87000000494,367387.660000005,-13153.790000000037
32876,2022-11-01 11:40:00,743.42,354977.2900000049,367387.660000005,-12410.370000000054
32877,2022-11-01 11:45:00,1692.67,356669.9600000049,367387.660000005,-10717.70000000007
32878,2022-11-01 11:50:00,1874.65,358544.61000000493,367387.660000005,-8843.050000000047
32879,2022-11-01 11:55:00,1831.19,360375.80000000494,367387.660000005,-7011.860000000044
32880,2022-11-01 12:00:00,-1961.72,358414.08000000496,367387.660000005,-8973.580000000016
32881,2022-11-01 12:05:00,-812.79,357601.290000005,367387.660000005,-9786.369999999995
32882,2022-11-01 12:10:00,248.0,357849.290000005,367387.660000005,-9538.369999999995
32883,2022-11-01 12:15:00,722.0,358571.290000005,367387.660000005,-8816.369999999995
32884,2022-11-01 12:20:00,187.35,358758.64000000496,367387.660000005,-8629.020000000019
32885,2022-11-01 12:25:00,1699.95,360458.590000005,367387.660000005,-6929.070000000007
32886,2022-11-01 12:30:00,977.83,361436.420000005,367387.660000005,-5951.239999999991
32887,2022-11-01 12:35:00,-235.85,361200.570000005,367387.660000005,-6187.089999999967
32888,2022-11-01 12:40:00,1059.78,362260.35000000504,367387.660000005,-5127.3099999999395
32889,2022-11-01 12:45:00,1583.43,363843.78000000503,367387.660000005,-3543.8799999999464
32890,2022-11-01 12:50:00,1414.61,365258.390000005,367387.660000005,-2129.2699999999604
32891,2022-11-01 12:55:00,1897.77,367156.16000000504,367387.660000005,-231.4999999999418
32892,2022-11-01 13:00:00,-878.95,366277.210000005,367387.660000005,-1110.4499999999534
32893,2022-11-01 13:05:00,-1411.53,364865.680000005,367387.660000005,-2521.9799999999814
32894,2022-11-01 13:10:00,-215.46,364650.220000005,367387.660000005,-2737.4400000000023
32895,2022-11-01 13:15:00,-1327.67,363322.550000005,367387.660000005,-4065.109999999986
32896,2022-11-01 13:20:00,-271.25,363051.300000005,367387.660000005,-4336.359999999986
32897,2022-11-01 13:25:00,-1017.01,362034.290000005,367387.660000005,-5353.369999999995
32898,2022-11-01 13:30:00,-1944.61,360089.680000005,367387.660000005,-7297.979999999981
32899,2022-11-01 13:35:00,-1334.49,358755.190000005,367387.660000005,-8632.469999999972
32900,2022-11-01 13:40:00,-326.1,358429.09000000503,367387.660000005,-8958.569999999949
32901,2022-11-01 13:45:00,194.49,358623.580000005,367387.660000005,-8764.079999999958
32902,2022-11-01 13:50:00,-1314.53,357309.050000005,367387.660000005,-10078.609999999986
32903,2022-11-01 13:55:00,-1058.22,356250.830000005,367387.660000005,-11136.829999999958
32904,2022-11-01 14:00:00,-881.5,355369.330000005,367387.660000005,-12018.329999999958
32905,2022-11-01 14:05:00,-1786.35,353582.98000000505,367387.660000005,-13804.679999999935
32906,2022-11-01 14:10:00,514.92,354097.90000000503,367387.660000005,-13289.759999999951
32907,2022-11-01 14:15:00,1789.33,355887.23000000505,367387.660000005,-11500.429999999935
32908,2022-11-01 14:20:00,1136.33,357023.56000000506,367387.660000005,-10364.099999999919
32909,2022-11-01 14:25:00,-456.66,356566.9000000051,367387.660000005,-10820.759999999893
32910,2022-11-01 14:30:00,430.19,356997.0900000051,367387.660000005,-10390.56999999989
32911,2022-11-01 14:35:00,-207.92,356789.1700000051,367387.660000005,-10598.489999999874
32912,2022-11-01 14:40:00,375.33,357164.5000000051,367387.660000005,-10223.159999999858
32913,2022-11-01 14:45:00,-1883.37,355281.1300000051,367387.660000005,-12106.529999999853
32914,2022-11-01 14:50:00,1705.07,356986.20000000513,367387.660000005,-10401.459999999846
32915,2022-11-01 14:55:00,1907.92,358894.1200000051,367387.660000005,-8493.539999999863
32916,2022-11-01 15:00:00,1662.33,360556.45000000513,367387.660000005,-6831.209999999846
32917,2022-11-01 15:05:00,-1881.76,358674.6900000051,367387.660000005,-8712.969999999856
32918,2022-11-01 15:10:00,-580.41,358094.28000000515,367387.660000005,-9293.37999999983
32919,2022-11-01 15:15:00,1721.77,359816.05000000517,367387.660000005,-7571.609999999811
32920,2022-11-01 15:20:00,-1355.55,358460.5000000052,367387.660000005,-8927.1599999998
32921,2022-11-01 15:25:00,194.84,358655.3400000052,367387.660000005,-8732.319999999774
32922,2022-11-01 15:30:00,728.8,359384.1400000052,367387.660000005,-8003.519999999786
32923,2022-11-01 15:35:00,1690.29,361074.4300000052,367387.660000005,-6313.229999999807
32924,2022-11-01 15:40:00,-1283.49,359790.9400000052,367387.660000005,-7596.719999999797
32925,2022-11-01 15:45:00,-606.58,359184.36000000517,367387.660000005,-8203.299999999814
32926,2022-11-01 15:50:00,1987.81,361172.17000000516,367387.660000005,-6215.489999999816
32927,2022-11-01 15:55:00,1201.28,362373.4500000052,367387.660000005,-5014.209999999788
32928,2022-11-01 16:00:00,1737.31,364110.7600000052,367387.660000005,-3276.8999999997905
32929,2022-11-01 16:05:00,1606.7,365717.4600000052,367387.660000005,-1670.1999999997788
32930,2022-11-01 16:10:00,-1835.56,363881.9000000052,367387.660000005,-3505.7599999997765
32931,2022-11-01 16:15:00,-614.42,363267.4800000052,367387.660000005,-4120.17999999976
32932,2022-11-01 16:20:00,1561.7,364829.18000000523,367387.660000005,-2558.4799999997485
32933,2022-11-01 16:25:00,319.35,365148.5300000052,367387.660000005,-2239.129999999772
32934,2022-11-01 16:30:00,-1628.8,363519.7300000052,367387.660000005,-3867.92999999976
32935,2022-11-01 16:35:00,-498.79,363020.94000000524,367387.660000005,-4366.719999999739
32936,2022-11-01 16:40:00,-340.93,362680.01000000525,367387.660000005,-4707.649999999732
32937,2022-11-01 16:45:00,-300.67,362379.34000000526,367387.660000005,-5008.319999999716
32938,2022-11-01 16:50:00,-407.06,361972.28000000527,367387.660000005,-5415.379999999714
32939,2022-11-01 16:55:00,-1662.69,360309.59000000526,367387.660000005,-7078.069999999716
32940,2022-11-02 08:00:00,308.41,360618.00000000524,360309.59000000526,308.4099999999744
32941,2022-11-02 08:05:00,-648.54,359969.46000000526,360309.59000000526,-340.13000000000466
32942,2022-11-02 08:10:00,1867.43,361836.89000000525,360309.59000000526,1527.2999999999884
32943,2022-11-02 08:15:00,-1795.24,360041.65000000526,360309.59000000526,-267.9400000000023
32944,2022-11-02 08:20:00,318.67,360360.32000000525,360309.59000000526,50.72999999998137
32945,2022-11-02 08:25:00,1624.43,361984.75000000524,360309.59000000526,1675.1599999999744
32946,2022-11-02 08:30:00,301.42,362286.1700000052,360309.59000000526,1976.579999999958
32947,2022-11-02 08:35:00,-1451.0,360835.1700000052,360309.59000000526,525.5799999999581
32948,2022-11-02 08:40:00,240.79,361075.9600000052,360309.59000000526,766.3699999999371
32949,2022-11-02 08:45:00,869.36,361945.3200000052,360309.59000000526,1635.7299999999232
32950,2022-11-02 08:50:00,1311.06,363256.3800000052,360309.59000000526,2946.789999999921
32951,2022-11-02 08:55:00,-222.31,363034.0700000052,360309.59000000526,2724.479999999923
32952,2022-11-02 09:00:00,-935.6,362098.4700000052,360309.59000000526,1788.8799999999464
32953,2022-11-02 09:05:00,-1706.95,360391.5200000052,360309.59000000526,81.92999999993481
32954,2022-11-02 09:10:00,-1670.61,358720.9100000052,360309.59000000526,-1588.6800000000512
32955,2022-11-02 09:15:00,1653.52,360374.43000000523,360309.59000000526,64.8399999999674
32956,2022-11-02 09:20:00,1301.6,361676.0300000052,360309.59000000526,1366.4399999999441
32957,2022-11-02 09:25:00,750.56,362426.5900000052,360309.59000000526,2116.999999999942
32958,2022-11-02 09:30:00,1758.92,364185.5100000052,360309.59000000526,3875.9199999999255
32959,2022-11-02 09:35:00,1669.89,365855.4000000052,360309.59000000526,5545.8099999999395
32960,2022-11-02 09:40:00,-607.34,365248.0600000052,360309.59000000526,4938.469999999914
32961,2022-11-02 09:45:00,-475.53,364772.53000000515,360309.59000000526,4462.939999999886
32962,2022-11-02 09:50:00,-260.16,364512.3700000052,360309.59000000526,4202.7799999999115
32963,2022-11-02 09:55:00,1280.87,365793.2400000052,360309.59000000526,5483.649999999907
32964,2022-11-02 10:00:00,700.07,366493.3100000052,360309.59000000526,6183.719999999914
32965,2022-11-02 10:05:00,-574.63,365918.6800000052,360309.59000000526,5609.089999999909
32966,2022-11-02 10:10:00,78.51,365997.1900000052,360309.59000000526,5687.5999999999185
32967,2022-11-02 10:15:00,-696.21,365300.98000000516,360309.59000000526,4991.389999999898
32968,2022-11-02 10:20:00,130.82,365431.80000000517,360309.59000000526,5122.2099999999045
32969,2022-11-02 10:25:00,423.17,365854.97000000515,360309.59000000526,5545.379999999888
32970,2022-11-02 10:30:00,1923.34,367778.3100000052,360309.59000000526,7468.719999999914
32971,2022-11-02 10:35:00,748.87,368527.1800000052,360309.59000000526,8217.58999999991
32972,2022-11-02 10:40:00,-462.55,368064.6300000052,360309.59000000526,7755.039999999921
32973,2022-11-02 10:45:00,520.93,368585.5600000052,360309.59000000526,8275.969999999914
32974,2022-11-02 10:50:00,1037.71,369623.2700000052,360309.59000000526,9313.679999999935
32975,2022-11-02 10:55:00,-332.86,369290.4100000052,360309.59000000526,8980.819999999949
32976,2022-11-02 11:00:00,-450.57,368839.8400000052,360309.59000000526,8530.249999999942
32977,2022-11-02 11:05:00,-1448.32,367391.5200000052,360309.59000000526,7081.929999999935
32978,2022-11-02 11:10:00,-528.89,366862.6300000052,360309.59000000526,6553.039999999921
32979,2022-11-02 11:15:00,-1419.85,365442.7800000052,360309.59000000526,5133.189999999944
32980,2022-11-02 11:20:00,970.58,366413.3600000052,360309.59000000526,6103.76999999996
32981,2022-11-02 11:25:00,-975.48,365437.88000000524,360309.59000000526,5128.289999999979
32982,2022-11-02 11:30:00,-695.42,364742.46000000526,360309.59000000526,4432.869999999995
32983,2022-11-02 11:35:00,1964.63,366707.09000000526,360309.59000000526,6397.5
32984,2022-11-02 11:40:00,312.57,367019.6600000053,360309.59000000526,6710.070000000007
32985,2022-11-02 11:45:00,1507.56,368527.22000000527,360309.59000000526,8217.630000000005
32986,2022-11-02 11:50:00,620.81,369148.03000000527,360309.59000000526,8838.440000000002
32987,2022-11-02 11:55:00,264.19,369412.22000000527,360309.59000000526,9102.630000000005
32988,2022-11-02 12:00:00,1618.34,371030.5600000053,360309.59000000526,10720.97000000003
32989,2022-11-02 12:05:00,284.76,371315.3200000053,360309.59000000526,11005.73000000004
32990,2022-11-02 12:10:00,273.08,371588.4000000053,360309.59000000526,11278.810000000056
32991,2022-11-02 12:15:00,-920.09,370668.3100000053,360309.59000000526,10358.72000000003
32992,2022-11-02 12:20:00,-830.37,369837.9400000053,360309.59000000526,9528.350000000035
32993,2022-11-02 12:25:00,-274.16,369563.7800000053,360309.59000000526,9254.19000000006
32994,2022-11-02 12:30:00,337.14,369900.92000000534,360309.59000000526,9591.330000000075
32995,2022-11-02 12:35:00,-912.33,368988.5900000053,360309.59000000526,8679.000000000058
32996,2022-11-02 12:40:00,-1957.79,367030.80000000534,360309.59000000526,6721.210000000079
32997,2022-11-02 12:45:00,-1450.67,365580.13000000536,360309.59000000526,5270.5400000000955
32998,2022-11-02 12:50:00,-1232.78,364347.35000000533,360309.59000000526,4037.7600000000675
32999,2022-11-02 12:55:00,179.34,364526.69000000536,360309.59000000526,4217.100000000093
33000,2022-11-02 13:00:00,1.26,364527.95000000537,360309.59000000526,4218.360000000102
33001,2022-11-02 13:05:00,755.52,365283.4700000054,360309.59000000526,4973.880000000121
33002,2022-11-02 13:10:00,-1969.16,363314.3100000054,360309.59000000526,3004.7200000001467
33003,2022-11-02 13:15:00,1082.98,364397.2900000054,360309.59000000526,4087.700000000128
33004,2022-11-02 13:20:00,-1294.93,363102.3600000054,360309.59000000526,2792.770000000135
33005,2022-11-02 13:25:00,-730.52,362371.8400000054,360309.59000000526,2062.2500000001164
33006,2022-11-02 13:30:00,1261.47,363633.31000000535,360309.59000000526,3323.7200000000885
33007,2022-11-02 13:35:00,1658.36,365291.67000000534,360309.59000000526,4982.0800000000745
33008,2022-11-02 13:40:00,125.07,365416.74000000535,360309.59000000526,5107.1500000000815
33009,2022-11-02 13:45:00,-1203.33,364213.41000000533,360309.59000000526,3903.820000000065
33010,2022-11-02 13:50:00,-721.65,363491.7600000053,360309.59000000526,3182.170000000042
33011,2022-11-02 13:55:00,-1013.34,362478.4200000053,360309.59000000526,2168.8300000000163
33012,2022-11-02 14:00:00,671.79,363150.21000000526,360309.59000000526,2840.6199999999953
33013,2022-11-02 14:05:00,-261.79,362888.4200000053,360309.59000000526,2578.8300000000163
33014,2022-11-02 14:10:00,832.75,363721.1700000053,360309.59000000526,3411.5800000000163
33015,2022-11-02 14:15:00,-870.9,362850.27000000526,360309.59000000526,2540.679999999993
33016,2022-11-02 14:20:00,-184.74,362665.53000000527,360309.59000000526,2355.9400000000023
33017,2022-11-02 14:25:00,1533.79,364199.32000000525,360309.59000000526,3889.7299999999814
33018,2022-11-02 14:30:00,-1628.33,362570.99000000523,360309.59000000526,2261.399999999965
33019,2022-11-02 14:35:00,960.81,363531.8000000052,360309.59000000526,3222.2099999999627
33020,2022-11-02 14:40:00,-807.0,362724.8000000052,360309.59000000526,2415.2099999999627
33021,2022-11-02 14:45:00,-431.51,362293.2900000052,360309.59000000526,1983.6999999999534
33022,2022-11-02 14:50:00,719.69,363012.9800000052,360309.59000000526,2703.3899999999558
33023,2022-11-02 14:55:00,-1605.97,361407.01000000525,360309.59000000526,1097.4199999999837
33024,2022-11-02 15:00:00,254.34,361661.3500000053,360309.59000000526,1351.7600000000093
33025,2022-11-02 15:05:00,-1022.33,360639.02000000526,360309.59000000526,329.429999999993
33026,2022-11-02 15:10:00,1677.64,362316.6600000053,360309.59000000526,2007.070000000007
33027,2022-11-02 15:15:00,493.12,362809.78000000527,360309.59000000526,2500.1900000000023
33028,2022-11-02 15:20:00,-750.41,362059.3700000053,360309.59000000526,1749.780000000028
33029,2022-11-02 15:25:00,-830.27,361229.1000000053,360309.59000000526,919.5100000000093
33030,2022-11-02 15:30:00,-1588.92,359640.1800000053,360309.59000000526,-669.4099999999744
33031,2022-11-02 15:35:00,-1340.41,358299.7700000053,360309.59000000526,-2009.8199999999488
33032,2022-11-02 15:40:00,360.15,358659.92000000534,360309.59000000526,-1649.6699999999255
33033,2022-11-02 15:45:00,319.56,358979.48000000534,360309.59000000526,-1330.1099999999278
33034,2022-11-02 15:50:00,-450.51,358528.9700000053,360309.59000000526,-1780.6199999999371
33035,2022-11-02 15:55:00,-130.82,358398.1500000053,360309.59000000526,-1911.4399999999441
33036,2022-11-02 16:00:00,1667.94,360066.0900000053,360309.59000000526,-243.4999999999418
33037,2022-11-02 16:05:00,428.17,360494.2600000053,360309.59000000526,184.6700000000419
33038,2022-11-02 16:10:00,1145.59,361639.85000000533,360309.59000000526,1330.2600000000675
33039,2022-11-02 16:15:00,-647.99,360991.86000000534,360309.59000000526,682.2700000000768
33040,2022-11-02 16:20:00,1777.84,362769.70000000537,360309.59000000526,2460.1100000001024
33041,2022-11-02 16:25:00,-1736.79,361032.9100000054,360309.59000000526,723.3200000001234
33042,2022-11-02 16:30:00,-388.49,360644.4200000054,360309.59000000526,334.8300000001327
33043,2022-11-02 16:35:00,1753.45,362397.8700000054,360309.59000000526,2088.2800000001444
33044,2022-11-02 16:40:00,-999.01,361398.8600000054,360309.59000000526,1089.270000000135
33045,2022-11-02 16:45:00,-1634.42,359764.4400000054,360309.59000000526,-545.1499999998487
33046,2022-11-02 16:50:00,1647.17,361411.6100000054,360309.59000000526,1102.020000000135
33047,2022-11-02 16:55:00,1947.34,363358.9500000054,360309.59000000526,3049.3600000001607
33048,2022-11-03 08:00:00,-1868.52,361490.4300000054,363358.9500000054,-1868.5200000000186
33049,2022-11-03 08:05:00,1313.64,362804.0700000054,363358.9500000054,-554.8800000000047
33050,2022-11-03 08:10:00,-1493.12,361310.9500000054,363358.9500000054,-2048.0
33051,2022-11-03 08:15:00,1471.05,362782.0000000054,363358.9500000054,-576.9500000000116
33052,2022-11-03 08:20:00,1142.91,363924.9100000054,363358.9500000054,565.9599999999627
33053,2022-11-03 08:25:00,-124.24,363800.6700000054,363358.9500000054,441.71999999997206
33054,2022-11-03 08:30:00,-546.2,363254.4700000054,363358.9500000054,-104.48000000003958
33055,2022-11-03 08:35:00,-1872.26,361382.2100000054,363358.9500000054,-1976.740000000049
33056,2022-11-03 08:40:00,995.1,362377.31000000535,363358.9500000054,-981.6400000000722
33057,2022-11-03 08:45:00,-115.14,362262.17000000534,363358.9500000054,-1096.7800000000861
33058,2022-11-03 08:50:00,329.39,362591.56000000535,363358.9500000054,-767.3900000000722
33059,2022-11-03 08:55:00,1476.78,364068.3400000054,363358.9500000054,709.3899999999558
33060,2022-11-03 09:00:00,1650.34,365718.6800000054,363358.9500000054,2359.7299999999814
33061,2022-11-03 09:05:00,-313.61,365405.0700000054,363358.9500000054,2046.1199999999953
33062,2022-11-03 09:10:00,1289.63,366694.7000000054,363358.9500000054,3335.75
33063,2022-11-03 09:15:00,-318.89,366375.8100000054,363358.9500000054,3016.859999999986
33064,2022-11-03 09:20:00,1383.35,367759.1600000054,363358.9500000054,4400.209999999963
33065,2022-11-03 09:25:00,1335.74,369094.9000000054,363358.9500000054,5735.949999999953
33066,2022-11-03 09:30:00,357.09,369451.9900000054,363358.9500000054,6093.039999999979
33067,2022-11-03 09:35:00,-1741.84,367710.1500000054,363358.9500000054,4351.199999999953
33068,2022-11-03 09:40:00,838.31,368548.4600000054,363358.9500000054,5189.509999999951
33069,2022-11-03 09:45:00,-1150.03,367398.43000000535,363358.9500000054,4039.479999999923
33070,2022-11-03 09:50:00,-1693.87,365704.56000000535,363358.9500000054,2345.609999999928
33071,2022-11-03 09:55:00,422.85,366127.41000000533,363358.9500000054,2768.4599999999045
33072,2022-11-03 10:00:00,-1227.51,364899.9000000053,363358.9500000054,1540.9499999998952
33073,2022-11-03 10:05:00,1773.65,366673.55000000534,363358.9500000054,3314.5999999999185
33074,2022-11-03 10:10:00,1037.12,367710.67000000534,363358.9500000054,4351.719999999914
33075,2022-11-03 10:15:00,-1509.42,366201.25000000536,363358.9500000054,2842.29999999993
33076,2022-11-03 10:20:00,-1554.14,364647.11000000534,363358.9500000054,1288.1599999999162
33077,2022-11-03 10:25:00,488.4,365135.51000000536,363358.9500000054,1776.5599999999395
33078,2022-11-03 10:30:00,1943.46,367078.9700000054,363358.9500000054,3720.0199999999604
33079,2022-11-03 10:35:00,-1992.17,365086.8000000054,363358.9500000054,1727.8499999999767
33080,2022-11-03 10:40:00,1903.35,366990.1500000054,363358.9500000054,3631.1999999999534
33081,2022-11-03 10:45:00,-361.25,366628.9000000054,363358.9500000054,3269.9499999999534
33082,2022-11-03 10:50:00,-200.48,366428.4200000054,363358.9500000054,3069.469999999972
33083,2022-11-03 10:55:00,1936.8,368365.2200000054,363358.9500000054,5006.26999999996
33084,2022-11-03 11:00:00,-1037.44,367327.7800000054,363358.9500000054,3968.829999999958
33085,2022-11-03 11:05:00,-684.08,366643.70000000537,363358.9500000054,3284.749999999942
33086,2022-11-03 11:10:00,-618.08,366025.62000000535,363358.9500000054,2666.6699999999255
33087,2022-11-03 11:15:00,-233.12,365792.50000000536,363358.9500000054,2433.54999999993
33088,2022-11-03 11:20:00,451.7,366244.20000000537,363358.9500000054,2885.249999999942
33089,2022-11-03 11:25:00,126.63,366370.8300000054,363358.9500000054,3011.8799999999464
33090,2022-11-03 11:30:00,-1144.28,365226.55000000534,363358.9500000054,1867.5999999999185
33091,2022-11-03 11:35:00,-800.86,364425.69000000536,363358.9500000054,1066.7399999999325
33092,2022-11-03 11:40:00,-1268.1,363157.5900000054,363358.9500000054,-201.36000000004424
33093,2022-11-03 11:45:00,243.52,363401.1100000054,363358.9500000054,42.15999999997439
33094,2022-11-03 11:50:00,-987.97,362413.1400000054,363358.9500000054,-945.8099999999977
33095,2022-11-03 11:55:00,1007.65,363420.79000000545,363358.9500000054,61.84000000002561
33096,2022-11-03 12:00:00,-687.16,362733.6300000055,363358.9500000054,-625.3199999999488
33097,2022-11-03 12:05:00,-72.5,362661.1300000055,363358.9500000054,-697.8199999999488
33098,2022-11-03 12:10:00,-1989.75,360671.3800000055,363358.9500000054,-2687.569999999949
33099,2022-11-03 12:15:00,560.99,361232.37000000547,363358.9500000054,-2126.579999999958
33100,2022-11-03 12:20:00,333.14,361565.5100000055,363358.9500000054,-1793.4399999999441
33101,2022-11-03 12:25:00,-261.22,361304.2900000055,363358.9500000054,-2054.659999999916
33102,2022-11-03 12:30:00,43.0,361347.2900000055,363358.9500000054,-2011.6599999999162
33103,2022-11-03 12:35:00,-1054.28,360293.0100000055,363358.9500000054,-3065.939999999944
33104,2022-11-03 12:40:00,185.66,360478.67000000546,363358.9500000054,-2880.2799999999697
33105,2022-11-03 12:45:00,-1130.18,359348.49000000546,363358.9500000054,-4010.4599999999627
33106,2022-11-03 12:50:00,1741.96,361090.4500000055,363358.9500000054,-2268.499999999942
33107,2022-11-03 12:55:00,663.46,361753.9100000055,363358.9500000054,-1605.0399999999208
33108,2022-11-03 13:00:00,-351.02,361402.8900000055,363358.9500000054,-1956.0599999999395
33109,2022-11-03 13:05:00,-1114.32,360288.5700000055,363358.9500000054,-3070.3799999999464
33110,2022-11-03 13:10:00,539.23,360827.80000000546,363358.9500000054,-2531.149999999965
33111,2022-11-03 13:15:00,-1172.67,359655.1300000055,363358.9500000054,-3703.819999999949
33112,2022-11-03 13:20:00,-658.02,358997.11000000546,363358.9500000054,-4361.839999999967
33113,2022-11-03 13:25:00,-941.24,358055.87000000547,363358.9500000054,-5303.079999999958
33114,2022-11-03 13:30:00,-1189.48,356866.3900000055,363358.9500000054,-6492.5599999999395
33115,2022-11-03 13:35:00,-1024.86,355841.5300000055,363358.9500000054,-7517.4199999999255
33116,2022-11-03 13:40:00,767.14,356608.6700000055,363358.9500000054,-6750.2799999999115
33117,2022-11-03 13:45:00,245.95,356854.6200000055,363358.9500000054,-6504.3299999999
33118,2022-11-03 13:50:00,-641.3,356213.32000000554,363358.9500000054,-7145.629999999888
33119,2022-11-03 13:55:00,396.9,356610.22000000556,363358.9500000054,-6748.729999999865
33120,2022-11-03 14:00:00,196.06,356806.28000000556,363358.9500000054,-6552.669999999867
33121,2022-11-03 14:05:00,-1844.87,354961.41000000556,363358.9500000054,-8397.539999999863
33122,2022-11-03 14:10:00,1077.95,356039.3600000056,363358.9500000054,-7319.589999999851
33123,2022-11-03 14:15:00,-1815.68,354223.6800000056,363358.9500000054,-9135.269999999844
33124,2022-11-03 14:20:00,-1348.93,352874.7500000056,363358.9500000054,-10484.199999999837
33125,2022-11-03 14:25:00,-1546.94,351327.8100000056,363358.9500000054,-12031.13999999984
33126,2022-11-03 14:30:00,632.39,351960.2000000056,363358.9500000054,-11398.749999999825
33127,2022-11-03 14:35:00,-1737.37,350222.8300000056,363358.9500000054,-13136.11999999982
33128,2022-11-03 14:40:00,1850.04,352072.8700000056,363358.9500000054,-11286.079999999842
33129,2022-11-03 14:45:00,1796.32,353869.1900000056,363358.9500000054,-9489.759999999835
33130,2022-11-03 14:50:00,-1896.01,351973.1800000056,363358.9500000054,-11385.769999999844
33131,2022-11-03 14:55:00,57.37,352030.5500000056,363358.9500000054,-11328.399999999849
33132,2022-11-03 15:00:00,-812.13,351218.4200000056,363358.9500000054,-12140.529999999853
33133,2022-11-03 15:05:00,-1416.72,349801.7000000056,363358.9500000054,-13557.249999999825
33134,2022-11-03 15:10:00,-1642.0,348159.7000000056,363358.9500000054,-15199.249999999825
33135,2022-11-03 15:15:00,-1615.6,346544.1000000056,363358.9500000054,-16814.849999999802
33136,2022-11-03 15:20:00,1056.34,347600.44000000565,363358.9500000054,-15758.509999999776
33137,2022-11-03 15:25:00,-619.07,346981.37000000564,363358.9500000054,-16377.579999999783
33138,2022-11-03 15:30:00,1212.54,348193.9100000056,363358.9500000054,-15165.039999999804
33139,2022-11-03 15:35:00,1755.51,349949.42000000563,363358.9500000054,-13409.529999999795
33140,2022-11-03 15:40:00,-551.54,349397.88000000565,363358.9500000054,-13961.069999999774
33141,2022-11-03 15:45:00,1549.89,350947.77000000566,363358.9500000054,-12411.17999999976
33142,2022-11-03 15:50:00,-219.59,350728.18000000564,363358.9500000054,-12630.769999999786
33143,2022-11-03 15:55:00,-1596.62,349131.56000000564,363358.9500000054,-14227.389999999781
33144,2022-11-03 16:00:00,-720.13,348411.43000000564,363358.9500000054,-14947.519999999786
33145,2022-11-03 16:05:00,-1940.41,346471.02000000566,363358.9500000054,-16887.92999999976
33146,2022-11-03 16:10:00,746.37,347217.39000000566,363358.9500000054,-16141.559999999765
33147,2022-11-03 16:15:00,-671.34,346546.05000000563,363358.9500000054,-16812.89999999979
33148,2022-11-03 16:20:00,-612.84,345933.2100000056,363358.9500000054,-17425.739999999816
33149,2022-11-03 16:25:00,-1533.65,344399.5600000056,363358.9500000054,-18959.38999999984
33150,2022-11-03 16:30:00,779.18,345178.7400000056,363358.9500000054,-18180.209999999846
33151,2022-11-03 16:35:00,1281.56,346460.3000000056,363358.9500000054,-16898.64999999985
33152,2022-11-03 16:40:00,-110.28,346350.02000000555,363358.9500000054,-17008.929999999877
33153,2022-11-03 16:45:00,1413.75,347763.77000000555,363358.9500000054,-15595.179999999877
33154,2022-11-03 16:50:00,746.47,348510.2400000055,363358.9500000054,-14848.709999999905
33155,2022-11-03 16:55:00,1554.45,350064.69000000553,363358.9500000054,-13294.259999999893
33156,2022-11-04 08:00:00,-502.15,349562.5400000055,350064.69000000553,-502.1500000000233
33157,2022-11-04 08:05:00,-1152.39,348410.1500000055,350064.69000000553,-1654.5400000000373
33158,2022-11-04 08:10:00,-1762.38,346647.7700000055,350064.69000000553,-3416.920000000042
33159,2022-11-04 08:15:00,32.84,346680.6100000055,350064.69000000553,-3384.0800000000163
33160,2022-11-04 08:20:00,935.82,347616.4300000055,350064.69000000553,-2448.2600000000093
33161,2022-11-04 08:25:00,705.68,348322.1100000055,350064.69000000553,-1742.5800000000163
33162,2022-11-04 08:30:00,-283.43,348038.6800000055,350064.69000000553,-2026.0100000000093
33163,2022-11-04 08:35:00,-1351.35,346687.33000000555,350064.69000000553,-3377.359999999986
33164,2022-11-04 08:40:00,1816.08,348503.41000000556,350064.69000000553,-1561.2799999999697
33165,2022-11-04 08:45:00,466.09,348969.5000000056,350064.69000000553,-1095.1899999999441
33166,2022-11-04 08:50:00,-882.28,348087.22000000556,350064.69000000553,-1977.469999999972
33167,2022-11-04 08:55:00,-362.64,347724.58000000555,350064.69000000553,-2340.109999999986
33168,2022-11-04 09:00:00,-692.6,347031.98000000557,350064.69000000553,-3032.7099999999627
33169,2022-11-04 09:05:00,-1317.29,345714.6900000056,350064.69000000553,-4349.999999999942
33170,2022-11-04 09:10:00,-738.96,344975.73000000557,350064.69000000553,-5088.959999999963
33171,2022-11-04 09:15:00,-1904.05,343071.6800000056,350064.69000000553,-6993.009999999951
33172,2022-11-04 09:20:00,750.07,343821.7500000056,350064.69000000553,-6242.939999999944
33173,2022-11-04 09:25:00,-72.07,343749.6800000056,350064.69000000553,-6315.009999999951
33174,2022-11-04 09:30:00,552.43,344302.1100000056,350064.69000000553,-5762.579999999958
33175,2022-11-04 09:35:00,-704.58,343597.53000000556,350064.69000000553,-6467.159999999974
33176,2022-11-04 09:40:00,1877.42,345474.95000000554,350064.69000000553,-4589.739999999991
33177,2022-11-04 09:45:00,1259.49,346734.44000000553,350064.69000000553,-3330.25
33178,2022-11-04 09:50:00,-1144.22,345590.22000000556,350064.69000000553,-4474.469999999972
33179,2022-11-04 09:55:00,-1372.93,344217.29000000557,350064.69000000553,-5847.399999999965
33180,2022-11-04 10:00:00,1630.44,345847.73000000557,350064.69000000553,-4216.959999999963
33181,2022-11-04 10:05:00,-164.76,345682.97000000556,350064.69000000553,-4381.719999999972
33182,2022-11-04 10:10:00,-71.06,345611.91000000556,350064.69000000553,-4452.77999999997
33183,2022-11-04 10:15:00,1663.79,347275.70000000554,350064.69000000553,-2788.9899999999907
33184,2022-11-04 10:20:00,-1354.74,345920.96000000555,350064.69000000553,-4143.729999999981
33185,2022-11-04 10:25:00,1678.27,347599.23000000557,350064.69000000553,-2465.4599999999627
33186,2022-11-04 10:30:00,940.58,348539.8100000056,350064.69000000553,-1524.8799999999464
33187,2022-11-04 10:35:00,1813.44,350353.2500000056,350064.69000000553,288.5600000000559
33188,2022-11-04 10:40:00,954.84,351308.0900000056,350064.69000000553,1243.4000000000815
33189,2022-11-04 10:45:00,513.09,351821.18000000564,350064.69000000553,1756.490000000107
33190,2022-11-04 10:50:00,140.45,351961.63000000565,350064.69000000553,1896.9400000001187
33191,2022-11-04 10:55:00,-1206.36,350755.27000000566,350064.69000000553,690.5800000001327
33192,2022-11-04 11:00:00,-1699.65,349055.62000000564,350064.69000000553,-1009.0699999998906
33193,2022-11-04 11:05:00,1544.09,350599.71000000567,350064.69000000553,535.020000000135
33194,2022-11-04 11:10:00,-1030.54,349569.1700000057,350064.69000000553,-495.519999999844
33195,2022-11-04 11:15:00,557.9,350127.0700000057,350064.69000000553,62.38000000017928
33196,2022-11-04 11:20:00,927.9,351054.97000000573,350064.69000000553,990.2800000002026
33197,2022-11-04 11:25:00,-1516.76,349538.2100000057,350064.69000000553,-526.4799999998068
33198,2022-11-04 11:30:00,768.08,350306.29000000574,350064.69000000553,241.60000000020955
33199,2022-11-04 11:35:00,464.28,350770.57000000577,350064.69000000553,705.8800000002375
33200,2022-11-04 11:40:00,638.39,351408.9600000058,350064.69000000553,1344.2700000002515
33201,2022-11-04 11:45:00,11.21,351420.1700000058,350064.69000000553,1355.4800000002724
33202,2022-11-04 11:50:00,-474.15,350946.0200000058,350064.69000000553,881.3300000002491
33203,2022-11-04 11:55:00,926.79,351872.81000000576,350064.69000000553,1808.1200000002282
33204,2022-11-04 12:00:00,1344.33,353217.1400000058,350064.69000000553,3152.4500000002445
33205,2022-11-04 12:05:00,-17.36,353199.7800000058,350064.69000000553,3135.0900000002584
33206,2022-11-04 12:10:00,1748.72,354948.50000000576,350064.69000000553,4883.8100000002305
33207,2022-11-04 12:15:00,498.43,355446.93000000576,350064.69000000553,5382.2400000002235
33208,2022-11-04 12:20:00,-1635.23,353811.7000000058,350064.69000000553,3747.010000000242
33209,2022-11-04 12:25:00,-1645.06,352166.6400000058,350064.69000000553,2101.9500000002445
33210,2022-11-04 12:30:00,1155.03,353321.6700000058,350064.69000000553,3256.9800000002724
33211,2022-11-04 12:35:00,-1320.97,352000.70000000583,350064.69000000553,1936.0100000003004
33212,2022-11-04 12:40:00,-1066.87,350933.83000000584,350064.69000000553,869.140000000305
33213,2022-11-04 12:45:00,-1561.16,349372.67000000586,350064.69000000553,-692.0199999996694
33214,2022-11-04 12:50:00,1570.07,350942.74000000587,350064.69000000553,878.0500000003376
33215,2022-11-04 12:55:00,-1424.14,349518.60000000586,350064.69000000553,-546.0899999996764
33216,2022-11-04 13:00:00,453.59,349972.1900000059,350064.69000000553,-92.49999999965075
33217,2022-11-04 13:05:00,1191.2,351163.3900000059,350064.69000000553,1098.700000000361
33218,2022-11-04 13:10:00,-664.52,350498.8700000059,350064.69000000553,434.18000000034226
33219,2022-11-04 13:15:00,-1631.56,348867.3100000059,350064.69000000553,-1197.3799999996554
33220,2022-11-04 13:20:00,-1359.17,347508.1400000059,350064.69000000553,-2556.549999999639
33221,2022-11-04 13:25:00,1448.42,348956.5600000059,350064.69000000553,-1108.1299999996554
33222,2022-11-04 13:30:00,-48.2,348908.36000000587,350064.69000000553,-1156.329999999667
33223,2022-11-04 13:35:00,-1167.04,347741.3200000059,350064.69000000553,-2323.369999999646
33224,2022-11-04 13:40:00,841.44,348582.7600000059,350064.69000000553,-1481.9299999996438
33225,2022-11-04 13:45:00,902.87,349485.6300000059,350064.69000000553,-579.0599999996484
33226,2022-11-04 13:50:00,1848.35,351333.98000000586,350064.69000000553,1269.2900000003283
33227,2022-11-04 13:55:00,1694.33,353028.3100000059,350064.69000000553,2963.6200000003446
33228,2022-11-04 14:00:00,-1402.41,351625.9000000059,350064.69000000553,1561.2100000003702
33229,2022-11-04 14:05:00,-1931.22,349694.68000000593,350064.69000000553,-370.00999999960186
33230,2022-11-04 14:10:00,-1097.54,348597.14000000595,350064.69000000553,-1467.549999999581
33231,2022-11-04 14:15:00,1108.71,349705.850000006,350064.69000000553,-358.83999999955995
33232,2022-11-04 14:20:00,-1267.04,348438.810000006,350064.69000000553,-1625.879999999539
33233,2022-11-04 14:25:00,1286.99,349725.800000006,350064.69000000553,-338.8899999995483
33234,2022-11-04 14:30:00,956.21,350682.010000006,350064.69000000553,617.3200000004726
33235,2022-11-04 14:35:00,176.14,350858.150000006,350064.69000000553,793.4600000004866
33236,2022-11-04 14:40:00,1228.63,352086.780000006,350064.69000000553,2022.0900000004913
33237,2022-11-04 14:45:00,1919.62,354006.400000006,350064.69000000553,3941.7100000004866
33238,2022-11-04 14:50:00,1948.06,355954.460000006,350064.69000000553,5889.770000000484
33239,2022-11-04 14:55:00,1607.99,357562.450000006,350064.69000000553,7497.760000000475
33240,2022-11-04 15:00:00,-1863.63,355698.820000006,350064.69000000553,5634.13000000047
33241,2022-11-04 15:05:00,-36.56,355662.260000006,350064.69000000553,5597.570000000473
33242,2022-11-04 15:10:00,-1237.97,354424.29000000603,350064.69000000553,4359.600000000501
33243,2022-11-04 15:15:00,-1523.61,352900.68000000605,350064.69000000553,2835.9900000005146
33244,2022-11-04 15:20:00,-1438.02,351462.660000006,350064.69000000553,1397.970000000496
33245,2022-11-04 15:25:00,-810.07,350652.590000006,350064.69000000553,587.900000000489
33246,2022-11-04 15:30:00,418.7,351071.29000000603,350064.69000000553,1006.6000000005006
33247,2022-11-04 15:35:00,-1990.16,349081.13000000606,350064.69000000553,-983.5599999994738
33248,2022-11-04 15:40:00,26.38,349107.51000000606,350064.69000000553,-957.1799999994691
33249,2022-11-04 15:45:00,-1242.41,347865.1000000061,350064.69000000553,-2199.5899999994435
33250,2022-11-04 15:50:00,93.69,347958.7900000061,350064.69000000553,-2105.899999999441
33251,2022-11-04 15:55:00,962.0,348920.7900000061,350064.69000000553,-1143.8999999994412
33252,2022-11-04 16:00:00,-7.46,348913.33000000607,350064.69000000553,-1151.3599999994622
33253,2022-11-04 16:05:00,369.31,349282.64000000607,350064.69000000553,-782.0499999994645
33254,2022-11-04 16:10:00,-763.29,348519.3500000061,350064.69000000553,-1545.3399999994435
33255,2022-11-04 16:15:00,-251.25,348268.1000000061,350064.69000000553,-1796.5899999994435
33256,2022-11-04 16:20:00,-1758.41,346509.6900000061,350064.69000000553,-3554.999999999418
33257,2022-11-04 16:25:00,-623.8,345885.8900000061,350064.69000000553,-4178.799999999406
33258,2022-11-04 16:30:00,1504.37,347390.2600000061,350064.69000000553,-2674.429999999411
33259,2022-11-04 16:35:00,-1496.85,345893.41000000614,350064.69000000553,-4171.279999999388
33260,2022-11-04 16:40:00,1427.89,347321.30000000616,350064.69000000553,-2743.3899999993737
33261,2022-11-04 16:45:00,1683.91,349005.21000000613,350064.69000000553,-1059.4799999993993
33262,2022-11-04 16:50:00,-1222.61,347782.60000000615,350064.69000000553,-2282.0899999993853
33263,2022-11-04 16:55:00,-1582.71,346199.8900000061,350064.69000000553,-3864.7999999994063
33264,2022-11-05 08:00:00,-1661.7,344538.1900000061,346199.8900000061,-1661.7000000000116
33265,2022-11-05 08:05:00,-418.85,344119.34000000614,346199.8900000061,-2080.5499999999884
33266,2022-11-05 08:10:00,-1160.97,342958.37000000617,346199.8900000061,-3241.5199999999604
33267,2022-11-05 08:15:00,-310.54,342647.8300000062,346199.8900000061,-3552.0599999999395
33268,2022-11-05 08:20:00,1467.03,344114.8600000062,346199.8900000061,-2085.0299999999115
33269,2022-11-05 08:25:00,1065.47,345180.3300000062,346199.8900000061,-1019.5599999999395
33270,2022-11-05 08:30:00,941.61,346121.9400000062,346199.8900000061,-77.94999999995343
33271,2022-11-05 08:35:00,1976.75,348098.6900000062,346199.8900000061,1898.8000000000466
33272,2022-11-05 08:40:00,1039.5,349138.1900000062,346199.8900000061,2938.3000000000466
33273,2022-11-05 08:45:00,1442.89,350581.0800000062,346199.8900000061,4381.1900000000605
33274,2022-11-05 08:50:00,-245.17,350335.9100000062,346199.8900000061,4136.020000000077
33275,2022-11-05 08:55:00,937.63,351273.5400000062,346199.8900000061,5073.6500000000815
33276,2022-11-05 09:00:00,-466.48,350807.0600000062,346199.8900000061,4607.1700000001
33277,2022-11-05 09:05:00,1704.62,352511.6800000062,346199.8900000061,6311.7900000000955
33278,2022-11-05 09:10:00,-1969.28,350542.4000000062,346199.8900000061,4342.5100000000675
33279,2022-11-05 09:15:00,41.75,350584.1500000062,346199.8900000061,4384.2600000000675
33280,2022-11-05 09:20:00,-10.31,350573.8400000062,346199.8900000061,4373.95000000007
33281,2022-11-05 09:25:00,1304.29,351878.1300000062,346199.8900000061,5678.240000000049
33282,2022-11-05 09:30:00,1624.79,353502.92000000615,346199.8900000061,7303.030000000028
33283,2022-11-05 09:35:00,-249.95,353252.97000000614,346199.8900000061,7053.080000000016
33284,2022-11-05 09:40:00,-212.44,353040.53000000614,346199.8900000061,6840.640000000014
33285,2022-11-05 09:45:00,1480.39,354520.92000000615,346199.8900000061,8321.030000000028
33286,2022-11-05 09:50:00,1580.72,356101.6400000061,346199.8900000061,9901.75
33287,2022-11-05 09:55:00,-848.37,355253.27000000613,346199.8900000061,9053.380000000005
33288,2022-11-05 10:00:00,-1849.33,353403.9400000061,346199.8900000061,7204.049999999988
33289,2022-11-05 10:05:00,-1141.2,352262.7400000061,346199.8900000061,6062.849999999977
33290,2022-11-05 10:10:00,727.7,352990.4400000061,346199.8900000061,6790.549999999988
33291,2022-11-05 10:15:00,586.87,353577.3100000061,346199.8900000061,7377.419999999984
33292,2022-11-05 10:20:00,1198.95,354776.2600000061,346199.8900000061,8576.369999999995
33293,2022-11-05 10:25:00,446.75,355223.0100000061,346199.8900000061,9023.119999999995
33294,2022-11-05 10:30:00,-811.89,354411.1200000061,346199.8900000061,8211.229999999981
33295,2022-11-05 10:35:00,1165.61,355576.7300000061,346199.8900000061,9376.839999999967
33296,2022-11-05 10:40:00,822.1,356398.83000000607,346199.8900000061,10198.939999999944
33297,2022-11-05 10:45:00,99.43,356498.26000000606,346199.8900000061,10298.369999999937
33298,2022-11-05 10:50:00,-1411.63,355086.63000000606,346199.8900000061,8886.739999999932
33299,2022-11-05 10:55:00,-161.55,354925.08000000607,346199.8900000061,8725.189999999944
33300,2022-11-05 11:00:00,1319.98,356245.06000000605,346199.8900000061,10045.169999999925
33301,2022-11-05 11:05:00,1628.62,357873.68000000605,346199.8900000061,11673.78999999992
33302,2022-11-05 11:10:00,678.64,358552.32000000606,346199.8900000061,12352.429999999935
33303,2022-11-05 11:15:00,-1062.8,357489.5200000061,346199.8900000061,11289.629999999946
33304,2022-11-05 11:20:00,-1562.2,355927.32000000606,346199.8900000061,9727.429999999935
33305,2022-11-05 11:25:00,239.27,356166.5900000061,346199.8900000061,9966.699999999953
33306,2022-11-05 11:30:00,-204.2,355962.39000000607,346199.8900000061,9762.499999999942
33307,2022-11-05 11:35:00,227.68,356190.07000000606,346199.8900000061,9990.179999999935
33308,2022-11-05 11:40:00,-1504.69,354685.38000000606,346199.8900000061,8485.489999999932
33309,2022-11-05 11:45:00,1812.72,356498.10000000603,346199.8900000061,10298.209999999905
33310,2022-11-05 11:50:00,77.08,356575.18000000605,346199.8900000061,10375.28999999992
33311,2022-11-05 11:55:00,-123.91,356451.2700000061,346199.8900000061,10251.379999999946
33312,2022-11-05 12:00:00,364.35,356815.62000000605,346199.8900000061,10615.729999999923
33313,2022-11-05 12:05:00,774.99,357590.61000000604,346199.8900000061,11390.719999999914
33314,2022-11-05 12:10:00,-1700.57,355890.04000000603,346199.8900000061,9690.149999999907
33315,2022-11-05 12:15:00,970.57,356860.61000000604,346199.8900000061,10660.719999999914
33316,2022-11-05 12:20:00,1438.06,358298.67000000604,346199.8900000061,12098.779999999912
33317,2022-11-05 12:25:00,1251.14,359549.81000000605,346199.8900000061,13349.919999999925
33318,2022-11-05 12:30:00,389.68,359939.49000000604,346199.8900000061,13739.599999999919
33319,2022-11-05 12:35:00,1303.45,361242.94000000606,346199.8900000061,15043.04999999993
33320,2022-11-05 12:40:00,449.77,361692.7100000061,346199.8900000061,15492.819999999949
33321,2022-11-05 12:45:00,-918.76,360773.95000000607,346199.8900000061,14574.05999999994
33322,2022-11-05 12:50:00,-1941.45,358832.50000000605,346199.8900000061,12632.609999999928
33323,2022-11-05 12:55:00,707.37,359539.87000000605,346199.8900000061,13339.979999999923
33324,2022-11-05 13:00:00,-1157.55,358382.32000000606,346199.8900000061,12182.429999999935
33325,2022-11-05 13:05:00,320.85,358703.17000000604,346199.8900000061,12503.279999999912
33326,2022-11-05 13:10:00,-656.37,358046.80000000604,346199.8900000061,11846.909999999916
33327,2022-11-05 13:15:00,787.94,358834.74000000604,346199.8900000061,12634.849999999919
33328,2022-11-05 13:20:00,-388.51,358446.23000000603,346199.8900000061,12246.33999999991
33329,2022-11-05 13:25:00,-1685.31,356760.92000000604,346199.8900000061,10561.029999999912
33330,2022-11-05 13:30:00,-1277.59,355483.330000006,346199.8900000061,9283.439999999886
33331,2022-11-05 13:35:00,-1728.63,353754.700000006,346199.8900000061,7554.809999999881
33332,2022-11-05 13:40:00,-543.43,353211.270000006,346199.8900000061,7011.379999999888
33333,2022-11-05 13:45:00,-1917.0,351294.270000006,346199.8900000061,5094.379999999888
33334,2022-11-05 13:50:00,206.33,351500.60000000603,346199.8900000061,5300.7099999999045
33335,2022-11-05 13:55:00,-1686.8,349813.80000000604,346199.8900000061,3613.909999999916
33336,2022-11-05 14:00:00,345.44,350159.24000000604,346199.8900000061,3959.3499999999185
33337,2022-11-05 14:05:00,803.24,350962.48000000603,346199.8900000061,4762.589999999909
33338,2022-11-05 14:10:00,176.38,351138.86000000604,346199.8900000061,4938.969999999914
33339,2022-11-05 14:15:00,721.46,351860.32000000606,346199.8900000061,5660.429999999935
33340,2022-11-05 14:20:00,-611.36,351248.9600000061,346199.8900000061,5049.069999999949
33341,2022-11-05 14:25:00,-240.43,351008.5300000061,346199.8900000061,4808.639999999956
33342,2022-11-05 14:30:00,-1160.13,349848.4000000061,346199.8900000061,3648.509999999951
33343,2022-11-05 14:35:00,-1042.72,348805.6800000061,346199.8900000061,2605.789999999979
33344,2022-11-05 14:40:00,241.06,349046.7400000061,346199.8900000061,2846.8499999999767
33345,2022-11-05 14:45:00,1655.89,350702.6300000061,346199.8900000061,4502.739999999991
33346,2022-11-05 14:50:00,1684.39,352387.02000000613,346199.8900000061,6187.130000000005
33347,2022-11-05 14:55:00,609.93,352996.9500000061,346199.8900000061,6797.059999999998
33348,2022-11-05 15:00:00,520.05,353517.0000000061,346199.8900000061,7317.109999999986
33349,2022-11-05 15:05:00,512.12,354029.1200000061,346199.8900000061,7829.229999999981
33350,2022-11-05 15:10:00,37.98,354067.1000000061,346199.8900000061,7867.209999999963
33351,2022-11-05 15:15:00,452.18,354519.2800000061,346199.8900000061,8319.389999999956
33352,2022-11-05 15:20:00,960.73,355480.01000000606,346199.8900000061,9280.119999999937
33353,2022-11-05 15:25:00,1320.74,356800.75000000605,346199.8900000061,10600.859999999928
33354,2022-11-05 15:30:00,129.12,356929.87000000605,346199.8900000061,10729.979999999923
33355,2022-11-05 15:35:00,0.27,356930.14000000607,346199.8900000061,10730.249999999942
33356,2022-11-05 15:40:00,-422.31,356507.83000000607,346199.8900000061,10307.939999999944
33357,2022-11-05 15:45:00,-1420.27,355087.56000000605,346199.8900000061,8887.669999999925
33358,2022-11-05 15:50:00,1607.48,356695.04000000603,346199.8900000061,10495.149999999907
33359,2022-11-05 15:55:00,4.18,356699.220000006,346199.8900000061,10499.3299999999
33360,2022-11-05 16:00:00,1499.79,358199.010000006,346199.8900000061,11999.119999999879
33361,2022-11-05 16:05:00,1677.25,359876.260000006,346199.8900000061,13676.369999999879
33362,2022-11-05 16:10:00,321.52,360197.780000006,346199.8900000061,13997.889999999898
33363,2022-11-05 16:15:00,1597.91,361795.690000006,346199.8900000061,15595.799999999872
33364,2022-11-05 16:20:00,677.04,362472.730000006,346199.8900000061,16272.839999999851
33365,2022-11-05 16:25:00,1949.89,364422.620000006,346199.8900000061,18222.729999999865
33366,2022-11-05 16:30:00,1888.88,366311.500000006,346199.8900000061,20111.60999999987
33367,2022-11-05 16:35:00,1326.78,367638.280000006,346199.8900000061,21438.389999999898
33368,2022-11-05 16:40:00,-1752.7,365885.580000006,346199.8900000061,19685.689999999886
33369,2022-11-05 16:45:00,-1828.52,364057.060000006,346199.8900000061,17857.169999999867
33370,2022-11-05 16:50:00,-386.04,363671.020000006,346199.8900000061,17471.12999999989
33371,2022-11-05 16:55:00,-1073.4,362597.620000006,346199.8900000061,16397.729999999865
33372,2022-11-06 08:00:00,628.57,363226.190000006,362597.620000006,628.570000000007
33373,2022-11-06 08:05:00,-1735.79,361490.400000006,362597.620000006,-1107.219999999972
33374,2022-11-06 08:10:00,379.29,361869.690000006,362597.620000006,-727.929999999993
33375,2022-11-06 08:15:00,1220.26,363089.950000006,362597.620000006,492.3300000000163
33376,2022-11-06 08:20:00,1391.16,364481.110000006,362597.620000006,1883.4899999999907
33377,2022-11-06 08:25:00,1086.43,365567.540000006,362597.620000006,2969.9199999999837
33378,2022-11-06 08:30:00,-1785.42,363782.120000006,362597.620000006,1184.5
33379,2022-11-06 08:35:00,-266.74,363515.380000006,362597.620000006,917.7600000000093
33380,2022-11-06 08:40:00,-1573.61,361941.770000006,362597.620000006,-655.8499999999767
33381,2022-11-06 08:45:00,821.63,362763.400000006,362597.620000006,165.78000000002794
33382,2022-11-06 08:50:00,1420.37,364183.770000006,362597.620000006,1586.1500000000233
33383,2022-11-06 08:55:00,947.73,365131.500000006,362597.620000006,2533.8800000000047
33384,2022-11-06 09:00:00,-1886.98,363244.520000006,362597.620000006,646.9000000000233
33385,2022-11-06 09:05:00,-585.86,362658.660000006,362597.620000006,61.04000000003725
33386,2022-11-06 09:10:00,-235.76,362422.900000006,362597.620000006,-174.71999999997206
33387,2022-11-06 09:15:00,-1422.47,361000.43000000605,362597.620000006,-1597.1899999999441
33388,2022-11-06 09:20:00,-444.16,360556.2700000061,362597.620000006,-2041.3499999999185
33389,2022-11-06 09:25:00,1170.89,361727.1600000061,362597.620000006,-870.4599999999045
33390,2022-11-06 09:30:00,166.06,361893.2200000061,362597.620000006,-704.3999999999069
33391,2022-11-06 09:35:00,-316.54,361576.6800000061,362597.620000006,-1020.9399999998859
33392,2022-11-06 09:40:00,-1098.77,360477.9100000061,362597.620000006,-2119.7099999999045
33393,2022-11-06 09:45:00,1524.51,362002.4200000061,362597.620000006,-595.1999999998952
33394,2022-11-06 09:50:00,870.66,362873.08000000607,362597.620000006,275.46000000007916
33395,2022-11-06 09:55:00,-1981.26,360891.82000000606,362597.620000006,-1705.7999999999302
33396,2022-11-06 10:00:00,-1915.0,358976.82000000606,362597.620000006,-3620.79999999993
33397,2022-11-06 10:05:00,-633.43,358343.39000000607,362597.620000006,-4254.229999999923
33398,2022-11-06 10:10:00,1810.21,360153.6000000061,362597.620000006,-2444.019999999902
33399,2022-11-06 10:15:00,1579.73,361733.33000000607,362597.620000006,-864.2899999999208
33400,2022-11-06 10:20:00,721.94,362455.2700000061,362597.620000006,-142.3499999999185
33401,2022-11-06 10:25:00,-1690.14,360765.13000000606,362597.620000006,-1832.4899999999325
33402,2022-11-06 10:30:00,-303.61,360461.5200000061,362597.620000006,-2136.0999999999185
33403,2022-11-06 10:35:00,1214.53,361676.0500000061,362597.620000006,-921.5699999998906
33404,2022-11-06 10:40:00,422.84,362098.8900000061,362597.620000006,-498.72999999986496
33405,2022-11-06 10:45:00,1119.49,363218.3800000061,362597.620000006,620.7600000001257
33406,2022-11-06 10:50:00,-365.25,362853.1300000061,362597.620000006,255.51000000012573
33407,2022-11-06 10:55:00,-1698.88,361154.2500000061,362597.620000006,-1443.369999999879
33408,2022-11-06 11:00:00,-329.47,360824.78000000614,362597.620000006,-1772.839999999851
33409,2022-11-06 11:05:00,-729.21,360095.5700000061,362597.620000006,-2502.049999999872
33410,2022-11-06 11:10:00,1578.6,361674.1700000061,362597.620000006,-923.4499999998952
33411,2022-11-06 11:15:00,-908.08,360766.0900000061,362597.620000006,-1831.5299999999115
33412,2022-11-06 11:20:00,-432.28,360333.81000000605,362597.620000006,-2263.8099999999395
33413,2022-11-06 11:25:00,-1941.82,358391.99000000604,362597.620000006,-4205.629999999946
33414,2022-11-06 11:30:00,-1322.72,357069.2700000061,362597.620000006,-5528.3499999999185
33415,2022-11-06 11:35:00,666.16,357735.43000000605,362597.620000006,-4862.189999999944
33416,2022-11-06 11:40:00,-1983.95,355751.48000000603,362597.620000006,-6846.139999999956
33417,2022-11-06 11:45:00,-460.96,355290.520000006,362597.620000006,-7307.099999999977
33418,2022-11-06 11:50:00,1770.93,357061.450000006,362597.620000006,-5536.169999999984
33419,2022-11-06 11:55:00,-939.94,356121.510000006,362597.620000006,-6476.109999999986
33420,2022-11-06 12:00:00,473.73,356595.240000006,362597.620000006,-6002.380000000005
33421,2022-11-06 12:05:00,752.22,357347.46000000596,362597.620000006,-5250.160000000033
33422,2022-11-06 12:10:00,-1928.06,355419.40000000596,362597.620000006,-7178.22000000003
33423,2022-11-06 12:15:00,-1184.9,354234.50000000594,362597.620000006,-8363.120000000054
33424,2022-11-06 12:20:00,-187.49,354047.01000000595,362597.620000006,-8550.610000000044
33425,2022-11-06 12:25:00,-865.41,353181.600000006,362597.620000006,-9416.020000000019
33426,2022-11-06 12:30:00,-1140.46,352041.14000000595,362597.620000006,-10556.48000000004
33427,2022-11-06 12:35:00,1196.51,353237.65000000596,362597.620000006,-9359.97000000003
33428,2022-11-06 12:40:00,-720.02,352517.63000000594,362597.620000006,-10079.990000000049
33429,2022-11-06 12:45:00,-1403.68,351113.95000000595,362597.620000006,-11483.670000000042
33430,2022-11-06 12:50:00,-995.47,350118.480000006,362597.620000006,-12479.140000000014
33431,2022-11-06 12:55:00,-1992.31,348126.170000006,362597.620000006,-14471.450000000012
33432,2022-11-06 13:00:00,-1273.59,346852.58000000595,362597.620000006,-15745.040000000037
33433,2022-11-06 13:05:00,-1260.05,345592.53000000597,362597.620000006,-17005.090000000026
33434,2022-11-06 13:10:00,-21.91,345570.620000006,362597.620000006,-17027.0
33435,2022-11-06 13:15:00,-105.39,345465.230000006,362597.620000006,-17132.390000000014
33436,2022-11-06 13:20:00,-1051.83,344413.40000000596,362597.620000006,-18184.22000000003
33437,2022-11-06 13:25:00,-800.88,343612.52000000596,362597.620000006,-18985.100000000035
33438,2022-11-06 13:30:00,-65.71,343546.81000000593,362597.620000006,-19050.810000000056
33439,2022-11-06 13:35:00,-1336.41,342210.40000000596,362597.620000006,-20387.22000000003
33440,2022-11-06 13:40:00,1881.65,344092.050000006,362597.620000006,-18505.570000000007
33441,2022-11-06 13:45:00,1377.81,345469.860000006,362597.620000006,-17127.76000000001
33442,2022-11-06 13:50:00,-1720.83,343749.03000000597,362597.620000006,-18848.590000000026
33443,2022-11-06 13:55:00,287.72,344036.75000000594,362597.620000006,-18560.870000000054
33444,2022-11-06 14:00:00,355.69,344392.44000000594,362597.620000006,-18205.18000000005
33445,2022-11-06 14:05:00,-426.03,343966.4100000059,362597.620000006,-18631.21000000008
33446,2022-11-06 14:10:00,1309.09,345275.50000000594,362597.620000006,-17322.120000000054
33447,2022-11-06 14:15:00,483.54,345759.0400000059,362597.620000006,-16838.580000000075
33448,2022-11-06 14:20:00,1656.95,347415.9900000059,362597.620000006,-15181.630000000063
33449,2022-11-06 14:25:00,703.99,348119.9800000059,362597.620000006,-14477.640000000072
33450,2022-11-06 14:30:00,157.11,348277.0900000059,362597.620000006,-14320.530000000086
33451,2022-11-06 14:35:00,-111.83,348165.2600000059,362597.620000006,-14432.360000000102
33452,2022-11-06 14:40:00,1463.06,349628.3200000059,362597.620000006,-12969.300000000105
33453,2022-11-06 14:45:00,24.66,349652.98000000586,362597.620000006,-12944.64000000013
33454,2022-11-06 14:50:00,1439.93,351092.91000000585,362597.620000006,-11504.710000000137
33455,2022-11-06 14:55:00,-1600.17,349492.74000000587,362597.620000006,-13104.880000000121
33456,2022-11-06 15:00:00,-1888.88,347603.86000000587,362597.620000006,-14993.760000000126
33457,2022-11-06 15:05:00,-1750.31,345853.55000000587,362597.620000006,-16744.070000000123
33458,2022-11-06 15:10:00,-1005.26,344848.29000000586,362597.620000006,-17749.330000000133
33459,2022-11-06 15:15:00,-454.42,344393.8700000059,362597.620000006,-18203.750000000116
33460,2022-11-06 15:20:00,-1252.78,343141.09000000585,362597.620000006,-19456.530000000144
33461,2022-11-06 15:25:00,-639.69,342501.40000000584,362597.620000006,-20096.220000000147
33462,2022-11-06 15:30:00,-325.15,342176.2500000058,362597.620000006,-20421.37000000017
33463,2022-11-06 15:35:00,1306.57,343482.8200000058,362597.620000006,-19114.800000000163
33464,2022-11-06 15:40:00,-594.38,342888.4400000058,362597.620000006,-19709.180000000168
33465,2022-11-06 15:45:00,-608.97,342279.47000000585,362597.620000006,-20318.15000000014
33466,2022-11-06 15:50:00,577.31,342856.78000000585,362597.620000006,-19740.840000000142
33467,2022-11-06 15:55:00,421.22,343278.0000000058,362597.620000006,-19319.62000000017
33468,2022-11-06 16:00:00,-1596.72,341681.28000000585,362597.620000006,-20916.340000000142
33469,2022-11-06 16:05:00,308.3,341989.58000000584,362597.620000006,-20608.040000000154
33470,2022-11-06 16:10:00,-1877.1,340112.48000000586,362597.620000006,-22485.14000000013
33471,2022-11-06 16:15:00,904.35,341016.83000000584,362597.620000006,-21580.790000000154
33472,2022-11-06 16:20:00,847.37,341864.20000000583,362597.620000006,-20733.42000000016
33473,2022-11-06 16:25:00,-187.59,341676.6100000058,362597.620000006,-20921.010000000184
33474,2022-11-06 16:30:00,-810.33,340866.2800000058,362597.620000006,-21731.3400000002
33475,2022-11-06 16:35:00,-1229.44,339636.8400000058,362597.620000006,-22960.780000000203
33476,2022-11-06 16:40:00,-327.55,339309.2900000058,362597.620000006,-23288.33000000019
33477,2022-11-06 16:45:00,-1435.99,337873.3000000058,362597.620000006,-24724.32000000018
33478,2022-11-06 16:50:00,1360.23,339233.5300000058,362597.620000006,-23364.0900000002
33479,2022-11-06 16:55:00,1563.56,340797.0900000058,362597.620000006,-21800.530000000203
33480,2022-11-07 08:00:00,-924.62,339872.4700000058,340797.0900000058,-924.6199999999953
33481,2022-11-07 08:05:00,448.02,340320.4900000058,340797.0900000058,-476.5999999999767
33482,2022-11-07 08:10:00,1982.68,342303.1700000058,340797.0900000058,1506.0800000000163
33483,2022-11-07 08:15:00,-1731.65,340571.5200000058,340797.0900000058,-225.57000000000698
33484,2022-11-07 08:20:00,-1789.16,338782.3600000058,340797.0900000058,-2014.7299999999814
33485,2022-11-07 08:25:00,-149.28,338633.0800000058,340797.0900000058,-2164.0100000000093
33486,2022-11-07 08:30:00,-203.96,338429.12000000576,340797.0900000058,-2367.9700000000303
33487,2022-11-07 08:35:00,1437.53,339866.6500000058,340797.0900000058,-930.4400000000023
33488,2022-11-07 08:40:00,745.12,340611.7700000058,340797.0900000058,-185.32000000000698
33489,2022-11-07 08:45:00,-843.89,339767.88000000577,340797.0900000058,-1029.210000000021
33490,2022-11-07 08:50:00,-199.26,339568.62000000576,340797.0900000058,-1228.4700000000303
33491,2022-11-07 08:55:00,137.69,339706.31000000576,340797.0900000058,-1090.780000000028
33492,2022-11-07 09:00:00,-824.57,338881.74000000575,340797.0900000058,-1915.350000000035
33493,2022-11-07 09:05:00,1905.1,340786.84000000573,340797.0900000058,-10.250000000058208
33494,2022-11-07 09:10:00,1156.94,341943.78000000573,340797.0900000058,1146.6899999999441
33495,2022-11-07 09:15:00,1521.51,343465.29000000574,340797.0900000058,2668.1999999999534
33496,2022-11-07 09:20:00,470.19,343935.48000000574,340797.0900000058,3138.3899999999558
33497,2022-11-07 09:25:00,620.25,344555.73000000574,340797.0900000058,3758.6399999999558
33498,2022-11-07 09:30:00,-312.65,344243.0800000057,340797.0900000058,3445.9899999999325
33499,2022-11-07 09:35:00,-1552.27,342690.8100000057,340797.0900000058,1893.7199999999139
33500,2022-11-07 09:40:00,-1902.56,340788.2500000057,340797.0900000058,-8.840000000083819
33501,2022-11-07 09:45:00,1986.22,342774.4700000057,340797.0900000058,1977.3799999998882
33502,2022-11-07 09:50:00,1198.58,343973.0500000057,340797.0900000058,3175.9599999999045
33503,2022-11-07 09:55:00,-875.55,343097.5000000057,340797.0900000058,2300.409999999916
33504,2022-11-07 10:00:00,-812.26,342285.2400000057,340797.0900000058,1488.1499999999069
33505,2022-11-07 10:05:00,-50.99,342234.2500000057,340797.0900000058,1437.1599999999162
33506,2022-11-07 10:10:00,-1819.18,340415.0700000057,340797.0900000058,-382.02000000007683
33507,2022-11-07 10:15:00,-4.1,340410.97000000573,340797.0900000058,-386.12000000005355
33508,2022-11-07 10:20:00,467.55,340878.5200000057,340797.0900000058,81.42999999993481
33509,2022-11-07 10:25:00,1016.91,341895.4300000057,340797.0900000058,1098.3399999999092
33510,2022-11-07 10:30:00,266.64,342162.0700000057,340797.0900000058,1364.9799999999232
33511,2022-11-07 10:35:00,-789.15,341372.9200000057,340797.0900000058,575.8299999998999
33512,2022-11-07 10:40:00,1170.81,342543.7300000057,340797.0900000058,1746.6399999998976
33513,2022-11-07 10:45:00,-399.09,342144.64000000566,340797.0900000058,1347.549999999872
33514,2022-11-07 10:50:00,1567.01,343711.65000000567,340797.0900000058,2914.5599999998813
33515,2022-11-07 10:55:00,-496.11,343215.5400000057,340797.0900000058,2418.449999999895
33516,2022-11-07 11:00:00,-348.6,342866.9400000057,340797.0900000058,2069.8499999999185
33517,2022-11-07 11:05:00,-1838.63,341028.3100000057,340797.0900000058,231.21999999991385
33518,2022-11-07 11:10:00,1260.98,342289.2900000057,340797.0900000058,1492.1999999998952
33519,2022-11-07 11:15:00,-1766.87,340522.4200000057,340797.0900000058,-274.6700000001001
33520,2022-11-07 11:20:00,-1790.0,338732.4200000057,340797.0900000058,-2064.6700000001
33521,2022-11-07 11:25:00,-1378.67,337353.7500000057,340797.0900000058,-3443.340000000084
33522,2022-11-07 11:30:00,-21.71,337332.0400000057,340797.0900000058,-3465.050000000105
33523,2022-11-07 11:35:00,-1958.79,335373.2500000057,340797.0900000058,-5423.840000000084
33524,2022-11-07 11:40:00,410.14,335783.3900000057,340797.0900000058,-5013.70000000007
33525,2022-11-07 11:45:00,720.35,336503.7400000057,340797.0900000058,-4293.350000000093
33526,2022-11-07 11:50:00,-1187.64,335316.1000000057,340797.0900000058,-5480.990000000107
33527,2022-11-07 11:55:00,-1236.8,334079.3000000057,340797.0900000058,-6717.7900000000955
33528,2022-11-07 12:00:00,-1547.3,332532.0000000057,340797.0900000058,-8265.090000000084
33529,2022-11-07 12:05:00,-172.22,332359.78000000573,340797.0900000058,-8437.310000000056
33530,2022-11-07 12:10:00,-1136.49,331223.29000000574,340797.0900000058,-9573.800000000047
33531,2022-11-07 12:15:00,1898.2,333121.49000000575,340797.0900000058,-7675.600000000035
33532,2022-11-07 12:20:00,825.69,333947.18000000576,340797.0900000058,-6849.910000000033
33533,2022-11-07 12:25:00,-1602.29,332344.8900000058,340797.0900000058,-8452.200000000012
33534,2022-11-07 12:30:00,600.22,332945.11000000575,340797.0900000058,-7851.98000000004
33535,2022-11-07 12:35:00,1423.96,334369.07000000577,340797.0900000058,-6428.020000000019
33536,2022-11-07 12:40:00,750.67,335119.74000000575,340797.0900000058,-5677.350000000035
33537,2022-11-07 12:45:00,983.47,336103.2100000057,340797.0900000058,-4693.880000000063
33538,2022-11-07 12:50:00,-1270.13,334833.0800000057,340797.0900000058,-5964.0100000000675
33539,2022-11-07 12:55:00,-194.07,334639.0100000057,340797.0900000058,-6158.0800000000745
33540,2022-11-07 13:00:00,939.56,335578.5700000057,340797.0900000058,-5218.520000000077
33541,2022-11-07 13:05:00,719.0,336297.5700000057,340797.0900000058,-4499.520000000077
33542,2022-11-07 13:10:00,1524.27,337821.84000000573,340797.0900000058,-2975.250000000058
33543,2022-11-07 13:15:00,-1409.5,336412.34000000573,340797.0900000058,-4384.750000000058
33544,2022-11-07 13:20:00,-1300.82,335111.5200000057,340797.0900000058,-5685.570000000065
33545,2022-11-07 13:25:00,-1686.31,333425.2100000057,340797.0900000058,-7371.880000000063
33546,2022-11-07 13:30:00,-1886.77,331538.4400000057,340797.0900000058,-9258.650000000081
33547,2022-11-07 13:35:00,-1829.98,329708.4600000057,340797.0900000058,-11088.630000000063
33548,2022-11-07 13:40:00,1118.87,330827.3300000057,340797.0900000058,-9969.760000000068
33549,2022-11-07 13:45:00,169.96,330997.29000000574,340797.0900000058,-9799.800000000047
33550,2022-11-07 13:50:00,-1920.63,329076.66000000574,340797.0900000058,-11720.430000000051
33551,2022-11-07 13:55:00,755.55,329832.2100000057,340797.0900000058,-10964.880000000063
33552,2022-11-07 14:00:00,1095.83,330928.04000000574,340797.0900000058,-9869.050000000047
33553,2022-11-07 14:05:00,-1343.36,329584.68000000576,340797.0900000058,-11212.410000000033
33554,2022-11-07 14:10:00,1075.66,330660.34000000573,340797.0900000058,-10136.750000000058
33555,2022-11-07 14:15:00,1052.18,331712.5200000057,340797.0900000058,-9084.570000000065
33556,2022-11-07 14:20:00,68.96,331781.48000000574,340797.0900000058,-9015.610000000044
33557,2022-11-07 14:25:00,1363.23,333144.7100000057,340797.0900000058,-7652.380000000063
33558,2022-11-07 14:30:00,886.59,334031.30000000575,340797.0900000058,-6765.790000000037
33559,2022-11-07 14:35:00,1995.27,336026.57000000577,340797.0900000058,-4770.520000000019
33560,2022-11-07 14:40:00,-1809.49,334217.0800000058,340797.0900000058,-6580.010000000009
33561,2022-11-07 14:45:00,1809.0,336026.0800000058,340797.0900000058,-4771.010000000009
33562,2022-11-07 14:50:00,-826.56,335199.5200000058,340797.0900000058,-5597.570000000007
33563,2022-11-07 14:55:00,577.35,335776.87000000576,340797.0900000058,-5020.22000000003
33564,2022-11-07 15:00:00,1851.42,337628.29000000574,340797.0900000058,-3168.8000000000466
33565,2022-11-07 15:05:00,1280.15,338908.44000000576,340797.0900000058,-1888.6500000000233
33566,2022-11-07 15:10:00,1313.8,340222.24000000575,340797.0900000058,-574.8500000000349
33567,2022-11-07 15:15:00,330.42,340552.66000000574,340797.0900000058,-244.43000000005122
33568,2022-11-07 15:20:00,-421.88,340130.78000000573,340797.0900000058,-666.3100000000559
33569,2022-11-07 15:25:00,-1849.72,338281.06000000576,340797.0900000058,-2516.030000000028
33570,2022-11-07 15:30:00,-338.73,337942.3300000058,340797.0900000058,-2854.7600000000093
33571,2022-11-07 15:35:00,341.44,338283.7700000058,340797.0900000058,-2513.320000000007
33572,2022-11-07 15:40:00,-1049.88,337233.8900000058,340797.0900000058,-3563.2000000000116
33573,2022-11-07 15:45:00,-298.94,336934.9500000058,340797.0900000058,-3862.140000000014
33574,2022-11-07 15:50:00,1750.18,338685.13000000577,340797.0900000058,-2111.960000000021
33575,2022-11-07 15:55:00,448.17,339133.30000000575,340797.0900000058,-1663.7900000000373
33576,2022-11-07 16:00:00,593.58,339726.88000000577,340797.0900000058,-1070.210000000021
33577,2022-11-07 16:05:00,1755.23,341482.11000000575,340797.0900000058,685.0199999999604
33578,2022-11-07 16:10:00,858.89,342341.00000000576,340797.0900000058,1543.9099999999744
33579,2022-11-07 16:15:00,-1795.86,340545.1400000058,340797.0900000058,-251.95000000001164
33580,2022-11-07 16:20:00,-108.6,340436.5400000058,340797.0900000058,-360.54999999998836
33581,2022-11-07 16:25:00,-439.01,339997.5300000058,340797.0900000058,-799.5599999999977
33582,2022-11-07 16:30:00,740.42,340737.9500000058,340797.0900000058,-59.14000000001397
33583,2022-11-07 16:35:00,320.16,341058.11000000575,340797.0900000058,261.0199999999604
33584,2022-11-07 16:40:00,1141.15,342199.2600000058,340797.0900000058,1402.1699999999837
33585,2022-11-07 16:45:00,1404.98,343604.24000000575,340797.0900000058,2807.149999999965
33586,2022-11-07 16:50:00,358.51,343962.75000000576,340797.0900000058,3165.6599999999744
33587,2022-11-07 16:55:00,1353.47,345316.22000000573,340797.0900000058,4519.129999999946
33588,2022-11-08 08:00:00,1335.57,346651.79000000574,345316.22000000573,1335.570000000007
33589,2022-11-08 08:05:00,1992.84,348644.63000000577,345316.22000000573,3328.4100000000326
33590,2022-11-08 08:10:00,-8.64,348635.99000000575,345316.22000000573,3319.7700000000186
33591,2022-11-08 08:15:00,886.73,349522.72000000573,345316.22000000573,4206.5
33592,2022-11-08 08:20:00,-560.84,348961.8800000057,345316.22000000573,3645.6599999999744
33593,2022-11-08 08:25:00,-89.17,348872.7100000057,345316.22000000573,3556.4899999999907
33594,2022-11-08 08:30:00,-1860.5,347012.2100000057,345316.22000000573,1695.9899999999907
33595,2022-11-08 08:35:00,502.53,347514.74000000575,345316.22000000573,2198.5200000000186
33596,2022-11-08 08:40:00,527.62,348042.36000000575,345316.22000000573,2726.140000000014
33597,2022-11-08 08:45:00,972.63,349014.99000000575,345316.22000000573,3698.7700000000186
33598,2022-11-08 08:50:00,1898.75,350913.74000000575,345316.22000000573,5597.520000000019
33599,2022-11-08 08:55:00,1662.58,352576.32000000577,345316.22000000573,7260.100000000035
33600,2022-11-08 09:00:00,-1699.77,350876.55000000575,345316.22000000573,5560.330000000016
33601,2022-11-08 09:05:00,-1661.18,349215.37000000576,345316.22000000573,3899.1500000000233
33602,2022-11-08 09:10:00,-1731.41,347483.9600000058,345316.22000000573,2167.740000000049
33603,2022-11-08 09:15:00,-1333.33,346150.63000000577,345316.22000000573,834.4100000000326
33604,2022-11-08 09:20:00,-1587.49,344563.1400000058,345316.22000000573,-753.0799999999581
33605,2022-11-08 09:25:00,164.67,344727.81000000576,345316.22000000573,-588.4099999999744
33606,2022-11-08 09:30:00,1482.86,346210.67000000575,345316.22000000573,894.4500000000116
33607,2022-11-08 09:35:00,24.11,346234.78000000573,345316.22000000573,918.5599999999977
33608,2022-11-08 09:40:00,1578.92,347813.7000000057,345316.22000000573,2497.4799999999814
33609,2022-11-08 09:45:00,1523.6,349337.3000000057,345316.22000000573,4021.079999999958
33610,2022-11-08 09:50:00,877.94,350215.2400000057,345316.22000000573,4899.01999999996
33611,2022-11-08 09:55:00,-1189.56,349025.6800000057,345316.22000000573,3709.4599999999627
33612,2022-11-08 10:00:00,-1135.24,347890.4400000057,345316.22000000573,2574.219999999972
33613,2022-11-08 10:05:00,1115.7,349006.1400000057,345316.22000000573,3689.9199999999837
33614,2022-11-08 10:10:00,57.26,349063.4000000057,345316.22000000573,3747.179999999993
33615,2022-11-08 10:15:00,1216.61,350280.0100000057,345316.22000000573,4963.789999999979
33616,2022-11-08 10:20:00,-1698.29,348581.72000000573,345316.22000000573,3265.5
33617,2022-11-08 10:25:00,-414.0,348167.72000000573,345316.22000000573,2851.5
33618,2022-11-08 10:30:00,1914.56,350082.28000000573,345316.22000000573,4766.059999999998
33619,2022-11-08 10:35:00,1813.98,351896.2600000057,345316.22000000573,6580.039999999979
33620,2022-11-08 10:40:00,-1455.25,350441.0100000057,345316.22000000573,5124.789999999979
33621,2022-11-08 10:45:00,461.95,350902.9600000057,345316.22000000573,5586.739999999991
33622,2022-11-08 10:50:00,955.77,351858.73000000574,345316.22000000573,6542.510000000009
33623,2022-11-08 10:55:00,-890.78,350967.9500000057,345316.22000000573,5651.729999999981
33624,2022-11-08 11:00:00,782.56,351750.5100000057,345316.22000000573,6434.289999999979
33625,2022-11-08 11:05:00,848.26,352598.7700000057,345316.22000000573,7282.549999999988
33626,2022-11-08 11:10:00,1276.62,353875.3900000057,345316.22000000573,8559.169999999984
33627,2022-11-08 11:15:00,-947.39,352928.0000000057,345316.22000000573,7611.77999999997
33628,2022-11-08 11:20:00,1035.74,353963.7400000057,345316.22000000573,8647.51999999996
33629,2022-11-08 11:25:00,-1128.13,352835.6100000057,345316.22000000573,7519.389999999956
33630,2022-11-08 11:30:00,1892.13,354727.7400000057,345316.22000000573,9411.51999999996
33631,2022-11-08 11:35:00,-532.05,354195.6900000057,345316.22000000573,8879.469999999972
33632,2022-11-08 11:40:00,-1500.0,352695.6900000057,345316.22000000573,7379.469999999972
33633,2022-11-08 11:45:00,-384.67,352311.0200000057,345316.22000000573,6994.799999999988
33634,2022-11-08 11:50:00,1474.71,353785.73000000574,345316.22000000573,8469.51000000001
33635,2022-11-08 11:55:00,-1152.01,352633.72000000573,345316.22000000573,7317.5
33636,2022-11-08 12:00:00,-1519.15,351114.5700000057,345316.22000000573,5798.349999999977
33637,2022-11-08 12:05:00,-1851.02,349263.5500000057,345316.22000000573,3947.329999999958
33638,2022-11-08 12:10:00,-1789.02,347474.5300000057,345316.22000000573,2158.3099999999395
33639,2022-11-08 12:15:00,760.54,348235.07000000565,345316.22000000573,2918.8499999999185
33640,2022-11-08 12:20:00,1599.38,349834.45000000566,345316.22000000573,4518.229999999923
33641,2022-11-08 12:25:00,732.69,350567.14000000566,345316.22000000573,5250.9199999999255
33642,2022-11-08 12:30:00,-71.56,350495.58000000566,345316.22000000573,5179.359999999928
33643,2022-11-08 12:35:00,1050.59,351546.1700000057,345316.22000000573,6229.949999999953
33644,2022-11-08 12:40:00,1281.17,352827.3400000057,345316.22000000573,7511.119999999937
33645,2022-11-08 12:45:00,1010.01,353837.3500000057,345316.22000000573,8521.129999999946
33646,2022-11-08 12:50:00,712.13,354549.4800000057,345316.22000000573,9233.259999999951
33647,2022-11-08 12:55:00,1244.34,355793.8200000057,345316.22000000573,10477.599999999977
33648,2022-11-08 13:00:00,939.94,356733.7600000057,345316.22000000573,11417.539999999979
33649,2022-11-08 13:05:00,-836.53,355897.2300000057,345316.22000000573,10581.009999999951
33650,2022-11-08 13:10:00,1158.35,357055.58000000566,345316.22000000573,11739.359999999928
33651,2022-11-08 13:15:00,-27.32,357028.26000000566,345316.22000000573,11712.03999999992
33652,2022-11-08 13:20:00,937.16,357965.42000000563,345316.22000000573,12649.199999999895
33653,2022-11-08 13:25:00,-1322.59,356642.8300000056,345316.22000000573,11326.60999999987
33654,2022-11-08 13:30:00,-1968.98,354673.8500000056,345316.22000000573,9357.629999999888
33655,2022-11-08 13:35:00,-991.28,353682.5700000056,345316.22000000573,8366.34999999986
33656,2022-11-08 13:40:00,-1866.23,351816.3400000056,345316.22000000573,6500.119999999879
33657,2022-11-08 13:45:00,1017.72,352834.0600000056,345316.22000000573,7517.839999999851
33658,2022-11-08 13:50:00,1136.16,353970.22000000556,345316.22000000573,8653.999999999825
33659,2022-11-08 13:55:00,-555.25,353414.97000000556,345316.22000000573,8098.749999999825
33660,2022-11-08 14:00:00,-1890.93,351524.04000000557,345316.22000000573,6207.819999999832
33661,2022-11-08 14:05:00,-1070.3,350453.7400000056,345316.22000000573,5137.519999999844
33662,2022-11-08 14:10:00,-980.7,349473.04000000557,345316.22000000573,4156.819999999832
33663,2022-11-08 14:15:00,1584.58,351057.6200000056,345316.22000000573,5741.399999999849
33664,2022-11-08 14:20:00,754.13,351811.7500000056,345316.22000000573,6495.529999999853
33665,2022-11-08 14:25:00,1021.77,352833.5200000056,345316.22000000573,7517.299999999872
33666,2022-11-08 14:30:00,-1223.03,351610.4900000056,345316.22000000573,6294.269999999844
33667,2022-11-08 14:35:00,661.84,352272.3300000056,345316.22000000573,6956.10999999987
33668,2022-11-08 14:40:00,913.16,353185.4900000056,345316.22000000573,7869.269999999844
33669,2022-11-08 14:45:00,-1137.64,352047.85000000556,345316.22000000573,6731.62999999983
33670,2022-11-08 14:50:00,-1596.05,350451.8000000056,345316.22000000573,5135.579999999842
33671,2022-11-08 14:55:00,-1062.61,349389.1900000056,345316.22000000573,4072.9699999998556
33672,2022-11-08 15:00:00,-895.26,348493.9300000056,345316.22000000573,3177.7099999998463
33673,2022-11-08 15:05:00,1532.75,350026.6800000056,345316.22000000573,4710.459999999846
33674,2022-11-08 15:10:00,-86.12,349940.5600000056,345316.22000000573,4624.339999999851
33675,2022-11-08 15:15:00,-1942.21,347998.35000000556,345316.22000000573,2682.12999999983
33676,2022-11-08 15:20:00,-603.39,347394.96000000555,345316.22000000573,2078.739999999816
33677,2022-11-08 15:25:00,881.33,348276.29000000557,345316.22000000573,2960.0699999998324
33678,2022-11-08 15:30:00,95.67,348371.96000000555,345316.22000000573,3055.739999999816
33679,2022-11-08 15:35:00,-1655.12,346716.84000000556,345316.22000000573,1400.6199999998207
33680,2022-11-08 15:40:00,494.72,347211.5600000055,345316.22000000573,1895.3399999997928
33681,2022-11-08 15:45:00,-641.02,346570.5400000055,345316.22000000573,1254.3199999997742
33682,2022-11-08 15:50:00,-148.22,346422.32000000554,345316.22000000573,1106.099999999802
33683,2022-11-08 15:55:00,1616.65,348038.97000000556,345316.22000000573,2722.7499999998254
33684,2022-11-08 16:00:00,-1345.24,346693.73000000557,345316.22000000573,1377.5099999998347
33685,2022-11-08 16:05:00,-1015.98,345677.7500000056,345316.22000000573,361.5299999998533
33686,2022-11-08 16:10:00,1041.66,346719.41000000556,345316.22000000573,1403.1899999998277
33687,2022-11-08 16:15:00,1381.08,348100.4900000056,345316.22000000573,2784.269999999844
33688,2022-11-08 16:20:00,-1306.48,346794.0100000056,345316.22000000573,1477.7899999998626
33689,2022-11-08 16:25:00,-1639.76,345154.2500000056,345316.22000000573,-161.97000000014668
33690,2022-11-08 16:30:00,-1459.69,343694.5600000056,345316.22000000573,-1621.660000000149
33691,2022-11-08 16:35:00,-38.77,343655.79000000557,345316.22000000573,-1660.4300000001676
33692,2022-11-08 16:40:00,1475.85,345131.64000000554,345316.22000000573,-184.58000000019092
33693,2022-11-08 16:45:00,1659.59,346791.23000000557,345316.22000000573,1475.0099999998347
33694,2022-11-08 16:50:00,241.59,347032.8200000056,345316.22000000573,1716.5999999998603
33695,2022-11-08 16:55:00,-1592.89,345439.9300000056,345316.22000000573,123.70999999984633
33696,2022-11-09 08:00:00,374.08,345814.0100000056,345439.9300000056,374.0800000000163
33697,2022-11-09 08:05:00,-1235.08,344578.9300000056,345439.9300000056,-861.0
33698,2022-11-09 08:10:00,1679.79,346258.72000000556,345439.9300000056,818.789999999979
33699,2022-11-09 08:15:00,-1118.46,345140.26000000554,345439.9300000056,-299.6700000000419
33700,2022-11-09 08:20:00,-1662.5,343477.76000000554,345439.9300000056,-1962.170000000042
33701,2022-11-09 08:25:00,74.99,343552.75000000553,345439.9300000056,-1887.1800000000512
33702,2022-11-09 08:30:00,1108.04,344660.7900000055,345439.9300000056,-779.1400000000722
33703,2022-11-09 08:35:00,-1439.92,343220.8700000055,345439.9300000056,-2219.060000000056
33704,2022-11-09 08:40:00,1603.25,344824.1200000055,345439.9300000056,-615.8100000000559
33705,2022-11-09 08:45:00,453.43,345277.5500000055,345439.9300000056,-162.38000000006286
33706,2022-11-09 08:50:00,-142.2,345135.3500000055,345439.9300000056,-304.5800000000745
33707,2022-11-09 08:55:00,-403.6,344731.75000000553,345439.9300000056,-708.1800000000512
33708,2022-11-09 09:00:00,1011.19,345742.94000000553,345439.9300000056,303.0099999999511
33709,2022-11-09 09:05:00,-1394.91,344348.03000000556,345439.9300000056,-1091.9000000000233
33710,2022-11-09 09:10:00,133.76,344481.79000000557,345439.9300000056,-958.140000000014
33711,2022-11-09 09:15:00,806.27,345288.0600000056,345439.9300000056,-151.86999999999534
33712,2022-11-09 09:20:00,-601.5,344686.5600000056,345439.9300000056,-753.3699999999953
33713,2022-11-09 09:25:00,1784.53,346471.0900000056,345439.9300000056,1031.1600000000326
33714,2022-11-09 09:30:00,1068.79,347539.8800000056,345439.9300000056,2099.9500000000116
33715,2022-11-09 09:35:00,1074.61,348614.4900000056,345439.9300000056,3174.5599999999977
33716,2022-11-09 09:40:00,775.97,349390.46000000555,345439.9300000056,3950.5299999999697
33717,2022-11-09 09:45:00,-247.26,349143.20000000554,345439.9300000056,3703.2699999999604
33718,2022-11-09 09:50:00,619.35,349762.5500000055,345439.9300000056,4322.619999999937
33719,2022-11-09 09:55:00,-1767.01,347995.5400000055,345439.9300000056,2555.609999999928
33720,2022-11-09 10:00:00,-1529.41,346466.13000000553,345439.9300000056,1026.1999999999534
33721,2022-11-09 10:05:00,391.48,346857.6100000055,345439.9300000056,1417.6799999999348
33722,2022-11-09 10:10:00,-1089.79,345767.82000000554,345439.9300000056,327.88999999995576
33723,2022-11-09 10:15:00,71.97,345839.7900000055,345439.9300000056,399.8599999999278
33724,2022-11-09 10:20:00,-1101.27,344738.5200000055,345439.9300000056,-701.4100000000908
33725,2022-11-09 10:25:00,-935.47,343803.0500000055,345439.9300000056,-1636.8800000000629
33726,2022-11-09 10:30:00,-1905.95,341897.1000000055,345439.9300000056,-3542.8300000000745
33727,2022-11-09 10:35:00,1171.55,343068.6500000055,345439.9300000056,-2371.280000000086
33728,2022-11-09 10:40:00,431.28,343499.9300000055,345439.9300000056,-1940.0000000000582
33729,2022-11-09 10:45:00,-108.36,343391.57000000554,345439.9300000056,-2048.3600000000442
33730,2022-11-09 10:50:00,1331.91,344723.4800000055,345439.9300000056,-716.4500000000698
33731,2022-11-09 10:55:00,341.3,345064.7800000055,345439.9300000056,-375.1500000000815
33732,2022-11-09 11:00:00,-1366.6,343698.1800000055,345439.9300000056,-1741.7500000000582
33733,2022-11-09 11:05:00,-1736.55,341961.63000000553,345439.9300000056,-3478.3000000000466
33734,2022-11-09 11:10:00,-155.48,341806.15000000555,345439.9300000056,-3633.780000000028
33735,2022-11-09 11:15:00,437.27,342243.4200000056,345439.9300000056,-3196.5100000000093
33736,2022-11-09 11:20:00,-301.53,341941.89000000554,345439.9300000056,-3498.0400000000373
33737,2022-11-09 11:25:00,-67.17,341874.72000000556,345439.9300000056,-3565.210000000021
33738,2022-11-09 11:30:00,389.12,342263.84000000556,345439.9300000056,-3176.0900000000256
33739,2022-11-09 11:35:00,-683.66,341580.1800000056,345439.9300000056,-3859.75
33740,2022-11-09 11:40:00,-1235.44,340344.7400000056,345439.9300000056,-5095.190000000002
33741,2022-11-09 11:45:00,-364.54,339980.2000000056,345439.9300000056,-5459.729999999981
33742,2022-11-09 11:50:00,-768.55,339211.6500000056,345439.9300000056,-6228.27999999997
33743,2022-11-09 11:55:00,1441.0,340652.6500000056,345439.9300000056,-4787.27999999997
33744,2022-11-09 12:00:00,1573.14,342225.7900000056,345439.9300000056,-3214.1399999999558
33745,2022-11-09 12:05:00,441.69,342667.4800000056,345439.9300000056,-2772.4499999999534
33746,2022-11-09 12:10:00,-1967.96,340699.5200000056,345439.9300000056,-4740.409999999974
33747,2022-11-09 12:15:00,851.53,341551.05000000563,345439.9300000056,-3888.8799999999464
33748,2022-11-09 12:20:00,-700.14,340850.9100000056,345439.9300000056,-4589.01999999996
33749,2022-11-09 12:25:00,1665.64,342516.55000000563,345439.9300000056,-2923.3799999999464
33750,2022-11-09 12:30:00,1244.08,343760.63000000565,345439.9300000056,-1679.2999999999302
33751,2022-11-09 12:35:00,-71.41,343689.2200000057,345439.9300000056,-1750.7099999999045
33752,2022-11-09 12:40:00,-1023.19,342666.0300000057,345439.9300000056,-2773.899999999907
33753,2022-11-09 12:45:00,-687.52,341978.51000000566,345439.9300000056,-3461.4199999999255
33754,2022-11-09 12:50:00,1977.46,343955.9700000057,345439.9300000056,-1483.9599999999045
33755,2022-11-09 12:55:00,1200.3,345156.27000000566,345439.9300000056,-283.6599999999162
33756,2022-11-09 13:00:00,-417.59,344738.68000000564,345439.9300000056,-701.2499999999418
33757,2022-11-09 13:05:00,1134.83,345873.51000000566,345439.9300000056,433.5800000000745
33758,2022-11-09 13:10:00,556.4,346429.9100000057,345439.9300000056,989.9800000000978
33759,2022-11-09 13:15:00,-879.96,345549.95000000566,345439.9300000056,110.02000000007683
33760,2022-11-09 13:20:00,1365.47,346915.42000000563,345439.9300000056,1475.490000000049
33761,2022-11-09 13:25:00,373.64,347289.06000000564,345439.9300000056,1849.1300000000629
33762,2022-11-09 13:30:00,-1358.05,345931.01000000566,345439.9300000056,491.0800000000745
33763,2022-11-09 13:35:00,-93.52,345837.49000000564,345439.9300000056,397.5600000000559
33764,2022-11-09 13:40:00,-691.4,345146.0900000056,345439.9300000056,-293.8399999999674
33765,2022-11-09 13:45:00,1946.8,347092.8900000056,345439.9300000056,1652.960000000021
33766,2022-11-09 13:50:00,-1595.09,345497.8000000056,345439.9300000056,57.86999999999534
33767,2022-11-09 13:55:00,777.78,346275.5800000056,345439.9300000056,835.6500000000233
33768,2022-11-09 14:00:00,-241.62,346033.9600000056,345439.9300000056,594.0300000000279
33769,2022-11-09 14:05:00,573.82,346607.7800000056,345439.9300000056,1167.850000000035
33770,2022-11-09 14:10:00,-1786.1,344821.68000000564,345439.9300000056,-618.2499999999418
33771,2022-11-09 14:15:00,216.14,345037.82000000565,345439.9300000056,-402.1099999999278
33772,2022-11-09 14:20:00,-1412.33,343625.49000000564,345439.9300000056,-1814.4399999999441
33773,2022-11-09 14:25:00,-1590.99,342034.50000000565,345439.9300000056,-3405.429999999935
33774,2022-11-09 14:30:00,-566.01,341468.49000000564,345439.9300000056,-3971.439999999944
33775,2022-11-09 14:35:00,-1683.78,339784.7100000056,345439.9300000056,-5655.219999999972
33776,2022-11-09 14:40:00,-150.82,339633.8900000056,345439.9300000056,-5806.039999999979
33777,2022-11-09 14:45:00,-1094.51,338539.3800000056,345439.9300000056,-6900.549999999988
33778,2022-11-09 14:50:00,-568.12,337971.2600000056,345439.9300000056,-7468.669999999984
33779,2022-11-09 14:55:00,-1301.38,336669.8800000056,345439.9300000056,-8770.049999999988
33780,2022-11-09 15:00:00,-1212.13,335457.7500000056,345439.9300000056,-9982.179999999993
33781,2022-11-09 15:05:00,166.48,335624.23000000557,345439.9300000056,-9815.700000000012
33782,2022-11-09 15:10:00,933.58,336557.8100000056,345439.9300000056,-8882.119999999995
33783,2022-11-09 15:15:00,-90.81,336467.0000000056,345439.9300000056,-8972.929999999993
33784,2022-11-09 15:20:00,551.76,337018.7600000056,345439.9300000056,-8421.169999999984
33785,2022-11-09 15:25:00,-1709.7,335309.0600000056,345439.9300000056,-10130.869999999995
33786,2022-11-09 15:30:00,-925.61,334383.4500000056,345439.9300000056,-11056.479999999981
33787,2022-11-09 15:35:00,-1116.94,333266.5100000056,345439.9300000056,-12173.419999999984
33788,2022-11-09 15:40:00,1729.38,334995.8900000056,345439.9300000056,-10444.039999999979
33789,2022-11-09 15:45:00,1976.22,336972.1100000056,345439.9300000056,-8467.820000000007
33790,2022-11-09 15:50:00,1211.41,338183.52000000555,345439.9300000056,-7256.410000000033
33791,2022-11-09 15:55:00,-357.64,337825.88000000553,345439.9300000056,-7614.050000000047
33792,2022-11-09 16:00:00,204.05,338029.9300000055,345439.9300000056,-7410.000000000058
33793,2022-11-09 16:05:00,-1542.95,336486.9800000055,345439.9300000056,-8952.95000000007
33794,2022-11-09 16:10:00,-669.4,335817.5800000055,345439.9300000056,-9622.350000000093
33795,2022-11-09 16:15:00,-1192.23,334625.3500000055,345439.9300000056,-10814.580000000075
33796,2022-11-09 16:20:00,-871.38,333753.9700000055,345439.9300000056,-11685.96000000008
33797,2022-11-09 16:25:00,643.75,334397.7200000055,345439.9300000056,-11042.21000000008
33798,2022-11-09 16:30:00,-1534.33,332863.3900000055,345439.9300000056,-12576.540000000095
33799,2022-11-09 16:35:00,1796.56,334659.9500000055,345439.9300000056,-10779.980000000098
33800,2022-11-09 16:40:00,1755.48,336415.43000000546,345439.9300000056,-9024.500000000116
33801,2022-11-09 16:45:00,-770.92,335644.5100000055,345439.9300000056,-9795.4200000001
33802,2022-11-09 16:50:00,824.61,336469.12000000547,345439.9300000056,-8970.810000000114
33803,2022-11-09 16:55:00,-1036.75,335432.37000000547,345439.9300000056,-10007.560000000114
33804,2022-11-10 08:00:00,1176.47,336608.84000000544,335432.37000000547,1176.469999999972
33805,2022-11-10 08:05:00,-1926.04,334682.80000000546,335432.37000000547,-749.570000000007
33806,2022-11-10 08:10:00,1181.15,335863.9500000055,335432.37000000547,431.5800000000163
33807,2022-11-10 08:15:00,1080.53,336944.4800000055,335432.37000000547,1512.1100000000442
33808,2022-11-10 08:20:00,88.05,337032.5300000055,335432.37000000547,1600.1600000000326
33809,2022-11-10 08:25:00,-601.36,336431.1700000055,335432.37000000547,998.8000000000466
33810,2022-11-10 08:30:00,-1593.44,334837.7300000055,335432.37000000547,-594.6399999999558
33811,2022-11-10 08:35:00,-538.35,334299.38000000553,335432.37000000547,-1132.9899999999325
33812,2022-11-10 08:40:00,1908.72,336208.1000000055,335432.37000000547,775.7300000000396
33813,2022-11-10 08:45:00,-640.14,335567.9600000055,335432.37000000547,135.5900000000256
33814,2022-11-10 08:50:00,1234.55,336802.5100000055,335432.37000000547,1370.140000000014
33815,2022-11-10 08:55:00,-621.03,336181.48000000545,335432.37000000547,749.109999999986
33816,2022-11-10 09:00:00,-229.75,335951.73000000545,335432.37000000547,519.359999999986
33817,2022-11-10 09:05:00,-1151.3,334800.43000000546,335432.37000000547,-631.9400000000023
33818,2022-11-10 09:10:00,-309.37,334491.06000000547,335432.37000000547,-941.3099999999977
33819,2022-11-10 09:15:00,-132.99,334358.0700000055,335432.37000000547,-1074.2999999999884
33820,2022-11-10 09:20:00,-827.4,333530.67000000546,335432.37000000547,-1901.7000000000116
33821,2022-11-10 09:25:00,1794.14,335324.81000000547,335432.37000000547,-107.55999999999767
33822,2022-11-10 09:30:00,1286.17,336610.98000000545,335432.37000000547,1178.609999999986
33823,2022-11-10 09:35:00,825.78,337436.7600000055,335432.37000000547,2004.390000000014
33824,2022-11-10 09:40:00,-1527.97,335908.7900000055,335432.37000000547,476.4200000000419
33825,2022-11-10 09:45:00,-121.62,335787.1700000055,335432.37000000547,354.80000000004657
33826,2022-11-10 09:50:00,1335.46,337122.63000000553,335432.37000000547,1690.2600000000675
33827,2022-11-10 09:55:00,-1640.72,335481.91000000556,335432.37000000547,49.54000000009546
33828,2022-11-10 10:00:00,-162.47,335319.4400000056,335432.37000000547,-112.9299999998766
33829,2022-11-10 10:05:00,847.72,336167.16000000556,335432.37000000547,734.7900000000955
33830,2022-11-10 10:10:00,233.81,336400.97000000556,335432.37000000547,968.6000000000931
33831,2022-11-10 10:15:00,1900.02,338300.9900000056,335432.37000000547,2868.6200000001118
33832,2022-11-10 10:20:00,-965.92,337335.0700000056,335432.37000000547,1902.700000000128
33833,2022-11-10 10:25:00,459.49,337794.5600000056,335432.37000000547,2362.1900000001187
33834,2022-11-10 10:30:00,1852.33,339646.8900000056,335432.37000000547,4214.520000000135
33835,2022-11-10 10:35:00,-740.16,338906.7300000056,335432.37000000547,3474.3600000001607
33836,2022-11-10 10:40:00,844.1,339750.8300000056,335432.37000000547,4318.460000000137
33837,2022-11-10 10:45:00,-1130.45,338620.3800000056,335432.37000000547,3188.0100000001257
33838,2022-11-10 10:50:00,1016.44,339636.8200000056,335432.37000000547,4204.450000000128
33839,2022-11-10 10:55:00,-595.86,339040.9600000056,335432.37000000547,3608.590000000142
33840,2022-11-10 11:00:00,558.55,339599.5100000056,335432.37000000547,4167.14000000013
33841,2022-11-10 11:05:00,660.86,340260.3700000056,335432.37000000547,4828.000000000116
33842,2022-11-10 11:10:00,1889.73,342150.10000000556,335432.37000000547,6717.730000000098
33843,2022-11-10 11:15:00,-800.35,341349.7500000056,335432.37000000547,5917.380000000121
33844,2022-11-10 11:20:00,160.48,341510.23000000557,335432.37000000547,6077.860000000102
33845,2022-11-10 11:25:00,1674.7,343184.9300000056,335432.37000000547,7752.560000000114
33846,2022-11-10 11:30:00,-1228.29,341956.6400000056,335432.37000000547,6524.270000000135
33847,2022-11-10 11:35:00,1161.44,343118.0800000056,335432.37000000547,7685.710000000137
33848,2022-11-10 11:40:00,324.06,343442.1400000056,335432.37000000547,8009.770000000135
33849,2022-11-10 11:45:00,1344.56,344786.7000000056,335432.37000000547,9354.330000000133
33850,2022-11-10 11:50:00,1134.8,345921.5000000056,335432.37000000547,10489.130000000121
33851,2022-11-10 11:55:00,401.57,346323.0700000056,335432.37000000547,10890.700000000128
33852,2022-11-10 12:00:00,-12.63,346310.4400000056,335432.37000000547,10878.070000000123
33853,2022-11-10 12:05:00,1236.74,347547.1800000056,335432.37000000547,12114.810000000114
33854,2022-11-10 12:10:00,324.44,347871.6200000056,335432.37000000547,12439.250000000116
33855,2022-11-10 12:15:00,-1773.63,346097.9900000056,335432.37000000547,10665.620000000112
33856,2022-11-10 12:20:00,-324.23,345773.7600000056,335432.37000000547,10341.39000000013
33857,2022-11-10 12:25:00,-1717.65,344056.1100000056,335432.37000000547,8623.740000000107
33858,2022-11-10 12:30:00,789.9,344846.0100000056,335432.37000000547,9413.64000000013
33859,2022-11-10 12:35:00,1993.66,346839.6700000056,335432.37000000547,11407.300000000105
33860,2022-11-10 12:40:00,-1414.62,345425.0500000056,335432.37000000547,9992.68000000011
33861,2022-11-10 12:45:00,724.84,346149.8900000056,335432.37000000547,10717.520000000135
33862,2022-11-10 12:50:00,-1399.99,344749.9000000056,335432.37000000547,9317.530000000144
33863,2022-11-10 12:55:00,-359.88,344390.0200000056,335432.37000000547,8957.65000000014
33864,2022-11-10 13:00:00,680.67,345070.6900000056,335432.37000000547,9638.320000000123
33865,2022-11-10 13:05:00,138.68,345209.3700000056,335432.37000000547,9777.000000000116
33866,2022-11-10 13:10:00,753.72,345963.09000000556,335432.37000000547,10530.720000000088
33867,2022-11-10 13:15:00,-1158.62,344804.47000000556,335432.37000000547,9372.100000000093
33868,2022-11-10 13:20:00,-702.9,344101.57000000554,335432.37000000547,8669.20000000007
33869,2022-11-10 13:25:00,-1577.29,342524.28000000556,335432.37000000547,7091.910000000091
33870,2022-11-10 13:30:00,134.34,342658.6200000056,335432.37000000547,7226.250000000116
33871,2022-11-10 13:35:00,-496.16,342162.4600000056,335432.37000000547,6730.090000000142
33872,2022-11-10 13:40:00,-328.95,341833.5100000056,335432.37000000547,6401.14000000013
33873,2022-11-10 13:45:00,376.46,342209.9700000056,335432.37000000547,6777.600000000151
33874,2022-11-10 13:50:00,-589.02,341620.9500000056,335432.37000000547,6188.580000000133
33875,2022-11-10 13:55:00,-1893.17,339727.7800000056,335432.37000000547,4295.410000000149
33876,2022-11-10 14:00:00,-1268.8,338458.9800000056,335432.37000000547,3026.6100000001607
33877,2022-11-10 14:05:00,-1081.31,337377.67000000563,335432.37000000547,1945.300000000163
33878,2022-11-10 14:10:00,354.37,337732.0400000056,335432.37000000547,2299.6700000001583
33879,2022-11-10 14:15:00,1798.09,339530.13000000565,335432.37000000547,4097.760000000184
33880,2022-11-10 14:20:00,-715.04,338815.0900000057,335432.37000000547,3382.720000000205
33881,2022-11-10 14:25:00,-78.72,338736.3700000057,335432.37000000547,3304.000000000233
33882,2022-11-10 14:30:00,-164.35,338572.0200000057,335432.37000000547,3139.650000000256
33883,2022-11-10 14:35:00,896.67,339468.6900000057,335432.37000000547,4036.32000000024
33884,2022-11-10 14:40:00,1938.92,341407.6100000057,335432.37000000547,5975.2400000002235
33885,2022-11-10 14:45:00,498.12,341905.7300000057,335432.37000000547,6473.360000000219
33886,2022-11-10 14:50:00,-1416.88,340488.8500000057,335432.37000000547,5056.480000000214
33887,2022-11-10 14:55:00,1038.2,341527.0500000057,335432.37000000547,6094.680000000226
33888,2022-11-10 15:00:00,699.73,342226.7800000057,335432.37000000547,6794.410000000207
33889,2022-11-10 15:05:00,1038.72,343265.50000000565,335432.37000000547,7833.130000000179
33890,2022-11-10 15:10:00,-106.34,343159.1600000056,335432.37000000547,7726.790000000154
33891,2022-11-10 15:15:00,-461.04,342698.12000000564,335432.37000000547,7265.750000000175
33892,2022-11-10 15:20:00,1771.66,344469.7800000056,335432.37000000547,9037.410000000149
33893,2022-11-10 15:25:00,-169.71,344300.0700000056,335432.37000000547,8867.700000000128
33894,2022-11-10 15:30:00,-732.19,343567.8800000056,335432.37000000547,8135.510000000126
33895,2022-11-10 15:35:00,-287.43,343280.4500000056,335432.37000000547,7848.080000000133
33896,2022-11-10 15:40:00,-1444.58,341835.8700000056,335432.37000000547,6403.500000000116
33897,2022-11-10 15:45:00,-1907.53,339928.34000000556,335432.37000000547,4495.9700000000885
33898,2022-11-10 15:50:00,164.23,340092.57000000554,335432.37000000547,4660.20000000007
33899,2022-11-10 15:55:00,1112.7,341205.27000000555,335432.37000000547,5772.9000000000815
33900,2022-11-10 16:00:00,-1881.18,339324.09000000556,335432.37000000547,3891.7200000000885
33901,2022-11-10 16:05:00,1040.25,340364.34000000556,335432.37000000547,4931.9700000000885
33902,2022-11-10 16:10:00,1474.81,341839.15000000555,335432.37000000547,6406.780000000086
33903,2022-11-10 16:15:00,-1788.79,340050.3600000056,335432.37000000547,4617.990000000107
33904,2022-11-10 16:20:00,1719.59,341769.9500000056,335432.37000000547,6337.580000000133
33905,2022-11-10 16:25:00,-1897.99,339871.9600000056,335432.37000000547,4439.590000000142
33906,2022-11-10 16:30:00,-553.57,339318.3900000056,335432.37000000547,3886.020000000135
33907,2022-11-10 16:35:00,-448.48,338869.9100000056,335432.37000000547,3437.5400000001537
33908,2022-11-10 16:40:00,33.67,338903.5800000056,335432.37000000547,3471.2100000001374
33909,2022-11-10 16:45:00,-402.22,338501.36000000563,335432.37000000547,3068.9900000001653
33910,2022-11-10 16:50:00,-1748.8,336752.56000000564,335432.37000000547,1320.190000000177
33911,2022-11-10 16:55:00,-1923.03,334829.5300000056,335432.37000000547,-602.839999999851
33912,2022-11-11 08:00:00,1655.09,336484.62000000564,334829.5300000056,1655.0900000000256
33913,2022-11-11 08:05:00,-1915.59,334569.0300000056,334829.5300000056,-260.5
33914,2022-11-11 08:10:00,-539.03,334030.0000000056,334829.5300000056,-799.5300000000279
33915,2022-11-11 08:15:00,711.49,334741.4900000056,334829.5300000056,-88.04000000003725
33916,2022-11-11 08:20:00,506.54,335248.03000000556,334829.5300000056,418.4999999999418
33917,2022-11-11 08:25:00,1855.21,337103.2400000056,334829.5300000056,2273.7099999999627
33918,2022-11-11 08:30:00,-1881.88,335221.3600000056,334829.5300000056,391.8299999999581
33919,2022-11-11 08:35:00,1345.69,336567.0500000056,334829.5300000056,1737.5199999999604
33920,2022-11-11 08:40:00,570.48,337137.53000000556,334829.5300000056,2307.999999999942
33921,2022-11-11 08:45:00,-1386.54,335750.9900000056,334829.5300000056,921.4599999999627
33922,2022-11-11 08:50:00,-836.15,334914.84000000556,334829.5300000056,85.30999999993946
33923,2022-11-11 08:55:00,737.89,335652.73000000557,334829.5300000056,823.1999999999534
33924,2022-11-11 09:00:00,-681.51,334971.22000000556,334829.5300000056,141.68999999994412
33925,2022-11-11 09:05:00,1670.23,336641.45000000554,334829.5300000056,1811.9199999999255
33926,2022-11-11 09:10:00,-758.25,335883.20000000554,334829.5300000056,1053.6699999999255
33927,2022-11-11 09:15:00,-1699.56,334183.64000000554,334829.5300000056,-645.8900000000722
33928,2022-11-11 09:20:00,1103.52,335287.16000000556,334829.5300000056,457.62999999994645
33929,2022-11-11 09:25:00,509.74,335796.90000000555,334829.5300000056,967.3699999999371
33930,2022-11-11 09:30:00,-1817.59,333979.3100000055,334829.5300000056,-850.2200000000885
33931,2022-11-11 09:35:00,1484.67,335463.9800000055,334829.5300000056,634.4499999998952
33932,2022-11-11 09:40:00,-716.43,334747.5500000055,334829.5300000056,-81.98000000009779
33933,2022-11-11 09:45:00,-791.49,333956.0600000055,334829.5300000056,-873.4700000000885
33934,2022-11-11 09:50:00,-1984.09,331971.9700000055,334829.5300000056,-2857.560000000114
33935,2022-11-11 09:55:00,-420.36,331551.6100000055,334829.5300000056,-3277.9200000001
33936,2022-11-11 10:00:00,1255.52,332807.13000000553,334829.5300000056,-2022.4000000000815
33937,2022-11-11 10:05:00,-1295.16,331511.97000000556,334829.5300000056,-3317.560000000056
33938,2022-11-11 10:10:00,-1429.31,330082.66000000556,334829.5300000056,-4746.870000000054
33939,2022-11-11 10:15:00,982.09,331064.7500000056,334829.5300000056,-3764.780000000028
33940,2022-11-11 10:20:00,1762.45,332827.2000000056,334829.5300000056,-2002.3300000000163
33941,2022-11-11 10:25:00,-1816.95,331010.2500000056,334829.5300000056,-3819.280000000028
33942,2022-11-11 10:30:00,-1132.41,329877.8400000056,334829.5300000056,-4951.690000000002
33943,2022-11-11 10:35:00,771.21,330649.05000000563,334829.5300000056,-4180.479999999981
33944,2022-11-11 10:40:00,1208.58,331857.63000000565,334829.5300000056,-2971.899999999965
33945,2022-11-11 10:45:00,845.24,332702.87000000564,334829.5300000056,-2126.6599999999744
33946,2022-11-11 10:50:00,1392.25,334095.12000000564,334829.5300000056,-734.4099999999744
33947,2022-11-11 10:55:00,1769.79,335864.9100000056,334829.5300000056,1035.3800000000047
33948,2022-11-11 11:00:00,-949.32,334915.5900000056,334829.5300000056,86.05999999999767
33949,2022-11-11 11:05:00,-214.63,334700.9600000056,334829.5300000056,-128.57000000000698
33950,2022-11-11 11:10:00,1153.67,335854.6300000056,334829.5300000056,1025.0999999999767
33951,2022-11-11 11:15:00,-1343.94,334510.6900000056,334829.5300000056,-318.8400000000256
33952,2022-11-11 11:20:00,1561.39,336072.0800000056,334829.5300000056,1242.5499999999884
33953,2022-11-11 11:25:00,1539.92,337612.0000000056,334829.5300000056,2782.469999999972
33954,2022-11-11 11:30:00,1962.33,339574.3300000056,334829.5300000056,4744.799999999988
33955,2022-11-11 11:35:00,-231.92,339342.4100000056,334829.5300000056,4512.880000000005
33956,2022-11-11 11:40:00,650.25,339992.6600000056,334829.5300000056,5163.130000000005
33957,2022-11-11 11:45:00,-916.48,339076.18000000564,334829.5300000056,4246.650000000023
33958,2022-11-11 11:50:00,546.26,339622.44000000565,334829.5300000056,4792.910000000033
33959,2022-11-11 11:55:00,-1066.59,338555.8500000056,334829.5300000056,3726.320000000007
33960,2022-11-11 12:00:00,-1944.29,336611.56000000564,334829.5300000056,1782.030000000028
33961,2022-11-11 12:05:00,-798.58,335812.9800000056,334829.5300000056,983.4500000000116
33962,2022-11-11 12:10:00,-1430.75,334382.2300000056,334829.5300000056,-447.29999999998836
33963,2022-11-11 12:15:00,934.62,335316.8500000056,334829.5300000056,487.320000000007
33964,2022-11-11 12:20:00,-631.42,334685.43000000564,334829.5300000056,-144.09999999997672
33965,2022-11-11 12:25:00,-1725.96,332959.4700000056,334829.5300000056,-1870.0599999999977
33966,2022-11-11 12:30:00,258.6,333218.0700000056,334829.5300000056,-1611.460000000021
33967,2022-11-11 12:35:00,1575.49,334793.5600000056,334829.5300000056,-35.97000000003027
33968,2022-11-11 12:40:00,-493.62,334299.9400000056,334829.5300000056,-529.5900000000256
33969,2022-11-11 12:45:00,-824.27,333475.6700000056,334829.5300000056,-1353.8600000000442
33970,2022-11-11 12:50:00,1368.46,334844.1300000056,334829.5300000056,14.599999999976717
33971,2022-11-11 12:55:00,466.9,335311.0300000056,334829.5300000056,481.5
33972,2022-11-11 13:00:00,1810.53,337121.56000000564,334829.5300000056,2292.030000000028
33973,2022-11-11 13:05:00,-1461.79,335659.77000000566,334829.5300000056,830.2400000000489
33974,2022-11-11 13:10:00,-1321.16,334338.6100000057,334829.5300000056,-490.9199999999255
33975,2022-11-11 13:15:00,-383.71,333954.90000000567,334829.5300000056,-874.6299999999464
33976,2022-11-11 13:20:00,1588.4,335543.3000000057,334829.5300000056,713.7700000000768
33977,2022-11-11 13:25:00,-462.05,335081.2500000057,334829.5300000056,251.72000000008848
33978,2022-11-11 13:30:00,-738.84,334342.4100000057,334829.5300000056,-487.11999999993714
33979,2022-11-11 13:35:00,-1955.97,332386.4400000057,334829.5300000056,-2443.089999999909
33980,2022-11-11 13:40:00,-487.56,331898.8800000057,334829.5300000056,-2930.649999999907
33981,2022-11-11 13:45:00,-157.32,331741.5600000057,334829.5300000056,-3087.969999999914
33982,2022-11-11 13:50:00,219.13,331960.6900000057,334829.5300000056,-2868.839999999909
33983,2022-11-11 13:55:00,381.58,332342.2700000057,334829.5300000056,-2487.259999999893
33984,2022-11-11 14:00:00,-1776.27,330566.0000000057,334829.5300000056,-4263.5299999999115
33985,2022-11-11 14:05:00,1015.39,331581.3900000057,334829.5300000056,-3248.1399999998976
33986,2022-11-11 14:10:00,-1835.21,329746.1800000057,334829.5300000056,-5083.3499999999185
33987,2022-11-11 14:15:00,-1440.12,328306.0600000057,334829.5300000056,-6523.469999999914
33988,2022-11-11 14:20:00,-337.6,327968.4600000057,334829.5300000056,-6861.069999999891
33989,2022-11-11 14:25:00,642.75,328611.2100000057,334829.5300000056,-6218.319999999891
33990,2022-11-11 14:30:00,662.37,329273.5800000057,334829.5300000056,-5555.949999999895
33991,2022-11-11 14:35:00,1613.47,330887.0500000057,334829.5300000056,-3942.479999999923
33992,2022-11-11 14:40:00,-788.59,330098.46000000567,334829.5300000056,-4731.069999999949
33993,2022-11-11 14:45:00,356.02,330454.4800000057,334829.5300000056,-4375.04999999993
33994,2022-11-11 14:50:00,-619.2,329835.2800000057,334829.5300000056,-4994.249999999942
33995,2022-11-11 14:55:00,-1757.22,328078.0600000057,334829.5300000056,-6751.469999999914
33996,2022-11-11 15:00:00,1772.81,329850.8700000057,334829.5300000056,-4978.659999999916
33997,2022-11-11 15:05:00,-296.87,329554.0000000057,334829.5300000056,-5275.5299999999115
33998,2022-11-11 15:10:00,-508.55,329045.4500000057,334829.5300000056,-5784.0799999999
33999,2022-11-11 15:15:00,1659.44,330704.8900000057,334829.5300000056,-4124.639999999898
34000,2022-11-11 15:20:00,-1505.77,329199.1200000057,334829.5300000056,-5630.409999999916
34001,2022-11-11 15:25:00,-1867.15,327331.9700000057,334829.5300000056,-7497.5599999999395
34002,2022-11-11 15:30:00,1320.56,328652.5300000057,334829.5300000056,-6176.999999999942
34003,2022-11-11 15:35:00,-474.48,328178.0500000057,334829.5300000056,-6651.479999999923
34004,2022-11-11 15:40:00,-171.58,328006.4700000057,334829.5300000056,-6823.0599999999395
34005,2022-11-11 15:45:00,-1005.74,327000.7300000057,334829.5300000056,-7828.79999999993
34006,2022-11-11 15:50:00,889.35,327890.08000000566,334829.5300000056,-6939.449999999953
34007,2022-11-11 15:55:00,-1530.22,326359.8600000057,334829.5300000056,-8469.669999999925
34008,2022-11-11 16:00:00,82.88,326442.7400000057,334829.5300000056,-8386.78999999992
34009,2022-11-11 16:05:00,1086.07,327528.8100000057,334829.5300000056,-7300.719999999914
34010,2022-11-11 16:10:00,1066.88,328595.6900000057,334829.5300000056,-6233.839999999909
34011,2022-11-11 16:15:00,-671.55,327924.1400000057,334829.5300000056,-6905.389999999898
34012,2022-11-11 16:20:00,111.57,328035.7100000057,334829.5300000056,-6793.819999999891
34013,2022-11-11 16:25:00,-132.78,327902.9300000057,334829.5300000056,-6926.5999999999185
34014,2022-11-11 16:30:00,1752.66,329655.5900000057,334829.5300000056,-5173.939999999944
34015,2022-11-11 16:35:00,1213.93,330869.52000000566,334829.5300000056,-3960.009999999951
34016,2022-11-11 16:40:00,1103.25,331972.77000000566,334829.5300000056,-2856.759999999951
34017,2022-11-11 16:45:00,-99.09,331873.68000000564,334829.5300000056,-2955.8499999999767
34018,2022-11-11 16:50:00,19.64,331893.32000000565,334829.5300000056,-2936.2099999999627
34019,2022-11-11 16:55:00,309.05,332202.37000000564,334829.5300000056,-2627.1599999999744
34020,2022-11-12 08:00:00,-282.44,331919.93000000564,332202.37000000564,-282.4400000000023
34021,2022-11-12 08:05:00,444.21,332364.14000000566,332202.37000000564,161.77000000001863
34022,2022-11-12 08:10:00,-1319.39,331044.75000000565,332202.37000000564,-1157.6199999999953
34023,2022-11-12 08:15:00,-1201.34,329843.4100000056,332202.37000000564,-2358.960000000021
34024,2022-11-12 08:20:00,736.25,330579.6600000056,332202.37000000564,-1622.710000000021
34025,2022-11-12 08:25:00,-1865.11,328714.55000000563,332202.37000000564,-3487.820000000007
34026,2022-11-12 08:30:00,1953.82,330668.37000000564,332202.37000000564,-1534.0
34027,2022-11-12 08:35:00,1923.1,332591.4700000056,332202.37000000564,389.0999999999767
34028,2022-11-12 08:40:00,-1002.85,331588.62000000564,332202.37000000564,-613.75
34029,2022-11-12 08:45:00,-421.64,331166.9800000056,332202.37000000564,-1035.390000000014
34030,2022-11-12 08:50:00,-1588.66,329578.32000000565,332202.37000000564,-2624.0499999999884
34031,2022-11-12 08:55:00,1804.62,331382.94000000565,332202.37000000564,-819.429999999993
34032,2022-11-12 09:00:00,-761.36,330621.58000000566,332202.37000000564,-1580.789999999979
34033,2022-11-12 09:05:00,1867.61,332489.19000000565,332202.37000000564,286.820000000007
34034,2022-11-12 09:10:00,1820.9,334310.0900000057,332202.37000000564,2107.7200000000303
34035,2022-11-12 09:15:00,1724.05,336034.14000000566,332202.37000000564,3831.7700000000186
34036,2022-11-12 09:20:00,-723.06,335311.08000000566,332202.37000000564,3108.710000000021
34037,2022-11-12 09:25:00,738.38,336049.46000000567,332202.37000000564,3847.0900000000256
34038,2022-11-12 09:30:00,132.37,336181.83000000566,332202.37000000564,3979.460000000021
34039,2022-11-12 09:35:00,-1260.82,334921.01000000566,332202.37000000564,2718.640000000014
34040,2022-11-12 09:40:00,403.17,335324.18000000564,332202.37000000564,3121.8099999999977
34041,2022-11-12 09:45:00,-475.04,334849.14000000566,332202.37000000564,2646.7700000000186
34042,2022-11-12 09:50:00,-1158.38,333690.76000000566,332202.37000000564,1488.390000000014
34043,2022-11-12 09:55:00,1720.58,335411.3400000057,332202.37000000564,3208.9700000000303
34044,2022-11-12 10:00:00,276.67,335688.01000000566,332202.37000000564,3485.640000000014
34045,2022-11-12 10:05:00,391.11,336079.12000000564,332202.37000000564,3876.75
34046,2022-11-12 10:10:00,205.72,336284.8400000056,332202.37000000564,4082.469999999972
34047,2022-11-12 10:15:00,1240.46,337525.30000000563,332202.37000000564,5322.929999999993
34048,2022-11-12 10:20:00,1016.81,338542.11000000563,332202.37000000564,6339.739999999991
34049,2022-11-12 10:25:00,1848.91,340391.0200000056,332202.37000000564,8188.649999999965
34050,2022-11-12 10:30:00,-1326.83,339064.1900000056,332202.37000000564,6861.819999999949
34051,2022-11-12 10:35:00,1758.94,340823.1300000056,332202.37000000564,8620.759999999951
34052,2022-11-12 10:40:00,-740.9,340082.23000000557,332202.37000000564,7879.859999999928
34053,2022-11-12 10:45:00,-737.04,339345.1900000056,332202.37000000564,7142.819999999949
34054,2022-11-12 10:50:00,-1413.94,337931.2500000056,332202.37000000564,5728.879999999946
34055,2022-11-12 10:55:00,-854.67,337076.5800000056,332202.37000000564,4874.209999999963
34056,2022-11-12 11:00:00,1602.53,338679.11000000563,332202.37000000564,6476.739999999991
34057,2022-11-12 11:05:00,1316.57,339995.68000000564,332202.37000000564,7793.309999999998
34058,2022-11-12 11:10:00,1481.38,341477.06000000564,332202.37000000564,9274.690000000002
34059,2022-11-12 11:15:00,369.64,341846.70000000566,332202.37000000564,9644.330000000016
34060,2022-11-12 11:20:00,1514.11,343360.81000000564,332202.37000000564,11158.440000000002
34061,2022-11-12 11:25:00,-1741.7,341619.11000000563,332202.37000000564,9416.73999999999
34062,2022-11-12 11:30:00,-187.22,341431.89000000566,332202.37000000564,9229.520000000019
34063,2022-11-12 11:35:00,1899.07,343330.96000000567,332202.37000000564,11128.590000000026
34064,2022-11-12 11:40:00,840.16,344171.12000000564,332202.37000000564,11968.75
34065,2022-11-12 11:45:00,-1172.31,342998.81000000564,332202.37000000564,10796.440000000002
34066,2022-11-12 11:50:00,1508.95,344507.76000000566,332202.37000000564,12305.390000000014
34067,2022-11-12 11:55:00,-1603.28,342904.4800000056,332202.37000000564,10702.109999999986
34068,2022-11-12 12:00:00,576.59,343481.07000000565,332202.37000000564,11278.700000000012
34069,2022-11-12 12:05:00,1614.63,345095.70000000566,332202.37000000564,12893.330000000016
34070,2022-11-12 12:10:00,827.68,345923.38000000565,332202.37000000564,13721.01000000001
34071,2022-11-12 12:15:00,1448.53,347371.9100000057,332202.37000000564,15169.540000000037
34072,2022-11-12 12:20:00,525.63,347897.5400000057,332202.37000000564,15695.170000000042
34073,2022-11-12 12:25:00,22.54,347920.08000000566,332202.37000000564,15717.710000000021
34074,2022-11-12 12:30:00,1352.94,349273.02000000566,332202.37000000564,17070.650000000023
34075,2022-11-12 12:35:00,808.17,350081.19000000565,332202.37000000564,17878.820000000007
34076,2022-11-12 12:40:00,733.41,350814.6000000056,332202.37000000564,18612.22999999998
34077,2022-11-12 12:45:00,-720.44,350094.1600000056,332202.37000000564,17891.78999999998
34078,2022-11-12 12:50:00,875.72,350969.8800000056,332202.37000000564,18767.50999999995
34079,2022-11-12 12:55:00,-747.15,350222.73000000557,332202.37000000564,18020.359999999928
34080,2022-11-12 13:00:00,-1382.82,348839.91000000556,332202.37000000564,16637.53999999992
34081,2022-11-12 13:05:00,713.42,349553.33000000555,332202.37000000564,17350.959999999905
34082,2022-11-12 13:10:00,-1836.89,347716.44000000553,332202.37000000564,15514.06999999989
34083,2022-11-12 13:15:00,-1645.25,346071.19000000553,332202.37000000564,13868.81999999989
34084,2022-11-12 13:20:00,1949.51,348020.70000000554,332202.37000000564,15818.3299999999
34085,2022-11-12 13:25:00,1627.98,349648.6800000055,332202.37000000564,17446.30999999988
34086,2022-11-12 13:30:00,-1796.33,347852.3500000055,332202.37000000564,15649.979999999865
34087,2022-11-12 13:35:00,1476.81,349329.1600000055,332202.37000000564,17126.789999999863
34088,2022-11-12 13:40:00,-1407.82,347921.3400000055,332202.37000000564,15718.969999999856
34089,2022-11-12 13:45:00,1175.85,349097.1900000055,332202.37000000564,16894.819999999832
34090,2022-11-12 13:50:00,928.89,350026.0800000055,332202.37000000564,17823.709999999846
34091,2022-11-12 13:55:00,1415.94,351442.0200000055,332202.37000000564,19239.64999999985
34092,2022-11-12 14:00:00,1371.25,352813.2700000055,332202.37000000564,20610.89999999985
34093,2022-11-12 14:05:00,1160.46,353973.7300000055,332202.37000000564,21771.35999999987
34094,2022-11-12 14:10:00,315.19,354288.9200000055,332202.37000000564,22086.549999999872
34095,2022-11-12 14:15:00,1057.51,355346.4300000055,332202.37000000564,23144.05999999988
34096,2022-11-12 14:20:00,1389.47,356735.9000000055,332202.37000000564,24533.529999999853
34097,2022-11-12 14:25:00,771.12,357507.0200000055,332202.37000000564,25304.64999999985
34098,2022-11-12 14:30:00,1251.49,358758.5100000055,332202.37000000564,26556.13999999984
34099,2022-11-12 14:35:00,-945.04,357813.4700000055,332202.37000000564,25611.09999999986
34100,2022-11-12 14:40:00,670.38,358483.8500000055,332202.37000000564,26281.479999999865
34101,2022-11-12 14:45:00,-116.92,358366.9300000055,332202.37000000564,26164.55999999988
34102,2022-11-12 14:50:00,1607.21,359974.14000000554,332202.37000000564,27771.769999999902
34103,2022-11-12 14:55:00,1161.66,361135.8000000055,332202.37000000564,28933.429999999877
34104,2022-11-12 15:00:00,-799.1,360336.70000000554,332202.37000000564,28134.3299999999
34105,2022-11-12 15:05:00,24.32,360361.02000000555,332202.37000000564,28158.649999999907
34106,2022-11-12 15:10:00,-1975.95,358385.07000000554,332202.37000000564,26182.699999999895
34107,2022-11-12 15:15:00,-315.85,358069.22000000556,332202.37000000564,25866.84999999992
34108,2022-11-12 15:20:00,-1191.77,356877.45000000554,332202.37000000564,24675.0799999999
34109,2022-11-12 15:25:00,664.93,357542.38000000553,332202.37000000564,25340.009999999893
34110,2022-11-12 15:30:00,-1837.81,355704.57000000554,332202.37000000564,23502.199999999895
34111,2022-11-12 15:35:00,1087.65,356792.22000000556,332202.37000000564,24589.84999999992
34112,2022-11-12 15:40:00,1813.16,358605.38000000553,332202.37000000564,26403.009999999893
34113,2022-11-12 15:45:00,-1993.5,356611.88000000553,332202.37000000564,24409.509999999893
34114,2022-11-12 15:50:00,-215.77,356396.1100000055,332202.37000000564,24193.739999999874
34115,2022-11-12 15:55:00,-524.3,355871.8100000055,332202.37000000564,23669.439999999886
34116,2022-11-12 16:00:00,998.96,356870.77000000555,332202.37000000564,24668.399999999907
34117,2022-11-12 16:05:00,424.5,357295.27000000555,332202.37000000564,25092.899999999907
34118,2022-11-12 16:10:00,604.2,357899.47000000556,332202.37000000564,25697.09999999992
34119,2022-11-12 16:15:00,-518.1,357381.3700000056,332202.37000000564,25178.99999999994
34120,2022-11-12 16:20:00,-1368.57,356012.8000000056,332202.37000000564,23810.429999999935
34121,2022-11-12 16:25:00,-519.58,355493.22000000556,332202.37000000564,23290.84999999992
34122,2022-11-12 16:30:00,-515.05,354978.1700000056,332202.37000000564,22775.79999999993
34123,2022-11-12 16:35:00,-1663.12,353315.0500000056,332202.37000000564,21112.679999999935
34124,2022-11-12 16:40:00,-447.84,352867.21000000555,332202.37000000564,20664.83999999991
34125,2022-11-12 16:45:00,-40.66,352826.5500000056,332202.37000000564,20624.179999999935
34126,2022-11-12 16:50:00,1827.19,354653.7400000056,332202.37000000564,22451.369999999937
34127,2022-11-12 16:55:00,110.6,354764.34000000556,332202.37000000564,22561.969999999914
34128,2022-11-13 08:00:00,-987.78,353776.5600000055,354764.34000000556,-987.7800000000279
34129,2022-11-13 08:05:00,555.23,354331.7900000055,354764.34000000556,-432.55000000004657
34130,2022-11-13 08:10:00,1038.59,355370.38000000553,354764.34000000556,606.039999999979
34131,2022-11-13 08:15:00,1861.71,357232.09000000556,354764.34000000556,2467.75
34132,2022-11-13 08:20:00,-1260.26,355971.83000000555,354764.34000000556,1207.4899999999907
34133,2022-11-13 08:25:00,-148.03,355823.8000000055,354764.34000000556,1059.4599999999627
34134,2022-11-13 08:30:00,1931.68,357755.4800000055,354764.34000000556,2991.1399999999558
34135,2022-11-13 08:35:00,-1076.39,356679.0900000055,354764.34000000556,1914.7499999999418
34136,2022-11-13 08:40:00,-1923.77,354755.3200000055,354764.34000000556,-9.020000000076834
34137,2022-11-13 08:45:00,-1206.37,353548.9500000055,354764.34000000556,-1215.3900000000722
34138,2022-11-13 08:50:00,-1914.33,351634.62000000547,354764.34000000556,-3129.7200000000885
34139,2022-11-13 08:55:00,1870.99,353505.61000000546,354764.34000000556,-1258.7300000000978
34140,2022-11-13 09:00:00,-1339.04,352166.5700000055,354764.34000000556,-2597.770000000077
34141,2022-11-13 09:05:00,869.87,353036.4400000055,354764.34000000556,-1727.9000000000815
34142,2022-11-13 09:10:00,-1072.33,351964.11000000546,354764.34000000556,-2800.230000000098
34143,2022-11-13 09:15:00,-768.66,351195.4500000055,354764.34000000556,-3568.890000000072
34144,2022-11-13 09:20:00,-1226.77,349968.68000000546,354764.34000000556,-4795.660000000091
34145,2022-11-13 09:25:00,1452.64,351421.3200000055,354764.34000000556,-3343.020000000077
34146,2022-11-13 09:30:00,398.58,351819.9000000055,354764.34000000556,-2944.4400000000605
34147,2022-11-13 09:35:00,-1317.29,350502.6100000055,354764.34000000556,-4261.73000000004
34148,2022-11-13 09:40:00,872.92,351375.5300000055,354764.34000000556,-3388.810000000056
34149,2022-11-13 09:45:00,1500.21,352875.7400000055,354764.34000000556,-1888.600000000035
34150,2022-11-13 09:50:00,979.25,353854.9900000055,354764.34000000556,-909.3500000000349
34151,2022-11-13 09:55:00,-864.44,352990.5500000055,354764.34000000556,-1773.7900000000373
34152,2022-11-13 10:00:00,1502.9,354493.45000000554,354764.34000000556,-270.89000000001397
34153,2022-11-13 10:05:00,107.71,354601.16000000556,354764.34000000556,-163.17999999999302
34154,2022-11-13 10:10:00,477.25,355078.41000000556,354764.34000000556,314.070000000007
34155,2022-11-13 10:15:00,-203.54,354874.8700000056,354764.34000000556,110.53000000002794
34156,2022-11-13 10:20:00,-473.88,354400.9900000056,354764.34000000556,-363.3499999999767
34157,2022-11-13 10:25:00,-260.51,354140.48000000557,354764.34000000556,-623.859999999986
34158,2022-11-13 10:30:00,-672.48,353468.0000000056,354764.34000000556,-1296.3399999999674
34159,2022-11-13 10:35:00,-54.62,353413.3800000056,354764.34000000556,-1350.9599999999627
34160,2022-11-13 10:40:00,-784.85,352628.5300000056,354764.34000000556,-2135.8099999999395
34161,2022-11-13 10:45:00,-618.22,352010.31000000564,354764.34000000556,-2754.0299999999115
34162,2022-11-13 10:50:00,621.74,352632.05000000563,354764.34000000556,-2132.289999999921
34163,2022-11-13 10:55:00,1562.27,354194.32000000565,354764.34000000556,-570.0199999999022
34164,2022-11-13 11:00:00,-1703.5,352490.82000000565,354764.34000000556,-2273.519999999902
34165,2022-11-13 11:05:00,258.75,352749.57000000565,354764.34000000556,-2014.7699999999022
34166,2022-11-13 11:10:00,-864.15,351885.42000000563,354764.34000000556,-2878.9199999999255
34167,2022-11-13 11:15:00,-1908.84,349976.5800000056,354764.34000000556,-4787.759999999951
34168,2022-11-13 11:20:00,-507.56,349469.0200000056,354764.34000000556,-5295.319999999949
34169,2022-11-13 11:25:00,-1627.9,347841.1200000056,354764.34000000556,-6923.219999999972
34170,2022-11-13 11:30:00,531.12,348372.2400000056,354764.34000000556,-6392.099999999977
34171,2022-11-13 11:35:00,1053.15,349425.3900000056,354764.34000000556,-5338.949999999953
34172,2022-11-13 11:40:00,-85.16,349340.2300000056,354764.34000000556,-5424.109999999928
34173,2022-11-13 11:45:00,-1660.42,347679.81000000564,354764.34000000556,-7084.5299999999115
34174,2022-11-13 11:50:00,-1564.2,346115.61000000563,354764.34000000556,-8648.729999999923
34175,2022-11-13 11:55:00,-499.15,345616.4600000056,354764.34000000556,-9147.879999999946
34176,2022-11-13 12:00:00,723.21,346339.67000000563,354764.34000000556,-8424.669999999925
34177,2022-11-13 12:05:00,-912.85,345426.82000000565,354764.34000000556,-9337.519999999902
34178,2022-11-13 12:10:00,-954.97,344471.8500000057,354764.34000000556,-10292.489999999874
34179,2022-11-13 12:15:00,1119.84,345591.6900000057,354764.34000000556,-9172.649999999849
34180,2022-11-13 12:20:00,1675.02,347266.7100000057,354764.34000000556,-7497.62999999983
34181,2022-11-13 12:25:00,-1093.71,346173.0000000057,354764.34000000556,-8591.339999999851
34182,2022-11-13 12:30:00,1976.74,348149.7400000057,354764.34000000556,-6614.59999999986
34183,2022-11-13 12:35:00,1300.26,349450.0000000057,354764.34000000556,-5314.339999999851
34184,2022-11-13 12:40:00,-1995.64,347454.3600000057,354764.34000000556,-7309.979999999865
34185,2022-11-13 12:45:00,1042.64,348497.0000000057,354764.34000000556,-6267.339999999851
34186,2022-11-13 12:50:00,1959.31,350456.3100000057,354764.34000000556,-4308.029999999853
34187,2022-11-13 12:55:00,-1099.36,349356.9500000057,354764.34000000556,-5407.389999999839
34188,2022-11-13 13:00:00,224.65,349581.60000000574,354764.34000000556,-5182.739999999816
34189,2022-11-13 13:05:00,-480.27,349101.3300000057,354764.34000000556,-5663.009999999835
34190,2022-11-13 13:10:00,1774.03,350875.36000000575,354764.34000000556,-3888.9799999998068
34191,2022-11-13 13:15:00,-1271.26,349604.10000000574,354764.34000000556,-5160.239999999816
34192,2022-11-13 13:20:00,-209.62,349394.48000000574,354764.34000000556,-5369.859999999811
34193,2022-11-13 13:25:00,1084.02,350478.50000000576,354764.34000000556,-4285.839999999793
34194,2022-11-13 13:30:00,-1472.6,349005.9000000058,354764.34000000556,-5758.4399999997695
34195,2022-11-13 13:35:00,1505.94,350511.8400000058,354764.34000000556,-4252.499999999767
34196,2022-11-13 13:40:00,1181.35,351693.19000000576,354764.34000000556,-3071.1499999997905
34197,2022-11-13 13:45:00,629.36,352322.55000000575,354764.34000000556,-2441.7899999998044
34198,2022-11-13 13:50:00,1516.02,353838.57000000577,354764.34000000556,-925.7699999997858
34199,2022-11-13 13:55:00,-499.01,353339.56000000576,354764.34000000556,-1424.779999999795
34200,2022-11-13 14:00:00,-1261.81,352077.75000000576,354764.34000000556,-2686.589999999793
34201,2022-11-13 14:05:00,10.19,352087.94000000576,354764.34000000556,-2676.3999999997905
34202,2022-11-13 14:10:00,-574.17,351513.7700000058,354764.34000000556,-3250.569999999774
34203,2022-11-13 14:15:00,1453.49,352967.2600000058,354764.34000000556,-1797.0799999997835
34204,2022-11-13 14:20:00,-1310.53,351656.73000000574,354764.34000000556,-3107.6099999998114
34205,2022-11-13 14:25:00,-847.75,350808.98000000574,354764.34000000556,-3955.3599999998114
34206,2022-11-13 14:30:00,-199.76,350609.22000000573,354764.34000000556,-4155.119999999821
34207,2022-11-13 14:35:00,1829.04,352438.2600000057,354764.34000000556,-2326.0799999998417
34208,2022-11-13 14:40:00,-1142.36,351295.9000000057,354764.34000000556,-3468.4399999998277
34209,2022-11-13 14:45:00,818.4,352114.30000000575,354764.34000000556,-2650.0399999998044
34210,2022-11-13 14:50:00,-1327.78,350786.5200000057,354764.34000000556,-3977.8199999998324
34211,2022-11-13 14:55:00,-1065.61,349720.91000000574,354764.34000000556,-5043.429999999818
34212,2022-11-13 15:00:00,1134.89,350855.80000000575,354764.34000000556,-3908.5399999998044
34213,2022-11-13 15:05:00,-609.88,350245.92000000575,354764.34000000556,-4518.419999999809
34214,2022-11-13 15:10:00,-1628.14,348617.78000000573,354764.34000000556,-6146.559999999823
34215,2022-11-13 15:15:00,1561.05,350178.8300000057,354764.34000000556,-4585.509999999835
34216,2022-11-13 15:20:00,131.03,350309.86000000575,354764.34000000556,-4454.479999999807
34217,2022-11-13 15:25:00,-791.38,349518.48000000574,354764.34000000556,-5245.859999999811
34218,2022-11-13 15:30:00,185.98,349704.4600000057,354764.34000000556,-5059.87999999983
34219,2022-11-13 15:35:00,-1287.08,348417.3800000057,354764.34000000556,-6346.959999999846
34220,2022-11-13 15:40:00,1811.64,350229.0200000057,354764.34000000556,-4535.319999999832
34221,2022-11-13 15:45:00,-135.02,350094.0000000057,354764.34000000556,-4670.339999999851
34222,2022-11-13 15:50:00,-1678.5,348415.5000000057,354764.34000000556,-6348.839999999851
34223,2022-11-13 15:55:00,1971.75,350387.2500000057,354764.34000000556,-4377.089999999851
34224,2022-11-13 16:00:00,-487.97,349899.28000000573,354764.34000000556,-4865.059999999823
34225,2022-11-13 16:05:00,877.52,350776.80000000575,354764.34000000556,-3987.5399999998044
34226,2022-11-13 16:10:00,47.3,350824.10000000574,354764.34000000556,-3940.239999999816
34227,2022-11-13 16:15:00,-42.58,350781.5200000057,354764.34000000556,-3982.8199999998324
34228,2022-11-13 16:20:00,-176.01,350605.5100000057,354764.34000000556,-4158.829999999842
34229,2022-11-13 16:25:00,-838.86,349766.6500000057,354764.34000000556,-4997.689999999828
34230,2022-11-13 16:30:00,892.75,350659.4000000057,354764.34000000556,-4104.939999999828
34231,2022-11-13 16:35:00,827.46,351486.86000000575,354764.34000000556,-3277.4799999998068
34232,2022-11-13 16:40:00,-960.16,350526.7000000058,354764.34000000556,-4237.639999999781
34233,2022-11-13 16:45:00,-1144.04,349382.6600000058,354764.34000000556,-5381.67999999976
34234,2022-11-13 16:50:00,1606.52,350989.1800000058,354764.34000000556,-3775.1599999997416
34235,2022-11-13 16:55:00,-1353.38,349635.8000000058,354764.34000000556,-5128.539999999746
34236,2022-11-14 08:00:00,51.41,349687.2100000058,349635.8000000058,51.40999999997439
34237,2022-11-14 08:05:00,466.58,350153.7900000058,349635.8000000058,517.9899999999907
34238,2022-11-14 08:10:00,645.36,350799.1500000058,349635.8000000058,1163.3499999999767
34239,2022-11-14 08:15:00,1049.28,351848.4300000058,349635.8000000058,2212.6300000000047
34240,2022-11-14 08:20:00,656.06,352504.4900000058,349635.8000000058,2868.6900000000023
34241,2022-11-14 08:25:00,211.01,352715.5000000058,349635.8000000058,3079.7000000000116
34242,2022-11-14 08:30:00,812.32,353527.8200000058,349635.8000000058,3892.0200000000186
34243,2022-11-14 08:35:00,939.87,354467.6900000058,349635.8000000058,4831.890000000014
34244,2022-11-14 08:40:00,484.0,354951.6900000058,349635.8000000058,5315.890000000014
34245,2022-11-14 08:45:00,607.84,355559.53000000585,349635.8000000058,5923.73000000004
34246,2022-11-14 08:50:00,1607.3,357166.83000000584,349635.8000000058,7531.030000000028
34247,2022-11-14 08:55:00,-954.57,356212.26000000583,349635.8000000058,6576.460000000021
34248,2022-11-14 09:00:00,1596.52,357808.78000000585,349635.8000000058,8172.98000000004
34249,2022-11-14 09:05:00,-1901.06,355907.72000000585,349635.8000000058,6271.920000000042
34250,2022-11-14 09:10:00,-1528.84,354378.8800000058,349635.8000000058,4743.080000000016
34251,2022-11-14 09:15:00,1995.85,356374.7300000058,349635.8000000058,6738.929999999993
34252,2022-11-14 09:20:00,-1449.47,354925.26000000583,349635.8000000058,5289.460000000021
34253,2022-11-14 09:25:00,382.79,355308.0500000058,349635.8000000058,5672.25
34254,2022-11-14 09:30:00,-660.53,354647.5200000058,349635.8000000058,5011.719999999972
34255,2022-11-14 09:35:00,984.2,355631.7200000058,349635.8000000058,5995.919999999984
34256,2022-11-14 09:40:00,1681.23,357312.9500000058,349635.8000000058,7677.149999999965
34257,2022-11-14 09:45:00,-1822.58,355490.37000000576,349635.8000000058,5854.569999999949
34258,2022-11-14 09:50:00,456.86,355947.23000000574,349635.8000000058,6311.429999999935
34259,2022-11-14 09:55:00,1411.46,357358.69000000576,349635.8000000058,7722.889999999956
34260,2022-11-14 10:00:00,8.81,357367.50000000576,349635.8000000058,7731.699999999953
34261,2022-11-14 10:05:00,1929.62,359297.12000000576,349635.8000000058,9661.319999999949
34262,2022-11-14 10:10:00,-259.61,359037.5100000058,349635.8000000058,9401.709999999963
34263,2022-11-14 10:15:00,-415.84,358621.67000000575,349635.8000000058,8985.869999999937
34264,2022-11-14 10:20:00,-565.71,358055.9600000057,349635.8000000058,8420.159999999916
34265,2022-11-14 10:25:00,143.56,358199.5200000057,349635.8000000058,8563.719999999914
34266,2022-11-14 10:30:00,1942.05,360141.5700000057,349635.8000000058,10505.769999999902
34267,2022-11-14 10:35:00,-769.38,359372.1900000057,349635.8000000058,9736.389999999898
34268,2022-11-14 10:40:00,117.63,359489.8200000057,349635.8000000058,9854.019999999902
34269,2022-11-14 10:45:00,-339.33,359150.4900000057,349635.8000000058,9514.689999999886
34270,2022-11-14 10:50:00,-1376.39,357774.1000000057,349635.8000000058,8138.299999999872
34271,2022-11-14 10:55:00,80.33,357854.4300000057,349635.8000000058,8218.629999999888
34272,2022-11-14 11:00:00,379.47,358233.90000000567,349635.8000000058,8598.09999999986
34273,2022-11-14 11:05:00,1742.66,359976.56000000564,349635.8000000058,10340.759999999835
34274,2022-11-14 11:10:00,1178.21,361154.77000000566,349635.8000000058,11518.969999999856
34275,2022-11-14 11:15:00,877.82,362032.5900000057,349635.8000000058,12396.789999999863
34276,2022-11-14 11:20:00,498.48,362531.07000000565,349635.8000000058,12895.269999999844
34277,2022-11-14 11:25:00,-1037.35,361493.7200000057,349635.8000000058,11857.919999999867
34278,2022-11-14 11:30:00,-481.6,361012.1200000057,349635.8000000058,11376.31999999989
34279,2022-11-14 11:35:00,-586.44,360425.6800000057,349635.8000000058,10789.879999999888
34280,2022-11-14 11:40:00,-303.69,360121.9900000057,349635.8000000058,10486.189999999886
34281,2022-11-14 11:45:00,155.65,360277.6400000057,349635.8000000058,10641.83999999991
34282,2022-11-14 11:50:00,-268.11,360009.53000000573,349635.8000000058,10373.729999999923
34283,2022-11-14 11:55:00,93.88,360103.41000000574,349635.8000000058,10467.609999999928
34284,2022-11-14 12:00:00,1014.5,361117.91000000574,349635.8000000058,11482.109999999928
34285,2022-11-14 12:05:00,489.3,361607.2100000057,349635.8000000058,11971.409999999916
34286,2022-11-14 12:10:00,10.99,361618.2000000057,349635.8000000058,11982.399999999907
34287,2022-11-14 12:15:00,-1598.75,360019.4500000057,349635.8000000058,10383.649999999907
34288,2022-11-14 12:20:00,-1740.5,358278.9500000057,349635.8000000058,8643.149999999907
34289,2022-11-14 12:25:00,-1847.64,356431.3100000057,349635.8000000058,6795.509999999893
34290,2022-11-14 12:30:00,1053.27,357484.5800000057,349635.8000000058,7848.7799999999115
34291,2022-11-14 12:35:00,-1661.26,355823.3200000057,349635.8000000058,6187.519999999902
34292,2022-11-14 12:40:00,463.46,356286.78000000573,349635.8000000058,6650.979999999923
34293,2022-11-14 12:45:00,1515.53,357802.31000000576,349635.8000000058,8166.509999999951
34294,2022-11-14 12:50:00,-1854.5,355947.81000000576,349635.8000000058,6312.009999999951
34295,2022-11-14 12:55:00,1219.07,357166.88000000577,349635.8000000058,7531.079999999958
34296,2022-11-14 13:00:00,-1339.54,355827.3400000058,349635.8000000058,6191.539999999979
34297,2022-11-14 13:05:00,-653.2,355174.1400000058,349635.8000000058,5538.339999999967
34298,2022-11-14 13:10:00,827.19,356001.3300000058,349635.8000000058,6365.52999999997
34299,2022-11-14 13:15:00,-105.82,355895.5100000058,349635.8000000058,6259.709999999963
34300,2022-11-14 13:20:00,777.39,356672.9000000058,349635.8000000058,7037.099999999977
34301,2022-11-14 13:25:00,249.78,356922.6800000058,349635.8000000058,7286.880000000005
34302,2022-11-14 13:30:00,-273.65,356649.0300000058,349635.8000000058,7013.229999999981
34303,2022-11-14 13:35:00,-1937.98,354711.0500000058,349635.8000000058,5075.25
34304,2022-11-14 13:40:00,1788.09,356499.14000000583,349635.8000000058,6863.340000000026
34305,2022-11-14 13:45:00,-1781.92,354717.22000000585,349635.8000000058,5081.420000000042
34306,2022-11-14 13:50:00,-1433.71,353283.51000000583,349635.8000000058,3647.710000000021
34307,2022-11-14 13:55:00,-1793.44,351490.0700000058,349635.8000000058,1854.2700000000186
34308,2022-11-14 14:00:00,588.58,352078.65000000584,349635.8000000058,2442.850000000035
34309,2022-11-14 14:05:00,1385.38,353464.03000000585,349635.8000000058,3828.2300000000396
34310,2022-11-14 14:10:00,-213.93,353250.10000000586,349635.8000000058,3614.3000000000466
34311,2022-11-14 14:15:00,24.5,353274.60000000586,349635.8000000058,3638.8000000000466
34312,2022-11-14 14:20:00,-1756.59,351518.01000000583,349635.8000000058,1882.210000000021
34313,2022-11-14 14:25:00,1456.24,352974.2500000058,349635.8000000058,3338.4500000000116
34314,2022-11-14 14:30:00,-1954.38,351019.8700000058,349635.8000000058,1384.070000000007
34315,2022-11-14 14:35:00,1216.34,352236.21000000584,349635.8000000058,2600.4100000000326
34316,2022-11-14 14:40:00,1619.59,353855.80000000587,349635.8000000058,4220.000000000058
34317,2022-11-14 14:45:00,1059.21,354915.0100000059,349635.8000000058,5279.210000000079
34318,2022-11-14 14:50:00,891.09,355806.1000000059,349635.8000000058,6170.300000000105
34319,2022-11-14 14:55:00,-683.3,355122.8000000059,349635.8000000058,5487.000000000116
34320,2022-11-14 15:00:00,350.93,355473.7300000059,349635.8000000058,5837.930000000109
34321,2022-11-14 15:05:00,-1869.02,353604.7100000059,349635.8000000058,3968.910000000091
34322,2022-11-14 15:10:00,1057.14,354661.8500000059,349635.8000000058,5026.050000000105
34323,2022-11-14 15:15:00,798.75,355460.6000000059,349635.8000000058,5824.800000000105
34324,2022-11-14 15:20:00,36.81,355497.4100000059,349635.8000000058,5861.610000000102
34325,2022-11-14 15:25:00,439.73,355937.1400000059,349635.8000000058,6301.340000000084
34326,2022-11-14 15:30:00,-266.69,355670.4500000059,349635.8000000058,6034.6500000000815
34327,2022-11-14 15:35:00,1858.86,357529.3100000059,349635.8000000058,7893.5100000000675
34328,2022-11-14 15:40:00,360.03,357889.3400000059,349635.8000000058,8253.540000000095
34329,2022-11-14 15:45:00,1801.63,359690.9700000059,349635.8000000058,10055.1700000001
34330,2022-11-14 15:50:00,-456.17,359234.8000000059,349635.8000000058,9599.000000000116
34331,2022-11-14 15:55:00,-1170.4,358064.4000000059,349635.8000000058,8428.600000000093
34332,2022-11-14 16:00:00,1648.03,359712.43000000593,349635.8000000058,10076.630000000121
34333,2022-11-14 16:05:00,1306.74,361019.1700000059,349635.8000000058,11383.370000000112
34334,2022-11-14 16:10:00,1740.41,362759.5800000059,349635.8000000058,13123.780000000086
34335,2022-11-14 16:15:00,516.49,363276.0700000059,349635.8000000058,13640.270000000077
34336,2022-11-14 16:20:00,1110.01,364386.0800000059,349635.8000000058,14750.280000000086
34337,2022-11-14 16:25:00,1138.68,365524.7600000059,349635.8000000058,15888.96000000008
34338,2022-11-14 16:30:00,-207.42,365317.3400000059,349635.8000000058,15681.540000000095
34339,2022-11-14 16:35:00,-631.14,364686.2000000059,349635.8000000058,15050.400000000081
34340,2022-11-14 16:40:00,-1230.83,363455.3700000059,349635.8000000058,13819.570000000065
34341,2022-11-14 16:45:00,99.44,363554.8100000059,349635.8000000058,13919.010000000068
34342,2022-11-14 16:50:00,485.18,364039.99000000587,349635.8000000058,14404.19000000006
34343,2022-11-14 16:55:00,1865.29,365905.28000000585,349635.8000000058,16269.48000000004
34344,2022-11-15 08:00:00,-1423.14,364482.14000000583,365905.28000000585,-1423.140000000014
34345,2022-11-15 08:05:00,1191.4,365673.54000000586,365905.28000000585,-231.7399999999907
34346,2022-11-15 08:10:00,-1098.38,364575.16000000585,365905.28000000585,-1330.1199999999953
34347,2022-11-15 08:15:00,44.88,364620.04000000586,365905.28000000585,-1285.2399999999907
34348,2022-11-15 08:20:00,-1927.19,362692.85000000586,365905.28000000585,-3212.429999999993
34349,2022-11-15 08:25:00,1100.96,363793.8100000059,365905.28000000585,-2111.469999999972
34350,2022-11-15 08:30:00,192.46,363986.2700000059,365905.28000000585,-1919.009999999951
34351,2022-11-15 08:35:00,-967.6,363018.6700000059,365905.28000000585,-2886.609999999928
34352,2022-11-15 08:40:00,-1577.15,361441.5200000059,365905.28000000585,-4463.759999999951
34353,2022-11-15 08:45:00,687.11,362128.6300000059,365905.28000000585,-3776.649999999965
34354,2022-11-15 08:50:00,-564.92,361563.7100000059,365905.28000000585,-4341.569999999949
34355,2022-11-15 08:55:00,1411.69,362975.4000000059,365905.28000000585,-2929.8799999999464
34356,2022-11-15 09:00:00,1340.56,364315.9600000059,365905.28000000585,-1589.3199999999488
34357,2022-11-15 09:05:00,-1551.71,362764.2500000059,365905.28000000585,-3141.0299999999697
34358,2022-11-15 09:10:00,902.47,363666.72000000585,365905.28000000585,-2238.5599999999977
34359,2022-11-15 09:15:00,1897.57,365564.29000000586,365905.28000000585,-340.9899999999907
34360,2022-11-15 09:20:00,1862.83,367427.1200000059,365905.28000000585,1521.8400000000256
34361,2022-11-15 09:25:00,-1577.61,365849.5100000059,365905.28000000585,-55.76999999996042
34362,2022-11-15 09:30:00,1335.54,367185.05000000587,365905.28000000585,1279.7700000000186
34363,2022-11-15 09:35:00,169.67,367354.72000000585,365905.28000000585,1449.4400000000023
34364,2022-11-15 09:40:00,-46.01,367308.71000000584,365905.28000000585,1403.429999999993
34365,2022-11-15 09:45:00,-1198.32,366110.39000000583,365905.28000000585,205.10999999998603
34366,2022-11-15 09:50:00,-13.55,366096.84000000585,365905.28000000585,191.55999999999767
34367,2022-11-15 09:55:00,-1698.87,364397.97000000585,365905.28000000585,-1507.3099999999977
34368,2022-11-15 10:00:00,-1648.48,362749.49000000587,365905.28000000585,-3155.789999999979
34369,2022-11-15 10:05:00,484.49,363233.98000000586,365905.28000000585,-2671.2999999999884
34370,2022-11-15 10:10:00,1326.12,364560.10000000586,365905.28000000585,-1345.179999999993
34371,2022-11-15 10:15:00,1889.08,366449.1800000059,365905.28000000585,543.9000000000233
34372,2022-11-15 10:20:00,334.97,366784.15000000584,365905.28000000585,878.8699999999953
34373,2022-11-15 10:25:00,-1436.01,365348.14000000583,365905.28000000585,-557.140000000014
34374,2022-11-15 10:30:00,-1166.67,364181.47000000585,365905.28000000585,-1723.8099999999977
34375,2022-11-15 10:35:00,-987.08,363194.39000000583,365905.28000000585,-2710.890000000014
34376,2022-11-15 10:40:00,1121.47,364315.8600000058,365905.28000000585,-1589.420000000042
34377,2022-11-15 10:45:00,960.52,365276.3800000058,365905.28000000585,-628.9000000000233
34378,2022-11-15 10:50:00,1052.74,366329.1200000058,365905.28000000585,423.8399999999674
34379,2022-11-15 10:55:00,-309.09,366020.0300000058,365905.28000000585,114.74999999994179
34380,2022-11-15 11:00:00,172.92,366192.9500000058,365905.28000000585,287.6699999999255
34381,2022-11-15 11:05:00,-843.75,365349.2000000058,365905.28000000585,-556.0800000000745
34382,2022-11-15 11:10:00,-1650.04,363699.1600000058,365905.28000000585,-2206.1200000000536
34383,2022-11-15 11:15:00,965.25,364664.4100000058,365905.28000000585,-1240.8700000000536
34384,2022-11-15 11:20:00,-1420.07,363244.3400000058,365905.28000000585,-2660.9400000000605
34385,2022-11-15 11:25:00,1966.74,365211.0800000058,365905.28000000585,-694.2000000000698
34386,2022-11-15 11:30:00,-1659.88,363551.2000000058,365905.28000000585,-2354.0800000000745
34387,2022-11-15 11:35:00,-751.35,362799.8500000058,365905.28000000585,-3105.430000000051
34388,2022-11-15 11:40:00,-1308.28,361491.57000000577,365905.28000000585,-4413.710000000079
34389,2022-11-15 11:45:00,1389.64,362881.2100000058,365905.28000000585,-3024.070000000065
34390,2022-11-15 11:50:00,-644.98,362236.2300000058,365905.28000000585,-3669.0500000000466
34391,2022-11-15 11:55:00,1909.9,364146.1300000058,365905.28000000585,-1759.1500000000233
34392,2022-11-15 12:00:00,-1587.57,362558.5600000058,365905.28000000585,-3346.7200000000303
34393,2022-11-15 12:05:00,1720.09,364278.65000000584,365905.28000000585,-1626.6300000000047
34394,2022-11-15 12:10:00,1753.94,366032.59000000585,365905.28000000585,127.30999999999767
34395,2022-11-15 12:15:00,1191.11,367223.70000000583,365905.28000000585,1318.4199999999837
34396,2022-11-15 12:20:00,-1798.59,365425.1100000058,365905.28000000585,-480.1700000000419
34397,2022-11-15 12:25:00,-124.07,365301.0400000058,365905.28000000585,-604.2400000000489
34398,2022-11-15 12:30:00,-207.75,365093.2900000058,365905.28000000585,-811.9900000000489
34399,2022-11-15 12:35:00,1861.15,366954.4400000058,365905.28000000585,1049.1599999999744
34400,2022-11-15 12:40:00,680.43,367634.8700000058,365905.28000000585,1729.5899999999674
34401,2022-11-15 12:45:00,-393.38,367241.4900000058,365905.28000000585,1336.2099999999627
34402,2022-11-15 12:50:00,-1486.76,365754.7300000058,365905.28000000585,-150.55000000004657
34403,2022-11-15 12:55:00,-484.52,365270.2100000058,365905.28000000585,-635.0700000000652
34404,2022-11-15 13:00:00,1222.05,366492.2600000058,365905.28000000585,586.9799999999232
34405,2022-11-15 13:05:00,-1710.61,364781.6500000058,365905.28000000585,-1123.6300000000629
34406,2022-11-15 13:10:00,1554.0,366335.6500000058,365905.28000000585,430.36999999993714
34407,2022-11-15 13:15:00,-108.53,366227.12000000576,365905.28000000585,321.8399999999092
34408,2022-11-15 13:20:00,-848.92,365378.2000000058,365905.28000000585,-527.0800000000745
34409,2022-11-15 13:25:00,1707.33,367085.5300000058,365905.28000000585,1180.2499999999418
34410,2022-11-15 13:30:00,1106.89,368192.4200000058,365905.28000000585,2287.1399999999558
34411,2022-11-15 13:35:00,-864.62,367327.8000000058,365905.28000000585,1422.5199999999604
34412,2022-11-15 13:40:00,544.56,367872.3600000058,365905.28000000585,1967.079999999958
34413,2022-11-15 13:45:00,1640.67,369513.0300000058,365905.28000000585,3607.749999999942
34414,2022-11-15 13:50:00,-241.16,369271.8700000058,365905.28000000585,3366.5899999999674
34415,2022-11-15 13:55:00,1979.91,371251.7800000058,365905.28000000585,5346.499999999942
34416,2022-11-15 14:00:00,-1732.38,369519.4000000058,365905.28000000585,3614.119999999937
34417,2022-11-15 14:05:00,-568.63,368950.7700000058,365905.28000000585,3045.4899999999325
34418,2022-11-15 14:10:00,-423.43,368527.3400000058,365905.28000000585,2622.0599999999395
34419,2022-11-15 14:15:00,1094.74,369622.0800000058,365905.28000000585,3716.79999999993
34420,2022-11-15 14:20:00,234.51,369856.5900000058,365905.28000000585,3951.3099999999395
34421,2022-11-15 14:25:00,314.03,370170.6200000058,365905.28000000585,4265.339999999967
34422,2022-11-15 14:30:00,-1719.71,368450.9100000058,365905.28000000585,2545.6299999999464
34423,2022-11-15 14:35:00,1903.78,370354.6900000058,365905.28000000585,4449.409999999974
34424,2022-11-15 14:40:00,-1551.55,368803.14000000583,365905.28000000585,2897.859999999986
34425,2022-11-15 14:45:00,1373.16,370176.3000000058,365905.28000000585,4271.01999999996
34426,2022-11-15 14:50:00,-580.1,369596.20000000583,365905.28000000585,3690.9199999999837
34427,2022-11-15 14:55:00,-332.15,369264.0500000058,365905.28000000585,3358.7699999999604
34428,2022-11-15 15:00:00,183.7,369447.7500000058,365905.28000000585,3542.469999999972
34429,2022-11-15 15:05:00,1287.72,370735.4700000058,365905.28000000585,4830.189999999944
34430,2022-11-15 15:10:00,1383.44,372118.9100000058,365905.28000000585,6213.629999999946
34431,2022-11-15 15:15:00,732.96,372851.8700000058,365905.28000000585,6946.589999999967
34432,2022-11-15 15:20:00,523.62,373375.4900000058,365905.28000000585,7470.209999999963
34433,2022-11-15 15:25:00,293.24,373668.7300000058,365905.28000000585,7763.449999999953
34434,2022-11-15 15:30:00,-1705.65,371963.0800000058,365905.28000000585,6057.79999999993
34435,2022-11-15 15:35:00,1519.43,373482.5100000058,365905.28000000585,7577.229999999923
34436,2022-11-15 15:40:00,-1466.92,372015.5900000058,365905.28000000585,6110.3099999999395
34437,2022-11-15 15:45:00,-28.04,371987.5500000058,365905.28000000585,6082.26999999996
34438,2022-11-15 15:50:00,-227.76,371759.7900000058,365905.28000000585,5854.509999999951
34439,2022-11-15 15:55:00,-1998.04,369761.7500000058,365905.28000000585,3856.469999999972
34440,2022-11-15 16:00:00,414.05,370175.8000000058,365905.28000000585,4270.51999999996
34441,2022-11-15 16:05:00,-189.29,369986.51000000583,365905.28000000585,4081.2299999999814
34442,2022-11-15 16:10:00,1516.53,371503.04000000586,365905.28000000585,5597.760000000009
34443,2022-11-15 16:15:00,-169.98,371333.0600000059,365905.28000000585,5427.780000000028
34444,2022-11-15 16:20:00,-249.21,371083.85000000586,365905.28000000585,5178.570000000007
34445,2022-11-15 16:25:00,1785.63,372869.48000000586,365905.28000000585,6964.200000000012
34446,2022-11-15 16:30:00,-65.39,372804.09000000585,365905.28000000585,6898.809999999998
34447,2022-11-15 16:35:00,-1391.71,371412.3800000058,365905.28000000585,5507.099999999977
34448,2022-11-15 16:40:00,-894.93,370517.45000000583,365905.28000000585,4612.169999999984
34449,2022-11-15 16:45:00,-935.44,369582.01000000583,365905.28000000585,3676.7299999999814
34450,2022-11-15 16:50:00,486.93,370068.9400000058,365905.28000000585,4163.659999999974
34451,2022-11-15 16:55:00,-448.8,369620.14000000583,365905.28000000585,3714.859999999986
34452,2022-11-16 08:00:00,1484.64,371104.78000000585,369620.14000000583,1484.640000000014
34453,2022-11-16 08:05:00,-304.72,370800.0600000059,369620.14000000583,1179.920000000042
34454,2022-11-16 08:10:00,906.64,371706.7000000059,369620.14000000583,2086.560000000056
34455,2022-11-16 08:15:00,-650.45,371056.2500000059,369620.14000000583,1436.1100000000442
34456,2022-11-16 08:20:00,-60.56,370995.6900000059,369620.14000000583,1375.5500000000466
34457,2022-11-16 08:25:00,351.49,371347.1800000059,369620.14000000583,1727.0400000000373
34458,2022-11-16 08:30:00,-1221.39,370125.79000000586,369620.14000000583,505.6500000000233
34459,2022-11-16 08:35:00,-1855.3,368270.49000000587,369620.14000000583,-1349.649999999965
34460,2022-11-16 08:40:00,1059.27,369329.7600000059,369620.14000000583,-290.37999999994645
34461,2022-11-16 08:45:00,699.73,370029.49000000587,369620.14000000583,409.3500000000349
34462,2022-11-16 08:50:00,-510.0,369519.49000000587,369620.14000000583,-100.64999999996508
34463,2022-11-16 08:55:00,899.49,370418.98000000586,369620.14000000583,798.8400000000256
34464,2022-11-16 09:00:00,1105.49,371524.47000000585,369620.14000000583,1904.3300000000163
34465,2022-11-16 09:05:00,1204.41,372728.8800000058,369620.14000000583,3108.7399999999907
34466,2022-11-16 09:10:00,-1447.37,371281.51000000583,369620.14000000583,1661.3699999999953
34467,2022-11-16 09:15:00,237.65,371519.16000000585,369620.14000000583,1899.0200000000186
34468,2022-11-16 09:20:00,-1099.42,370419.74000000587,369620.14000000583,799.6000000000349
34469,2022-11-16 09:25:00,211.1,370630.84000000585,369620.14000000583,1010.7000000000116
34470,2022-11-16 09:30:00,-1552.97,369077.8700000059,369620.14000000583,-542.2699999999604
34471,2022-11-16 09:35:00,-1600.38,367477.49000000587,369620.14000000583,-2142.649999999965
34472,2022-11-16 09:40:00,-1579.15,365898.34000000585,369620.14000000583,-3721.7999999999884
34473,2022-11-16 09:45:00,-281.18,365617.16000000585,369620.14000000583,-4002.9799999999814
34474,2022-11-16 09:50:00,106.25,365723.41000000585,369620.14000000583,-3896.7299999999814
34475,2022-11-16 09:55:00,467.03,366190.4400000059,369620.14000000583,-3429.6999999999534
34476,2022-11-16 10:00:00,871.27,367061.7100000059,369620.14000000583,-2558.429999999935
34477,2022-11-16 10:05:00,-1731.44,365330.2700000059,369620.14000000583,-4289.869999999937
34478,2022-11-16 10:10:00,-1492.37,363837.9000000059,369620.14000000583,-5782.2399999999325
34479,2022-11-16 10:15:00,-947.99,362889.9100000059,369620.14000000583,-6730.229999999923
34480,2022-11-16 10:20:00,-28.01,362861.9000000059,369620.14000000583,-6758.2399999999325
34481,2022-11-16 10:25:00,688.96,363550.8600000059,369620.14000000583,-6069.2799999999115
34482,2022-11-16 10:30:00,-1078.62,362472.2400000059,369620.14000000583,-7147.899999999907
34483,2022-11-16 10:35:00,-1632.87,360839.37000000593,369620.14000000583,-8780.769999999902
34484,2022-11-16 10:40:00,-1649.25,359190.12000000593,369620.14000000583,-10430.019999999902
34485,2022-11-16 10:45:00,-1382.75,357807.37000000593,369620.14000000583,-11812.769999999902
34486,2022-11-16 10:50:00,-1654.39,356152.9800000059,369620.14000000583,-13467.159999999916
34487,2022-11-16 10:55:00,280.5,356433.4800000059,369620.14000000583,-13186.659999999916
34488,2022-11-16 11:00:00,-22.98,356410.50000000594,369620.14000000583,-13209.639999999898
34489,2022-11-16 11:05:00,577.11,356987.6100000059,369620.14000000583,-12632.529999999912
34490,2022-11-16 11:10:00,1596.37,358583.9800000059,369620.14000000583,-11036.159999999916
34491,2022-11-16 11:15:00,-692.27,357891.7100000059,369620.14000000583,-11728.429999999935
34492,2022-11-16 11:20:00,-245.17,357646.5400000059,369620.14000000583,-11973.599999999919
34493,2022-11-16 11:25:00,1107.23,358753.7700000059,369620.14000000583,-10866.369999999937
34494,2022-11-16 11:30:00,-577.37,358176.4000000059,369620.14000000583,-11443.739999999932
34495,2022-11-16 11:35:00,1487.76,359664.1600000059,369620.14000000583,-9955.979999999923
34496,2022-11-16 11:40:00,-503.69,359160.4700000059,369620.14000000583,-10459.669999999925
34497,2022-11-16 11:45:00,1013.1,360173.5700000059,369620.14000000583,-9446.569999999949
34498,2022-11-16 11:50:00,814.63,360988.2000000059,369620.14000000583,-8631.939999999944
34499,2022-11-16 11:55:00,-1880.93,359107.2700000059,369620.14000000583,-10512.869999999937
34500,2022-11-16 12:00:00,534.69,359641.9600000059,369620.14000000583,-9978.179999999935
34501,2022-11-16 12:05:00,-527.93,359114.0300000059,369620.14000000583,-10506.109999999928
34502,2022-11-16 12:10:00,1875.11,360989.1400000059,369620.14000000583,-8630.999999999942
34503,2022-11-16 12:15:00,-1945.52,359043.6200000059,369620.14000000583,-10576.51999999996
34504,2022-11-16 12:20:00,89.4,359133.0200000059,369620.14000000583,-10487.119999999937
34505,2022-11-16 12:25:00,-1410.11,357722.9100000059,369620.14000000583,-11897.229999999923
34506,2022-11-16 12:30:00,1489.04,359211.9500000059,369620.14000000583,-10408.189999999944
34507,2022-11-16 12:35:00,904.18,360116.1300000059,369620.14000000583,-9504.009999999951
34508,2022-11-16 12:40:00,1221.23,361337.36000000587,369620.14000000583,-8282.77999999997
34509,2022-11-16 12:45:00,1875.83,363213.1900000059,369620.14000000583,-6406.949999999953
34510,2022-11-16 12:50:00,-1970.27,361242.92000000586,369620.14000000583,-8377.219999999972
34511,2022-11-16 12:55:00,806.09,362049.0100000059,369620.14000000583,-7571.129999999946
34512,2022-11-16 13:00:00,386.7,362435.7100000059,369620.14000000583,-7184.429999999935
34513,2022-11-16 13:05:00,-405.16,362030.5500000059,369620.14000000583,-7589.589999999909
34514,2022-11-16 13:10:00,43.94,362074.4900000059,369620.14000000583,-7545.649999999907
34515,2022-11-16 13:15:00,-1030.13,361044.3600000059,369620.14000000583,-8575.779999999912
34516,2022-11-16 13:20:00,-1418.88,359625.4800000059,369620.14000000583,-9994.659999999916
34517,2022-11-16 13:25:00,758.58,360384.06000000593,369620.14000000583,-9236.0799999999
34518,2022-11-16 13:30:00,1862.07,362246.13000000594,369620.14000000583,-7374.009999999893
34519,2022-11-16 13:35:00,1302.28,363548.41000000597,369620.14000000583,-6071.729999999865
34520,2022-11-16 13:40:00,-1822.7,361725.71000000596,369620.14000000583,-7894.429999999877
34521,2022-11-16 13:45:00,-64.83,361660.88000000594,369620.14000000583,-7959.259999999893
34522,2022-11-16 13:50:00,-1461.89,360198.9900000059,369620.14000000583,-9421.149999999907
34523,2022-11-16 13:55:00,1586.84,361785.83000000595,369620.14000000583,-7834.309999999881
34524,2022-11-16 14:00:00,1274.78,363060.610000006,369620.14000000583,-6559.529999999853
34525,2022-11-16 14:05:00,-1440.99,361619.620000006,369620.14000000583,-8000.519999999844
34526,2022-11-16 14:10:00,1835.79,363455.41000000597,369620.14000000583,-6164.729999999865
34527,2022-11-16 14:15:00,-1622.77,361832.64000000595,369620.14000000583,-7787.499999999884
34528,2022-11-16 14:20:00,-1738.19,360094.45000000595,369620.14000000583,-9525.689999999886
34529,2022-11-16 14:25:00,-1131.95,358962.50000000594,369620.14000000583,-10657.639999999898
34530,2022-11-16 14:30:00,-1070.22,357892.28000000597,369620.14000000583,-11727.85999999987
34531,2022-11-16 14:35:00,1445.01,359337.290000006,369620.14000000583,-10282.84999999986
34532,2022-11-16 14:40:00,41.5,359378.790000006,369620.14000000583,-10241.34999999986
34533,2022-11-16 14:45:00,1801.47,361180.26000000595,369620.14000000583,-8439.879999999888
34534,2022-11-16 14:50:00,-1629.13,359551.13000000594,369620.14000000583,-10069.009999999893
34535,2022-11-16 14:55:00,-1983.74,357567.39000000595,369620.14000000583,-12052.749999999884
34536,2022-11-16 15:00:00,-1335.4,356231.9900000059,369620.14000000583,-13388.149999999907
34537,2022-11-16 15:05:00,-708.82,355523.1700000059,369620.14000000583,-14096.969999999914
34538,2022-11-16 15:10:00,534.46,356057.63000000594,369620.14000000583,-13562.509999999893
34539,2022-11-16 15:15:00,-652.13,355405.50000000594,369620.14000000583,-14214.639999999898
34540,2022-11-16 15:20:00,-495.02,354910.4800000059,369620.14000000583,-14709.659999999916
34541,2022-11-16 15:25:00,-408.91,354501.57000000594,369620.14000000583,-15118.56999999989
34542,2022-11-16 15:30:00,1299.86,355801.43000000593,369620.14000000583,-13818.709999999905
34543,2022-11-16 15:35:00,170.35,355971.7800000059,369620.14000000583,-13648.359999999928
34544,2022-11-16 15:40:00,-1601.11,354370.6700000059,369620.14000000583,-15249.469999999914
34545,2022-11-16 15:45:00,-1422.7,352947.9700000059,369620.14000000583,-16672.169999999925
34546,2022-11-16 15:50:00,-537.84,352410.1300000059,369620.14000000583,-17210.00999999995
34547,2022-11-16 15:55:00,632.52,353042.6500000059,369620.14000000583,-16577.489999999932
34548,2022-11-16 16:00:00,-271.43,352771.2200000059,369620.14000000583,-16848.919999999925
34549,2022-11-16 16:05:00,-1273.39,351497.8300000059,369620.14000000583,-18122.30999999994
34550,2022-11-16 16:10:00,-1075.41,350422.4200000059,369620.14000000583,-19197.719999999914
34551,2022-11-16 16:15:00,-296.5,350125.9200000059,369620.14000000583,-19494.219999999914
34552,2022-11-16 16:20:00,921.46,351047.38000000594,369620.14000000583,-18572.759999999893
34553,2022-11-16 16:25:00,-1006.2,350041.18000000593,369620.14000000583,-19578.959999999905
34554,2022-11-16 16:30:00,-494.89,349546.2900000059,369620.14000000583,-20073.84999999992
34555,2022-11-16 16:35:00,-1322.32,348223.9700000059,369620.14000000583,-21396.169999999925
34556,2022-11-16 16:40:00,872.66,349096.6300000059,369620.14000000583,-20523.50999999995
34557,2022-11-16 16:45:00,550.5,349647.1300000059,369620.14000000583,-19973.00999999995
34558,2022-11-16 16:50:00,1254.57,350901.7000000059,369620.14000000583,-18718.439999999944
34559,2022-11-16 16:55:00,385.47,351287.17000000586,369620.14000000583,-18332.969999999972
34560,2022-11-17 08:00:00,281.41,351568.58000000584,351287.17000000586,281.4099999999744
34561,2022-11-17 08:05:00,-934.69,350633.89000000583,351287.17000000586,-653.2800000000279
34562,2022-11-17 08:10:00,989.0,351622.89000000583,351287.17000000586,335.71999999997206
34563,2022-11-17 08:15:00,-1044.42,350578.47000000585,351287.17000000586,-708.7000000000116
34564,2022-11-17 08:20:00,-208.99,350369.48000000586,351287.17000000586,-917.6900000000023
34565,2022-11-17 08:25:00,694.24,351063.72000000585,351287.17000000586,-223.45000000001164
34566,2022-11-17 08:30:00,1978.39,353042.11000000587,351287.17000000586,1754.9400000000023
34567,2022-11-17 08:35:00,1004.77,354046.8800000059,351287.17000000586,2759.710000000021
34568,2022-11-17 08:40:00,893.15,354940.0300000059,351287.17000000586,3652.8600000000442
34569,2022-11-17 08:45:00,434.32,355374.3500000059,351287.17000000586,4087.180000000051
34570,2022-11-17 08:50:00,745.58,356119.93000000593,351287.17000000586,4832.7600000000675
34571,2022-11-17 08:55:00,985.03,357104.96000000596,351287.17000000586,5817.7900000000955
34572,2022-11-17 09:00:00,-747.68,356357.28000000597,351287.17000000586,5070.110000000102
34573,2022-11-17 09:05:00,-266.66,356090.620000006,351287.17000000586,4803.450000000128
34574,2022-11-17 09:10:00,-256.47,355834.150000006,351287.17000000586,4546.980000000156
34575,2022-11-17 09:15:00,-1301.42,354532.73000000603,351287.17000000586,3245.5600000001723
34576,2022-11-17 09:20:00,-630.66,353902.07000000606,351287.17000000586,2614.900000000198
34577,2022-11-17 09:25:00,1678.72,355580.79000000603,351287.17000000586,4293.62000000017
34578,2022-11-17 09:30:00,1430.34,357011.13000000606,351287.17000000586,5723.960000000196
34579,2022-11-17 09:35:00,755.26,357766.39000000607,351287.17000000586,6479.220000000205
34580,2022-11-17 09:40:00,-1149.36,356617.0300000061,351287.17000000586,5329.860000000219
34581,2022-11-17 09:45:00,-1850.85,354766.1800000061,351287.17000000586,3479.010000000242
34582,2022-11-17 09:50:00,-1535.74,353230.4400000061,351287.17000000586,1943.2700000002515
34583,2022-11-17 09:55:00,29.08,353259.52000000613,351287.17000000586,1972.3500000002678
34584,2022-11-17 10:00:00,1994.44,355253.96000000613,351287.17000000586,3966.79000000027
34585,2022-11-17 10:05:00,-1443.55,353810.41000000614,351287.17000000586,2523.2400000002817
34586,2022-11-17 10:10:00,-989.58,352820.8300000061,351287.17000000586,1533.6600000002654
34587,2022-11-17 10:15:00,-1211.33,351609.5000000061,351287.17000000586,322.33000000024913
34588,2022-11-17 10:20:00,582.36,352191.8600000061,351287.17000000586,904.6900000002352
34589,2022-11-17 10:25:00,598.72,352790.58000000607,351287.17000000586,1503.4100000002072
34590,2022-11-17 10:30:00,1947.06,354737.64000000607,351287.17000000586,3450.470000000205
34591,2022-11-17 10:35:00,-1010.8,353726.8400000061,351287.17000000586,2439.6700000002165
34592,2022-11-17 10:40:00,1342.08,355068.9200000061,351287.17000000586,3781.750000000233
34593,2022-11-17 10:45:00,1634.35,356703.2700000061,351287.17000000586,5416.10000000021
34594,2022-11-17 10:50:00,953.01,357656.2800000061,351287.17000000586,6369.110000000219
34595,2022-11-17 10:55:00,624.03,358280.3100000061,351287.17000000586,6993.140000000247
34596,2022-11-17 11:00:00,-289.72,357990.59000000614,351287.17000000586,6703.420000000275
34597,2022-11-17 11:05:00,-964.99,357025.60000000615,351287.17000000586,5738.430000000284
34598,2022-11-17 11:10:00,497.35,357522.9500000061,351287.17000000586,6235.780000000261
34599,2022-11-17 11:15:00,807.08,358330.03000000614,351287.17000000586,7042.860000000277
34600,2022-11-17 11:20:00,1118.84,359448.87000000617,351287.17000000586,8161.700000000303
34601,2022-11-17 11:25:00,-664.06,358784.81000000617,351287.17000000586,7497.640000000305
34602,2022-11-17 11:30:00,-590.05,358194.7600000062,351287.17000000586,6907.590000000317
34603,2022-11-17 11:35:00,1311.9,359506.6600000062,351287.17000000586,8219.49000000034
34604,2022-11-17 11:40:00,-1327.12,358179.5400000062,351287.17000000586,6892.370000000345
34605,2022-11-17 11:45:00,1124.83,359304.3700000062,351287.17000000586,8017.200000000361
34606,2022-11-17 11:50:00,-913.56,358390.8100000062,351287.17000000586,7103.640000000363
34607,2022-11-17 11:55:00,1895.06,360285.8700000062,351287.17000000586,8998.70000000036
34608,2022-11-17 12:00:00,456.02,360741.89000000624,351287.17000000586,9454.72000000038
34609,2022-11-17 12:05:00,633.8,361375.69000000623,351287.17000000586,10088.520000000368
34610,2022-11-17 12:10:00,-1311.65,360064.0400000062,351287.17000000586,8776.870000000345
34611,2022-11-17 12:15:00,384.78,360448.82000000624,351287.17000000586,9161.650000000373
34612,2022-11-17 12:20:00,-1702.18,358746.64000000624,351287.17000000586,7459.4700000003795
34613,2022-11-17 12:25:00,1459.22,360205.8600000062,351287.17000000586,8918.690000000352
34614,2022-11-17 12:30:00,-1430.18,358775.6800000062,351287.17000000586,7488.510000000359
34615,2022-11-17 12:35:00,1064.45,359840.13000000623,351287.17000000586,8552.96000000037
34616,2022-11-17 12:40:00,1953.94,361794.07000000624,351287.17000000586,10506.900000000373
34617,2022-11-17 12:45:00,-391.88,361402.19000000623,351287.17000000586,10115.020000000368
34618,2022-11-17 12:50:00,113.76,361515.95000000624,351287.17000000586,10228.780000000377
34619,2022-11-17 12:55:00,-371.14,361144.8100000062,351287.17000000586,9857.640000000363
34620,2022-11-17 13:00:00,-873.14,360271.6700000062,351287.17000000586,8984.50000000035
34621,2022-11-17 13:05:00,69.44,360341.1100000062,351287.17000000586,9053.940000000352
34622,2022-11-17 13:10:00,694.29,361035.4000000062,351287.17000000586,9748.23000000033
34623,2022-11-17 13:15:00,-54.4,360981.00000000617,351287.17000000586,9693.830000000307
34624,2022-11-17 13:20:00,-1864.95,359116.05000000616,351287.17000000586,7828.880000000296
34625,2022-11-17 13:25:00,1533.2,360649.25000000617,351287.17000000586,9362.080000000307
34626,2022-11-17 13:30:00,216.96,360866.2100000062,351287.17000000586,9579.040000000328
34627,2022-11-17 13:35:00,-1719.73,359146.4800000062,351287.17000000586,7859.310000000347
34628,2022-11-17 13:40:00,1709.24,360855.7200000062,351287.17000000586,9568.550000000338
34629,2022-11-17 13:45:00,700.07,361555.7900000062,351287.17000000586,10268.620000000345
34630,2022-11-17 13:50:00,-796.01,360759.7800000062,351287.17000000586,9472.610000000335
34631,2022-11-17 13:55:00,768.99,361528.7700000062,351287.17000000586,10241.600000000326
34632,2022-11-17 14:00:00,1542.44,363071.2100000062,351287.17000000586,11784.040000000328
34633,2022-11-17 14:05:00,-751.64,362319.5700000062,351287.17000000586,11032.400000000314
34634,2022-11-17 14:10:00,103.23,362422.80000000616,351287.17000000586,11135.630000000296
34635,2022-11-17 14:15:00,-555.91,361866.8900000062,351287.17000000586,10579.720000000321
34636,2022-11-17 14:20:00,-1093.06,360773.8300000062,351287.17000000586,9486.660000000324
34637,2022-11-17 14:25:00,-1068.47,359705.3600000062,351287.17000000586,8418.190000000352
34638,2022-11-17 14:30:00,889.29,360594.6500000062,351287.17000000586,9307.48000000033
34639,2022-11-17 14:35:00,-1403.95,359190.7000000062,351287.17000000586,7903.530000000319
34640,2022-11-17 14:40:00,-367.67,358823.0300000062,351287.17000000586,7535.860000000335
34641,2022-11-17 14:45:00,-746.63,358076.4000000062,351287.17000000586,6789.230000000331
34642,2022-11-17 14:50:00,1182.57,359258.9700000062,351287.17000000586,7971.800000000338
34643,2022-11-17 14:55:00,1549.33,360808.3000000062,351287.17000000586,9521.130000000354
34644,2022-11-17 15:00:00,-724.94,360083.3600000062,351287.17000000586,8796.190000000352
34645,2022-11-17 15:05:00,359.79,360443.1500000062,351287.17000000586,9155.98000000033
34646,2022-11-17 15:10:00,-895.89,359547.2600000062,351287.17000000586,8260.090000000317
34647,2022-11-17 15:15:00,785.53,360332.7900000062,351287.17000000586,9045.620000000345
34648,2022-11-17 15:20:00,-290.06,360042.7300000062,351287.17000000586,8755.560000000347
34649,2022-11-17 15:25:00,-1672.99,358369.7400000062,351287.17000000586,7082.570000000356
34650,2022-11-17 15:30:00,-1817.01,356552.7300000062,351287.17000000586,5265.560000000347
34651,2022-11-17 15:35:00,-1851.05,354701.6800000062,351287.17000000586,3414.5100000003586
34652,2022-11-17 15:40:00,-1571.72,353129.96000000625,351287.17000000586,1842.7900000003865
34653,2022-11-17 15:45:00,-916.62,352213.34000000625,351287.17000000586,926.1700000003912
34654,2022-11-17 15:50:00,-1440.32,350773.02000000625,351287.17000000586,-514.1499999996158
34655,2022-11-17 15:55:00,-190.8,350582.22000000626,351287.17000000586,-704.9499999996042
34656,2022-11-17 16:00:00,1995.29,352577.51000000624,351287.17000000586,1290.3400000003749
34657,2022-11-17 16:05:00,-354.91,352222.60000000626,351287.17000000586,935.4300000004005
34658,2022-11-17 16:10:00,-1648.44,350574.16000000626,351287.17000000586,-713.0099999996019
34659,2022-11-17 16:15:00,37.74,350611.90000000625,351287.17000000586,-675.2699999996112
34660,2022-11-17 16:20:00,1958.85,352570.7500000062,351287.17000000586,1283.5800000003655
34661,2022-11-17 16:25:00,905.13,353475.88000000623,351287.17000000586,2188.71000000037
34662,2022-11-17 16:30:00,-1006.44,352469.44000000623,351287.17000000586,1182.2700000003679
34663,2022-11-17 16:35:00,1459.5,353928.94000000623,351287.17000000586,2641.770000000368
34664,2022-11-17 16:40:00,-1452.77,352476.1700000062,351287.17000000586,1189.0000000003492
34665,2022-11-17 16:45:00,557.8,353033.9700000062,351287.17000000586,1746.8000000003376
34666,2022-11-17 16:50:00,755.05,353789.0200000062,351287.17000000586,2501.850000000326
34667,2022-11-17 16:55:00,-1608.8,352180.2200000062,351287.17000000586,893.0500000003376
34668,2022-11-18 08:00:00,-1830.99,350349.2300000062,352180.2200000062,-1830.9899999999907
34669,2022-11-18 08:05:00,-1304.07,349045.1600000062,352180.2200000062,-3135.0599999999977
34670,2022-11-18 08:10:00,-1190.48,347854.6800000062,352180.2200000062,-4325.539999999979
34671,2022-11-18 08:15:00,-611.58,347243.1000000062,352180.2200000062,-4937.119999999995
34672,2022-11-18 08:20:00,-1733.66,345509.44000000623,352180.2200000062,-6670.77999999997
34673,2022-11-18 08:25:00,-570.14,344939.3000000062,352180.2200000062,-7240.919999999984
34674,2022-11-18 08:30:00,178.61,345117.9100000062,352180.2200000062,-7062.309999999998
34675,2022-11-18 08:35:00,61.08,345178.9900000062,352180.2200000062,-7001.229999999981
34676,2022-11-18 08:40:00,439.86,345618.8500000062,352180.2200000062,-6561.369999999995
34677,2022-11-18 08:45:00,382.49,346001.3400000062,352180.2200000062,-6178.880000000005
34678,2022-11-18 08:50:00,267.57,346268.9100000062,352180.2200000062,-5911.309999999998
34679,2022-11-18 08:55:00,-577.12,345691.7900000062,352180.2200000062,-6488.429999999993
34680,2022-11-18 09:00:00,1534.85,347226.6400000062,352180.2200000062,-4953.580000000016
34681,2022-11-18 09:05:00,202.83,347429.4700000062,352180.2200000062,-4750.75
34682,2022-11-18 09:10:00,368.12,347797.5900000062,352180.2200000062,-4382.630000000005
34683,2022-11-18 09:15:00,238.03,348035.6200000062,352180.2200000062,-4144.599999999977
34684,2022-11-18 09:20:00,303.07,348338.69000000623,352180.2200000062,-3841.5299999999697
34685,2022-11-18 09:25:00,-678.85,347659.84000000625,352180.2200000062,-4520.379999999946
34686,2022-11-18 09:30:00,975.46,348635.3000000063,352180.2200000062,-3544.9199999999255
34687,2022-11-18 09:35:00,1869.66,350504.96000000625,352180.2200000062,-1675.259999999951
34688,2022-11-18 09:40:00,-1829.14,348675.82000000624,352180.2200000062,-3504.399999999965
34689,2022-11-18 09:45:00,-1631.09,347044.7300000062,352180.2200000062,-5135.489999999991
34690,2022-11-18 09:50:00,529.33,347574.0600000062,352180.2200000062,-4606.159999999974
34691,2022-11-18 09:55:00,-707.97,346866.09000000625,352180.2200000062,-5314.129999999946
34692,2022-11-18 10:00:00,-1815.62,345050.47000000626,352180.2200000062,-7129.749999999942
34693,2022-11-18 10:05:00,1522.35,346572.82000000624,352180.2200000062,-5607.399999999965
34694,2022-11-18 10:10:00,1252.97,347825.7900000062,352180.2200000062,-4354.429999999993
34695,2022-11-18 10:15:00,-1373.58,346452.2100000062,352180.2200000062,-5728.010000000009
34696,2022-11-18 10:20:00,-1831.87,344620.3400000062,352180.2200000062,-7559.880000000005
34697,2022-11-18 10:25:00,1946.93,346567.2700000062,352180.2200000062,-5612.950000000012
34698,2022-11-18 10:30:00,1915.23,348482.50000000617,352180.2200000062,-3697.7200000000303
34699,2022-11-18 10:35:00,-1134.67,347347.8300000062,352180.2200000062,-4832.390000000014
34700,2022-11-18 10:40:00,-808.37,346539.4600000062,352180.2200000062,-5640.760000000009
34701,2022-11-18 10:45:00,1948.48,348487.9400000062,352180.2200000062,-3692.280000000028
34702,2022-11-18 10:50:00,-608.34,347879.60000000615,352180.2200000062,-4300.620000000054
34703,2022-11-18 10:55:00,1013.02,348892.62000000617,352180.2200000062,-3287.600000000035
34704,2022-11-18 11:00:00,728.22,349620.84000000614,352180.2200000062,-2559.380000000063
34705,2022-11-18 11:05:00,-1317.65,348303.1900000061,352180.2200000062,-3877.030000000086
34706,2022-11-18 11:10:00,409.44,348712.6300000061,352180.2200000062,-3467.590000000084
34707,2022-11-18 11:15:00,-1604.05,347108.5800000061,352180.2200000062,-5071.640000000072
34708,2022-11-18 11:20:00,-1218.15,345890.4300000061,352180.2200000062,-6289.7900000000955
34709,2022-11-18 11:25:00,-326.38,345564.0500000061,352180.2200000062,-6616.1700000001
34710,2022-11-18 11:30:00,935.21,346499.2600000061,352180.2200000062,-5680.960000000079
34711,2022-11-18 11:35:00,476.3,346975.5600000061,352180.2200000062,-5204.660000000091
34712,2022-11-18 11:40:00,1217.53,348193.09000000614,352180.2200000062,-3987.130000000063
34713,2022-11-18 11:45:00,-569.18,347623.91000000614,352180.2200000062,-4556.310000000056
34714,2022-11-18 11:50:00,-891.03,346732.8800000061,352180.2200000062,-5447.340000000084
34715,2022-11-18 11:55:00,417.19,347150.0700000061,352180.2200000062,-5030.1500000000815
34716,2022-11-18 12:00:00,-358.95,346791.1200000061,352180.2200000062,-5389.100000000093
34717,2022-11-18 12:05:00,569.64,347360.7600000061,352180.2200000062,-4819.460000000079
34718,2022-11-18 12:10:00,885.8,348246.5600000061,352180.2200000062,-3933.660000000091
34719,2022-11-18 12:15:00,1131.63,349378.1900000061,352180.2200000062,-2802.030000000086
34720,2022-11-18 12:20:00,304.52,349682.71000000613,352180.2200000062,-2497.5100000000675
34721,2022-11-18 12:25:00,-732.23,348950.48000000615,352180.2200000062,-3229.740000000049
34722,2022-11-18 12:30:00,-906.61,348043.87000000617,352180.2200000062,-4136.350000000035
34723,2022-11-18 12:35:00,175.19,348219.06000000617,352180.2200000062,-3961.1600000000326
34724,2022-11-18 12:40:00,1769.96,349989.0200000062,352180.2200000062,-2191.2000000000116
34725,2022-11-18 12:45:00,1563.59,351552.6100000062,352180.2200000062,-627.609999999986
34726,2022-11-18 12:50:00,393.09,351945.70000000624,352180.2200000062,-234.51999999996042
34727,2022-11-18 12:55:00,298.59,352244.29000000627,352180.2200000062,64.07000000006519
34728,2022-11-18 13:00:00,-1399.64,350844.65000000625,352180.2200000062,-1335.5699999999488
34729,2022-11-18 13:05:00,278.33,351122.98000000627,352180.2200000062,-1057.2399999999325
34730,2022-11-18 13:10:00,1849.22,352972.20000000624,352180.2200000062,791.9800000000396
34731,2022-11-18 13:15:00,-1437.77,351534.4300000062,352180.2200000062,-645.789999999979
34732,2022-11-18 13:20:00,-203.17,351331.26000000624,352180.2200000062,-848.9599999999627
34733,2022-11-18 13:25:00,1710.13,353041.39000000624,352180.2200000062,861.1700000000419
34734,2022-11-18 13:30:00,587.58,353628.97000000626,352180.2200000062,1448.7500000000582
34735,2022-11-18 13:35:00,-547.26,353081.71000000625,352180.2200000062,901.4900000000489
34736,2022-11-18 13:40:00,467.53,353549.2400000063,352180.2200000062,1369.0200000000768
34737,2022-11-18 13:45:00,1210.18,354759.42000000627,352180.2200000062,2579.20000000007
34738,2022-11-18 13:50:00,803.51,355562.9300000063,352180.2200000062,3382.710000000079
34739,2022-11-18 13:55:00,-1765.5,353797.4300000063,352180.2200000062,1617.2100000000792
34740,2022-11-18 14:00:00,-1097.34,352700.09000000625,352180.2200000062,519.8700000000536
34741,2022-11-18 14:05:00,-341.97,352358.1200000063,352180.2200000062,177.9000000000815
34742,2022-11-18 14:10:00,1255.58,353613.7000000063,352180.2200000062,1433.4800000000978
34743,2022-11-18 14:15:00,791.63,354405.3300000063,352180.2200000062,2225.1100000001024
34744,2022-11-18 14:20:00,-1546.81,352858.5200000063,352180.2200000062,678.3000000001048
34745,2022-11-18 14:25:00,-1238.11,351620.4100000063,352180.2200000062,-559.8099999998813
34746,2022-11-18 14:30:00,841.01,352461.4200000063,352180.2200000062,281.20000000012806
34747,2022-11-18 14:35:00,1492.06,353953.4800000063,352180.2200000062,1773.2600000001257
34748,2022-11-18 14:40:00,641.32,354594.80000000633,352180.2200000062,2414.5800000001327
34749,2022-11-18 14:45:00,69.35,354664.1500000063,352180.2200000062,2483.9300000001094
34750,2022-11-18 14:50:00,160.92,354825.0700000063,352180.2200000062,2644.850000000093
34751,2022-11-18 14:55:00,-1704.51,353120.5600000063,352180.2200000062,940.3400000000838
34752,2022-11-18 15:00:00,-735.03,352385.53000000626,352180.2200000062,205.31000000005588
34753,2022-11-18 15:05:00,1725.22,354110.7500000062,352180.2200000062,1930.530000000028
34754,2022-11-18 15:10:00,-1915.41,352195.34000000625,352180.2200000062,15.120000000053551
34755,2022-11-18 15:15:00,-1445.14,350750.20000000624,352180.2200000062,-1430.0199999999604
34756,2022-11-18 15:20:00,181.45,350931.65000000625,352180.2200000062,-1248.5699999999488
34757,2022-11-18 15:25:00,1103.48,352035.13000000623,352180.2200000062,-145.0899999999674
34758,2022-11-18 15:30:00,-233.04,351802.09000000625,352180.2200000062,-378.12999999994645
34759,2022-11-18 15:35:00,-1343.41,350458.6800000063,352180.2200000062,-1721.5399999999208
34760,2022-11-18 15:40:00,1231.71,351690.3900000063,352180.2200000062,-489.8299999998999
34761,2022-11-18 15:45:00,1986.89,353677.2800000063,352180.2200000062,1497.060000000114
34762,2022-11-18 15:50:00,-813.98,352863.30000000633,352180.2200000062,683.0800000001327
34763,2022-11-18 15:55:00,135.08,352998.38000000635,352180.2200000062,818.160000000149
34764,2022-11-18 16:00:00,220.39,353218.77000000636,352180.2200000062,1038.550000000163
34765,2022-11-18 16:05:00,-1277.29,351941.4800000064,352180.2200000062,-238.73999999981606
34766,2022-11-18 16:10:00,-316.61,351624.8700000064,352180.2200000062,-555.3499999998021
34767,2022-11-18 16:15:00,-1794.73,349830.1400000064,352180.2200000062,-2350.0799999997835
34768,2022-11-18 16:20:00,-794.63,349035.5100000064,352180.2200000062,-3144.709999999788
34769,2022-11-18 16:25:00,876.14,349911.6500000064,352180.2200000062,-2268.569999999774
34770,2022-11-18 16:30:00,-619.2,349292.4500000064,352180.2200000062,-2887.769999999786
34771,2022-11-18 16:35:00,1218.84,350511.29000000644,352180.2200000062,-1668.9299999997602
34772,2022-11-18 16:40:00,1807.19,352318.48000000644,352180.2200000062,138.26000000024214
34773,2022-11-18 16:45:00,-1996.37,350322.11000000645,352180.2200000062,-1858.1099999997532
34774,2022-11-18 16:50:00,1642.7,351964.81000000646,352180.2200000062,-215.40999999974156
34775,2022-11-18 16:55:00,353.68,352318.49000000645,352180.2200000062,138.27000000025146
34776,2022-11-19 08:00:00,-384.81,351933.68000000645,352318.49000000645,-384.8099999999977
34777,2022-11-19 08:05:00,1128.47,353062.1500000064,352318.49000000645,743.6599999999744
34778,2022-11-19 08:10:00,289.92,353352.0700000064,352318.49000000645,1033.579999999958
34779,2022-11-19 08:15:00,-996.57,352355.5000000064,352318.49000000645,37.009999999951106
34780,2022-11-19 08:20:00,-13.84,352341.6600000064,352318.49000000645,23.169999999925494
34781,2022-11-19 08:25:00,-1716.84,350624.82000000635,352318.49000000645,-1693.6700000001001
34782,2022-11-19 08:30:00,-477.3,350147.52000000636,352318.49000000645,-2170.9700000000885
34783,2022-11-19 08:35:00,484.56,350632.08000000636,352318.49000000645,-1686.4100000000908
34784,2022-11-19 08:40:00,-441.55,350190.5300000064,352318.49000000645,-2127.960000000079
34785,2022-11-19 08:45:00,269.56,350460.09000000637,352318.49000000645,-1858.4000000000815
34786,2022-11-19 08:50:00,1804.05,352264.14000000636,352318.49000000645,-54.35000000009313
34787,2022-11-19 08:55:00,747.05,353011.19000000635,352318.49000000645,692.6999999998952
34788,2022-11-19 09:00:00,1163.77,354174.96000000637,352318.49000000645,1856.4699999999139
34789,2022-11-19 09:05:00,-1101.14,353073.82000000635,352318.49000000645,755.3299999998999
34790,2022-11-19 09:10:00,11.21,353085.0300000064,352318.49000000645,766.5399999999208
34791,2022-11-19 09:15:00,149.2,353234.2300000064,352318.49000000645,915.7399999999325
34792,2022-11-19 09:20:00,85.85,353320.08000000636,352318.49000000645,1001.5899999999092
34793,2022-11-19 09:25:00,-1523.39,351796.69000000635,352318.49000000645,-521.8000000001048
34794,2022-11-19 09:30:00,790.52,352587.21000000637,352318.49000000645,268.71999999991385
34795,2022-11-19 09:35:00,-375.8,352211.4100000064,352318.49000000645,-107.0800000000745
34796,2022-11-19 09:40:00,1164.31,353375.7200000064,352318.49000000645,1057.2299999999232
34797,2022-11-19 09:45:00,1941.56,355317.2800000064,352318.49000000645,2998.789999999921
34798,2022-11-19 09:50:00,-848.47,354468.8100000064,352318.49000000645,2150.319999999949
34799,2022-11-19 09:55:00,-1145.04,353323.7700000064,352318.49000000645,1005.2799999999697
34800,2022-11-19 10:00:00,1110.06,354433.8300000064,352318.49000000645,2115.3399999999674
34801,2022-11-19 10:05:00,-1292.86,353140.97000000643,352318.49000000645,822.4799999999814
34802,2022-11-19 10:10:00,143.72,353284.6900000064,352318.49000000645,966.1999999999534
34803,2022-11-19 10:15:00,1554.58,354839.2700000064,352318.49000000645,2520.7799999999697
34804,2022-11-19 10:20:00,1879.36,356718.6300000064,352318.49000000645,4400.139999999956
34805,2022-11-19 10:25:00,1466.07,358184.7000000064,352318.49000000645,5866.209999999963
34806,2022-11-19 10:30:00,626.14,358810.8400000064,352318.49000000645,6492.349999999977
34807,2022-11-19 10:35:00,-1767.51,357043.3300000064,352318.49000000645,4724.839999999967
34808,2022-11-19 10:40:00,-1884.24,355159.0900000064,352318.49000000645,2840.5999999999767
34809,2022-11-19 10:45:00,492.81,355651.9000000064,352318.49000000645,3333.4099999999744
34810,2022-11-19 10:50:00,569.4,356221.30000000645,352318.49000000645,3902.8099999999977
34811,2022-11-19 10:55:00,1724.43,357945.73000000644,352318.49000000645,5627.239999999991
34812,2022-11-19 11:00:00,211.07,358156.80000000645,352318.49000000645,5838.309999999998
34813,2022-11-19 11:05:00,-767.59,357389.2100000064,352318.49000000645,5070.719999999972
34814,2022-11-19 11:10:00,1453.0,358842.2100000064,352318.49000000645,6523.719999999972
34815,2022-11-19 11:15:00,-1479.19,357363.0200000064,352318.49000000645,5044.52999999997
34816,2022-11-19 11:20:00,161.76,357524.78000000643,352318.49000000645,5206.289999999979
34817,2022-11-19 11:25:00,-1105.66,356419.12000000646,352318.49000000645,4100.630000000005
34818,2022-11-19 11:30:00,1342.42,357761.54000000644,352318.49000000645,5443.049999999988
34819,2022-11-19 11:35:00,-1050.34,356711.2000000064,352318.49000000645,4392.709999999963
34820,2022-11-19 11:40:00,113.4,356824.60000000644,352318.49000000645,4506.109999999986
34821,2022-11-19 11:45:00,-928.76,355895.8400000064,352318.49000000645,3577.3499999999767
34822,2022-11-19 11:50:00,-789.88,355105.9600000064,352318.49000000645,2787.469999999972
34823,2022-11-19 11:55:00,1344.18,356450.1400000064,352318.49000000645,4131.649999999965
34824,2022-11-19 12:00:00,277.7,356727.8400000064,352318.49000000645,4409.349999999977
34825,2022-11-19 12:05:00,1715.66,358443.5000000064,352318.49000000645,6125.009999999951
34826,2022-11-19 12:10:00,-1918.96,356524.5400000064,352318.49000000645,4206.04999999993
34827,2022-11-19 12:15:00,-543.48,355981.0600000064,352318.49000000645,3662.569999999949
34828,2022-11-19 12:20:00,1564.98,357546.0400000064,352318.49000000645,5227.54999999993
34829,2022-11-19 12:25:00,1246.7,358792.7400000064,352318.49000000645,6474.249999999942
34830,2022-11-19 12:30:00,623.55,359416.2900000064,352318.49000000645,7097.79999999993
34831,2022-11-19 12:35:00,-1667.89,357748.40000000637,352318.49000000645,5429.909999999916
34832,2022-11-19 12:40:00,-1322.6,356425.8000000064,352318.49000000645,4107.3099999999395
34833,2022-11-19 12:45:00,1361.49,357787.2900000064,352318.49000000645,5468.79999999993
34834,2022-11-19 12:50:00,-799.59,356987.70000000636,352318.49000000645,4669.2099999999045
34835,2022-11-19 12:55:00,-1845.75,355141.95000000636,352318.49000000645,2823.4599999999045
34836,2022-11-19 13:00:00,-866.25,354275.70000000636,352318.49000000645,1957.2099999999045
34837,2022-11-19 13:05:00,-791.9,353483.80000000633,352318.49000000645,1165.3099999998813
34838,2022-11-19 13:10:00,-592.95,352890.8500000063,352318.49000000645,572.3599999998696
34839,2022-11-19 13:15:00,701.76,353592.61000000633,352318.49000000645,1274.119999999879
34840,2022-11-19 13:20:00,-536.11,353056.50000000634,352318.49000000645,738.0099999998929
34841,2022-11-19 13:25:00,-689.18,352367.32000000635,352318.49000000645,48.82999999989988
34842,2022-11-19 13:30:00,90.64,352457.96000000637,352318.49000000645,139.46999999991385
34843,2022-11-19 13:35:00,1564.96,354022.9200000064,352318.49000000645,1704.4299999999348
34844,2022-11-19 13:40:00,-793.57,353229.3500000064,352318.49000000645,910.8599999999278
34845,2022-11-19 13:45:00,-1560.03,351669.32000000635,352318.49000000645,-649.1700000001001
34846,2022-11-19 13:50:00,-1889.62,349779.70000000636,352318.49000000645,-2538.7900000000955
34847,2022-11-19 13:55:00,-671.35,349108.3500000064,352318.49000000645,-3210.140000000072
34848,2022-11-19 14:00:00,1822.38,350930.7300000064,352318.49000000645,-1387.7600000000675
34849,2022-11-19 14:05:00,-99.0,350831.7300000064,352318.49000000645,-1486.7600000000675
34850,2022-11-19 14:10:00,171.89,351003.6200000064,352318.49000000645,-1314.8700000000536
34851,2022-11-19 14:15:00,1659.07,352662.6900000064,352318.49000000645,344.19999999995343
34852,2022-11-19 14:20:00,-1978.9,350683.7900000064,352318.49000000645,-1634.7000000000698
34853,2022-11-19 14:25:00,-774.88,349908.9100000064,352318.49000000645,-2409.5800000000745
34854,2022-11-19 14:30:00,1836.19,351745.1000000064,352318.49000000645,-573.3900000000722
34855,2022-11-19 14:35:00,1029.35,352774.45000000636,352318.49000000645,455.95999999990454
34856,2022-11-19 14:40:00,977.89,353752.34000000637,352318.49000000645,1433.8499999999185
34857,2022-11-19 14:45:00,499.84,354252.1800000064,352318.49000000645,1933.6899999999441
34858,2022-11-19 14:50:00,-1701.21,352550.9700000064,352318.49000000645,232.47999999992317
34859,2022-11-19 14:55:00,1497.38,354048.3500000064,352318.49000000645,1729.8599999999278
34860,2022-11-19 15:00:00,1036.44,355084.7900000064,352318.49000000645,2766.29999999993
34861,2022-11-19 15:05:00,-1164.62,353920.1700000064,352318.49000000645,1601.6799999999348
34862,2022-11-19 15:10:00,1302.12,355222.2900000064,352318.49000000645,2903.79999999993
34863,2022-11-19 15:15:00,-1693.21,353529.08000000636,352318.49000000645,1210.5899999999092
34864,2022-11-19 15:20:00,342.42,353871.50000000634,352318.49000000645,1553.009999999893
34865,2022-11-19 15:25:00,806.77,354678.27000000636,352318.49000000645,2359.7799999999115
34866,2022-11-19 15:30:00,659.87,355338.14000000636,352318.49000000645,3019.649999999907
34867,2022-11-19 15:35:00,1572.05,356910.19000000635,352318.49000000645,4591.699999999895
34868,2022-11-19 15:40:00,1304.94,358215.13000000635,352318.49000000645,5896.639999999898
34869,2022-11-19 15:45:00,1533.65,359748.7800000064,352318.49000000645,7430.289999999921
34870,2022-11-19 15:50:00,-246.75,359502.0300000064,352318.49000000645,7183.539999999921
34871,2022-11-19 15:55:00,1992.81,361494.84000000637,352318.49000000645,9176.349999999919
34872,2022-11-19 16:00:00,-1561.01,359933.83000000636,352318.49000000645,7615.339999999909
34873,2022-11-19 16:05:00,-727.47,359206.3600000064,352318.49000000645,6887.869999999937
34874,2022-11-19 16:10:00,-1761.05,357445.3100000064,352318.49000000645,5126.819999999949
34875,2022-11-19 16:15:00,-1518.4,355926.9100000064,352318.49000000645,3608.4199999999255
34876,2022-11-19 16:20:00,706.08,356632.9900000064,352318.49000000645,4314.499999999942
34877,2022-11-19 16:25:00,-1446.91,355186.0800000064,352318.49000000645,2867.5899999999674
34878,2022-11-19 16:30:00,120.96,355307.04000000644,352318.49000000645,2988.5499999999884
34879,2022-11-19 16:35:00,448.19,355755.23000000644,352318.49000000645,3436.7399999999907
34880,2022-11-19 16:40:00,-1921.79,353833.44000000646,352318.49000000645,1514.9500000000116
34881,2022-11-19 16:45:00,-1695.54,352137.9000000065,352318.49000000645,-180.5899999999674
34882,2022-11-19 16:50:00,1858.71,353996.6100000065,352318.49000000645,1678.1200000000536
34883,2022-11-19 16:55:00,1041.24,355037.8500000065,352318.49000000645,2719.3600000000442
34884,2022-11-20 08:00:00,1978.74,357016.5900000065,355037.8500000065,1978.7399999999907
34885,2022-11-20 08:05:00,-612.18,356404.4100000065,355037.8500000065,1366.5599999999977
34886,2022-11-20 08:10:00,1738.29,358142.7000000065,355037.8500000065,3104.8499999999767
34887,2022-11-20 08:15:00,-792.83,357349.87000000646,355037.8500000065,2312.0199999999604
34888,2022-11-20 08:20:00,1515.78,358865.6500000065,355037.8500000065,3827.7999999999884
34889,2022-11-20 08:25:00,-1166.82,357698.8300000065,355037.8500000065,2660.9799999999814
34890,2022-11-20 08:30:00,1853.16,359551.99000000645,355037.8500000065,4514.139999999956
34891,2022-11-20 08:35:00,-568.45,358983.54000000644,355037.8500000065,3945.689999999944
34892,2022-11-20 08:40:00,-71.35,358912.19000000646,355037.8500000065,3874.3399999999674
34893,2022-11-20 08:45:00,-1280.06,357632.13000000647,355037.8500000065,2594.2799999999697
34894,2022-11-20 08:50:00,872.68,358504.81000000646,355037.8500000065,3466.9599999999627
34895,2022-11-20 08:55:00,-1057.11,357447.7000000065,355037.8500000065,2409.8499999999767
34896,2022-11-20 09:00:00,-525.79,356921.9100000065,355037.8500000065,1884.0599999999977
34897,2022-11-20 09:05:00,526.35,357448.26000000647,355037.8500000065,2410.4099999999744
34898,2022-11-20 09:10:00,-1241.2,356207.06000000646,355037.8500000065,1169.2099999999627
34899,2022-11-20 09:15:00,-719.63,355487.43000000645,355037.8500000065,449.5799999999581
34900,2022-11-20 09:20:00,-1212.55,354274.88000000647,355037.8500000065,-762.9700000000303
34901,2022-11-20 09:25:00,1604.47,355879.35000000644,355037.8500000065,841.4999999999418
34902,2022-11-20 09:30:00,-980.77,354898.5800000064,355037.8500000065,-139.27000000007683
34903,2022-11-20 09:35:00,1272.09,356170.67000000644,355037.8500000065,1132.8199999999488
34904,2022-11-20 09:40:00,-19.51,356151.16000000644,355037.8500000065,1113.3099999999395
34905,2022-11-20 09:45:00,-1838.65,354312.5100000064,355037.8500000065,-725.3400000000838
34906,2022-11-20 09:50:00,1046.65,355359.16000000644,355037.8500000065,321.30999999993946
34907,2022-11-20 09:55:00,-916.43,354442.73000000644,355037.8500000065,-595.1200000000536
34908,2022-11-20 10:00:00,-1055.71,353387.0200000064,355037.8500000065,-1650.8300000000745
34909,2022-11-20 10:05:00,-132.36,353254.66000000644,355037.8500000065,-1783.1900000000605
34910,2022-11-20 10:10:00,1637.15,354891.81000000646,355037.8500000065,-146.04000000003725
34911,2022-11-20 10:15:00,-994.57,353897.24000000645,355037.8500000065,-1140.6100000000442
34912,2022-11-20 10:20:00,-1536.0,352361.24000000645,355037.8500000065,-2676.6100000000442
34913,2022-11-20 10:25:00,1911.27,354272.51000000647,355037.8500000065,-765.3400000000256
34914,2022-11-20 10:30:00,-127.79,354144.7200000065,355037.8500000065,-893.1300000000047
34915,2022-11-20 10:35:00,-1907.94,352236.7800000065,355037.8500000065,-2801.070000000007
34916,2022-11-20 10:40:00,-1888.42,350348.3600000065,355037.8500000065,-4689.489999999991
34917,2022-11-20 10:45:00,-695.33,349653.0300000065,355037.8500000065,-5384.820000000007
34918,2022-11-20 10:50:00,-942.43,348710.6000000065,355037.8500000065,-6327.25
34919,2022-11-20 10:55:00,-1984.48,346726.1200000065,355037.8500000065,-8311.729999999981
34920,2022-11-20 11:00:00,-278.29,346447.83000000654,355037.8500000065,-8590.01999999996
34921,2022-11-20 11:05:00,-1766.15,344681.6800000065,355037.8500000065,-10356.169999999984
34922,2022-11-20 11:10:00,767.4,345449.08000000654,355037.8500000065,-9588.76999999996
34923,2022-11-20 11:15:00,1895.61,347344.6900000065,355037.8500000065,-7693.159999999974
34924,2022-11-20 11:20:00,104.45,347449.14000000653,355037.8500000065,-7588.709999999963
34925,2022-11-20 11:25:00,-33.3,347415.84000000654,355037.8500000065,-7622.009999999951
34926,2022-11-20 11:30:00,251.24,347667.08000000654,355037.8500000065,-7370.76999999996
34927,2022-11-20 11:35:00,-77.66,347589.42000000656,355037.8500000065,-7448.429999999935
34928,2022-11-20 11:40:00,-1494.79,346094.6300000066,355037.8500000065,-8943.219999999914
34929,2022-11-20 11:45:00,-123.09,345971.54000000656,355037.8500000065,-9066.30999999994
34930,2022-11-20 11:50:00,1570.08,347541.6200000066,355037.8500000065,-7496.229999999923
34931,2022-11-20 11:55:00,-1885.9,345655.72000000655,355037.8500000065,-9382.129999999946
34932,2022-11-20 12:00:00,678.34,346334.0600000066,355037.8500000065,-8703.78999999992
34933,2022-11-20 12:05:00,-1008.8,345325.2600000066,355037.8500000065,-9712.58999999991
34934,2022-11-20 12:10:00,-1800.05,343525.2100000066,355037.8500000065,-11512.639999999898
34935,2022-11-20 12:15:00,1029.95,344555.1600000066,355037.8500000065,-10482.689999999886
34936,2022-11-20 12:20:00,1129.82,345684.9800000066,355037.8500000065,-9352.869999999879
34937,2022-11-20 12:25:00,1155.85,346840.8300000066,355037.8500000065,-8197.019999999902
34938,2022-11-20 12:30:00,-829.71,346011.1200000066,355037.8500000065,-9026.729999999923
34939,2022-11-20 12:35:00,-1343.25,344667.8700000066,355037.8500000065,-10369.979999999923
34940,2022-11-20 12:40:00,-1571.99,343095.8800000066,355037.8500000065,-11941.969999999914
34941,2022-11-20 12:45:00,-1966.97,341128.9100000066,355037.8500000065,-13908.939999999886
34942,2022-11-20 12:50:00,-1274.61,339854.3000000066,355037.8500000065,-15183.549999999872
34943,2022-11-20 12:55:00,-835.45,339018.8500000066,355037.8500000065,-16018.999999999884
34944,2022-11-20 13:00:00,239.08,339257.9300000066,355037.8500000065,-15779.919999999867
34945,2022-11-20 13:05:00,-632.36,338625.57000000664,355037.8500000065,-16412.279999999853
34946,2022-11-20 13:10:00,-899.98,337725.59000000666,355037.8500000065,-17312.259999999835
34947,2022-11-20 13:15:00,-990.54,336735.0500000067,355037.8500000065,-18302.799999999814
34948,2022-11-20 13:20:00,-1804.58,334930.47000000667,355037.8500000065,-20107.37999999983
34949,2022-11-20 13:25:00,631.49,335561.96000000666,355037.8500000065,-19475.88999999984
34950,2022-11-20 13:30:00,-1343.89,334218.07000000664,355037.8500000065,-20819.779999999853
34951,2022-11-20 13:35:00,-1646.75,332571.32000000664,355037.8500000065,-22466.529999999853
34952,2022-11-20 13:40:00,-282.69,332288.63000000664,355037.8500000065,-22749.219999999856
34953,2022-11-20 13:45:00,-1590.72,330697.91000000667,355037.8500000065,-24339.939999999828
34954,2022-11-20 13:50:00,982.56,331680.47000000667,355037.8500000065,-23357.37999999983
34955,2022-11-20 13:55:00,-1721.15,329959.32000000664,355037.8500000065,-25078.529999999853
34956,2022-11-20 14:00:00,1337.47,331296.7900000066,355037.8500000065,-23741.05999999988
34957,2022-11-20 14:05:00,139.97,331436.7600000066,355037.8500000065,-23601.08999999991
34958,2022-11-20 14:10:00,71.9,331508.6600000066,355037.8500000065,-23529.189999999886
34959,2022-11-20 14:15:00,1639.53,333148.19000000664,355037.8500000065,-21889.659999999858
34960,2022-11-20 14:20:00,-1052.04,332096.15000000666,355037.8500000065,-22941.699999999837
34961,2022-11-20 14:25:00,-1504.33,330591.82000000664,355037.8500000065,-24446.029999999853
34962,2022-11-20 14:30:00,-68.41,330523.41000000667,355037.8500000065,-24514.439999999828
34963,2022-11-20 14:35:00,47.09,330570.5000000067,355037.8500000065,-24467.349999999802
34964,2022-11-20 14:40:00,-408.4,330162.10000000667,355037.8500000065,-24875.749999999825
34965,2022-11-20 14:45:00,-146.53,330015.57000000664,355037.8500000065,-25022.279999999853
34966,2022-11-20 14:50:00,-1043.16,328972.41000000667,355037.8500000065,-26065.439999999828
34967,2022-11-20 14:55:00,1424.13,330396.5400000067,355037.8500000065,-24641.309999999823
34968,2022-11-20 15:00:00,178.12,330574.66000000667,355037.8500000065,-24463.189999999828
34969,2022-11-20 15:05:00,-1993.23,328581.4300000067,355037.8500000065,-26456.41999999981
34970,2022-11-20 15:10:00,506.38,329087.8100000067,355037.8500000065,-25950.039999999804
34971,2022-11-20 15:15:00,-245.84,328841.97000000667,355037.8500000065,-26195.87999999983
34972,2022-11-20 15:20:00,1468.59,330310.5600000067,355037.8500000065,-24727.289999999804
34973,2022-11-20 15:25:00,591.28,330901.8400000067,355037.8500000065,-24136.009999999776
34974,2022-11-20 15:30:00,1328.81,332230.6500000067,355037.8500000065,-22807.19999999978
34975,2022-11-20 15:35:00,1379.73,333610.3800000067,355037.8500000065,-21427.469999999797
34976,2022-11-20 15:40:00,1350.79,334961.1700000067,355037.8500000065,-20076.67999999982
34977,2022-11-20 15:45:00,-917.83,334043.34000000666,355037.8500000065,-20994.509999999835
34978,2022-11-20 15:50:00,-1556.76,332486.58000000665,355037.8500000065,-22551.269999999844
34979,2022-11-20 15:55:00,1978.25,334464.83000000665,355037.8500000065,-20573.019999999844
34980,2022-11-20 16:00:00,1270.38,335735.21000000666,355037.8500000065,-19302.63999999984
34981,2022-11-20 16:05:00,-1082.02,334653.19000000664,355037.8500000065,-20384.659999999858
34982,2022-11-20 16:10:00,131.36,334784.5500000066,355037.8500000065,-20253.299999999872
34983,2022-11-20 16:15:00,-266.9,334517.6500000066,355037.8500000065,-20520.199999999895
34984,2022-11-20 16:20:00,-1825.79,332691.8600000066,355037.8500000065,-22345.989999999874
34985,2022-11-20 16:25:00,175.21,332867.07000000664,355037.8500000065,-22170.779999999853
34986,2022-11-20 16:30:00,-1412.88,331454.19000000664,355037.8500000065,-23583.659999999858
34987,2022-11-20 16:35:00,217.29,331671.4800000066,355037.8500000065,-23366.36999999988
34988,2022-11-20 16:40:00,-1416.37,330255.1100000066,355037.8500000065,-24782.739999999874
34989,2022-11-20 16:45:00,1727.94,331983.0500000066,355037.8500000065,-23054.799999999872
34990,2022-11-20 16:50:00,-1800.94,330182.1100000066,355037.8500000065,-24855.739999999874
34991,2022-11-20 16:55:00,189.27,330371.38000000664,355037.8500000065,-24666.469999999856
34992,2022-11-21 08:00:00,1318.04,331689.4200000066,330371.38000000664,1318.039999999979
34993,2022-11-21 08:05:00,-1372.35,330317.07000000664,330371.38000000664,-54.30999999999767
34994,2022-11-21 08:10:00,-426.61,329890.46000000666,330371.38000000664,-480.9199999999837
34995,2022-11-21 08:15:00,-1766.43,328124.03000000666,330371.38000000664,-2247.3499999999767
34996,2022-11-21 08:20:00,1967.3,330091.33000000665,330371.38000000664,-280.04999999998836
34997,2022-11-21 08:25:00,-616.18,329475.15000000666,330371.38000000664,-896.2299999999814
34998,2022-11-21 08:30:00,-194.37,329280.78000000666,330371.38000000664,-1090.5999999999767
34999,2022-11-21 08:35:00,265.52,329546.3000000067,330371.38000000664,-825.0799999999581
35000,2022-11-21 08:40:00,513.63,330059.9300000067,330371.38000000664,-311.44999999995343
35001,2022-11-21 08:45:00,720.22,330780.15000000666,330371.38000000664,408.7700000000186
35002,2022-11-21 08:50:00,59.49,330839.64000000665,330371.38000000664,468.2600000000093
35003,2022-11-21 08:55:00,560.27,331399.91000000667,330371.38000000664,1028.530000000028
35004,2022-11-21 09:00:00,-1992.12,329407.7900000067,330371.38000000664,-963.5899999999674
35005,2022-11-21 09:05:00,-492.67,328915.1200000067,330371.38000000664,-1456.259999999951
35006,2022-11-21 09:10:00,-1661.5,327253.6200000067,330371.38000000664,-3117.759999999951
35007,2022-11-21 09:15:00,35.55,327289.1700000067,330371.38000000664,-3082.2099999999627
35008,2022-11-21 09:20:00,98.45,327387.6200000067,330371.38000000664,-2983.759999999951
35009,2022-11-21 09:25:00,385.17,327772.7900000067,330371.38000000664,-2598.5899999999674
35010,2022-11-21 09:30:00,563.75,328336.5400000067,330371.38000000664,-2034.8399999999674
35011,2022-11-21 09:35:00,-1045.73,327290.8100000067,330371.38000000664,-3080.569999999949
35012,2022-11-21 09:40:00,-495.67,326795.1400000067,330371.38000000664,-3576.2399999999325
35013,2022-11-21 09:45:00,1185.16,327980.3000000067,330371.38000000664,-2391.079999999958
35014,2022-11-21 09:50:00,-670.64,327309.66000000667,330371.38000000664,-3061.719999999972
35015,2022-11-21 09:55:00,-560.02,326749.64000000665,330371.38000000664,-3621.7399999999907
35016,2022-11-21 10:00:00,1361.05,328110.69000000664,330371.38000000664,-2260.6900000000023
35017,2022-11-21 10:05:00,-1888.89,326221.8000000066,330371.38000000664,-4149.580000000016
35018,2022-11-21 10:10:00,1425.4,327647.20000000665,330371.38000000664,-2724.179999999993
35019,2022-11-21 10:15:00,-1101.37,326545.83000000665,330371.38000000664,-3825.5499999999884
35020,2022-11-21 10:20:00,1324.74,327870.57000000664,330371.38000000664,-2500.8099999999977
35021,2022-11-21 10:25:00,-485.38,327385.19000000664,330371.38000000664,-2986.1900000000023
35022,2022-11-21 10:30:00,-1002.77,326382.4200000066,330371.38000000664,-3988.960000000021
35023,2022-11-21 10:35:00,1452.8,327835.2200000066,330371.38000000664,-2536.1600000000326
35024,2022-11-21 10:40:00,-462.15,327373.0700000066,330371.38000000664,-2998.310000000056
35025,2022-11-21 10:45:00,-1594.24,325778.8300000066,330371.38000000664,-4592.550000000047
35026,2022-11-21 10:50:00,1503.64,327282.4700000066,330371.38000000664,-3088.9100000000326
35027,2022-11-21 10:55:00,1205.91,328488.3800000066,330371.38000000664,-1883.0000000000582
35028,2022-11-21 11:00:00,-439.65,328048.73000000656,330371.38000000664,-2322.6500000000815
35029,2022-11-21 11:05:00,1523.28,329572.0100000066,330371.38000000664,-799.3700000000536
35030,2022-11-21 11:10:00,-1429.85,328142.1600000066,330371.38000000664,-2229.2200000000303
35031,2022-11-21 11:15:00,-231.71,327910.4500000066,330371.38000000664,-2460.930000000051
35032,2022-11-21 11:20:00,-296.85,327613.6000000066,330371.38000000664,-2757.780000000028
35033,2022-11-21 11:25:00,-867.82,326745.7800000066,330371.38000000664,-3625.600000000035
35034,2022-11-21 11:30:00,-1981.97,324763.81000000663,330371.38000000664,-5607.570000000007
35035,2022-11-21 11:35:00,-1287.73,323476.08000000665,330371.38000000664,-6895.299999999988
35036,2022-11-21 11:40:00,-1506.31,321969.77000000665,330371.38000000664,-8401.609999999986
35037,2022-11-21 11:45:00,268.1,322237.87000000663,330371.38000000664,-8133.510000000009
35038,2022-11-21 11:50:00,944.07,323181.94000000664,330371.38000000664,-7189.440000000002
35039,2022-11-21 11:55:00,-707.73,322474.21000000666,330371.38000000664,-7897.169999999984
35040,2022-11-21 12:00:00,882.8,323357.01000000664,330371.38000000664,-7014.369999999995
35041,2022-11-21 12:05:00,-690.58,322666.4300000066,330371.38000000664,-7704.950000000012
35042,2022-11-21 12:10:00,-1816.51,320849.9200000066,330371.38000000664,-9521.460000000021
35043,2022-11-21 12:15:00,604.22,321454.1400000066,330371.38000000664,-8917.240000000049
35044,2022-11-21 12:20:00,1510.55,322964.6900000066,330371.38000000664,-7406.6900000000605
35045,2022-11-21 12:25:00,1698.72,324663.41000000655,330371.38000000664,-5707.9700000000885
35046,2022-11-21 12:30:00,644.6,325308.0100000065,330371.38000000664,-5063.370000000112
35047,2022-11-21 12:35:00,204.15,325512.16000000655,330371.38000000664,-4859.2200000000885
35048,2022-11-21 12:40:00,-395.43,325116.73000000656,330371.38000000664,-5254.6500000000815
35049,2022-11-21 12:45:00,-1314.5,323802.23000000656,330371.38000000664,-6569.1500000000815
35050,2022-11-21 12:50:00,1076.36,324878.59000000654,330371.38000000664,-5492.7900000000955
35051,2022-11-21 12:55:00,1335.76,326214.35000000655,330371.38000000664,-4157.030000000086
35052,2022-11-21 13:00:00,-1873.38,324340.97000000655,330371.38000000664,-6030.410000000091
35053,2022-11-21 13:05:00,405.46,324746.43000000657,330371.38000000664,-5624.95000000007
35054,2022-11-21 13:10:00,1569.93,326316.36000000656,330371.38000000664,-4055.020000000077
35055,2022-11-21 13:15:00,-995.39,325320.97000000655,330371.38000000664,-5050.410000000091
35056,2022-11-21 13:20:00,-1680.82,323640.15000000654,330371.38000000664,-6731.230000000098
35057,2022-11-21 13:25:00,1120.96,324761.11000000656,330371.38000000664,-5610.270000000077
35058,2022-11-21 13:30:00,780.75,325541.86000000656,330371.38000000664,-4829.520000000077
35059,2022-11-21 13:35:00,1713.11,327254.97000000655,330371.38000000664,-3116.410000000091
35060,2022-11-21 13:40:00,-1153.63,326101.34000000654,330371.38000000664,-4270.0400000000955
35061,2022-11-21 13:45:00,-1388.96,324712.3800000065,330371.38000000664,-5659.000000000116
35062,2022-11-21 13:50:00,-1462.54,323249.84000000654,330371.38000000664,-7121.5400000000955
35063,2022-11-21 13:55:00,1808.13,325057.97000000655,330371.38000000664,-5313.410000000091
35064,2022-11-21 14:00:00,-863.35,324194.6200000066,330371.38000000664,-6176.7600000000675
35065,2022-11-21 14:05:00,-1408.02,322786.60000000655,330371.38000000664,-7584.780000000086
35066,2022-11-21 14:10:00,-661.43,322125.17000000656,330371.38000000664,-8246.21000000008
35067,2022-11-21 14:15:00,-1896.34,320228.83000000654,330371.38000000664,-10142.550000000105
35068,2022-11-21 14:20:00,-703.45,319525.3800000065,330371.38000000664,-10846.000000000116
35069,2022-11-21 14:25:00,-679.41,318845.97000000655,330371.38000000664,-11525.41000000009
35070,2022-11-21 14:30:00,-1914.58,316931.39000000653,330371.38000000664,-13439.990000000107
35071,2022-11-21 14:35:00,-1370.99,315560.40000000654,330371.38000000664,-14810.980000000098
35072,2022-11-21 14:40:00,651.96,316212.36000000656,330371.38000000664,-14159.020000000077
35073,2022-11-21 14:45:00,-83.0,316129.36000000656,330371.38000000664,-14242.020000000077
35074,2022-11-21 14:50:00,883.14,317012.5000000066,330371.38000000664,-13358.880000000063
35075,2022-11-21 14:55:00,197.1,317209.60000000655,330371.38000000664,-13161.780000000086
35076,2022-11-21 15:00:00,1150.56,318360.16000000655,330371.38000000664,-12011.220000000088
35077,2022-11-21 15:05:00,-188.88,318171.28000000655,330371.38000000664,-12200.100000000093
35078,2022-11-21 15:10:00,272.65,318443.93000000657,330371.38000000664,-11927.45000000007
35079,2022-11-21 15:15:00,-75.83,318368.10000000655,330371.38000000664,-12003.280000000086
35080,2022-11-21 15:20:00,1443.27,319811.3700000066,330371.38000000664,-10560.010000000068
35081,2022-11-21 15:25:00,-1194.96,318616.41000000655,330371.38000000664,-11754.970000000088
35082,2022-11-21 15:30:00,1208.32,319824.73000000656,330371.38000000664,-10546.650000000081
35083,2022-11-21 15:35:00,966.49,320791.22000000655,330371.38000000664,-9580.16000000009
35084,2022-11-21 15:40:00,375.85,321167.0700000065,330371.38000000664,-9204.310000000114
35085,2022-11-21 15:45:00,-282.7,320884.3700000065,330371.38000000664,-9487.010000000126
35086,2022-11-21 15:50:00,117.56,321001.9300000065,330371.38000000664,-9369.450000000128
35087,2022-11-21 15:55:00,770.39,321772.3200000065,330371.38000000664,-8599.060000000114
35088,2022-11-21 16:00:00,-1186.73,320585.59000000654,330371.38000000664,-9785.790000000095
35089,2022-11-21 16:05:00,113.28,320698.8700000066,330371.38000000664,-9672.510000000068
35090,2022-11-21 16:10:00,-393.17,320305.7000000066,330371.38000000664,-10065.680000000051
35091,2022-11-21 16:15:00,-370.41,319935.2900000066,330371.38000000664,-10436.090000000026
35092,2022-11-21 16:20:00,-228.46,319706.8300000066,330371.38000000664,-10664.550000000047
35093,2022-11-21 16:25:00,353.61,320060.4400000066,330371.38000000664,-10310.94000000006
35094,2022-11-21 16:30:00,-296.94,319763.5000000066,330371.38000000664,-10607.880000000063
35095,2022-11-21 16:35:00,-519.35,319244.1500000066,330371.38000000664,-11127.23000000004
35096,2022-11-21 16:40:00,846.78,320090.9300000066,330371.38000000664,-10280.450000000012
35097,2022-11-21 16:45:00,1514.63,321605.56000000663,330371.38000000664,-8765.820000000007
35098,2022-11-21 16:50:00,1155.68,322761.2400000066,330371.38000000664,-7610.140000000014
35099,2022-11-21 16:55:00,-857.85,321903.39000000665,330371.38000000664,-8467.98999999999
35100,2022-11-22 08:00:00,506.28,322409.6700000067,321903.39000000665,506.28000000002794
35101,2022-11-22 08:05:00,-73.05,322336.6200000067,321903.39000000665,433.2300000000396
35102,2022-11-22 08:10:00,1528.21,323864.8300000067,321903.39000000665,1961.4400000000605
35103,2022-11-22 08:15:00,-985.51,322879.3200000067,321903.39000000665,975.9300000000512
35104,2022-11-22 08:20:00,-1443.89,321435.4300000067,321903.39000000665,-467.95999999996275
35105,2022-11-22 08:25:00,1582.42,323017.85000000667,321903.39000000665,1114.460000000021
35106,2022-11-22 08:30:00,28.04,323045.89000000665,321903.39000000665,1142.5
35107,2022-11-22 08:35:00,1756.03,324801.9200000067,321903.39000000665,2898.530000000028
35108,2022-11-22 08:40:00,-250.92,324551.0000000067,321903.39000000665,2647.6100000000442
35109,2022-11-22 08:45:00,-1950.18,322600.8200000067,321903.39000000665,697.4300000000512
35110,2022-11-22 08:50:00,17.38,322618.2000000067,321903.39000000665,714.8100000000559
35111,2022-11-22 08:55:00,-1606.81,321011.3900000067,321903.39000000665,-891.9999999999418
35112,2022-11-22 09:00:00,817.55,321828.9400000067,321903.39000000665,-74.44999999995343
35113,2022-11-22 09:05:00,784.27,322613.2100000067,321903.39000000665,709.8200000000652
35114,2022-11-22 09:10:00,649.45,323262.6600000067,321903.39000000665,1359.2700000000768
35115,2022-11-22 09:15:00,-1164.07,322098.5900000067,321903.39000000665,195.20000000006985
35116,2022-11-22 09:20:00,212.77,322311.36000000674,321903.39000000665,407.9700000000885
35117,2022-11-22 09:25:00,1777.99,324089.3500000067,321903.39000000665,2185.960000000079
35118,2022-11-22 09:30:00,-350.64,323738.7100000067,321903.39000000665,1835.3200000000652
35119,2022-11-22 09:35:00,441.52,324180.23000000673,321903.39000000665,2276.840000000084
35120,2022-11-22 09:40:00,-1715.3,322464.93000000675,321903.39000000665,561.5400000000955
35121,2022-11-22 09:45:00,-724.99,321739.94000000675,321903.39000000665,-163.44999999989523
35122,2022-11-22 09:50:00,-1850.72,319889.2200000068,321903.39000000665,-2014.1699999998673
35123,2022-11-22 09:55:00,-1556.8,318332.4200000068,321903.39000000665,-3570.9699999998556
35124,2022-11-22 10:00:00,-701.13,317631.2900000068,321903.39000000665,-4272.09999999986
35125,2022-11-22 10:05:00,1114.41,318745.70000000676,321903.39000000665,-3157.689999999886
35126,2022-11-22 10:10:00,505.9,319251.6000000068,321903.39000000665,-2651.7899999998626
35127,2022-11-22 10:15:00,-747.74,318503.8600000068,321903.39000000665,-3399.5299999998533
35128,2022-11-22 10:20:00,382.42,318886.2800000068,321903.39000000665,-3017.1099999998696
35129,2022-11-22 10:25:00,591.63,319477.9100000068,321903.39000000665,-2425.479999999865
35130,2022-11-22 10:30:00,564.5,320042.4100000068,321903.39000000665,-1860.979999999865
35131,2022-11-22 10:35:00,-340.16,319702.2500000068,321903.39000000665,-2201.1399999998393
35132,2022-11-22 10:40:00,-117.41,319584.84000000684,321903.39000000665,-2318.5499999998137
35133,2022-11-22 10:45:00,-1611.34,317973.5000000068,321903.39000000665,-3929.8899999998393
35134,2022-11-22 10:50:00,1568.8,319542.3000000068,321903.39000000665,-2361.089999999851
35135,2022-11-22 10:55:00,1101.66,320643.9600000068,321903.39000000665,-1259.4299999998766
35136,2022-11-22 11:00:00,1416.11,322060.07000000676,321903.39000000665,156.68000000010943
35137,2022-11-22 11:05:00,98.86,322158.93000000675,321903.39000000665,255.54000000009546
35138,2022-11-22 11:10:00,1966.9,324125.83000000677,321903.39000000665,2222.4400000001187
35139,2022-11-22 11:15:00,-223.0,323902.83000000677,321903.39000000665,1999.4400000001187
35140,2022-11-22 11:20:00,829.59,324732.4200000068,321903.39000000665,2829.0300000001444
35141,2022-11-22 11:25:00,1306.0,326038.4200000068,321903.39000000665,4135.030000000144
35142,2022-11-22 11:30:00,-1002.87,325035.5500000068,321903.39000000665,3132.160000000149
35143,2022-11-22 11:35:00,232.44,325267.9900000068,321903.39000000665,3364.6000000001513
35144,2022-11-22 11:40:00,-1985.83,323282.1600000068,321903.39000000665,1378.770000000135
35145,2022-11-22 11:45:00,-152.55,323129.6100000068,321903.39000000665,1226.2200000001467
35146,2022-11-22 11:50:00,-1821.61,321308.0000000068,321903.39000000665,-595.3899999998393
35147,2022-11-22 11:55:00,508.02,321816.0200000068,321903.39000000665,-87.36999999982072
35148,2022-11-22 12:00:00,-341.2,321474.8200000068,321903.39000000665,-428.56999999983236
35149,2022-11-22 12:05:00,-684.86,320789.96000000683,321903.39000000665,-1113.4299999998184
35150,2022-11-22 12:10:00,-1812.62,318977.34000000684,321903.39000000665,-2926.0499999998137
35151,2022-11-22 12:15:00,231.74,319209.0800000068,321903.39000000665,-2694.309999999823
35152,2022-11-22 12:20:00,-107.68,319101.40000000683,321903.39000000665,-2801.989999999816
35153,2022-11-22 12:25:00,-1861.17,317240.23000000685,321903.39000000665,-4663.1599999998
35154,2022-11-22 12:30:00,-241.13,316999.10000000685,321903.39000000665,-4904.289999999804
35155,2022-11-22 12:35:00,25.07,317024.17000000685,321903.39000000665,-4879.219999999797
35156,2022-11-22 12:40:00,-1431.04,315593.1300000069,321903.39000000665,-6310.2599999997765
35157,2022-11-22 12:45:00,-73.75,315519.3800000069,321903.39000000665,-6384.0099999997765
35158,2022-11-22 12:50:00,777.07,316296.4500000069,321903.39000000665,-5606.9399999997695
35159,2022-11-22 12:55:00,-798.56,315497.8900000069,321903.39000000665,-6405.499999999767
35160,2022-11-22 13:00:00,1793.32,317291.2100000069,321903.39000000665,-4612.17999999976
35161,2022-11-22 13:05:00,-17.16,317274.0500000069,321903.39000000665,-4629.339999999735
35162,2022-11-22 13:10:00,-87.87,317186.1800000069,321903.39000000665,-4717.20999999973
35163,2022-11-22 13:15:00,-1479.06,315707.1200000069,321903.39000000665,-6196.269999999728
35164,2022-11-22 13:20:00,-1642.18,314064.9400000069,321903.39000000665,-7838.449999999721
35165,2022-11-22 13:25:00,695.23,314760.1700000069,321903.39000000665,-7143.219999999739
35166,2022-11-22 13:30:00,1354.32,316114.4900000069,321903.39000000665,-5788.899999999732
35167,2022-11-22 13:35:00,1180.63,317295.1200000069,321903.39000000665,-4608.269999999728
35168,2022-11-22 13:40:00,-428.51,316866.6100000069,321903.39000000665,-5036.779999999737
35169,2022-11-22 13:45:00,-839.52,316027.0900000069,321903.39000000665,-5876.2999999997555
35170,2022-11-22 13:50:00,-1701.63,314325.4600000069,321903.39000000665,-7577.92999999976
35171,2022-11-22 13:55:00,1043.13,315368.5900000069,321903.39000000665,-6534.7999999997555
35172,2022-11-22 14:00:00,795.19,316163.7800000069,321903.39000000665,-5739.609999999753
35173,2022-11-22 14:05:00,-1441.79,314721.9900000069,321903.39000000665,-7181.399999999732
35174,2022-11-22 14:10:00,1868.52,316590.51000000694,321903.39000000665,-5312.879999999714
35175,2022-11-22 14:15:00,-1385.4,315205.1100000069,321903.39000000665,-6698.279999999737
35176,2022-11-22 14:20:00,1860.56,317065.6700000069,321903.39000000665,-4837.719999999739
35177,2022-11-22 14:25:00,1958.68,319024.3500000069,321903.39000000665,-2879.039999999746
35178,2022-11-22 14:30:00,-1686.54,317337.8100000069,321903.39000000665,-4565.579999999725
35179,2022-11-22 14:35:00,-63.71,317274.1000000069,321903.39000000665,-4629.289999999746
35180,2022-11-22 14:40:00,-801.91,316472.1900000069,321903.39000000665,-5431.199999999721
35181,2022-11-22 14:45:00,-1979.85,314492.34000000695,321903.39000000665,-7411.049999999697
35182,2022-11-22 14:50:00,-1750.81,312741.53000000695,321903.39000000665,-9161.859999999695
35183,2022-11-22 14:55:00,-1823.22,310918.310000007,321903.39000000665,-10985.079999999667
35184,2022-11-22 15:00:00,-1182.71,309735.60000000696,321903.39000000665,-12167.789999999688
35185,2022-11-22 15:05:00,-1147.99,308587.610000007,321903.39000000665,-13315.779999999679
35186,2022-11-22 15:10:00,-907.72,307679.890000007,321903.39000000665,-14223.49999999965
35187,2022-11-22 15:15:00,-925.47,306754.420000007,321903.39000000665,-15148.969999999623
35188,2022-11-22 15:20:00,-669.06,306085.36000000703,321903.39000000665,-15818.02999999962
35189,2022-11-22 15:25:00,-1083.95,305001.410000007,321903.39000000665,-16901.979999999632
35190,2022-11-22 15:30:00,1164.69,306166.100000007,321903.39000000665,-15737.28999999963
35191,2022-11-22 15:35:00,1505.63,307671.730000007,321903.39000000665,-14231.659999999625
35192,2022-11-22 15:40:00,1578.99,309250.720000007,321903.39000000665,-12652.669999999634
35193,2022-11-22 15:45:00,-121.27,309129.450000007,321903.39000000665,-12773.939999999653
35194,2022-11-22 15:50:00,-1048.25,308081.200000007,321903.39000000665,-13822.189999999653
35195,2022-11-22 15:55:00,1313.65,309394.850000007,321903.39000000665,-12508.53999999963
35196,2022-11-22 16:00:00,-1641.47,307753.38000000705,321903.39000000665,-14150.009999999602
35197,2022-11-22 16:05:00,1374.66,309128.040000007,321903.39000000665,-12775.349999999627
35198,2022-11-22 16:10:00,1555.07,310683.11000000703,321903.39000000665,-11220.27999999962
35199,2022-11-22 16:15:00,-146.86,310536.25000000704,321903.39000000665,-11367.139999999607
35200,2022-11-22 16:20:00,-367.75,310168.50000000704,321903.39000000665,-11734.889999999607
35201,2022-11-22 16:25:00,-1874.54,308293.96000000706,321903.39000000665,-13609.429999999586
35202,2022-11-22 16:30:00,710.53,309004.4900000071,321903.39000000665,-12898.899999999558
35203,2022-11-22 16:35:00,544.67,309549.1600000071,321903.39000000665,-12354.229999999574
35204,2022-11-22 16:40:00,1133.98,310683.14000000706,321903.39000000665,-11220.249999999593
35205,2022-11-22 16:45:00,-1432.34,309250.80000000703,321903.39000000665,-12652.589999999618
35206,2022-11-22 16:50:00,-158.81,309091.99000000703,321903.39000000665,-12811.399999999616
35207,2022-11-22 16:55:00,-650.68,308441.31000000704,321903.39000000665,-13462.079999999609
35208,2022-11-23 08:00:00,77.43,308518.74000000703,308441.31000000704,77.42999999999302
35209,2022-11-23 08:05:00,369.03,308887.77000000706,308441.31000000704,446.46000000002095
35210,2022-11-23 08:10:00,415.62,309303.39000000706,308441.31000000704,862.0800000000163
35211,2022-11-23 08:15:00,-1833.2,307470.19000000705,308441.31000000704,-971.1199999999953
35212,2022-11-23 08:20:00,-1928.04,305542.15000000707,308441.31000000704,-2899.1599999999744
35213,2022-11-23 08:25:00,-547.78,304994.37000000704,308441.31000000704,-3446.9400000000023
35214,2022-11-23 08:30:00,-480.87,304513.50000000704,308441.31000000704,-3927.8099999999977
35215,2022-11-23 08:35:00,691.44,305204.94000000705,308441.31000000704,-3236.3699999999953
35216,2022-11-23 08:40:00,-1711.15,303493.790000007,308441.31000000704,-4947.520000000019
35217,2022-11-23 08:45:00,17.29,303511.080000007,308441.31000000704,-4930.23000000004
35218,2022-11-23 08:50:00,-1646.67,301864.410000007,308441.31000000704,-6576.900000000023
35219,2022-11-23 08:55:00,1647.63,303512.040000007,308441.31000000704,-4929.270000000019
35220,2022-11-23 09:00:00,928.4,304440.44000000705,308441.31000000704,-4000.8699999999953
35221,2022-11-23 09:05:00,-838.47,303601.9700000071,308441.31000000704,-4839.339999999967
35222,2022-11-23 09:10:00,-429.44,303172.5300000071,308441.31000000704,-5268.77999999997
35223,2022-11-23 09:15:00,-1625.32,301547.21000000706,308441.31000000704,-6894.099999999977
35224,2022-11-23 09:20:00,-950.44,300596.77000000706,308441.31000000704,-7844.539999999979
35225,2022-11-23 09:25:00,-73.92,300522.8500000071,308441.31000000704,-7918.459999999963
35226,2022-11-23 09:30:00,1751.45,302274.3000000071,308441.31000000704,-6167.009999999951
35227,2022-11-23 09:35:00,315.14,302589.4400000071,308441.31000000704,-5851.869999999937
35228,2022-11-23 09:40:00,-1822.14,300767.3000000071,308441.31000000704,-7674.009999999951
35229,2022-11-23 09:45:00,1764.59,302531.8900000071,308441.31000000704,-5909.4199999999255
35230,2022-11-23 09:50:00,-1843.09,300688.8000000071,308441.31000000704,-7752.509999999951
35231,2022-11-23 09:55:00,-797.57,299891.2300000071,308441.31000000704,-8550.079999999958
35232,2022-11-23 10:00:00,1076.78,300968.0100000071,308441.31000000704,-7473.29999999993
35233,2022-11-23 10:05:00,1884.73,302852.7400000071,308441.31000000704,-5588.569999999949
35234,2022-11-23 10:10:00,1910.59,304763.3300000071,308441.31000000704,-3677.979999999923
35235,2022-11-23 10:15:00,-1578.15,303185.1800000071,308441.31000000704,-5256.129999999946
35236,2022-11-23 10:20:00,190.47,303375.65000000707,308441.31000000704,-5065.659999999974
35237,2022-11-23 10:25:00,718.36,304094.01000000705,308441.31000000704,-4347.299999999988
35238,2022-11-23 10:30:00,-1556.4,302537.61000000703,308441.31000000704,-5903.700000000012
35239,2022-11-23 10:35:00,-815.17,301722.44000000705,308441.31000000704,-6718.869999999995
35240,2022-11-23 10:40:00,753.61,302476.05000000703,308441.31000000704,-5965.260000000009
35241,2022-11-23 10:45:00,1189.73,303665.780000007,308441.31000000704,-4775.530000000028
35242,2022-11-23 10:50:00,-1616.67,302049.11000000703,308441.31000000704,-6392.200000000012
35243,2022-11-23 10:55:00,-1155.56,300893.55000000703,308441.31000000704,-7547.760000000009
35244,2022-11-23 11:00:00,1484.84,302378.39000000706,308441.31000000704,-6062.919999999984
35245,2022-11-23 11:05:00,-1179.6,301198.7900000071,308441.31000000704,-7242.51999999996
35246,2022-11-23 11:10:00,-503.88,300694.9100000071,308441.31000000704,-7746.399999999965
35247,2022-11-23 11:15:00,-892.64,299802.27000000706,308441.31000000704,-8639.039999999979
35248,2022-11-23 11:20:00,-1695.47,298106.8000000071,308441.31000000704,-10334.509999999951
35249,2022-11-23 11:25:00,-361.64,297745.1600000071,308441.31000000704,-10696.149999999965
35250,2022-11-23 11:30:00,212.8,297957.96000000706,308441.31000000704,-10483.349999999977
35251,2022-11-23 11:35:00,1196.61,299154.57000000705,308441.31000000704,-9286.73999999999
35252,2022-11-23 11:40:00,1459.75,300614.32000000705,308441.31000000704,-7826.989999999991
35253,2022-11-23 11:45:00,-542.02,300072.30000000703,308441.31000000704,-8369.01000000001
35254,2022-11-23 11:50:00,-1421.61,298650.69000000705,308441.31000000704,-9790.619999999995
35255,2022-11-23 11:55:00,-1028.56,297622.13000000705,308441.31000000704,-10819.179999999993
35256,2022-11-23 12:00:00,419.42,298041.55000000703,308441.31000000704,-10399.76000000001
35257,2022-11-23 12:05:00,649.22,298690.770000007,308441.31000000704,-9750.540000000037
35258,2022-11-23 12:10:00,-266.88,298423.890000007,308441.31000000704,-10017.420000000042
35259,2022-11-23 12:15:00,802.39,299226.280000007,308441.31000000704,-9215.030000000028
35260,2022-11-23 12:20:00,-946.19,298280.090000007,308441.31000000704,-10161.22000000003
35261,2022-11-23 12:25:00,-505.71,297774.380000007,308441.31000000704,-10666.930000000051
35262,2022-11-23 12:30:00,-1991.99,295782.390000007,308441.31000000704,-12658.920000000042
35263,2022-11-23 12:35:00,942.76,296725.150000007,308441.31000000704,-11716.160000000033
35264,2022-11-23 12:40:00,530.88,297256.030000007,308441.31000000704,-11185.280000000028
35265,2022-11-23 12:45:00,1319.22,298575.250000007,308441.31000000704,-9866.060000000056
35266,2022-11-23 12:50:00,-1750.28,296824.97000000696,308441.31000000704,-11616.340000000084
35267,2022-11-23 12:55:00,1822.96,298647.930000007,308441.31000000704,-9793.380000000063
35268,2022-11-23 13:00:00,775.06,299422.990000007,308441.31000000704,-9018.320000000065
35269,2022-11-23 13:05:00,600.41,300023.40000000695,308441.31000000704,-8417.91000000009
35270,2022-11-23 13:10:00,-1255.37,298768.03000000695,308441.31000000704,-9673.280000000086
35271,2022-11-23 13:15:00,-242.04,298525.990000007,308441.31000000704,-9915.320000000065
35272,2022-11-23 13:20:00,1578.01,300104.000000007,308441.31000000704,-8337.310000000056
35273,2022-11-23 13:25:00,1950.54,302054.54000000696,308441.31000000704,-6386.770000000077
35274,2022-11-23 13:30:00,1949.81,304004.35000000696,308441.31000000704,-4436.960000000079
35275,2022-11-23 13:35:00,-913.05,303091.300000007,308441.31000000704,-5350.0100000000675
35276,2022-11-23 13:40:00,-1702.4,301388.90000000695,308441.31000000704,-7052.410000000091
35277,2022-11-23 13:45:00,351.37,301740.27000000695,308441.31000000704,-6701.0400000000955
35278,2022-11-23 13:50:00,-747.79,300992.48000000697,308441.31000000704,-7448.8300000000745
35279,2022-11-23 13:55:00,-1309.2,299683.28000000695,308441.31000000704,-8758.030000000086
35280,2022-11-23 14:00:00,22.77,299706.050000007,308441.31000000704,-8735.260000000068
35281,2022-11-23 14:05:00,-1996.47,297709.580000007,308441.31000000704,-10731.73000000004
35282,2022-11-23 14:10:00,-1312.76,296396.820000007,308441.31000000704,-12044.490000000049
35283,2022-11-23 14:15:00,1856.11,298252.930000007,308441.31000000704,-10188.380000000063
35284,2022-11-23 14:20:00,1101.79,299354.72000000696,308441.31000000704,-9086.590000000084
35285,2022-11-23 14:25:00,-1015.31,298339.41000000696,308441.31000000704,-10101.900000000081
35286,2022-11-23 14:30:00,-232.13,298107.28000000695,308441.31000000704,-10334.030000000086
35287,2022-11-23 14:35:00,-1280.66,296826.620000007,308441.31000000704,-11614.69000000006
35288,2022-11-23 14:40:00,298.54,297125.16000000696,308441.31000000704,-11316.150000000081
35289,2022-11-23 14:45:00,-1792.15,295333.01000000694,308441.31000000704,-13108.300000000105
35290,2022-11-23 14:50:00,-914.39,294418.6200000069,308441.31000000704,-14022.690000000119
35291,2022-11-23 14:55:00,-1721.97,292696.65000000695,308441.31000000704,-15744.66000000009
35292,2022-11-23 15:00:00,1341.25,294037.90000000695,308441.31000000704,-14403.41000000009
35293,2022-11-23 15:05:00,1620.72,295658.6200000069,308441.31000000704,-12782.690000000119
35294,2022-11-23 15:10:00,-592.17,295066.45000000694,308441.31000000704,-13374.860000000102
35295,2022-11-23 15:15:00,335.75,295402.20000000694,308441.31000000704,-13039.110000000102
35296,2022-11-23 15:20:00,-1358.61,294043.59000000695,308441.31000000704,-14397.720000000088
35297,2022-11-23 15:25:00,-1209.64,292833.95000000694,308441.31000000704,-15607.360000000102
35298,2022-11-23 15:30:00,-1064.94,291769.01000000694,308441.31000000704,-16672.300000000105
35299,2022-11-23 15:35:00,1686.29,293455.3000000069,308441.31000000704,-14986.010000000126
35300,2022-11-23 15:40:00,-1303.47,292151.83000000694,308441.31000000704,-16289.480000000098
35301,2022-11-23 15:45:00,1283.41,293435.2400000069,308441.31000000704,-15006.070000000123
35302,2022-11-23 15:50:00,-77.62,293357.6200000069,308441.31000000704,-15083.690000000119
35303,2022-11-23 15:55:00,676.01,294033.63000000693,308441.31000000704,-14407.68000000011
35304,2022-11-23 16:00:00,-1118.53,292915.1000000069,308441.31000000704,-15526.210000000137
35305,2022-11-23 16:05:00,-19.26,292895.8400000069,308441.31000000704,-15545.470000000147
35306,2022-11-23 16:10:00,-1175.55,291720.2900000069,308441.31000000704,-16721.020000000135
35307,2022-11-23 16:15:00,1984.72,293705.0100000069,308441.31000000704,-14736.300000000163
35308,2022-11-23 16:20:00,255.1,293960.11000000685,308441.31000000704,-14481.200000000186
35309,2022-11-23 16:25:00,-1439.99,292520.12000000686,308441.31000000704,-15921.190000000177
35310,2022-11-23 16:30:00,-1661.03,290859.09000000684,308441.31000000704,-17582.220000000205
35311,2022-11-23 16:35:00,566.26,291425.35000000685,308441.31000000704,-17015.960000000196
35312,2022-11-23 16:40:00,-1670.96,289754.3900000068,308441.31000000704,-18686.920000000217
35313,2022-11-23 16:45:00,-133.91,289620.48000000685,308441.31000000704,-18820.83000000019
35314,2022-11-23 16:50:00,-8.17,289612.31000000687,308441.31000000704,-18829.000000000175
35315,2022-11-23 16:55:00,724.51,290336.8200000069,308441.31000000704,-18104.490000000165
35316,2022-11-24 08:00:00,960.32,291297.1400000069,290336.8200000069,960.320000000007
35317,2022-11-24 08:05:00,-507.84,290789.30000000686,290336.8200000069,452.4799999999814
35318,2022-11-24 08:10:00,-707.9,290081.40000000683,290336.8200000069,-255.4200000000419
35319,2022-11-24 08:15:00,1519.54,291600.9400000068,290336.8200000069,1264.1199999999371
35320,2022-11-24 08:20:00,1383.85,292984.7900000068,290336.8200000069,2647.969999999914
35321,2022-11-24 08:25:00,929.4,293914.1900000068,290336.8200000069,3577.369999999937
35322,2022-11-24 08:30:00,-733.35,293180.84000000684,290336.8200000069,2844.0199999999604
35323,2022-11-24 08:35:00,-1707.0,291473.84000000684,290336.8200000069,1137.0199999999604
35324,2022-11-24 08:40:00,-265.94,291207.90000000683,290336.8200000069,871.0799999999581
35325,2022-11-24 08:45:00,-337.22,290870.68000000686,290336.8200000069,533.859999999986
35326,2022-11-24 08:50:00,1422.17,292292.85000000685,290336.8200000069,1956.0299999999697
35327,2022-11-24 08:55:00,1342.73,293635.5800000068,290336.8200000069,3298.759999999951
35328,2022-11-24 09:00:00,-424.41,293211.17000000685,290336.8200000069,2874.3499999999767
35329,2022-11-24 09:05:00,1021.54,294232.71000000683,290336.8200000069,3895.8899999999558
35330,2022-11-24 09:10:00,-867.01,293365.7000000068,290336.8200000069,3028.8799999999464
35331,2022-11-24 09:15:00,-870.6,292495.10000000685,290336.8200000069,2158.2799999999697
35332,2022-11-24 09:20:00,-222.76,292272.34000000684,290336.8200000069,1935.5199999999604
35333,2022-11-24 09:25:00,-1896.65,290375.6900000068,290336.8200000069,38.869999999937136
35334,2022-11-24 09:30:00,-895.23,289480.46000000683,290336.8200000069,-856.3600000000442
35335,2022-11-24 09:35:00,-1892.98,287587.48000000685,290336.8200000069,-2749.3400000000256
35336,2022-11-24 09:40:00,1651.59,289239.0700000069,290336.8200000069,-1097.75
35337,2022-11-24 09:45:00,995.9,290234.9700000069,290336.8200000069,-101.84999999997672
35338,2022-11-24 09:50:00,668.51,290903.4800000069,290336.8200000069,566.6600000000326
35339,2022-11-24 09:55:00,409.64,291313.1200000069,290336.8200000069,976.3000000000466
35340,2022-11-24 10:00:00,-1831.78,289481.3400000069,290336.8200000069,-855.4799999999814
35341,2022-11-24 10:05:00,-710.99,288770.3500000069,290336.8200000069,-1566.469999999972
35342,2022-11-24 10:10:00,-1330.42,287439.9300000069,290336.8200000069,-2896.8899999999558
35343,2022-11-24 10:15:00,-894.41,286545.52000000695,290336.8200000069,-3791.29999999993
35344,2022-11-24 10:20:00,-1453.89,285091.63000000693,290336.8200000069,-5245.189999999944
35345,2022-11-24 10:25:00,-1271.89,283819.7400000069,290336.8200000069,-6517.079999999958
35346,2022-11-24 10:30:00,314.63,284134.3700000069,290336.8200000069,-6202.449999999953
35347,2022-11-24 10:35:00,-235.15,283899.2200000069,290336.8200000069,-6437.599999999977
35348,2022-11-24 10:40:00,454.21,284353.4300000069,290336.8200000069,-5983.389999999956
35349,2022-11-24 10:45:00,-962.04,283391.39000000694,290336.8200000069,-6945.429999999935
35350,2022-11-24 10:50:00,435.02,283826.41000000696,290336.8200000069,-6510.409999999916
35351,2022-11-24 10:55:00,-431.17,283395.240000007,290336.8200000069,-6941.5799999999
35352,2022-11-24 11:00:00,-294.58,283100.66000000696,290336.8200000069,-7236.159999999916
35353,2022-11-24 11:05:00,1905.74,285006.40000000695,290336.8200000069,-5330.4199999999255
35354,2022-11-24 11:10:00,1675.81,286682.21000000695,290336.8200000069,-3654.609999999928
35355,2022-11-24 11:15:00,-987.29,285694.92000000697,290336.8200000069,-4641.899999999907
35356,2022-11-24 11:20:00,1566.39,287261.310000007,290336.8200000069,-3075.509999999893
35357,2022-11-24 11:25:00,-215.9,287045.41000000696,290336.8200000069,-3291.409999999916
35358,2022-11-24 11:30:00,-832.24,286213.17000000697,290336.8200000069,-4123.649999999907
35359,2022-11-24 11:35:00,1640.45,287853.620000007,290336.8200000069,-2483.199999999895
35360,2022-11-24 11:40:00,1027.61,288881.23000000697,290336.8200000069,-1455.5899999999092
35361,2022-11-24 11:45:00,1473.43,290354.66000000696,290336.8200000069,17.84000000008382
35362,2022-11-24 11:50:00,1396.31,291750.97000000696,290336.8200000069,1414.1500000000815
35363,2022-11-24 11:55:00,-440.93,291310.04000000696,290336.8200000069,973.2200000000885
35364,2022-11-24 12:00:00,1983.86,293293.90000000695,290336.8200000069,2957.0800000000745
35365,2022-11-24 12:05:00,-257.08,293036.82000000693,290336.8200000069,2700.000000000058
35366,2022-11-24 12:10:00,1441.59,294478.41000000696,290336.8200000069,4141.590000000084
35367,2022-11-24 12:15:00,-6.8,294471.610000007,290336.8200000069,4134.7900000000955
35368,2022-11-24 12:20:00,95.08,294566.690000007,290336.8200000069,4229.870000000112
35369,2022-11-24 12:25:00,684.96,295251.650000007,290336.8200000069,4914.830000000133
35370,2022-11-24 12:30:00,875.83,296127.480000007,290336.8200000069,5790.660000000149
35371,2022-11-24 12:35:00,1572.51,297699.99000000703,290336.8200000069,7363.170000000158
35372,2022-11-24 12:40:00,1321.73,299021.720000007,290336.8200000069,8684.90000000014
35373,2022-11-24 12:45:00,368.79,299390.510000007,290336.8200000069,9053.690000000119
35374,2022-11-24 12:50:00,349.81,299740.320000007,290336.8200000069,9403.500000000116
35375,2022-11-24 12:55:00,1124.07,300864.390000007,290336.8200000069,10527.570000000123
35376,2022-11-24 13:00:00,705.6,301569.990000007,290336.8200000069,11233.1700000001
35377,2022-11-24 13:05:00,843.7,302413.690000007,290336.8200000069,12076.870000000112
35378,2022-11-24 13:10:00,-941.67,301472.020000007,290336.8200000069,11135.200000000128
35379,2022-11-24 13:15:00,-1953.13,299518.890000007,290336.8200000069,9182.070000000123
35380,2022-11-24 13:20:00,-1781.81,297737.080000007,290336.8200000069,7400.260000000126
35381,2022-11-24 13:25:00,1030.1,298767.180000007,290336.8200000069,8430.360000000102
35382,2022-11-24 13:30:00,1966.95,300734.130000007,290336.8200000069,10397.310000000114
35383,2022-11-24 13:35:00,1629.13,302363.260000007,290336.8200000069,12026.440000000119
35384,2022-11-24 13:40:00,-469.7,301893.560000007,290336.8200000069,11556.740000000107
35385,2022-11-24 13:45:00,-18.67,301874.890000007,290336.8200000069,11538.070000000123
35386,2022-11-24 13:50:00,1119.5,302994.390000007,290336.8200000069,12657.570000000123
35387,2022-11-24 13:55:00,1464.01,304458.400000007,290336.8200000069,14121.580000000133
35388,2022-11-24 14:00:00,-742.02,303716.380000007,290336.8200000069,13379.560000000114
35389,2022-11-24 14:05:00,-749.3,302967.080000007,290336.8200000069,12630.260000000126
35390,2022-11-24 14:10:00,1361.5,304328.580000007,290336.8200000069,13991.760000000126
35391,2022-11-24 14:15:00,-1159.53,303169.050000007,290336.8200000069,12832.230000000098
35392,2022-11-24 14:20:00,74.13,303243.180000007,290336.8200000069,12906.360000000102
35393,2022-11-24 14:25:00,946.54,304189.72000000696,290336.8200000069,13852.900000000081
35394,2022-11-24 14:30:00,-958.75,303230.97000000696,290336.8200000069,12894.150000000081
35395,2022-11-24 14:35:00,-1925.26,301305.71000000695,290336.8200000069,10968.890000000072
35396,2022-11-24 14:40:00,-1857.48,299448.23000000697,290336.8200000069,9111.41000000009
35397,2022-11-24 14:45:00,-1036.95,298411.28000000695,290336.8200000069,8074.460000000079
35398,2022-11-24 14:50:00,-1078.86,297332.42000000697,290336.8200000069,6995.600000000093
35399,2022-11-24 14:55:00,-1165.58,296166.84000000695,290336.8200000069,5830.020000000077
35400,2022-11-24 15:00:00,340.8,296507.64000000694,290336.8200000069,6170.820000000065
35401,2022-11-24 15:05:00,1586.56,298094.20000000694,290336.8200000069,7757.380000000063
35402,2022-11-24 15:10:00,525.6,298619.8000000069,290336.8200000069,8282.98000000004
35403,2022-11-24 15:15:00,850.29,299470.0900000069,290336.8200000069,9133.270000000019
35404,2022-11-24 15:20:00,1435.36,300905.4500000069,290336.8200000069,10568.630000000005
35405,2022-11-24 15:25:00,-427.25,300478.2000000069,290336.8200000069,10141.380000000005
35406,2022-11-24 15:30:00,-278.43,300199.7700000069,290336.8200000069,9862.950000000012
35407,2022-11-24 15:35:00,-1613.67,298586.1000000069,290336.8200000069,8249.280000000028
35408,2022-11-24 15:40:00,-437.29,298148.8100000069,290336.8200000069,7811.990000000049
35409,2022-11-24 15:45:00,-982.09,297166.7200000069,290336.8200000069,6829.900000000023
35410,2022-11-24 15:50:00,-407.03,296759.69000000687,290336.8200000069,6422.869999999995
35411,2022-11-24 15:55:00,-153.74,296605.9500000069,290336.8200000069,6269.130000000005
35412,2022-11-24 16:00:00,967.65,297573.6000000069,290336.8200000069,7236.780000000028
35413,2022-11-24 16:05:00,-1808.23,295765.3700000069,290336.8200000069,5428.550000000047
35414,2022-11-24 16:10:00,1743.09,297508.46000000695,290336.8200000069,7171.640000000072
35415,2022-11-24 16:15:00,-367.79,297140.67000000697,290336.8200000069,6803.850000000093
35416,2022-11-24 16:20:00,1401.04,298541.71000000695,290336.8200000069,8204.890000000072
35417,2022-11-24 16:25:00,-1077.04,297464.67000000697,290336.8200000069,7127.850000000093
35418,2022-11-24 16:30:00,-1803.61,295661.060000007,290336.8200000069,5324.240000000107
35419,2022-11-24 16:35:00,611.04,296272.10000000696,290336.8200000069,5935.280000000086
35420,2022-11-24 16:40:00,-1061.17,295210.930000007,290336.8200000069,4874.110000000102
35421,2022-11-24 16:45:00,884.05,296094.98000000697,290336.8200000069,5758.160000000091
35422,2022-11-24 16:50:00,-1008.19,295086.79000000696,290336.8200000069,4749.9700000000885
35423,2022-11-24 16:55:00,378.14,295464.930000007,290336.8200000069,5128.110000000102
35424,2022-11-25 08:00:00,-603.84,294861.09000000695,295464.930000007,-603.8400000000256
35425,2022-11-25 08:05:00,1082.51,295943.60000000696,295464.930000007,478.6699999999837
35426,2022-11-25 08:10:00,1763.52,297707.120000007,295464.930000007,2242.1900000000023
35427,2022-11-25 08:15:00,-1584.15,296122.97000000696,295464.930000007,658.039999999979
35428,2022-11-25 08:20:00,-1108.6,295014.370000007,295464.930000007,-450.5599999999977
35429,2022-11-25 08:25:00,1399.13,296413.500000007,295464.930000007,948.570000000007
35430,2022-11-25 08:30:00,1947.29,298360.79000000696,295464.930000007,2895.859999999986
35431,2022-11-25 08:35:00,1939.09,300299.880000007,295464.930000007,4834.950000000012
35432,2022-11-25 08:40:00,218.95,300518.830000007,295464.930000007,5053.900000000023
35433,2022-11-25 08:45:00,-46.26,300472.570000007,295464.930000007,5007.640000000014
35434,2022-11-25 08:50:00,851.71,301324.280000007,295464.930000007,5859.350000000035
35435,2022-11-25 08:55:00,1112.2,302436.480000007,295464.930000007,6971.550000000047
35436,2022-11-25 09:00:00,-682.88,301753.600000007,295464.930000007,6288.670000000042
35437,2022-11-25 09:05:00,-60.64,301692.960000007,295464.930000007,6228.030000000028
35438,2022-11-25 09:10:00,871.36,302564.320000007,295464.930000007,7099.390000000014
35439,2022-11-25 09:15:00,628.82,303193.140000007,295464.930000007,7728.210000000021
35440,2022-11-25 09:20:00,1148.34,304341.480000007,295464.930000007,8876.550000000047
35441,2022-11-25 09:25:00,1134.03,305475.51000000705,295464.930000007,10010.580000000075
35442,2022-11-25 09:30:00,-1808.18,303667.33000000706,295464.930000007,8202.400000000081
35443,2022-11-25 09:35:00,664.19,304331.52000000706,295464.930000007,8866.590000000084
35444,2022-11-25 09:40:00,-1028.42,303303.1000000071,295464.930000007,7838.1700000001
35445,2022-11-25 09:45:00,-61.76,303241.34000000707,295464.930000007,7776.410000000091
35446,2022-11-25 09:50:00,878.58,304119.9200000071,295464.930000007,8654.990000000107
35447,2022-11-25 09:55:00,132.83,304252.7500000071,295464.930000007,8787.820000000123
35448,2022-11-25 10:00:00,1065.87,305318.6200000071,295464.930000007,9853.690000000119
35449,2022-11-25 10:05:00,-347.91,304970.7100000071,295464.930000007,9505.780000000144
35450,2022-11-25 10:10:00,-727.87,304242.8400000071,295464.930000007,8777.910000000149
35451,2022-11-25 10:15:00,521.53,304764.37000000715,295464.930000007,9299.440000000177
35452,2022-11-25 10:20:00,977.37,305741.74000000715,295464.930000007,10276.810000000172
35453,2022-11-25 10:25:00,1267.6,307009.3400000071,295464.930000007,11544.410000000149
35454,2022-11-25 10:30:00,1088.36,308097.7000000071,295464.930000007,12632.770000000135
35455,2022-11-25 10:35:00,-806.13,307291.5700000071,295464.930000007,11826.64000000013
35456,2022-11-25 10:40:00,-1879.74,305411.8300000071,295464.930000007,9946.90000000014
35457,2022-11-25 10:45:00,287.88,305699.7100000071,295464.930000007,10234.780000000144
35458,2022-11-25 10:50:00,-1021.65,304678.0600000071,295464.930000007,9213.130000000121
35459,2022-11-25 10:55:00,-637.32,304040.7400000071,295464.930000007,8575.810000000114
35460,2022-11-25 11:00:00,1444.76,305485.5000000071,295464.930000007,10020.570000000123
35461,2022-11-25 11:05:00,-863.16,304622.3400000071,295464.930000007,9157.410000000149
35462,2022-11-25 11:10:00,521.7,305144.04000000714,295464.930000007,9679.11000000016
35463,2022-11-25 11:15:00,-1583.5,303560.54000000714,295464.930000007,8095.610000000161
35464,2022-11-25 11:20:00,-652.6,302907.94000000716,295464.930000007,7443.010000000184
35465,2022-11-25 11:25:00,-1403.23,301504.7100000072,295464.930000007,6039.780000000203
35466,2022-11-25 11:30:00,936.25,302440.9600000072,295464.930000007,6976.030000000203
35467,2022-11-25 11:35:00,-619.13,301821.8300000072,295464.930000007,6356.900000000198
35468,2022-11-25 11:40:00,-384.97,301436.8600000072,295464.930000007,5971.930000000226
35469,2022-11-25 11:45:00,-1143.56,300293.3000000072,295464.930000007,4828.370000000228
35470,2022-11-25 11:50:00,1222.58,301515.8800000072,295464.930000007,6050.9500000002445
35471,2022-11-25 11:55:00,188.54,301704.4200000072,295464.930000007,6239.4900000002235
35472,2022-11-25 12:00:00,-1150.34,300554.0800000072,295464.930000007,5089.150000000198
35473,2022-11-25 12:05:00,216.36,300770.44000000716,295464.930000007,5305.510000000184
35474,2022-11-25 12:10:00,662.96,301433.4000000072,295464.930000007,5968.470000000205
35475,2022-11-25 12:15:00,-321.15,301112.25000000716,295464.930000007,5647.320000000182
35476,2022-11-25 12:20:00,-451.46,300660.79000000714,295464.930000007,5195.860000000161
35477,2022-11-25 12:25:00,-1412.35,299248.44000000716,295464.930000007,3783.510000000184
35478,2022-11-25 12:30:00,762.69,300011.13000000716,295464.930000007,4546.200000000186
35479,2022-11-25 12:35:00,-1511.14,298499.99000000715,295464.930000007,3035.0600000001723
35480,2022-11-25 12:40:00,-1440.7,297059.29000000714,295464.930000007,1594.3600000001607
35481,2022-11-25 12:45:00,-1509.79,295549.50000000716,295464.930000007,84.57000000018161
35482,2022-11-25 12:50:00,-583.46,294966.04000000714,295464.930000007,-498.88999999983935
35483,2022-11-25 12:55:00,548.7,295514.74000000715,295464.930000007,49.810000000172295
35484,2022-11-25 13:00:00,1671.79,297186.53000000713,295464.930000007,1721.6000000001513
35485,2022-11-25 13:05:00,-1098.3,296088.23000000714,295464.930000007,623.300000000163
35486,2022-11-25 13:10:00,-841.92,295246.31000000716,295464.930000007,-218.61999999982072
35487,2022-11-25 13:15:00,696.74,295943.05000000715,295464.930000007,478.12000000016997
35488,2022-11-25 13:20:00,1732.43,297675.48000000714,295464.930000007,2210.550000000163
35489,2022-11-25 13:25:00,1234.55,298910.03000000713,295464.930000007,3445.1000000001513
35490,2022-11-25 13:30:00,-1686.94,297223.0900000071,295464.930000007,1758.160000000149
35491,2022-11-25 13:35:00,-1558.05,295665.04000000714,295464.930000007,200.11000000016065
35492,2022-11-25 13:40:00,-493.21,295171.8300000071,295464.930000007,-293.0999999998603
35493,2022-11-25 13:45:00,-1611.24,293560.5900000071,295464.930000007,-1904.339999999851
35494,2022-11-25 13:50:00,5.06,293565.6500000071,295464.930000007,-1899.2799999998533
35495,2022-11-25 13:55:00,742.08,294307.73000000714,295464.930000007,-1157.199999999837
35496,2022-11-25 14:00:00,1351.91,295659.6400000071,295464.930000007,194.71000000013737
35497,2022-11-25 14:05:00,304.06,295963.7000000071,295464.930000007,498.77000000013504
35498,2022-11-25 14:10:00,1073.3,297037.0000000071,295464.930000007,1572.0700000001234
35499,2022-11-25 14:15:00,-1578.99,295458.0100000071,295464.930000007,-6.9199999998672865
35500,2022-11-25 14:20:00,1310.28,296768.29000000714,295464.930000007,1303.3600000001607
35501,2022-11-25 14:25:00,44.83,296813.12000000715,295464.930000007,1348.190000000177
35502,2022-11-25 14:30:00,-1084.72,295728.4000000072,295464.930000007,263.4700000002049
35503,2022-11-25 14:35:00,-136.07,295592.3300000072,295464.930000007,127.4000000001979
35504,2022-11-25 14:40:00,1616.09,297208.4200000072,295464.930000007,1743.4900000002235
35505,2022-11-25 14:45:00,1451.98,298660.4000000072,295464.930000007,3195.470000000205
35506,2022-11-25 14:50:00,-1182.85,297477.5500000072,295464.930000007,2012.6200000002282
35507,2022-11-25 14:55:00,-842.88,296634.6700000072,295464.930000007,1169.7400000002235
35508,2022-11-25 15:00:00,-1194.77,295439.9000000072,295464.930000007,-25.02999999979511
35509,2022-11-25 15:05:00,806.1,296246.00000000716,295464.930000007,781.0700000001816
35510,2022-11-25 15:10:00,632.52,296878.5200000072,295464.930000007,1413.5900000002002
35511,2022-11-25 15:15:00,658.29,297536.81000000716,295464.930000007,2071.8800000001793
35512,2022-11-25 15:20:00,1004.15,298540.9600000072,295464.930000007,3076.0300000002026
35513,2022-11-25 15:25:00,-1562.23,296978.7300000072,295464.930000007,1513.8000000002212
35514,2022-11-25 15:30:00,1617.92,298596.6500000072,295464.930000007,3131.720000000205
35515,2022-11-25 15:35:00,-939.45,297657.2000000072,295464.930000007,2192.2700000001932
35516,2022-11-25 15:40:00,-235.18,297422.0200000072,295464.930000007,1957.0900000002002
35517,2022-11-25 15:45:00,-404.49,297017.5300000072,295464.930000007,1552.6000000002095
35518,2022-11-25 15:50:00,-1750.4,295267.13000000716,295464.930000007,-197.79999999981374
35519,2022-11-25 15:55:00,1952.0,297219.13000000716,295464.930000007,1754.2000000001863
35520,2022-11-25 16:00:00,-101.59,297117.54000000714,295464.930000007,1652.6100000001607
35521,2022-11-25 16:05:00,1645.23,298762.7700000071,295464.930000007,3297.840000000142
35522,2022-11-25 16:10:00,955.85,299718.6200000071,295464.930000007,4253.690000000119
35523,2022-11-25 16:15:00,1337.87,301056.4900000071,295464.930000007,5591.560000000114
35524,2022-11-25 16:20:00,-1588.03,299468.46000000706,295464.930000007,4003.530000000086
35525,2022-11-25 16:25:00,157.1,299625.56000000704,295464.930000007,4160.630000000063
35526,2022-11-25 16:30:00,-656.59,298968.970000007,295464.930000007,3504.0400000000373
35527,2022-11-25 16:35:00,1037.8,300006.770000007,295464.930000007,4541.840000000026
35528,2022-11-25 16:40:00,667.96,300674.730000007,295464.930000007,5209.800000000047
35529,2022-11-25 16:45:00,477.59,301152.32000000705,295464.930000007,5687.390000000072
35530,2022-11-25 16:50:00,-1548.27,299604.05000000703,295464.930000007,4139.120000000054
35531,2022-11-25 16:55:00,516.47,300120.520000007,295464.930000007,4655.590000000026
35532,2022-11-26 08:00:00,1655.07,301775.590000007,300120.520000007,1655.070000000007
35533,2022-11-26 08:05:00,1093.5,302869.090000007,300120.520000007,2748.570000000007
35534,2022-11-26 08:10:00,1165.07,304034.160000007,300120.520000007,3913.640000000014
35535,2022-11-26 08:15:00,-403.4,303630.760000007,300120.520000007,3510.2399999999907
35536,2022-11-26 08:20:00,1217.88,304848.640000007,300120.520000007,4728.119999999995
35537,2022-11-26 08:25:00,-857.89,303990.750000007,300120.520000007,3870.2299999999814
35538,2022-11-26 08:30:00,469.57,304460.320000007,300120.520000007,4339.799999999988
35539,2022-11-26 08:35:00,1882.8,306343.120000007,300120.520000007,6222.599999999977
35540,2022-11-26 08:40:00,617.57,306960.690000007,300120.520000007,6840.169999999984
35541,2022-11-26 08:45:00,1712.13,308672.820000007,300120.520000007,8552.299999999988
35542,2022-11-26 08:50:00,-864.43,307808.390000007,300120.520000007,7687.869999999995
35543,2022-11-26 08:55:00,1057.87,308866.260000007,300120.520000007,8745.73999999999
35544,2022-11-26 09:00:00,315.4,309181.660000007,300120.520000007,9061.140000000014
35545,2022-11-26 09:05:00,-66.78,309114.880000007,300120.520000007,8994.359999999986
35546,2022-11-26 09:10:00,22.91,309137.79000000696,300120.520000007,9017.26999999996
35547,2022-11-26 09:15:00,-816.82,308320.97000000696,300120.520000007,8200.449999999953
35548,2022-11-26 09:20:00,930.29,309251.26000000694,300120.520000007,9130.739999999932
35549,2022-11-26 09:25:00,68.17,309319.4300000069,300120.520000007,9198.909999999916
35550,2022-11-26 09:30:00,-1138.67,308180.76000000694,300120.520000007,8060.2399999999325
35551,2022-11-26 09:35:00,103.88,308284.64000000694,300120.520000007,8164.119999999937
35552,2022-11-26 09:40:00,1875.96,310160.60000000696,300120.520000007,10040.079999999958
35553,2022-11-26 09:45:00,1831.05,311991.65000000695,300120.520000007,11871.129999999946
35554,2022-11-26 09:50:00,391.16,312382.8100000069,300120.520000007,12262.28999999992
35555,2022-11-26 09:55:00,-1799.59,310583.2200000069,300120.520000007,10462.699999999895
35556,2022-11-26 10:00:00,1719.5,312302.7200000069,300120.520000007,12182.199999999895
35557,2022-11-26 10:05:00,1651.6,313954.3200000069,300120.520000007,13833.799999999872
35558,2022-11-26 10:10:00,1664.54,315618.86000000685,300120.520000007,15498.339999999851
35559,2022-11-26 10:15:00,352.09,315970.9500000069,300120.520000007,15850.429999999877
35560,2022-11-26 10:20:00,1502.32,317473.2700000069,300120.520000007,17352.749999999884
35561,2022-11-26 10:25:00,1425.49,318898.7600000069,300120.520000007,18778.239999999874
35562,2022-11-26 10:30:00,1924.66,320823.42000000685,300120.520000007,20702.89999999985
35563,2022-11-26 10:35:00,835.92,321659.34000000684,300120.520000007,21538.819999999832
35564,2022-11-26 10:40:00,1663.2,323322.54000000685,300120.520000007,23202.019999999844
35565,2022-11-26 10:45:00,-509.37,322813.17000000685,300120.520000007,22692.64999999985
35566,2022-11-26 10:50:00,-733.12,322080.05000000686,300120.520000007,21959.529999999853
35567,2022-11-26 10:55:00,949.42,323029.47000000684,300120.520000007,22908.949999999837
35568,2022-11-26 11:00:00,838.09,323867.56000000687,300120.520000007,23747.039999999863
35569,2022-11-26 11:05:00,-1121.87,322745.69000000687,300120.520000007,22625.169999999867
35570,2022-11-26 11:10:00,-1039.34,321706.35000000685,300120.520000007,21585.82999999984
35571,2022-11-26 11:15:00,192.83,321899.18000000686,300120.520000007,21778.659999999858
35572,2022-11-26 11:20:00,1526.05,323425.23000000685,300120.520000007,23304.709999999846
35573,2022-11-26 11:25:00,-1733.42,321691.81000000687,300120.520000007,21571.289999999863
35574,2022-11-26 11:30:00,-228.6,321463.2100000069,300120.520000007,21342.689999999886
35575,2022-11-26 11:35:00,-811.2,320652.0100000069,300120.520000007,20531.489999999874
35576,2022-11-26 11:40:00,1004.53,321656.5400000069,300120.520000007,21536.019999999902
35577,2022-11-26 11:45:00,-826.03,320830.5100000069,300120.520000007,20709.989999999874
35578,2022-11-26 11:50:00,-877.2,319953.31000000687,300120.520000007,19832.789999999863
35579,2022-11-26 11:55:00,-1071.6,318881.7100000069,300120.520000007,18761.189999999886
35580,2022-11-26 12:00:00,573.68,319455.3900000069,300120.520000007,19334.86999999988
35581,2022-11-26 12:05:00,-565.58,318889.81000000687,300120.520000007,18769.289999999863
35582,2022-11-26 12:10:00,106.42,318996.23000000685,300120.520000007,18875.709999999846
35583,2022-11-26 12:15:00,-389.31,318606.92000000685,300120.520000007,18486.39999999985
35584,2022-11-26 12:20:00,-914.75,317692.17000000685,300120.520000007,17571.64999999985
35585,2022-11-26 12:25:00,-477.63,317214.54000000685,300120.520000007,17094.019999999844
35586,2022-11-26 12:30:00,-825.72,316388.8200000069,300120.520000007,16268.299999999872
35587,2022-11-26 12:35:00,-850.41,315538.4100000069,300120.520000007,15417.889999999898
35588,2022-11-26 12:40:00,-838.27,314700.1400000069,300120.520000007,14579.619999999879
35589,2022-11-26 12:45:00,-1924.17,312775.9700000069,300120.520000007,12655.449999999895
35590,2022-11-26 12:50:00,1419.25,314195.2200000069,300120.520000007,14074.699999999895
35591,2022-11-26 12:55:00,1784.73,315979.9500000069,300120.520000007,15859.429999999877
35592,2022-11-26 13:00:00,-1964.61,314015.3400000069,300120.520000007,13894.81999999989
35593,2022-11-26 13:05:00,534.24,314549.5800000069,300120.520000007,14429.059999999881
35594,2022-11-26 13:10:00,-863.06,313686.5200000069,300120.520000007,13565.999999999884
35595,2022-11-26 13:15:00,-1034.28,312652.24000000686,300120.520000007,12531.719999999856
35596,2022-11-26 13:20:00,1499.93,314152.17000000685,300120.520000007,14031.649999999849
35597,2022-11-26 13:25:00,207.17,314359.34000000684,300120.520000007,14238.819999999832
35598,2022-11-26 13:30:00,985.53,315344.87000000686,300120.520000007,15224.34999999986
35599,2022-11-26 13:35:00,956.91,316301.78000000684,300120.520000007,16181.259999999835
35600,2022-11-26 13:40:00,339.26,316641.04000000685,300120.520000007,16520.519999999844
35601,2022-11-26 13:45:00,1106.34,317747.3800000069,300120.520000007,17626.85999999987
35602,2022-11-26 13:50:00,-1064.11,316683.2700000069,300120.520000007,16562.749999999884
35603,2022-11-26 13:55:00,1510.14,318193.4100000069,300120.520000007,18072.889999999898
35604,2022-11-26 14:00:00,-102.75,318090.6600000069,300120.520000007,17970.139999999898
35605,2022-11-26 14:05:00,-457.78,317632.8800000069,300120.520000007,17512.35999999987
35606,2022-11-26 14:10:00,-116.94,317515.94000000687,300120.520000007,17395.419999999867
35607,2022-11-26 14:15:00,617.07,318133.0100000069,300120.520000007,18012.489999999874
35608,2022-11-26 14:20:00,534.94,318667.9500000069,300120.520000007,18547.429999999877
35609,2022-11-26 14:25:00,1148.48,319816.43000000686,300120.520000007,19695.909999999858
35610,2022-11-26 14:30:00,618.69,320435.12000000686,300120.520000007,20314.59999999986
35611,2022-11-26 14:35:00,42.98,320478.10000000685,300120.520000007,20357.57999999984
35612,2022-11-26 14:40:00,1595.77,322073.87000000686,300120.520000007,21953.34999999986
35613,2022-11-26 14:45:00,-428.71,321645.16000000684,300120.520000007,21524.63999999984
35614,2022-11-26 14:50:00,-500.85,321144.31000000687,300120.520000007,21023.789999999863
35615,2022-11-26 14:55:00,-67.8,321076.5100000069,300120.520000007,20955.989999999874
35616,2022-11-26 15:00:00,-858.55,320217.9600000069,300120.520000007,20097.439999999886
35617,2022-11-26 15:05:00,-130.2,320087.7600000069,300120.520000007,19967.239999999874
35618,2022-11-26 15:10:00,-1239.53,318848.23000000685,300120.520000007,18727.709999999846
35619,2022-11-26 15:15:00,-1587.1,317261.1300000069,300120.520000007,17140.60999999987
35620,2022-11-26 15:20:00,40.31,317301.44000000687,300120.520000007,17180.919999999867
35621,2022-11-26 15:25:00,219.34,317520.7800000069,300120.520000007,17400.259999999893
35622,2022-11-26 15:30:00,-1926.53,315594.25000000687,300120.520000007,15473.729999999865
35623,2022-11-26 15:35:00,-13.71,315580.54000000685,300120.520000007,15460.019999999844
35624,2022-11-26 15:40:00,1244.62,316825.16000000684,300120.520000007,16704.63999999984
35625,2022-11-26 15:45:00,-1277.29,315547.87000000686,300120.520000007,15427.34999999986
35626,2022-11-26 15:50:00,-1795.25,313752.62000000686,300120.520000007,13632.09999999986
35627,2022-11-26 15:55:00,-1384.84,312367.78000000684,300120.520000007,12247.259999999835
35628,2022-11-26 16:00:00,1961.07,314328.85000000685,300120.520000007,14208.329999999842
35629,2022-11-26 16:05:00,1226.13,315554.98000000685,300120.520000007,15434.459999999846
35630,2022-11-26 16:10:00,-1006.23,314548.75000000687,300120.520000007,14428.229999999865
35631,2022-11-26 16:15:00,990.62,315539.37000000686,300120.520000007,15418.84999999986
35632,2022-11-26 16:20:00,1320.82,316860.19000000687,300120.520000007,16739.669999999867
35633,2022-11-26 16:25:00,1162.49,318022.68000000686,300120.520000007,17902.159999999858
35634,2022-11-26 16:30:00,511.95,318534.6300000069,300120.520000007,18414.10999999987
35635,2022-11-26 16:35:00,-1159.33,317375.30000000686,300120.520000007,17254.779999999853
35636,2022-11-26 16:40:00,1637.98,319013.28000000684,300120.520000007,18892.759999999835
35637,2022-11-26 16:45:00,-1271.02,317742.2600000068,300120.520000007,17621.739999999816
35638,2022-11-26 16:50:00,-208.63,317533.6300000068,300120.520000007,17413.10999999981
35639,2022-11-26 16:55:00,880.87,318414.5000000068,300120.520000007,18293.979999999807
35640,2022-11-27 08:00:00,1337.71,319752.21000000683,318414.5000000068,1337.710000000021
35641,2022-11-27 08:05:00,1649.78,321401.99000000686,318414.5000000068,2987.490000000049
35642,2022-11-27 08:10:00,550.82,321952.81000000687,318414.5000000068,3538.310000000056
35643,2022-11-27 08:15:00,-12.68,321940.1300000069,318414.5000000068,3525.630000000063
35644,2022-11-27 08:20:00,1594.4,323534.5300000069,318414.5000000068,5120.030000000086
35645,2022-11-27 08:25:00,-218.13,323316.4000000069,318414.5000000068,4901.9000000000815
35646,2022-11-27 08:30:00,-603.3,322713.1000000069,318414.5000000068,4298.600000000093
35647,2022-11-27 08:35:00,-1895.44,320817.6600000069,318414.5000000068,2403.160000000091
35648,2022-11-27 08:40:00,-1022.37,319795.2900000069,318414.5000000068,1380.7900000000955
35649,2022-11-27 08:45:00,-1113.63,318681.6600000069,318414.5000000068,267.1600000000908
35650,2022-11-27 08:50:00,1222.8,319904.4600000069,318414.5000000068,1489.9600000000792
35651,2022-11-27 08:55:00,1854.55,321759.0100000069,318414.5000000068,3344.5100000000675
35652,2022-11-27 09:00:00,1251.14,323010.1500000069,318414.5000000068,4595.6500000000815
35653,2022-11-27 09:05:00,1336.38,324346.5300000069,318414.5000000068,5932.030000000086
35654,2022-11-27 09:10:00,-373.78,323972.75000000687,318414.5000000068,5558.250000000058
35655,2022-11-27 09:15:00,1261.9,325234.6500000069,318414.5000000068,6820.1500000000815
35656,2022-11-27 09:20:00,-1355.7,323878.9500000069,318414.5000000068,5464.45000000007
35657,2022-11-27 09:25:00,-674.28,323204.67000000685,318414.5000000068,4790.170000000042
35658,2022-11-27 09:30:00,730.53,323935.2000000069,318414.5000000068,5520.70000000007
35659,2022-11-27 09:35:00,-59.17,323876.0300000069,318414.5000000068,5461.530000000086
35660,2022-11-27 09:40:00,-1598.12,322277.9100000069,318414.5000000068,3863.410000000091
35661,2022-11-27 09:45:00,1231.65,323509.5600000069,318414.5000000068,5095.060000000114
35662,2022-11-27 09:50:00,1026.52,324536.08000000694,318414.5000000068,6121.580000000133
35663,2022-11-27 09:55:00,817.85,325353.9300000069,318414.5000000068,6939.430000000109
35664,2022-11-27 10:00:00,-604.56,324749.3700000069,318414.5000000068,6334.870000000112
35665,2022-11-27 10:05:00,-1568.17,323181.20000000694,318414.5000000068,4766.700000000128
35666,2022-11-27 10:10:00,-668.72,322512.48000000697,318414.5000000068,4097.980000000156
35667,2022-11-27 10:15:00,1324.76,323837.240000007,318414.5000000068,5422.740000000165
35668,2022-11-27 10:20:00,127.58,323964.820000007,318414.5000000068,5550.320000000182
35669,2022-11-27 10:25:00,1394.35,325359.17000000697,318414.5000000068,6944.670000000158
35670,2022-11-27 10:30:00,-848.96,324510.21000000695,318414.5000000068,6095.710000000137
35671,2022-11-27 10:35:00,-1073.46,323436.7500000069,318414.5000000068,5022.250000000116
35672,2022-11-27 10:40:00,606.64,324043.39000000694,318414.5000000068,5628.89000000013
35673,2022-11-27 10:45:00,-166.46,323876.9300000069,318414.5000000068,5462.430000000109
35674,2022-11-27 10:50:00,-544.71,323332.2200000069,318414.5000000068,4917.7200000000885
35675,2022-11-27 10:55:00,908.13,324240.3500000069,318414.5000000068,5825.850000000093
35676,2022-11-27 11:00:00,1130.33,325370.6800000069,318414.5000000068,6956.180000000109
35677,2022-11-27 11:05:00,513.73,325884.4100000069,318414.5000000068,7469.910000000091
35678,2022-11-27 11:10:00,932.57,326816.9800000069,318414.5000000068,8402.480000000098
35679,2022-11-27 11:15:00,1358.62,328175.6000000069,318414.5000000068,9761.100000000093
35680,2022-11-27 11:20:00,91.36,328266.9600000069,318414.5000000068,9852.46000000008
35681,2022-11-27 11:25:00,-1868.3,326398.6600000069,318414.5000000068,7984.160000000091
35682,2022-11-27 11:30:00,-1308.99,325089.6700000069,318414.5000000068,6675.1700000001
35683,2022-11-27 11:35:00,185.71,325275.38000000693,318414.5000000068,6860.880000000121
35684,2022-11-27 11:40:00,-1191.05,324084.33000000694,318414.5000000068,5669.830000000133
35685,2022-11-27 11:45:00,1574.87,325659.20000000694,318414.5000000068,7244.700000000128
35686,2022-11-27 11:50:00,159.78,325818.98000000697,318414.5000000068,7404.480000000156
35687,2022-11-27 11:55:00,-1015.06,324803.92000000697,318414.5000000068,6389.420000000158
35688,2022-11-27 12:00:00,-1048.94,323754.98000000697,318414.5000000068,5340.480000000156
35689,2022-11-27 12:05:00,-491.16,323263.820000007,318414.5000000068,4849.320000000182
35690,2022-11-27 12:10:00,-1046.41,322217.410000007,318414.5000000068,3802.910000000207
35691,2022-11-27 12:15:00,-1298.3,320919.11000000703,318414.5000000068,2504.610000000219
35692,2022-11-27 12:20:00,-300.87,320618.24000000703,318414.5000000068,2203.7400000002235
35693,2022-11-27 12:25:00,-209.5,320408.74000000703,318414.5000000068,1994.2400000002235
35694,2022-11-27 12:30:00,1093.4,321502.14000000706,318414.5000000068,3087.640000000247
35695,2022-11-27 12:35:00,1676.39,323178.5300000071,318414.5000000068,4764.030000000261
35696,2022-11-27 12:40:00,1410.79,324589.32000000705,318414.5000000068,6174.82000000024
35697,2022-11-27 12:45:00,453.7,325043.02000000706,318414.5000000068,6628.5200000002515
35698,2022-11-27 12:50:00,-1728.9,323314.12000000704,318414.5000000068,4899.620000000228
35699,2022-11-27 12:55:00,-953.79,322360.33000000706,318414.5000000068,3945.830000000249
35700,2022-11-27 13:00:00,-848.04,321512.2900000071,318414.5000000068,3097.79000000027
35701,2022-11-27 13:05:00,-1480.5,320031.7900000071,318414.5000000068,1617.29000000027
35702,2022-11-27 13:10:00,-338.85,319692.9400000071,318414.5000000068,1278.4400000002934
35703,2022-11-27 13:15:00,1840.65,321533.5900000071,318414.5000000068,3119.0900000003166
35704,2022-11-27 13:20:00,-481.07,321052.5200000071,318414.5000000068,2638.0200000003097
35705,2022-11-27 13:25:00,829.04,321881.5600000071,318414.5000000068,3467.0600000002887
35706,2022-11-27 13:30:00,703.28,322584.8400000071,318414.5000000068,4170.340000000317
35707,2022-11-27 13:35:00,-1977.77,320607.0700000071,318414.5000000068,2192.570000000298
35708,2022-11-27 13:40:00,-1615.37,318991.7000000071,318414.5000000068,577.2000000003027
35709,2022-11-27 13:45:00,-1871.46,317120.2400000071,318414.5000000068,-1294.2599999997183
35710,2022-11-27 13:50:00,496.03,317616.2700000071,318414.5000000068,-798.2299999996903
35711,2022-11-27 13:55:00,1660.72,319276.9900000071,318414.5000000068,862.4900000002817
35712,2022-11-27 14:00:00,1369.5,320646.4900000071,318414.5000000068,2231.9900000002817
35713,2022-11-27 14:05:00,618.48,321264.9700000071,318414.5000000068,2850.470000000263
35714,2022-11-27 14:10:00,-1822.82,319442.15000000707,318414.5000000068,1027.6500000002561
35715,2022-11-27 14:15:00,1918.5,321360.65000000707,318414.5000000068,2946.150000000256
35716,2022-11-27 14:20:00,1250.5,322611.15000000707,318414.5000000068,4196.650000000256
35717,2022-11-27 14:25:00,907.83,323518.9800000071,318414.5000000068,5104.480000000272
35718,2022-11-27 14:30:00,1120.37,324639.3500000071,318414.5000000068,6224.850000000268
35719,2022-11-27 14:35:00,1007.24,325646.59000000707,318414.5000000068,7232.090000000258
35720,2022-11-27 14:40:00,-1198.64,324447.95000000705,318414.5000000068,6033.4500000002445
35721,2022-11-27 14:45:00,-57.09,324390.86000000703,318414.5000000068,5976.360000000219
35722,2022-11-27 14:50:00,-1769.56,322621.30000000703,318414.5000000068,4206.800000000221
35723,2022-11-27 14:55:00,-917.85,321703.45000000705,318414.5000000068,3288.9500000002445
35724,2022-11-27 15:00:00,1226.53,322929.9800000071,318414.5000000068,4515.480000000272
35725,2022-11-27 15:05:00,1863.37,324793.3500000071,318414.5000000068,6378.850000000268
35726,2022-11-27 15:10:00,-1710.32,323083.0300000071,318414.5000000068,4668.530000000261
35727,2022-11-27 15:15:00,23.42,323106.45000000705,318414.5000000068,4691.9500000002445
35728,2022-11-27 15:20:00,-20.16,323086.2900000071,318414.5000000068,4671.79000000027
35729,2022-11-27 15:25:00,-1362.71,321723.58000000706,318414.5000000068,3309.080000000249
35730,2022-11-27 15:30:00,-1516.11,320207.4700000071,318414.5000000068,1792.970000000263
35731,2022-11-27 15:35:00,-1429.44,318778.0300000071,318414.5000000068,363.53000000026077
35732,2022-11-27 15:40:00,558.75,319336.7800000071,318414.5000000068,922.2800000002608
35733,2022-11-27 15:45:00,-12.15,319324.63000000705,318414.5000000068,910.1300000002375
35734,2022-11-27 15:50:00,730.1,320054.730000007,318414.5000000068,1640.2300000002142
35735,2022-11-27 15:55:00,-1873.55,318181.18000000704,318414.5000000068,-233.31999999977415
35736,2022-11-27 16:00:00,-1538.59,316642.590000007,318414.5000000068,-1771.9099999997998
35737,2022-11-27 16:05:00,-710.19,315932.400000007,318414.5000000068,-2482.099999999802
35738,2022-11-27 16:10:00,1129.03,317061.43000000704,318414.5000000068,-1353.0699999997742
35739,2022-11-27 16:15:00,729.06,317790.49000000703,318414.5000000068,-624.0099999997765
35740,2022-11-27 16:20:00,-56.88,317733.61000000703,318414.5000000068,-680.8899999997811
35741,2022-11-27 16:25:00,986.84,318720.45000000705,318414.5000000068,305.9500000002445
35742,2022-11-27 16:30:00,1434.38,320154.83000000706,318414.5000000068,1740.3300000002491
35743,2022-11-27 16:35:00,-317.58,319837.25000000704,318414.5000000068,1422.7500000002328
35744,2022-11-27 16:40:00,-241.24,319596.01000000705,318414.5000000068,1181.5100000002421
35745,2022-11-27 16:45:00,411.16,320007.170000007,318414.5000000068,1592.6700000002165
35746,2022-11-27 16:50:00,997.32,321004.49000000703,318414.5000000068,2589.9900000002235
35747,2022-11-27 16:55:00,1717.27,322721.76000000705,318414.5000000068,4307.260000000242
35748,2022-11-28 08:00:00,1690.42,324412.18000000704,322721.76000000705,1690.4199999999837
35749,2022-11-28 08:05:00,-431.65,323980.530000007,322721.76000000705,1258.7699999999604
35750,2022-11-28 08:10:00,-1947.88,322032.650000007,322721.76000000705,-689.1100000000442
35751,2022-11-28 08:15:00,-1111.41,320921.24000000703,322721.76000000705,-1800.5200000000186
35752,2022-11-28 08:20:00,-584.75,320336.49000000703,322721.76000000705,-2385.2700000000186
35753,2022-11-28 08:25:00,-1899.81,318436.68000000704,322721.76000000705,-4285.080000000016
35754,2022-11-28 08:30:00,-739.61,317697.07000000705,322721.76000000705,-5024.690000000002
35755,2022-11-28 08:35:00,-50.19,317646.88000000705,322721.76000000705,-5074.880000000005
35756,2022-11-28 08:40:00,-546.56,317100.32000000705,322721.76000000705,-5621.440000000002
35757,2022-11-28 08:45:00,-1687.02,315413.30000000703,322721.76000000705,-7308.460000000021
35758,2022-11-28 08:50:00,137.18,315550.480000007,322721.76000000705,-7171.280000000028
35759,2022-11-28 08:55:00,-673.44,314877.040000007,322721.76000000705,-7844.72000000003
35760,2022-11-28 09:00:00,-712.7,314164.340000007,322721.76000000705,-8557.420000000042
35761,2022-11-28 09:05:00,733.84,314898.18000000704,322721.76000000705,-7823.580000000016
35762,2022-11-28 09:10:00,923.63,315821.81000000704,322721.76000000705,-6899.950000000012
35763,2022-11-28 09:15:00,1108.16,316929.970000007,322721.76000000705,-5791.790000000037
35764,2022-11-28 09:20:00,-1395.71,315534.260000007,322721.76000000705,-7187.500000000058
35765,2022-11-28 09:25:00,1225.07,316759.330000007,322721.76000000705,-5962.430000000051
35766,2022-11-28 09:30:00,-283.97,316475.36000000703,322721.76000000705,-6246.400000000023
35767,2022-11-28 09:35:00,1215.54,317690.900000007,322721.76000000705,-5030.860000000044
35768,2022-11-28 09:40:00,-757.57,316933.330000007,322721.76000000705,-5788.430000000051
35769,2022-11-28 09:45:00,-7.44,316925.890000007,322721.76000000705,-5795.870000000054
35770,2022-11-28 09:50:00,-1688.59,315237.300000007,322721.76000000705,-7484.460000000079
35771,2022-11-28 09:55:00,1065.43,316302.73000000697,322721.76000000705,-6419.030000000086
35772,2022-11-28 10:00:00,653.79,316956.52000000695,322721.76000000705,-5765.240000000107
35773,2022-11-28 10:05:00,-1309.32,315647.20000000694,322721.76000000705,-7074.560000000114
35774,2022-11-28 10:10:00,919.56,316566.76000000694,322721.76000000705,-6155.000000000116
35775,2022-11-28 10:15:00,-1862.42,314704.34000000695,322721.76000000705,-8017.4200000001
35776,2022-11-28 10:20:00,919.79,315624.13000000693,322721.76000000705,-7097.630000000121
35777,2022-11-28 10:25:00,309.39,315933.52000000695,322721.76000000705,-6788.240000000107
35778,2022-11-28 10:30:00,-358.05,315575.47000000696,322721.76000000705,-7146.2900000000955
35779,2022-11-28 10:35:00,315.19,315890.66000000696,322721.76000000705,-6831.100000000093
35780,2022-11-28 10:40:00,831.62,316722.28000000695,322721.76000000705,-5999.480000000098
35781,2022-11-28 10:45:00,954.11,317676.39000000694,322721.76000000705,-5045.370000000112
35782,2022-11-28 10:50:00,-1052.83,316623.5600000069,322721.76000000705,-6098.200000000128
35783,2022-11-28 10:55:00,1436.95,318060.51000000694,322721.76000000705,-4661.250000000116
35784,2022-11-28 11:00:00,1460.61,319521.1200000069,322721.76000000705,-3200.6400000001304
35785,2022-11-28 11:05:00,-914.53,318606.5900000069,322721.76000000705,-4115.170000000158
35786,2022-11-28 11:10:00,801.5,319408.0900000069,322721.76000000705,-3313.6700000001583
35787,2022-11-28 11:15:00,1134.64,320542.7300000069,322721.76000000705,-2179.0300000001444
35788,2022-11-28 11:20:00,-1207.99,319334.7400000069,322721.76000000705,-3387.020000000135
35789,2022-11-28 11:25:00,1336.96,320671.70000000694,322721.76000000705,-2050.060000000114
35790,2022-11-28 11:30:00,-536.03,320135.6700000069,322721.76000000705,-2586.090000000142
35791,2022-11-28 11:35:00,-168.42,319967.2500000069,322721.76000000705,-2754.5100000001257
35792,2022-11-28 11:40:00,647.27,320614.52000000695,322721.76000000705,-2107.240000000107
35793,2022-11-28 11:45:00,-363.16,320251.360000007,322721.76000000705,-2470.4000000000815
35794,2022-11-28 11:50:00,94.48,320345.84000000695,322721.76000000705,-2375.9200000001
35795,2022-11-28 11:55:00,-1193.23,319152.610000007,322721.76000000705,-3569.1500000000815
35796,2022-11-28 12:00:00,288.42,319441.03000000695,322721.76000000705,-3280.730000000098
35797,2022-11-28 12:05:00,-401.35,319039.680000007,322721.76000000705,-3682.0800000000745
35798,2022-11-28 12:10:00,974.38,320014.060000007,322721.76000000705,-2707.70000000007
35799,2022-11-28 12:15:00,1573.62,321587.680000007,322721.76000000705,-1134.0800000000745
35800,2022-11-28 12:20:00,682.05,322269.73000000697,322721.76000000705,-452.03000000008615
35801,2022-11-28 12:25:00,1696.38,323966.110000007,322721.76000000705,1244.3499999999185
35802,2022-11-28 12:30:00,-1736.68,322229.430000007,322721.76000000705,-492.3300000000745
35803,2022-11-28 12:35:00,-1624.04,320605.390000007,322721.76000000705,-2116.3700000000536
35804,2022-11-28 12:40:00,512.42,321117.810000007,322721.76000000705,-1603.9500000000698
35805,2022-11-28 12:45:00,-1165.08,319952.73000000697,322721.76000000705,-2769.030000000086
35806,2022-11-28 12:50:00,-664.42,319288.310000007,322721.76000000705,-3433.45000000007
35807,2022-11-28 12:55:00,1496.03,320784.340000007,322721.76000000705,-1937.420000000042
35808,2022-11-28 13:00:00,-866.11,319918.230000007,322721.76000000705,-2803.530000000028
35809,2022-11-28 13:05:00,-1336.26,318581.970000007,322721.76000000705,-4139.790000000037
35810,2022-11-28 13:10:00,-1770.04,316811.93000000704,322721.76000000705,-5909.830000000016
35811,2022-11-28 13:15:00,-1383.2,315428.730000007,322721.76000000705,-7293.030000000028
35812,2022-11-28 13:20:00,1957.88,317386.61000000703,322721.76000000705,-5335.150000000023
35813,2022-11-28 13:25:00,1305.61,318692.220000007,322721.76000000705,-4029.5400000000373
35814,2022-11-28 13:30:00,1658.78,320351.00000000704,322721.76000000705,-2370.7600000000093
35815,2022-11-28 13:35:00,-511.19,319839.81000000704,322721.76000000705,-2881.9500000000116
35816,2022-11-28 13:40:00,99.13,319938.94000000705,322721.76000000705,-2782.820000000007
35817,2022-11-28 13:45:00,-267.46,319671.480000007,322721.76000000705,-3050.280000000028
35818,2022-11-28 13:50:00,179.01,319850.49000000703,322721.76000000705,-2871.2700000000186
35819,2022-11-28 13:55:00,1822.42,321672.910000007,322721.76000000705,-1048.850000000035
35820,2022-11-28 14:00:00,-358.19,321314.720000007,322721.76000000705,-1407.0400000000373
35821,2022-11-28 14:05:00,751.66,322066.380000007,322721.76000000705,-655.3800000000629
35822,2022-11-28 14:10:00,1230.81,323297.190000007,322721.76000000705,575.4299999999348
35823,2022-11-28 14:15:00,-1719.15,321578.04000000696,322721.76000000705,-1143.7200000000885
35824,2022-11-28 14:20:00,857.29,322435.33000000694,322721.76000000705,-286.43000000010943
35825,2022-11-28 14:25:00,-389.41,322045.92000000697,322721.76000000705,-675.8400000000838
35826,2022-11-28 14:30:00,-1754.8,320291.120000007,322721.76000000705,-2430.640000000072
35827,2022-11-28 14:35:00,-147.37,320143.750000007,322721.76000000705,-2578.0100000000675
35828,2022-11-28 14:40:00,1806.98,321950.73000000697,322721.76000000705,-771.0300000000861
35829,2022-11-28 14:45:00,1933.95,323884.680000007,322721.76000000705,1162.9199999999255
35830,2022-11-28 14:50:00,1992.06,325876.740000007,322721.76000000705,3154.979999999923
35831,2022-11-28 14:55:00,80.48,325957.22000000696,322721.76000000705,3235.4599999999045
35832,2022-11-28 15:00:00,620.9,326578.120000007,322721.76000000705,3856.359999999928
35833,2022-11-28 15:05:00,710.36,327288.48000000697,322721.76000000705,4566.719999999914
35834,2022-11-28 15:10:00,-593.63,326694.85000000696,322721.76000000705,3973.089999999909
35835,2022-11-28 15:15:00,-1220.95,325473.90000000695,322721.76000000705,2752.1399999998976
35836,2022-11-28 15:20:00,28.16,325502.0600000069,322721.76000000705,2780.299999999872
35837,2022-11-28 15:25:00,1387.86,326889.9200000069,322721.76000000705,4168.159999999858
35838,2022-11-28 15:30:00,947.4,327837.32000000693,322721.76000000705,5115.559999999881
35839,2022-11-28 15:35:00,1277.62,329114.9400000069,322721.76000000705,6393.179999999877
35840,2022-11-28 15:40:00,-1709.55,327405.39000000694,322721.76000000705,4683.629999999888
35841,2022-11-28 15:45:00,1044.63,328450.02000000695,322721.76000000705,5728.259999999893
35842,2022-11-28 15:50:00,686.23,329136.2500000069,322721.76000000705,6414.489999999874
35843,2022-11-28 15:55:00,-1729.8,327406.45000000694,322721.76000000705,4684.689999999886
35844,2022-11-28 16:00:00,-1094.48,326311.97000000696,322721.76000000705,3590.2099999999045
35845,2022-11-28 16:05:00,253.0,326564.97000000696,322721.76000000705,3843.2099999999045
35846,2022-11-28 16:10:00,539.05,327104.02000000695,322721.76000000705,4382.259999999893
35847,2022-11-28 16:15:00,485.5,327589.52000000695,322721.76000000705,4867.759999999893
35848,2022-11-28 16:20:00,-1322.55,326266.97000000696,322721.76000000705,3545.2099999999045
35849,2022-11-28 16:25:00,1006.79,327273.76000000694,322721.76000000705,4551.999999999884
35850,2022-11-28 16:30:00,108.5,327382.26000000694,322721.76000000705,4660.499999999884
35851,2022-11-28 16:35:00,624.85,328007.1100000069,322721.76000000705,5285.34999999986
35852,2022-11-28 16:40:00,98.2,328105.3100000069,322721.76000000705,5383.549999999872
35853,2022-11-28 16:45:00,1131.68,329236.9900000069,322721.76000000705,6515.229999999865
35854,2022-11-28 16:50:00,506.28,329743.27000000695,322721.76000000705,7021.509999999893
35855,2022-11-28 16:55:00,-947.49,328795.78000000695,322721.76000000705,6074.019999999902
35856,2022-11-29 08:00:00,816.15,329611.930000007,328795.78000000695,816.1500000000233
35857,2022-11-29 08:05:00,-1832.75,327779.180000007,328795.78000000695,-1016.5999999999767
35858,2022-11-29 08:10:00,476.35,328255.53000000695,328795.78000000695,-540.25
35859,2022-11-29 08:15:00,1326.37,329581.90000000695,328795.78000000695,786.1199999999953
35860,2022-11-29 08:20:00,-1838.25,327743.65000000695,328795.78000000695,-1052.1300000000047
35861,2022-11-29 08:25:00,1661.83,329405.48000000697,328795.78000000695,609.7000000000116
35862,2022-11-29 08:30:00,412.76,329818.240000007,328795.78000000695,1022.460000000021
35863,2022-11-29 08:35:00,-1067.46,328750.78000000695,328795.78000000695,-45.0
35864,2022-11-29 08:40:00,-1773.26,326977.52000000695,328795.78000000695,-1818.2600000000093
35865,2022-11-29 08:45:00,713.29,327690.8100000069,328795.78000000695,-1104.9700000000303
35866,2022-11-29 08:50:00,-1618.26,326072.5500000069,328795.78000000695,-2723.2300000000396
35867,2022-11-29 08:55:00,-794.49,325278.0600000069,328795.78000000695,-3517.7200000000303
35868,2022-11-29 09:00:00,-1445.29,323832.77000000695,328795.78000000695,-4963.010000000009
35869,2022-11-29 09:05:00,-420.57,323412.20000000694,328795.78000000695,-5383.580000000016
35870,2022-11-29 09:10:00,1282.5,324694.70000000694,328795.78000000695,-4101.080000000016
35871,2022-11-29 09:15:00,1604.5,326299.20000000694,328795.78000000695,-2496.5800000000163
35872,2022-11-29 09:20:00,-1884.23,324414.97000000696,328795.78000000695,-4380.809999999998
35873,2022-11-29 09:25:00,559.72,324974.6900000069,328795.78000000695,-3821.0900000000256
35874,2022-11-29 09:30:00,775.06,325749.7500000069,328795.78000000695,-3046.030000000028
35875,2022-11-29 09:35:00,325.46,326075.21000000695,328795.78000000695,-2720.570000000007
35876,2022-11-29 09:40:00,471.99,326547.20000000694,328795.78000000695,-2248.5800000000163
35877,2022-11-29 09:45:00,261.26,326808.46000000695,328795.78000000695,-1987.320000000007
35878,2022-11-29 09:50:00,1248.45,328056.91000000696,328795.78000000695,-738.8699999999953
35879,2022-11-29 09:55:00,-779.55,327277.360000007,328795.78000000695,-1518.4199999999837
35880,2022-11-29 10:00:00,-1280.55,325996.810000007,328795.78000000695,-2798.969999999972
35881,2022-11-29 10:05:00,-1809.51,324187.300000007,328795.78000000695,-4608.479999999981
35882,2022-11-29 10:10:00,-458.82,323728.48000000697,328795.78000000695,-5067.299999999988
35883,2022-11-29 10:15:00,521.55,324250.03000000695,328795.78000000695,-4545.75
35884,2022-11-29 10:20:00,-1456.38,322793.65000000695,328795.78000000695,-6002.130000000005
35885,2022-11-29 10:25:00,40.26,322833.91000000696,328795.78000000695,-5961.869999999995
35886,2022-11-29 10:30:00,1884.44,324718.35000000696,328795.78000000695,-4077.429999999993
35887,2022-11-29 10:35:00,-1719.17,322999.180000007,328795.78000000695,-5796.599999999977
35888,2022-11-29 10:40:00,-1342.27,321656.91000000696,328795.78000000695,-7138.869999999995
35889,2022-11-29 10:45:00,1587.18,323244.09000000695,328795.78000000695,-5551.690000000002
35890,2022-11-29 10:50:00,1257.88,324501.97000000696,328795.78000000695,-4293.809999999998
35891,2022-11-29 10:55:00,-1778.03,322723.9400000069,328795.78000000695,-6071.840000000026
35892,2022-11-29 11:00:00,1431.38,324155.32000000693,328795.78000000695,-4640.460000000021
35893,2022-11-29 11:05:00,757.04,324912.3600000069,328795.78000000695,-3883.420000000042
35894,2022-11-29 11:10:00,-309.82,324602.5400000069,328795.78000000695,-4193.240000000049
35895,2022-11-29 11:15:00,574.8,325177.3400000069,328795.78000000695,-3618.4400000000605
35896,2022-11-29 11:20:00,1300.32,326477.6600000069,328795.78000000695,-2318.1200000000536
35897,2022-11-29 11:25:00,141.33,326618.9900000069,328795.78000000695,-2176.7900000000373
35898,2022-11-29 11:30:00,-851.2,325767.7900000069,328795.78000000695,-3027.990000000049
35899,2022-11-29 11:35:00,1575.26,327343.0500000069,328795.78000000695,-1452.7300000000396
35900,2022-11-29 11:40:00,494.47,327837.5200000069,328795.78000000695,-958.2600000000675
35901,2022-11-29 11:45:00,-106.1,327731.4200000069,328795.78000000695,-1064.3600000000442
35902,2022-11-29 11:50:00,380.13,328111.5500000069,328795.78000000695,-684.2300000000396
35903,2022-11-29 11:55:00,50.75,328162.3000000069,328795.78000000695,-633.4800000000396
35904,2022-11-29 12:00:00,-1328.49,326833.8100000069,328795.78000000695,-1961.9700000000303
35905,2022-11-29 12:05:00,451.09,327284.90000000695,328795.78000000695,-1510.8800000000047
35906,2022-11-29 12:10:00,152.23,327437.13000000693,328795.78000000695,-1358.6500000000233
35907,2022-11-29 12:15:00,281.24,327718.3700000069,328795.78000000695,-1077.4100000000326
35908,2022-11-29 12:20:00,-955.54,326762.83000000694,328795.78000000695,-2032.9500000000116
35909,2022-11-29 12:25:00,-1228.7,325534.13000000693,328795.78000000695,-3261.6500000000233
35910,2022-11-29 12:30:00,1735.76,327269.89000000694,328795.78000000695,-1525.890000000014
35911,2022-11-29 12:35:00,916.65,328186.54000000696,328795.78000000695,-609.2399999999907
35912,2022-11-29 12:40:00,-1496.39,326690.15000000695,328795.78000000695,-2105.6300000000047
35913,2022-11-29 12:45:00,-24.43,326665.72000000696,328795.78000000695,-2130.0599999999977
35914,2022-11-29 12:50:00,-1974.47,324691.250000007,328795.78000000695,-4104.52999999997
35915,2022-11-29 12:55:00,1515.77,326207.020000007,328795.78000000695,-2588.759999999951
35916,2022-11-29 13:00:00,-803.91,325403.11000000703,328795.78000000695,-3392.6699999999255
35917,2022-11-29 13:05:00,590.86,325993.970000007,328795.78000000695,-2801.8099999999395
35918,2022-11-29 13:10:00,1973.5,327967.470000007,328795.78000000695,-828.3099999999395
35919,2022-11-29 13:15:00,-800.04,327167.43000000704,328795.78000000695,-1628.3499999999185
35920,2022-11-29 13:20:00,-1780.29,325387.14000000706,328795.78000000695,-3408.6399999998976
35921,2022-11-29 13:25:00,-1686.4,323700.74000000703,328795.78000000695,-5095.039999999921
35922,2022-11-29 13:30:00,640.94,324341.68000000704,328795.78000000695,-4454.0999999999185
35923,2022-11-29 13:35:00,-349.86,323991.82000000705,328795.78000000695,-4803.9599999999045
35924,2022-11-29 13:40:00,1099.99,325091.81000000704,328795.78000000695,-3703.969999999914
35925,2022-11-29 13:45:00,900.12,325991.93000000704,328795.78000000695,-2803.8499999999185
35926,2022-11-29 13:50:00,1456.02,327447.95000000705,328795.78000000695,-1347.8299999998999
35927,2022-11-29 13:55:00,-1041.89,326406.06000000704,328795.78000000695,-2389.719999999914
35928,2022-11-29 14:00:00,-634.98,325771.08000000706,328795.78000000695,-3024.699999999895
35929,2022-11-29 14:05:00,-1280.08,324491.00000000704,328795.78000000695,-4304.7799999999115
35930,2022-11-29 14:10:00,-1974.65,322516.350000007,328795.78000000695,-6279.429999999935
35931,2022-11-29 14:15:00,-866.97,321649.38000000705,328795.78000000695,-7146.399999999907
35932,2022-11-29 14:20:00,949.96,322599.34000000707,328795.78000000695,-6196.439999999886
35933,2022-11-29 14:25:00,1746.05,324345.39000000706,328795.78000000695,-4450.389999999898
35934,2022-11-29 14:30:00,-1899.62,322445.77000000706,328795.78000000695,-6350.009999999893
35935,2022-11-29 14:35:00,761.97,323207.74000000703,328795.78000000695,-5588.039999999921
35936,2022-11-29 14:40:00,-892.27,322315.470000007,328795.78000000695,-6480.3099999999395
35937,2022-11-29 14:45:00,1476.89,323792.36000000703,328795.78000000695,-5003.4199999999255
35938,2022-11-29 14:50:00,-171.34,323621.020000007,328795.78000000695,-5174.759999999951
35939,2022-11-29 14:55:00,-430.21,323190.810000007,328795.78000000695,-5604.969999999972
35940,2022-11-29 15:00:00,950.6,324141.41000000696,328795.78000000695,-4654.369999999995
35941,2022-11-29 15:05:00,603.19,324744.60000000696,328795.78000000695,-4051.179999999993
35942,2022-11-29 15:10:00,-113.01,324631.59000000695,328795.78000000695,-4164.190000000002
35943,2022-11-29 15:15:00,-287.6,324343.990000007,328795.78000000695,-4451.789999999979
35944,2022-11-29 15:20:00,1303.72,325647.71000000695,328795.78000000695,-3148.070000000007
35945,2022-11-29 15:25:00,373.27,326020.98000000697,328795.78000000695,-2774.7999999999884
35946,2022-11-29 15:30:00,-1390.03,324630.95000000694,328795.78000000695,-4164.830000000016
35947,2022-11-29 15:35:00,-865.47,323765.48000000697,328795.78000000695,-5030.299999999988
35948,2022-11-29 15:40:00,-788.22,322977.260000007,328795.78000000695,-5818.51999999996
35949,2022-11-29 15:45:00,102.25,323079.510000007,328795.78000000695,-5716.26999999996
35950,2022-11-29 15:50:00,-1525.21,321554.300000007,328795.78000000695,-7241.479999999981
35951,2022-11-29 15:55:00,-407.32,321146.98000000697,328795.78000000695,-7648.799999999988
35952,2022-11-29 16:00:00,703.42,321850.40000000695,328795.78000000695,-6945.380000000005
35953,2022-11-29 16:05:00,301.35,322151.7500000069,328795.78000000695,-6644.030000000028
35954,2022-11-29 16:10:00,617.93,322769.6800000069,328795.78000000695,-6026.100000000035
35955,2022-11-29 16:15:00,-4.65,322765.0300000069,328795.78000000695,-6030.750000000058
35956,2022-11-29 16:20:00,1380.98,324146.0100000069,328795.78000000695,-4649.770000000077
35957,2022-11-29 16:25:00,-1433.58,322712.43000000686,328795.78000000695,-6083.350000000093
35958,2022-11-29 16:30:00,1113.73,323826.16000000684,328795.78000000695,-4969.620000000112
35959,2022-11-29 16:35:00,730.48,324556.6400000068,328795.78000000695,-4239.14000000013
35960,2022-11-29 16:40:00,1161.64,325718.28000000684,328795.78000000695,-3077.5000000001164
35961,2022-11-29 16:45:00,1447.98,327166.2600000068,328795.78000000695,-1629.520000000135
35962,2022-11-29 16:50:00,-1467.18,325699.0800000068,328795.78000000695,-3096.700000000128
35963,2022-11-29 16:55:00,1656.06,327355.1400000068,328795.78000000695,-1440.6400000001304
35964,2022-11-30 08:00:00,581.66,327936.8000000068,327355.1400000068,581.6599999999744
35965,2022-11-30 08:05:00,1786.14,329722.9400000068,327355.1400000068,2367.7999999999884
35966,2022-11-30 08:10:00,-871.77,328851.1700000068,327355.1400000068,1496.0299999999697
35967,2022-11-30 08:15:00,-1178.24,327672.9300000068,327355.1400000068,317.78999999997905
35968,2022-11-30 08:20:00,-675.47,326997.46000000683,327355.1400000068,-357.679999999993
35969,2022-11-30 08:25:00,-157.33,326840.1300000068,327355.1400000068,-515.0100000000093
35970,2022-11-30 08:30:00,379.97,327220.1000000068,327355.1400000068,-135.04000000003725
35971,2022-11-30 08:35:00,-1984.13,325235.9700000068,327355.1400000068,-2119.170000000042
35972,2022-11-30 08:40:00,1502.58,326738.5500000068,327355.1400000068,-616.5900000000256
35973,2022-11-30 08:45:00,-1918.44,324820.1100000068,327355.1400000068,-2535.030000000028
35974,2022-11-30 08:50:00,-85.9,324734.2100000068,327355.1400000068,-2620.930000000051
35975,2022-11-30 08:55:00,-1205.3,323528.9100000068,327355.1400000068,-3826.2300000000396
35976,2022-11-30 09:00:00,1576.46,325105.3700000068,327355.1400000068,-2249.7700000000186
35977,2022-11-30 09:05:00,-324.64,324780.7300000068,327355.1400000068,-2574.4100000000326
35978,2022-11-30 09:10:00,-1691.91,323088.8200000068,327355.1400000068,-4266.320000000007
35979,2022-11-30 09:15:00,-31.97,323056.85000000685,327355.1400000068,-4298.289999999979
35980,2022-11-30 09:20:00,1633.91,324690.7600000068,327355.1400000068,-2664.3800000000047
35981,2022-11-30 09:25:00,-813.46,323877.3000000068,327355.1400000068,-3477.8400000000256
35982,2022-11-30 09:30:00,1722.41,325599.7100000068,327355.1400000068,-1755.4300000000512
35983,2022-11-30 09:35:00,117.64,325717.3500000068,327355.1400000068,-1637.7900000000373
35984,2022-11-30 09:40:00,1082.26,326799.6100000068,327355.1400000068,-555.5300000000279
35985,2022-11-30 09:45:00,1371.14,328170.7500000068,327355.1400000068,815.609999999986
35986,2022-11-30 09:50:00,-999.56,327171.1900000068,327355.1400000068,-183.95000000001164
35987,2022-11-30 09:55:00,-510.74,326660.4500000068,327355.1400000068,-694.6900000000023
35988,2022-11-30 10:00:00,1743.93,328404.3800000068,327355.1400000068,1049.2399999999907
35989,2022-11-30 10:05:00,1562.4,329966.78000000684,327355.1400000068,2611.640000000014
35990,2022-11-30 10:10:00,-834.62,329132.16000000684,327355.1400000068,1777.0200000000186
35991,2022-11-30 10:15:00,1713.7,330845.86000000685,327355.1400000068,3490.7200000000303
35992,2022-11-30 10:20:00,574.92,331420.78000000684,327355.1400000068,4065.640000000014
35993,2022-11-30 10:25:00,-1604.11,329816.67000000685,327355.1400000068,2461.530000000028
35994,2022-11-30 10:30:00,1937.91,331754.5800000068,327355.1400000068,4399.440000000002
35995,2022-11-30 10:35:00,-109.55,331645.03000000684,327355.1400000068,4289.890000000014
35996,2022-11-30 10:40:00,-168.79,331476.24000000686,327355.1400000068,4121.100000000035
35997,2022-11-30 10:45:00,1563.58,333039.8200000069,327355.1400000068,5684.680000000051
35998,2022-11-30 10:50:00,-117.37,332922.4500000069,327355.1400000068,5567.310000000056
35999,2022-11-30 10:55:00,552.29,333474.74000000686,327355.1400000068,6119.600000000035
36000,2022-11-30 11:00:00,-1437.67,332037.0700000069,327355.1400000068,4681.930000000051
36001,2022-11-30 11:05:00,-959.85,331077.2200000069,327355.1400000068,3722.0800000000745
36002,2022-11-30 11:10:00,176.5,331253.7200000069,327355.1400000068,3898.5800000000745
36003,2022-11-30 11:15:00,1959.48,333213.2000000069,327355.1400000068,5858.060000000056
36004,2022-11-30 11:20:00,1199.73,334412.93000000686,327355.1400000068,7057.790000000037
36005,2022-11-30 11:25:00,1635.71,336048.6400000069,327355.1400000068,8693.500000000058
36006,2022-11-30 11:30:00,-975.07,335073.5700000069,327355.1400000068,7718.430000000051
36007,2022-11-30 11:35:00,-1645.12,333428.4500000069,327355.1400000068,6073.310000000056
36008,2022-11-30 11:40:00,-21.1,333407.3500000069,327355.1400000068,6052.210000000079
36009,2022-11-30 11:45:00,1970.51,335377.8600000069,327355.1400000068,8022.7200000000885
36010,2022-11-30 11:50:00,-469.11,334908.7500000069,327355.1400000068,7553.610000000102
36011,2022-11-30 11:55:00,1953.7,336862.45000000694,327355.1400000068,9507.310000000114
36012,2022-11-30 12:00:00,-1387.88,335474.57000000693,327355.1400000068,8119.430000000109
36013,2022-11-30 12:05:00,-718.04,334756.53000000695,327355.1400000068,7401.39000000013
36014,2022-11-30 12:10:00,-1805.02,332951.51000000694,327355.1400000068,5596.370000000112
36015,2022-11-30 12:15:00,922.07,333873.58000000694,327355.1400000068,6518.440000000119
36016,2022-11-30 12:20:00,1637.56,335511.14000000694,327355.1400000068,8156.000000000116
36017,2022-11-30 12:25:00,896.63,336407.77000000695,327355.1400000068,9052.630000000121
36018,2022-11-30 12:30:00,1209.9,337617.67000000697,327355.1400000068,10262.530000000144
36019,2022-11-30 12:35:00,-1244.85,336372.820000007,327355.1400000068,9017.680000000168
36020,2022-11-30 12:40:00,1021.57,337394.390000007,327355.1400000068,10039.250000000175
36021,2022-11-30 12:45:00,1107.09,338501.480000007,327355.1400000068,11146.3400000002
36022,2022-11-30 12:50:00,-730.64,337770.840000007,327355.1400000068,10415.700000000186
36023,2022-11-30 12:55:00,33.36,337804.200000007,327355.1400000068,10449.060000000172
36024,2022-11-30 13:00:00,-37.5,337766.700000007,327355.1400000068,10411.560000000172
36025,2022-11-30 13:05:00,1357.67,339124.370000007,327355.1400000068,11769.230000000156
36026,2022-11-30 13:10:00,-251.82,338872.550000007,327355.1400000068,11517.410000000149
36027,2022-11-30 13:15:00,1395.99,340268.54000000696,327355.1400000068,12913.40000000014
36028,2022-11-30 13:20:00,-762.47,339506.070000007,327355.1400000068,12150.930000000168
36029,2022-11-30 13:25:00,429.59,339935.660000007,327355.1400000068,12580.520000000193
36030,2022-11-30 13:30:00,347.56,340283.220000007,327355.1400000068,12928.080000000191
36031,2022-11-30 13:35:00,1369.07,341652.290000007,327355.1400000068,14297.150000000198
36032,2022-11-30 13:40:00,1692.87,343345.160000007,327355.1400000068,15990.020000000193
36033,2022-11-30 13:45:00,-1260.16,342085.00000000704,327355.1400000068,14729.860000000219
36034,2022-11-30 13:50:00,-1619.04,340465.96000000706,327355.1400000068,13110.82000000024
36035,2022-11-30 13:55:00,1334.36,341800.32000000705,327355.1400000068,14445.180000000226
36036,2022-11-30 14:00:00,1562.65,343362.9700000071,327355.1400000068,16007.83000000025
36037,2022-11-30 14:05:00,-335.88,343027.09000000707,327355.1400000068,15671.950000000244
36038,2022-11-30 14:10:00,-233.14,342793.95000000705,327355.1400000068,15438.81000000023
36039,2022-11-30 14:15:00,514.48,343308.43000000704,327355.1400000068,15953.290000000212
36040,2022-11-30 14:20:00,1558.84,344867.27000000706,327355.1400000068,17512.130000000237
36041,2022-11-30 14:25:00,1269.52,346136.7900000071,327355.1400000068,18781.650000000256
36042,2022-11-30 14:30:00,617.55,346754.34000000707,327355.1400000068,19399.200000000244
36043,2022-11-30 14:35:00,-1750.4,345003.94000000705,327355.1400000068,17648.80000000022
36044,2022-11-30 14:40:00,82.17,345086.11000000703,327355.1400000068,17730.970000000205
36045,2022-11-30 14:45:00,-1104.2,343981.910000007,327355.1400000068,16626.770000000193
36046,2022-11-30 14:50:00,286.1,344268.010000007,327355.1400000068,16912.87000000017
36047,2022-11-30 14:55:00,-541.44,343726.570000007,327355.1400000068,16371.430000000168
36048,2022-11-30 15:00:00,-274.43,343452.140000007,327355.1400000068,16097.000000000175
36049,2022-11-30 15:05:00,1369.69,344821.830000007,327355.1400000068,17466.690000000177
36050,2022-11-30 15:10:00,-1358.88,343462.950000007,327355.1400000068,16107.810000000172
36051,2022-11-30 15:15:00,608.59,344071.540000007,327355.1400000068,16716.400000000198
36052,2022-11-30 15:20:00,-691.47,343380.07000000705,327355.1400000068,16024.930000000226
36053,2022-11-30 15:25:00,444.8,343824.87000000704,327355.1400000068,16469.730000000214
36054,2022-11-30 15:30:00,1899.26,345724.13000000705,327355.1400000068,18368.990000000224
36055,2022-11-30 15:35:00,1497.81,347221.94000000705,327355.1400000068,19866.80000000022
36056,2022-11-30 15:40:00,-572.42,346649.52000000706,327355.1400000068,19294.380000000237
36057,2022-11-30 15:45:00,-362.49,346287.0300000071,327355.1400000068,18931.890000000247
36058,2022-11-30 15:50:00,-428.28,345858.75000000704,327355.1400000068,18503.61000000022
36059,2022-11-30 15:55:00,279.09,346137.84000000707,327355.1400000068,18782.700000000244
36060,2022-11-30 16:00:00,-875.19,345262.65000000707,327355.1400000068,17907.510000000242
36061,2022-11-30 16:05:00,900.29,346162.94000000705,327355.1400000068,18807.80000000022
36062,2022-11-30 16:10:00,-93.4,346069.540000007,327355.1400000068,18714.400000000198
36063,2022-11-30 16:15:00,1610.28,347679.82000000705,327355.1400000068,20324.680000000226
36064,2022-11-30 16:20:00,1085.04,348764.86000000703,327355.1400000068,21409.720000000205
36065,2022-11-30 16:25:00,546.45,349311.31000000704,327355.1400000068,21956.170000000217
36066,2022-11-30 16:30:00,-1954.46,347356.850000007,327355.1400000068,20001.710000000196
36067,2022-11-30 16:35:00,-440.0,346916.850000007,327355.1400000068,19561.710000000196
36068,2022-11-30 16:40:00,541.47,347458.320000007,327355.1400000068,20103.180000000168
36069,2022-11-30 16:45:00,-738.91,346719.410000007,327355.1400000068,19364.270000000193
36070,2022-11-30 16:50:00,1124.1,347843.510000007,327355.1400000068,20488.37000000017
36071,2022-11-30 16:55:00,275.1,348118.610000007,327355.1400000068,20763.470000000147
36072,2022-12-01 08:00:00,523.94,348642.550000007,348118.610000007,523.9400000000023
36073,2022-12-01 08:05:00,1713.28,350355.830000007,348118.610000007,2237.2200000000303
36074,2022-12-01 08:10:00,1887.9,352243.730000007,348118.610000007,4125.120000000054
36075,2022-12-01 08:15:00,408.98,352652.710000007,348118.610000007,4534.100000000035
36076,2022-12-01 08:20:00,-1761.74,350890.970000007,348118.610000007,2772.3600000000442
36077,2022-12-01 08:25:00,-1000.71,349890.260000007,348118.610000007,1771.6500000000233
36078,2022-12-01 08:30:00,506.26,350396.520000007,348118.610000007,2277.9100000000326
36079,2022-12-01 08:35:00,-455.31,349941.210000007,348118.610000007,1822.600000000035
36080,2022-12-01 08:40:00,-1474.01,348467.200000007,348118.610000007,348.5900000000256
36081,2022-12-01 08:45:00,-234.88,348232.320000007,348118.610000007,113.71000000002095
36082,2022-12-01 08:50:00,185.65,348417.970000007,348118.610000007,299.36000000004424
36083,2022-12-01 08:55:00,301.4,348719.37000000704,348118.610000007,600.7600000000675
36084,2022-12-01 09:00:00,1905.8,350625.170000007,348118.610000007,2506.560000000056
36085,2022-12-01 09:05:00,1450.33,352075.50000000704,348118.610000007,3956.890000000072
36086,2022-12-01 09:10:00,-936.71,351138.790000007,348118.610000007,3020.180000000051
36087,2022-12-01 09:15:00,-154.52,350984.270000007,348118.610000007,2865.6600000000326
36088,2022-12-01 09:20:00,626.4,351610.670000007,348118.610000007,3492.060000000056
36089,2022-12-01 09:25:00,64.16,351674.830000007,348118.610000007,3556.2200000000303
36090,2022-12-01 09:30:00,458.63,352133.460000007,348118.610000007,4014.850000000035
36091,2022-12-01 09:35:00,125.66,352259.120000007,348118.610000007,4140.510000000009
36092,2022-12-01 09:40:00,1351.97,353611.09000000695,348118.610000007,5492.479999999981
36093,2022-12-01 09:45:00,147.45,353758.54000000696,348118.610000007,5639.929999999993
36094,2022-12-01 09:50:00,275.89,354034.430000007,348118.610000007,5915.820000000007
36095,2022-12-01 09:55:00,-560.0,353474.430000007,348118.610000007,5355.820000000007
36096,2022-12-01 10:00:00,-256.52,353217.91000000696,348118.610000007,5099.299999999988
36097,2022-12-01 10:05:00,-361.23,352856.680000007,348118.610000007,4738.070000000007
36098,2022-12-01 10:10:00,-1553.03,351303.65000000695,348118.610000007,3185.039999999979
36099,2022-12-01 10:15:00,-423.1,350880.550000007,348118.610000007,2761.9400000000023
36100,2022-12-01 10:20:00,-417.48,350463.070000007,348118.610000007,2344.460000000021
36101,2022-12-01 10:25:00,-1237.07,349226.000000007,348118.610000007,1107.390000000014
36102,2022-12-01 10:30:00,1692.12,350918.120000007,348118.610000007,2799.5100000000093
36103,2022-12-01 10:35:00,466.26,351384.380000007,348118.610000007,3265.7700000000186
36104,2022-12-01 10:40:00,1052.13,352436.510000007,348118.610000007,4317.900000000023
36105,2022-12-01 10:45:00,-141.37,352295.140000007,348118.610000007,4176.530000000028
36106,2022-12-01 10:50:00,-1365.21,350929.930000007,348118.610000007,2811.320000000007
36107,2022-12-01 10:55:00,-182.51,350747.42000000697,348118.610000007,2628.8099999999977
36108,2022-12-01 11:00:00,-386.51,350360.91000000696,348118.610000007,2242.2999999999884
36109,2022-12-01 11:05:00,1180.73,351541.64000000694,348118.610000007,3423.0299999999697
36110,2022-12-01 11:10:00,-328.88,351212.76000000694,348118.610000007,3094.149999999965
36111,2022-12-01 11:15:00,946.83,352159.59000000695,348118.610000007,4040.9799999999814
36112,2022-12-01 11:20:00,-1535.3,350624.29000000696,348118.610000007,2505.679999999993
36113,2022-12-01 11:25:00,1645.0,352269.29000000696,348118.610000007,4150.679999999993
36114,2022-12-01 11:30:00,1328.91,353598.20000000694,348118.610000007,5479.589999999967
36115,2022-12-01 11:35:00,542.94,354141.14000000694,348118.610000007,6022.52999999997
36116,2022-12-01 11:40:00,745.46,354886.60000000696,348118.610000007,6767.989999999991
36117,2022-12-01 11:45:00,1537.18,356423.78000000695,348118.610000007,8305.169999999984
36118,2022-12-01 11:50:00,505.36,356929.14000000694,348118.610000007,8810.52999999997
36119,2022-12-01 11:55:00,926.08,357855.22000000696,348118.610000007,9736.609999999986
36120,2022-12-01 12:00:00,156.34,358011.560000007,348118.610000007,9892.950000000012
36121,2022-12-01 12:05:00,332.2,358343.760000007,348118.610000007,10225.150000000023
36122,2022-12-01 12:10:00,-1928.96,356414.800000007,348118.610000007,8296.190000000002
36123,2022-12-01 12:15:00,-203.6,356211.200000007,348118.610000007,8092.590000000026
36124,2022-12-01 12:20:00,-967.14,355244.060000007,348118.610000007,7125.450000000012
36125,2022-12-01 12:25:00,-628.93,354615.130000007,348118.610000007,6496.520000000019
36126,2022-12-01 12:30:00,-604.79,354010.340000007,348118.610000007,5891.73000000004
36127,2022-12-01 12:35:00,-302.11,353708.230000007,348118.610000007,5589.620000000054
36128,2022-12-01 12:40:00,137.86,353846.090000007,348118.610000007,5727.48000000004
36129,2022-12-01 12:45:00,1230.14,355076.230000007,348118.610000007,6957.620000000054
36130,2022-12-01 12:50:00,1800.22,356876.450000007,348118.610000007,8757.840000000026
36131,2022-12-01 12:55:00,-647.67,356228.780000007,348118.610000007,8110.170000000042
36132,2022-12-01 13:00:00,154.12,356382.900000007,348118.610000007,8264.290000000037
36133,2022-12-01 13:05:00,864.86,357247.760000007,348118.610000007,9129.150000000023
36134,2022-12-01 13:10:00,-545.55,356702.210000007,348118.610000007,8583.600000000035
36135,2022-12-01 13:15:00,-1315.16,355387.05000000703,348118.610000007,7268.4400000000605
36136,2022-12-01 13:20:00,-998.21,354388.840000007,348118.610000007,6270.23000000004
36137,2022-12-01 13:25:00,-1195.35,353193.49000000703,348118.610000007,5074.880000000063
36138,2022-12-01 13:30:00,-1994.8,351198.69000000705,348118.610000007,3080.0800000000745
36139,2022-12-01 13:35:00,-1155.05,350043.64000000706,348118.610000007,1925.0300000000861
36140,2022-12-01 13:40:00,-625.1,349418.5400000071,348118.610000007,1299.9300000001094
36141,2022-12-01 13:45:00,431.48,349850.02000000706,348118.610000007,1731.4100000000908
36142,2022-12-01 13:50:00,1914.06,351764.08000000706,348118.610000007,3645.4700000000885
36143,2022-12-01 13:55:00,-1267.8,350496.2800000071,348118.610000007,2377.6700000001
36144,2022-12-01 14:00:00,-1787.39,348708.89000000706,348118.610000007,590.2800000000861
36145,2022-12-01 14:05:00,1439.84,350148.7300000071,348118.610000007,2030.1200000001118
36146,2022-12-01 14:10:00,-1953.51,348195.2200000071,348118.610000007,76.61000000010245
36147,2022-12-01 14:15:00,101.84,348297.0600000071,348118.610000007,178.45000000012806
36148,2022-12-01 14:20:00,875.34,349172.4000000071,348118.610000007,1053.7900000001537
36149,2022-12-01 14:25:00,808.28,349980.68000000715,348118.610000007,1862.0700000001816
36150,2022-12-01 14:30:00,-189.11,349791.57000000717,348118.610000007,1672.9600000001956
36151,2022-12-01 14:35:00,1750.98,351542.55000000715,348118.610000007,3423.940000000177
36152,2022-12-01 14:40:00,-1891.56,349650.99000000715,348118.610000007,1532.3800000001793
36153,2022-12-01 14:45:00,-1616.68,348034.31000000716,348118.610000007,-84.29999999981374
36154,2022-12-01 14:50:00,571.31,348605.62000000715,348118.610000007,487.01000000018394
36155,2022-12-01 14:55:00,161.18,348766.80000000715,348118.610000007,648.190000000177
36156,2022-12-01 15:00:00,-50.53,348716.2700000071,348118.610000007,597.660000000149
36157,2022-12-01 15:05:00,273.56,348989.8300000071,348118.610000007,871.2200000001467
36158,2022-12-01 15:10:00,807.7,349797.53000000713,348118.610000007,1678.9200000001583
36159,2022-12-01 15:15:00,821.84,350619.37000000715,348118.610000007,2500.760000000184
36160,2022-12-01 15:20:00,-1842.26,348777.11000000715,348118.610000007,658.5000000001746
36161,2022-12-01 15:25:00,604.19,349381.30000000715,348118.610000007,1262.690000000177
36162,2022-12-01 15:30:00,-1250.18,348131.12000000715,348118.610000007,12.510000000183936
36163,2022-12-01 15:35:00,1742.07,349873.19000000716,348118.610000007,1754.580000000191
36164,2022-12-01 15:40:00,-810.66,349062.5300000072,348118.610000007,943.9200000002165
36165,2022-12-01 15:45:00,-1577.36,347485.1700000072,348118.610000007,-633.4399999997695
36166,2022-12-01 15:50:00,-618.48,346866.6900000072,348118.610000007,-1251.9199999997509
36167,2022-12-01 15:55:00,-1554.22,345312.47000000725,348118.610000007,-2806.139999999723
36168,2022-12-01 16:00:00,-1592.93,343719.54000000726,348118.610000007,-4399.069999999716
36169,2022-12-01 16:05:00,-1032.04,342687.5000000073,348118.610000007,-5431.109999999695
36170,2022-12-01 16:10:00,-1052.9,341634.60000000725,348118.610000007,-6484.009999999718
36171,2022-12-01 16:15:00,5.22,341639.8200000072,348118.610000007,-6478.789999999746
36172,2022-12-01 16:20:00,-1996.5,339643.3200000072,348118.610000007,-8475.289999999746
36173,2022-12-01 16:25:00,500.27,340143.59000000724,348118.610000007,-7975.019999999728
36174,2022-12-01 16:30:00,294.1,340437.6900000072,348118.610000007,-7680.919999999751
36175,2022-12-01 16:35:00,-1811.81,338625.8800000072,348118.610000007,-9492.729999999749
36176,2022-12-01 16:40:00,-1118.2,337507.6800000072,348118.610000007,-10610.92999999976
36177,2022-12-01 16:45:00,-150.04,337357.64000000723,348118.610000007,-10760.96999999974
36178,2022-12-01 16:50:00,-1556.17,335801.47000000725,348118.610000007,-12317.139999999723
36179,2022-12-01 16:55:00,-467.37,335334.10000000725,348118.610000007,-12784.509999999718
36180,2022-12-02 08:00:00,-680.87,334653.23000000726,335334.10000000725,-680.8699999999953
36181,2022-12-02 08:05:00,-197.28,334455.95000000723,335334.10000000725,-878.1500000000233
36182,2022-12-02 08:10:00,-1363.55,333092.40000000724,335334.10000000725,-2241.7000000000116
36183,2022-12-02 08:15:00,422.41,333514.8100000072,335334.10000000725,-1819.2900000000373
36184,2022-12-02 08:20:00,1024.32,334539.1300000072,335334.10000000725,-794.9700000000303
36185,2022-12-02 08:25:00,885.42,335424.5500000072,335334.10000000725,90.44999999995343
36186,2022-12-02 08:30:00,-929.22,334495.33000000723,335334.10000000725,-838.7700000000186
36187,2022-12-02 08:35:00,153.89,334649.22000000725,335334.10000000725,-684.8800000000047
36188,2022-12-02 08:40:00,-1265.05,333384.17000000726,335334.10000000725,-1949.929999999993
36189,2022-12-02 08:45:00,413.58,333797.7500000073,335334.10000000725,-1536.3499999999767
36190,2022-12-02 08:50:00,-1030.31,332767.4400000073,335334.10000000725,-2566.6599999999744
36191,2022-12-02 08:55:00,535.49,333302.93000000727,335334.10000000725,-2031.1699999999837
36192,2022-12-02 09:00:00,-544.9,332758.03000000725,335334.10000000725,-2576.070000000007
36193,2022-12-02 09:05:00,122.85,332880.8800000072,335334.10000000725,-2453.2200000000303
36194,2022-12-02 09:10:00,-23.85,332857.03000000725,335334.10000000725,-2477.070000000007
36195,2022-12-02 09:15:00,-642.03,332215.0000000072,335334.10000000725,-3119.100000000035
36196,2022-12-02 09:20:00,-1033.22,331181.78000000725,335334.10000000725,-4152.320000000007
36197,2022-12-02 09:25:00,-306.26,330875.52000000724,335334.10000000725,-4458.580000000016
36198,2022-12-02 09:30:00,-1971.27,328904.2500000072,335334.10000000725,-6429.850000000035
36199,2022-12-02 09:35:00,245.57,329149.8200000072,335334.10000000725,-6184.280000000028
36200,2022-12-02 09:40:00,-1199.68,327950.14000000723,335334.10000000725,-7383.960000000021
36201,2022-12-02 09:45:00,-1973.42,325976.72000000725,335334.10000000725,-9357.380000000005
36202,2022-12-02 09:50:00,-232.81,325743.91000000725,335334.10000000725,-9590.190000000002
36203,2022-12-02 09:55:00,1660.74,327404.65000000724,335334.10000000725,-7929.450000000012
36204,2022-12-02 10:00:00,354.61,327759.2600000072,335334.10000000725,-7574.840000000026
36205,2022-12-02 10:05:00,-804.02,326955.2400000072,335334.10000000725,-8378.860000000044
36206,2022-12-02 10:10:00,-1054.25,325900.9900000072,335334.10000000725,-9433.110000000044
36207,2022-12-02 10:15:00,1844.3,327745.2900000072,335334.10000000725,-7588.810000000056
36208,2022-12-02 10:20:00,-1783.12,325962.1700000072,335334.10000000725,-9371.930000000051
36209,2022-12-02 10:25:00,1094.8,327056.9700000072,335334.10000000725,-8277.130000000063
36210,2022-12-02 10:30:00,-1830.18,325226.7900000072,335334.10000000725,-10107.310000000056
36211,2022-12-02 10:35:00,1531.16,326757.9500000072,335334.10000000725,-8576.150000000081
36212,2022-12-02 10:40:00,-1033.92,325724.0300000072,335334.10000000725,-9610.070000000065
36213,2022-12-02 10:45:00,-832.09,324891.94000000716,335334.10000000725,-10442.16000000009
36214,2022-12-02 10:50:00,-1474.41,323417.5300000072,335334.10000000725,-11916.570000000065
36215,2022-12-02 10:55:00,-886.34,322531.19000000716,335334.10000000725,-12802.91000000009
36216,2022-12-02 11:00:00,1127.02,323658.2100000072,335334.10000000725,-11675.890000000072
36217,2022-12-02 11:05:00,979.49,324637.7000000072,335334.10000000725,-10696.400000000081
36218,2022-12-02 11:10:00,-1121.65,323516.05000000715,335334.10000000725,-11818.050000000105
36219,2022-12-02 11:15:00,-734.28,322781.7700000071,335334.10000000725,-12552.330000000133
36220,2022-12-02 11:20:00,1537.54,324319.3100000071,335334.10000000725,-11014.790000000154
36221,2022-12-02 11:25:00,219.59,324538.9000000071,335334.10000000725,-10795.200000000128
36222,2022-12-02 11:30:00,-341.45,324197.4500000071,335334.10000000725,-11136.65000000014
36223,2022-12-02 11:35:00,-625.59,323571.8600000071,335334.10000000725,-11762.240000000165
36224,2022-12-02 11:40:00,1980.26,325552.1200000071,335334.10000000725,-9781.980000000156
36225,2022-12-02 11:45:00,-1478.36,324073.7600000071,335334.10000000725,-11260.340000000142
36226,2022-12-02 11:50:00,-163.17,323910.5900000071,335334.10000000725,-11423.510000000126
36227,2022-12-02 11:55:00,-456.02,323454.5700000071,335334.10000000725,-11879.530000000144
36228,2022-12-02 12:00:00,-1688.91,321765.66000000713,335334.10000000725,-13568.440000000119
36229,2022-12-02 12:05:00,-1002.81,320762.85000000714,335334.10000000725,-14571.250000000116
36230,2022-12-02 12:10:00,-550.79,320212.06000000716,335334.10000000725,-15122.040000000095
36231,2022-12-02 12:15:00,-219.89,319992.17000000714,335334.10000000725,-15341.93000000011
36232,2022-12-02 12:20:00,-679.92,319312.25000000716,335334.10000000725,-16021.850000000093
36233,2022-12-02 12:25:00,-1053.33,318258.92000000714,335334.10000000725,-17075.18000000011
36234,2022-12-02 12:30:00,1896.21,320155.13000000716,335334.10000000725,-15178.970000000088
36235,2022-12-02 12:35:00,1278.8,321433.93000000715,335334.10000000725,-13900.1700000001
36236,2022-12-02 12:40:00,1334.47,322768.4000000071,335334.10000000725,-12565.700000000128
36237,2022-12-02 12:45:00,960.02,323728.42000000714,335334.10000000725,-11605.68000000011
36238,2022-12-02 12:50:00,738.16,324466.5800000071,335334.10000000725,-10867.520000000135
36239,2022-12-02 12:55:00,1090.82,325557.4000000071,335334.10000000725,-9776.700000000128
36240,2022-12-02 13:00:00,-1890.74,323666.66000000713,335334.10000000725,-11667.440000000119
36241,2022-12-02 13:05:00,397.83,324064.49000000715,335334.10000000725,-11269.610000000102
36242,2022-12-02 13:10:00,1631.86,325696.35000000714,335334.10000000725,-9637.750000000116
36243,2022-12-02 13:15:00,362.37,326058.72000000713,335334.10000000725,-9275.380000000121
36244,2022-12-02 13:20:00,544.07,326602.79000000714,335334.10000000725,-8731.310000000114
36245,2022-12-02 13:25:00,-1994.22,324608.57000000717,335334.10000000725,-10725.530000000086
36246,2022-12-02 13:30:00,-214.38,324394.19000000716,335334.10000000725,-10939.91000000009
36247,2022-12-02 13:35:00,-723.85,323670.3400000072,335334.10000000725,-11663.760000000068
36248,2022-12-02 13:40:00,-859.63,322810.7100000072,335334.10000000725,-12523.390000000072
36249,2022-12-02 13:45:00,-638.91,322171.8000000072,335334.10000000725,-13162.300000000047
36250,2022-12-02 13:50:00,-967.6,321204.20000000723,335334.10000000725,-14129.900000000023
36251,2022-12-02 13:55:00,-626.74,320577.46000000724,335334.10000000725,-14756.640000000014
36252,2022-12-02 14:00:00,1099.95,321677.41000000725,335334.10000000725,-13656.690000000002
36253,2022-12-02 14:05:00,1295.98,322973.39000000723,335334.10000000725,-12360.710000000021
36254,2022-12-02 14:10:00,922.16,323895.5500000072,335334.10000000725,-11438.550000000047
36255,2022-12-02 14:15:00,-760.68,323134.8700000072,335334.10000000725,-12199.23000000004
36256,2022-12-02 14:20:00,-1728.04,321406.83000000723,335334.10000000725,-13927.270000000019
36257,2022-12-02 14:25:00,-757.93,320648.90000000724,335334.10000000725,-14685.200000000012
36258,2022-12-02 14:30:00,-321.69,320327.21000000724,335334.10000000725,-15006.890000000014
36259,2022-12-02 14:35:00,-1086.41,319240.80000000726,335334.10000000725,-16093.299999999988
36260,2022-12-02 14:40:00,953.97,320194.77000000724,335334.10000000725,-15139.330000000016
36261,2022-12-02 14:45:00,-841.91,319352.86000000726,335334.10000000725,-15981.23999999999
36262,2022-12-02 14:50:00,-103.67,319249.1900000073,335334.10000000725,-16084.909999999974
36263,2022-12-02 14:55:00,631.85,319881.04000000726,335334.10000000725,-15453.059999999998
36264,2022-12-02 15:00:00,-950.37,318930.67000000726,335334.10000000725,-16403.429999999993
36265,2022-12-02 15:05:00,-747.88,318182.79000000726,335334.10000000725,-17151.309999999998
36266,2022-12-02 15:10:00,-656.69,317526.10000000725,335334.10000000725,-17808.0
36267,2022-12-02 15:15:00,-1118.64,316407.46000000724,335334.10000000725,-18926.640000000014
36268,2022-12-02 15:20:00,330.45,316737.91000000725,335334.10000000725,-18596.190000000002
36269,2022-12-02 15:25:00,1093.4,317831.3100000073,335334.10000000725,-17502.78999999998
36270,2022-12-02 15:30:00,-963.96,316867.35000000725,335334.10000000725,-18466.75
36271,2022-12-02 15:35:00,1561.72,318429.0700000072,335334.10000000725,-16905.030000000028
36272,2022-12-02 15:40:00,-1457.22,316971.85000000725,335334.10000000725,-18362.25
36273,2022-12-02 15:45:00,-1708.31,315263.54000000726,335334.10000000725,-20070.559999999998
36274,2022-12-02 15:50:00,-1648.85,313614.6900000073,335334.10000000725,-21719.409999999974
36275,2022-12-02 15:55:00,-1187.5,312427.1900000073,335334.10000000725,-22906.909999999974
36276,2022-12-02 16:00:00,-276.3,312150.8900000073,335334.10000000725,-23183.209999999963
36277,2022-12-02 16:05:00,973.96,313124.8500000073,335334.10000000725,-22209.24999999994
36278,2022-12-02 16:10:00,781.31,313906.1600000073,335334.10000000725,-21427.939999999944
36279,2022-12-02 16:15:00,-805.79,313100.37000000733,335334.10000000725,-22233.729999999923
36280,2022-12-02 16:20:00,1810.64,314911.01000000734,335334.10000000725,-20423.08999999991
36281,2022-12-02 16:25:00,-1346.26,313564.75000000733,335334.10000000725,-21769.34999999992
36282,2022-12-02 16:30:00,853.63,314418.38000000734,335334.10000000725,-20915.719999999914
36283,2022-12-02 16:35:00,-552.34,313866.0400000073,335334.10000000725,-21468.05999999994
36284,2022-12-02 16:40:00,1370.23,315236.2700000073,335334.10000000725,-20097.829999999958
36285,2022-12-02 16:45:00,-1489.8,313746.4700000073,335334.10000000725,-21587.629999999946
36286,2022-12-02 16:50:00,-692.51,313053.9600000073,335334.10000000725,-22280.139999999956
36287,2022-12-02 16:55:00,-1090.32,311963.6400000073,335334.10000000725,-23370.459999999963
36288,2022-12-03 08:00:00,-1874.99,310088.6500000073,311963.6400000073,-1874.9899999999907
36289,2022-12-03 08:05:00,167.23,310255.8800000073,311963.6400000073,-1707.7600000000093
36290,2022-12-03 08:10:00,-597.1,309658.7800000073,311963.6400000073,-2304.859999999986
36291,2022-12-03 08:15:00,-223.36,309435.4200000073,311963.6400000073,-2528.219999999972
36292,2022-12-03 08:20:00,-245.98,309189.44000000734,311963.6400000073,-2774.1999999999534
36293,2022-12-03 08:25:00,-519.83,308669.6100000073,311963.6400000073,-3294.0299999999697
36294,2022-12-03 08:30:00,-1012.25,307657.3600000073,311963.6400000073,-4306.27999999997
36295,2022-12-03 08:35:00,-175.14,307482.2200000073,311963.6400000073,-4481.419999999984
36296,2022-12-03 08:40:00,-1057.93,306424.2900000073,311963.6400000073,-5539.349999999977
36297,2022-12-03 08:45:00,-1509.92,304914.37000000733,311963.6400000073,-7049.26999999996
36298,2022-12-03 08:50:00,-179.47,304734.90000000736,311963.6400000073,-7228.7399999999325
36299,2022-12-03 08:55:00,-1759.58,302975.32000000734,311963.6400000073,-8988.319999999949
36300,2022-12-03 09:00:00,669.57,303644.89000000735,311963.6400000073,-8318.749999999942
36301,2022-12-03 09:05:00,59.12,303704.01000000734,311963.6400000073,-8259.629999999946
36302,2022-12-03 09:10:00,-1206.7,302497.31000000733,311963.6400000073,-9466.329999999958
36303,2022-12-03 09:15:00,384.28,302881.59000000736,311963.6400000073,-9082.04999999993
36304,2022-12-03 09:20:00,1660.04,304541.63000000734,311963.6400000073,-7422.009999999951
36305,2022-12-03 09:25:00,827.1,305368.7300000073,311963.6400000073,-6594.909999999974
36306,2022-12-03 09:30:00,99.03,305467.76000000734,311963.6400000073,-6495.879999999946
36307,2022-12-03 09:35:00,-766.19,304701.57000000734,311963.6400000073,-7262.069999999949
36308,2022-12-03 09:40:00,1172.03,305873.60000000737,311963.6400000073,-6090.039999999921
36309,2022-12-03 09:45:00,208.12,306081.72000000736,311963.6400000073,-5881.9199999999255
36310,2022-12-03 09:50:00,-831.15,305250.57000000734,311963.6400000073,-6713.069999999949
36311,2022-12-03 09:55:00,-1430.57,303820.00000000733,311963.6400000073,-8143.639999999956
36312,2022-12-03 10:00:00,137.77,303957.77000000735,311963.6400000073,-8005.869999999937
36313,2022-12-03 10:05:00,1560.85,305518.62000000733,311963.6400000073,-6445.01999999996
36314,2022-12-03 10:10:00,-661.75,304856.87000000733,311963.6400000073,-7106.76999999996
36315,2022-12-03 10:15:00,665.71,305522.58000000735,311963.6400000073,-6441.0599999999395
36316,2022-12-03 10:20:00,782.86,306305.44000000734,311963.6400000073,-5658.199999999953
36317,2022-12-03 10:25:00,-1037.2,305268.2400000073,311963.6400000073,-6695.399999999965
36318,2022-12-03 10:30:00,1500.05,306768.2900000073,311963.6400000073,-5195.349999999977
36319,2022-12-03 10:35:00,-776.0,305992.2900000073,311963.6400000073,-5971.349999999977
36320,2022-12-03 10:40:00,237.66,306229.9500000073,311963.6400000073,-5733.690000000002
36321,2022-12-03 10:45:00,1400.66,307630.61000000726,311963.6400000073,-4333.030000000028
36322,2022-12-03 10:50:00,-1715.94,305914.67000000726,311963.6400000073,-6048.97000000003
36323,2022-12-03 10:55:00,-935.18,304979.49000000727,311963.6400000073,-6984.150000000023
36324,2022-12-03 11:00:00,-1742.92,303236.5700000073,311963.6400000073,-8727.070000000007
36325,2022-12-03 11:05:00,-1149.49,302087.0800000073,311963.6400000073,-9876.559999999998
36326,2022-12-03 11:10:00,-1433.15,300653.93000000727,311963.6400000073,-11309.710000000021
36327,2022-12-03 11:15:00,253.91,300907.84000000724,311963.6400000073,-11055.800000000047
36328,2022-12-03 11:20:00,-831.17,300076.67000000726,311963.6400000073,-11886.97000000003
36329,2022-12-03 11:25:00,-555.63,299521.04000000726,311963.6400000073,-12442.600000000035
36330,2022-12-03 11:30:00,349.68,299870.72000000725,311963.6400000073,-12092.920000000042
36331,2022-12-03 11:35:00,1733.96,301604.68000000727,311963.6400000073,-10358.960000000021
36332,2022-12-03 11:40:00,1156.66,302761.34000000724,311963.6400000073,-9202.300000000047
36333,2022-12-03 11:45:00,-727.23,302034.11000000726,311963.6400000073,-9929.530000000028
36334,2022-12-03 11:50:00,-1941.36,300092.7500000073,311963.6400000073,-11870.890000000014
36335,2022-12-03 11:55:00,952.62,301045.3700000073,311963.6400000073,-10918.270000000019
36336,2022-12-03 12:00:00,1864.75,302910.1200000073,311963.6400000073,-9053.520000000019
36337,2022-12-03 12:05:00,-585.78,302324.34000000724,311963.6400000073,-9639.300000000047
36338,2022-12-03 12:10:00,1815.45,304139.79000000726,311963.6400000073,-7823.850000000035
36339,2022-12-03 12:15:00,1742.41,305882.20000000723,311963.6400000073,-6081.4400000000605
36340,2022-12-03 12:20:00,-115.0,305767.20000000723,311963.6400000073,-6196.4400000000605
36341,2022-12-03 12:25:00,841.0,306608.20000000723,311963.6400000073,-5355.4400000000605
36342,2022-12-03 12:30:00,1207.51,307815.71000000724,311963.6400000073,-4147.930000000051
36343,2022-12-03 12:35:00,-1897.64,305918.0700000072,311963.6400000073,-6045.570000000065
36344,2022-12-03 12:40:00,1632.63,307550.70000000723,311963.6400000073,-4412.9400000000605
36345,2022-12-03 12:45:00,515.78,308066.48000000726,311963.6400000073,-3897.1600000000326
36346,2022-12-03 12:50:00,-1178.26,306888.22000000725,311963.6400000073,-5075.420000000042
36347,2022-12-03 12:55:00,1603.81,308492.03000000725,311963.6400000073,-3471.6100000000442
36348,2022-12-03 13:00:00,-1537.26,306954.77000000724,311963.6400000073,-5008.870000000054
36349,2022-12-03 13:05:00,-1043.12,305911.65000000724,311963.6400000073,-6051.990000000049
36350,2022-12-03 13:10:00,1319.22,307230.8700000072,311963.6400000073,-4732.770000000077
36351,2022-12-03 13:15:00,883.85,308114.7200000072,311963.6400000073,-3848.9200000001
36352,2022-12-03 13:20:00,1941.65,310056.3700000072,311963.6400000073,-1907.2700000000768
36353,2022-12-03 13:25:00,-694.64,309361.7300000072,311963.6400000073,-2601.910000000091
36354,2022-12-03 13:30:00,295.48,309657.2100000072,311963.6400000073,-2306.4300000001094
36355,2022-12-03 13:35:00,-302.89,309354.32000000717,311963.6400000073,-2609.3200000001234
36356,2022-12-03 13:40:00,563.35,309917.67000000714,311963.6400000073,-2045.9700000001467
36357,2022-12-03 13:45:00,-1850.9,308066.7700000071,311963.6400000073,-3896.87000000017
36358,2022-12-03 13:50:00,-1804.45,306262.3200000071,311963.6400000073,-5701.320000000182
36359,2022-12-03 13:55:00,980.57,307242.8900000071,311963.6400000073,-4720.750000000175
36360,2022-12-03 14:00:00,-246.29,306996.60000000714,311963.6400000073,-4967.040000000154
36361,2022-12-03 14:05:00,-1566.9,305429.7000000071,311963.6400000073,-6533.940000000177
36362,2022-12-03 14:10:00,517.25,305946.9500000071,311963.6400000073,-6016.690000000177
36363,2022-12-03 14:15:00,-1082.58,304864.3700000071,311963.6400000073,-7099.270000000193
36364,2022-12-03 14:20:00,-290.54,304573.8300000071,311963.6400000073,-7389.810000000172
36365,2022-12-03 14:25:00,-366.93,304206.9000000071,311963.6400000073,-7756.740000000165
36366,2022-12-03 14:30:00,1947.67,306154.5700000071,311963.6400000073,-5809.070000000182
36367,2022-12-03 14:35:00,341.38,306495.9500000071,311963.6400000073,-5467.690000000177
36368,2022-12-03 14:40:00,1033.42,307529.3700000071,311963.6400000073,-4434.270000000193
36369,2022-12-03 14:45:00,718.01,308247.3800000071,311963.6400000073,-3716.260000000184
36370,2022-12-03 14:50:00,-1837.77,306409.6100000071,311963.6400000073,-5554.030000000203
36371,2022-12-03 14:55:00,-1263.51,305146.1000000071,311963.6400000073,-6817.540000000212
36372,2022-12-03 15:00:00,-116.0,305030.1000000071,311963.6400000073,-6933.540000000212
36373,2022-12-03 15:05:00,-1893.51,303136.59000000707,311963.6400000073,-8827.050000000221
36374,2022-12-03 15:10:00,810.31,303946.90000000707,311963.6400000073,-8016.7400000002235
36375,2022-12-03 15:15:00,-814.69,303132.21000000706,311963.6400000073,-8831.430000000226
36376,2022-12-03 15:20:00,-869.51,302262.70000000705,311963.6400000073,-9700.940000000235
36377,2022-12-03 15:25:00,-1960.96,300301.74000000703,311963.6400000073,-11661.900000000256
36378,2022-12-03 15:30:00,-455.56,299846.18000000704,311963.6400000073,-12117.460000000254
36379,2022-12-03 15:35:00,-167.48,299678.70000000705,311963.6400000073,-12284.940000000235
36380,2022-12-03 15:40:00,-35.81,299642.89000000706,311963.6400000073,-12320.750000000233
36381,2022-12-03 15:45:00,816.81,300459.70000000705,311963.6400000073,-11503.940000000235
36382,2022-12-03 15:50:00,645.04,301104.74000000703,311963.6400000073,-10858.900000000256
36383,2022-12-03 15:55:00,838.1,301942.840000007,311963.6400000073,-10020.80000000028
36384,2022-12-03 16:00:00,773.88,302716.720000007,311963.6400000073,-9246.920000000275
36385,2022-12-03 16:05:00,-480.4,302236.320000007,311963.6400000073,-9727.320000000298
36386,2022-12-03 16:10:00,-1095.75,301140.570000007,311963.6400000073,-10823.070000000298
36387,2022-12-03 16:15:00,-1118.08,300022.490000007,311963.6400000073,-11941.150000000314
36388,2022-12-03 16:20:00,-1506.93,298515.560000007,311963.6400000073,-13448.080000000307
36389,2022-12-03 16:25:00,-586.47,297929.090000007,311963.6400000073,-14034.55000000028
36390,2022-12-03 16:30:00,1541.4,299470.49000000703,311963.6400000073,-12493.150000000256
36391,2022-12-03 16:35:00,-440.73,299029.76000000705,311963.6400000073,-12933.880000000237
36392,2022-12-03 16:40:00,345.83,299375.59000000707,311963.6400000073,-12588.050000000221
36393,2022-12-03 16:45:00,-1212.54,298163.0500000071,311963.6400000073,-13800.5900000002
36394,2022-12-03 16:50:00,156.46,298319.5100000071,311963.6400000073,-13644.13000000018
36395,2022-12-03 16:55:00,-913.07,297406.4400000071,311963.6400000073,-14557.200000000186
36396,2022-12-04 08:00:00,1464.88,298871.3200000071,297406.4400000071,1464.8800000000047
36397,2022-12-04 08:05:00,1598.22,300469.5400000071,297406.4400000071,3063.0999999999767
36398,2022-12-04 08:10:00,1153.59,301623.1300000071,297406.4400000071,4216.690000000002
36399,2022-12-04 08:15:00,-285.56,301337.5700000071,297406.4400000071,3931.1300000000047
36400,2022-12-04 08:20:00,1755.64,303093.2100000071,297406.4400000071,5686.770000000019
36401,2022-12-04 08:25:00,-318.92,302774.29000000714,297406.4400000071,5367.850000000035
36402,2022-12-04 08:30:00,-979.77,301794.5200000071,297406.4400000071,4388.080000000016
36403,2022-12-04 08:35:00,833.64,302628.16000000713,297406.4400000071,5221.72000000003
36404,2022-12-04 08:40:00,-194.78,302433.3800000071,297406.4400000071,5026.940000000002
36405,2022-12-04 08:45:00,1454.29,303887.6700000071,297406.4400000071,6481.229999999981
36406,2022-12-04 08:50:00,-1065.0,302822.6700000071,297406.4400000071,5416.229999999981
36407,2022-12-04 08:55:00,3.57,302826.2400000071,297406.4400000071,5419.799999999988
36408,2022-12-04 09:00:00,972.92,303799.1600000071,297406.4400000071,6392.719999999972
36409,2022-12-04 09:05:00,1839.56,305638.7200000071,297406.4400000071,8232.27999999997
36410,2022-12-04 09:10:00,146.56,305785.2800000071,297406.4400000071,8378.839999999967
36411,2022-12-04 09:15:00,-996.09,304789.19000000705,297406.4400000071,7382.749999999942
36412,2022-12-04 09:20:00,1570.8,306359.99000000703,297406.4400000071,8953.54999999993
36413,2022-12-04 09:25:00,-124.49,306235.50000000704,297406.4400000071,8829.05999999994
36414,2022-12-04 09:30:00,1589.14,307824.64000000706,297406.4400000071,10418.199999999953
36415,2022-12-04 09:35:00,-241.02,307583.62000000704,297406.4400000071,10177.179999999935
36416,2022-12-04 09:40:00,721.61,308305.230000007,297406.4400000071,10898.78999999992
36417,2022-12-04 09:45:00,-834.18,307471.05000000703,297406.4400000071,10064.609999999928
36418,2022-12-04 09:50:00,621.21,308092.26000000705,297406.4400000071,10685.819999999949
36419,2022-12-04 09:55:00,-239.61,307852.65000000707,297406.4400000071,10446.209999999963
36420,2022-12-04 10:00:00,-1850.67,306001.9800000071,297406.4400000071,8595.539999999979
36421,2022-12-04 10:05:00,1400.2,307402.1800000071,297406.4400000071,9995.73999999999
36422,2022-12-04 10:10:00,-427.94,306974.2400000071,297406.4400000071,9567.799999999988
36423,2022-12-04 10:15:00,-1158.22,305816.0200000071,297406.4400000071,8409.580000000016
36424,2022-12-04 10:20:00,1433.41,307249.4300000071,297406.4400000071,9842.98999999999
36425,2022-12-04 10:25:00,-1482.55,305766.8800000071,297406.4400000071,8360.440000000002
36426,2022-12-04 10:30:00,-1322.95,304443.9300000071,297406.4400000071,7037.489999999991
36427,2022-12-04 10:35:00,-1154.48,303289.4500000071,297406.4400000071,5883.010000000009
36428,2022-12-04 10:40:00,918.01,304207.4600000071,297406.4400000071,6801.020000000019
36429,2022-12-04 10:45:00,-707.87,303499.5900000071,297406.4400000071,6093.150000000023
36430,2022-12-04 10:50:00,-1146.74,302352.85000000714,297406.4400000071,4946.410000000033
36431,2022-12-04 10:55:00,120.14,302472.99000000715,297406.4400000071,5066.550000000047
36432,2022-12-04 11:00:00,-1192.36,301280.63000000716,297406.4400000071,3874.1900000000605
36433,2022-12-04 11:05:00,-523.58,300757.05000000715,297406.4400000071,3350.6100000000442
36434,2022-12-04 11:10:00,-1390.23,299366.82000000717,297406.4400000071,1960.3800000000629
36435,2022-12-04 11:15:00,-1920.29,297446.5300000072,297406.4400000071,40.09000000008382
36436,2022-12-04 11:20:00,-1316.81,296129.7200000072,297406.4400000071,-1276.7199999999139
36437,2022-12-04 11:25:00,973.05,297102.7700000072,297406.4400000071,-303.6699999999255
36438,2022-12-04 11:30:00,-344.96,296757.81000000716,297406.4400000071,-648.6299999999464
36439,2022-12-04 11:35:00,1661.1,298418.91000000713,297406.4400000071,1012.4700000000303
36440,2022-12-04 11:40:00,1400.8,299819.7100000071,297406.4400000071,2413.2700000000186
36441,2022-12-04 11:45:00,1422.92,301242.6300000071,297406.4400000071,3836.1900000000023
36442,2022-12-04 11:50:00,1012.28,302254.91000000713,297406.4400000071,4848.47000000003
36443,2022-12-04 11:55:00,50.17,302305.0800000071,297406.4400000071,4898.640000000014
36444,2022-12-04 12:00:00,130.99,302436.0700000071,297406.4400000071,5029.630000000005
36445,2022-12-04 12:05:00,-0.87,302435.2000000071,297406.4400000071,5028.760000000009
36446,2022-12-04 12:10:00,-1567.92,300867.28000000713,297406.4400000071,3460.8400000000256
36447,2022-12-04 12:15:00,-679.07,300188.2100000071,297406.4400000071,2781.7700000000186
36448,2022-12-04 12:20:00,1480.14,301668.35000000714,297406.4400000071,4261.910000000033
36449,2022-12-04 12:25:00,1255.23,302923.5800000071,297406.4400000071,5517.140000000014
36450,2022-12-04 12:30:00,-1806.4,301117.1800000071,297406.4400000071,3710.7399999999907
36451,2022-12-04 12:35:00,655.88,301773.0600000071,297406.4400000071,4366.619999999995
36452,2022-12-04 12:40:00,1674.72,303447.7800000071,297406.4400000071,6041.339999999967
36453,2022-12-04 12:45:00,-920.38,302527.40000000707,297406.4400000071,5120.959999999963
36454,2022-12-04 12:50:00,1608.45,304135.8500000071,297406.4400000071,6729.409999999974
36455,2022-12-04 12:55:00,-1160.93,302974.9200000071,297406.4400000071,5568.479999999981
36456,2022-12-04 13:00:00,1930.57,304905.4900000071,297406.4400000071,7499.049999999988
36457,2022-12-04 13:05:00,1835.92,306741.4100000071,297406.4400000071,9334.969999999972
36458,2022-12-04 13:10:00,-1317.78,305423.63000000705,297406.4400000071,8017.189999999944
36459,2022-12-04 13:15:00,-1613.19,303810.44000000705,297406.4400000071,6403.999999999942
36460,2022-12-04 13:20:00,-766.43,303044.01000000705,297406.4400000071,5637.569999999949
36461,2022-12-04 13:25:00,-545.26,302498.75000000704,297406.4400000071,5092.3099999999395
36462,2022-12-04 13:30:00,-1870.5,300628.25000000704,297406.4400000071,3221.8099999999395
36463,2022-12-04 13:35:00,-214.52,300413.730000007,297406.4400000071,3007.289999999921
36464,2022-12-04 13:40:00,1961.62,302375.350000007,297406.4400000071,4968.909999999916
36465,2022-12-04 13:45:00,-844.4,301530.950000007,297406.4400000071,4124.509999999893
36466,2022-12-04 13:50:00,-160.83,301370.120000007,297406.4400000071,3963.6799999998766
36467,2022-12-04 13:55:00,1119.97,302490.09000000695,297406.4400000071,5083.649999999849
36468,2022-12-04 14:00:00,238.44,302728.53000000695,297406.4400000071,5322.089999999851
36469,2022-12-04 14:05:00,-1413.04,301315.490000007,297406.4400000071,3909.049999999872
36470,2022-12-04 14:10:00,-928.68,300386.810000007,297406.4400000071,2980.369999999879
36471,2022-12-04 14:15:00,-1723.83,298662.98000000697,297406.4400000071,1256.5399999998626
36472,2022-12-04 14:20:00,-486.26,298176.72000000696,297406.4400000071,770.2799999998533
36473,2022-12-04 14:25:00,-1792.05,296384.67000000697,297406.4400000071,-1021.770000000135
36474,2022-12-04 14:30:00,1805.44,298190.110000007,297406.4400000071,783.6699999998673
36475,2022-12-04 14:35:00,1497.3,299687.41000000696,297406.4400000071,2280.9699999998556
36476,2022-12-04 14:40:00,1866.24,301553.65000000695,297406.4400000071,4147.209999999846
36477,2022-12-04 14:45:00,893.58,302447.23000000697,297406.4400000071,5040.789999999863
36478,2022-12-04 14:50:00,-187.47,302259.760000007,297406.4400000071,4853.319999999891
36479,2022-12-04 14:55:00,1737.04,303996.800000007,297406.4400000071,6590.35999999987
36480,2022-12-04 15:00:00,-651.56,303345.240000007,297406.4400000071,5938.799999999872
36481,2022-12-04 15:05:00,1233.73,304578.97000000696,297406.4400000071,7172.529999999853
36482,2022-12-04 15:10:00,1483.71,306062.680000007,297406.4400000071,8656.239999999874
36483,2022-12-04 15:15:00,597.01,306659.690000007,297406.4400000071,9253.249999999884
36484,2022-12-04 15:20:00,-358.51,306301.180000007,297406.4400000071,8894.739999999874
36485,2022-12-04 15:25:00,479.02,306780.200000007,297406.4400000071,9373.759999999893
36486,2022-12-04 15:30:00,1490.61,308270.810000007,297406.4400000071,10864.369999999879
36487,2022-12-04 15:35:00,-1295.21,306975.60000000696,297406.4400000071,9569.159999999858
36488,2022-12-04 15:40:00,337.02,307312.620000007,297406.4400000071,9906.179999999877
36489,2022-12-04 15:45:00,-1961.69,305350.930000007,297406.4400000071,7944.489999999874
36490,2022-12-04 15:50:00,-1940.67,303410.260000007,297406.4400000071,6003.819999999891
36491,2022-12-04 15:55:00,193.34,303603.600000007,297406.4400000071,6197.159999999916
36492,2022-12-04 16:00:00,-788.87,302814.730000007,297406.4400000071,5408.289999999921
36493,2022-12-04 16:05:00,-948.83,301865.900000007,297406.4400000071,4459.4599999999045
36494,2022-12-04 16:10:00,690.76,302556.660000007,297406.4400000071,5150.219999999914
36495,2022-12-04 16:15:00,39.82,302596.480000007,297406.4400000071,5190.039999999921
36496,2022-12-04 16:20:00,1079.09,303675.57000000705,297406.4400000071,6269.129999999946
36497,2022-12-04 16:25:00,-1458.69,302216.88000000705,297406.4400000071,4810.439999999944
36498,2022-12-04 16:30:00,1974.58,304191.46000000706,297406.4400000071,6785.01999999996
36499,2022-12-04 16:35:00,-54.75,304136.71000000706,297406.4400000071,6730.26999999996
36500,2022-12-04 16:40:00,640.93,304777.64000000706,297406.4400000071,7371.199999999953
36501,2022-12-04 16:45:00,-961.49,303816.15000000707,297406.4400000071,6409.709999999963
36502,2022-12-04 16:50:00,-364.35,303451.8000000071,297406.4400000071,6045.359999999986
36503,2022-12-04 16:55:00,1935.89,305387.6900000071,297406.4400000071,7981.25
36504,2022-12-05 08:00:00,1973.8,307361.4900000071,305387.6900000071,1973.7999999999884
36505,2022-12-05 08:05:00,736.31,308097.8000000071,305387.6900000071,2710.109999999986
36506,2022-12-05 08:10:00,1534.52,309632.3200000071,305387.6900000071,4244.630000000005
36507,2022-12-05 08:15:00,-69.18,309563.1400000071,305387.6900000071,4175.450000000012
36508,2022-12-05 08:20:00,-1852.76,307710.3800000071,305387.6900000071,2322.6900000000023
36509,2022-12-05 08:25:00,496.23,308206.6100000071,305387.6900000071,2818.9199999999837
36510,2022-12-05 08:30:00,-643.35,307563.2600000071,305387.6900000071,2175.570000000007
36511,2022-12-05 08:35:00,1938.35,309501.6100000071,305387.6900000071,4113.919999999984
36512,2022-12-05 08:40:00,812.5,310314.1100000071,305387.6900000071,4926.419999999984
36513,2022-12-05 08:45:00,1105.53,311419.6400000071,305387.6900000071,6031.950000000012
36514,2022-12-05 08:50:00,-803.01,310616.6300000071,305387.6900000071,5228.940000000002
36515,2022-12-05 08:55:00,1550.22,312166.8500000071,305387.6900000071,6779.159999999974
36516,2022-12-05 09:00:00,-1025.56,311141.2900000071,305387.6900000071,5753.599999999977
36517,2022-12-05 09:05:00,896.59,312037.8800000071,305387.6900000071,6650.190000000002
36518,2022-12-05 09:10:00,-1382.09,310655.7900000071,305387.6900000071,5268.099999999977
36519,2022-12-05 09:15:00,-1956.24,308699.5500000071,305387.6900000071,3311.859999999986
36520,2022-12-05 09:20:00,1945.9,310645.4500000071,305387.6900000071,5257.760000000009
36521,2022-12-05 09:25:00,-1898.91,308746.54000000714,305387.6900000071,3358.850000000035
36522,2022-12-05 09:30:00,-1976.37,306770.17000000714,305387.6900000071,1382.4800000000396
36523,2022-12-05 09:35:00,-604.82,306165.35000000714,305387.6900000071,777.6600000000326
36524,2022-12-05 09:40:00,1201.59,307366.94000000716,305387.6900000071,1979.2500000000582
36525,2022-12-05 09:45:00,-1121.7,306245.24000000715,305387.6900000071,857.5500000000466
36526,2022-12-05 09:50:00,-8.17,306237.07000000717,305387.6900000071,849.3800000000629
36527,2022-12-05 09:55:00,1195.79,307432.86000000715,305387.6900000071,2045.170000000042
36528,2022-12-05 10:00:00,-1.34,307431.5200000071,305387.6900000071,2043.8300000000163
36529,2022-12-05 10:05:00,834.89,308266.41000000713,305387.6900000071,2878.7200000000303
36530,2022-12-05 10:10:00,-417.79,307848.62000000715,305387.6900000071,2460.930000000051
36531,2022-12-05 10:15:00,1114.87,308963.49000000715,305387.6900000071,3575.8000000000466
36532,2022-12-05 10:20:00,1798.44,310761.93000000715,305387.6900000071,5374.240000000049
36533,2022-12-05 10:25:00,965.97,311727.9000000071,305387.6900000071,6340.210000000021
36534,2022-12-05 10:30:00,743.23,312471.1300000071,305387.6900000071,7083.440000000002
36535,2022-12-05 10:35:00,-1019.45,311451.6800000071,305387.6900000071,6063.989999999991
36536,2022-12-05 10:40:00,1479.27,312930.9500000071,305387.6900000071,7543.260000000009
36537,2022-12-05 10:45:00,-266.01,312664.9400000071,305387.6900000071,7277.25
36538,2022-12-05 10:50:00,-1014.48,311650.4600000071,305387.6900000071,6262.770000000019
36539,2022-12-05 10:55:00,-1570.05,310080.41000000713,305387.6900000071,4692.72000000003
36540,2022-12-05 11:00:00,285.64,310366.05000000715,305387.6900000071,4978.360000000044
36541,2022-12-05 11:05:00,492.88,310858.93000000715,305387.6900000071,5471.240000000049
36542,2022-12-05 11:10:00,-1688.0,309170.93000000715,305387.6900000071,3783.240000000049
36543,2022-12-05 11:15:00,-1490.2,307680.73000000714,305387.6900000071,2293.0400000000373
36544,2022-12-05 11:20:00,484.67,308165.4000000071,305387.6900000071,2777.710000000021
36545,2022-12-05 11:25:00,-401.81,307763.5900000071,305387.6900000071,2375.9000000000233
36546,2022-12-05 11:30:00,1616.88,309380.47000000713,305387.6900000071,3992.780000000028
36547,2022-12-05 11:35:00,-184.54,309195.93000000715,305387.6900000071,3808.240000000049
36548,2022-12-05 11:40:00,327.31,309523.24000000715,305387.6900000071,4135.550000000047
36549,2022-12-05 11:45:00,-525.4,308997.8400000071,305387.6900000071,3610.1500000000233
36550,2022-12-05 11:50:00,759.06,309756.9000000071,305387.6900000071,4369.210000000021
36551,2022-12-05 11:55:00,336.89,310093.79000000714,305387.6900000071,4706.100000000035
36552,2022-12-05 12:00:00,1645.06,311738.85000000714,305387.6900000071,6351.160000000033
36553,2022-12-05 12:05:00,860.7,312599.55000000715,305387.6900000071,7211.860000000044
36554,2022-12-05 12:10:00,-898.09,311701.4600000071,305387.6900000071,6313.770000000019
36555,2022-12-05 12:15:00,4.01,311705.47000000713,305387.6900000071,6317.780000000028
36556,2022-12-05 12:20:00,-1674.02,310031.4500000071,305387.6900000071,4643.760000000009
36557,2022-12-05 12:25:00,678.35,310709.8000000071,305387.6900000071,5322.109999999986
36558,2022-12-05 12:30:00,-847.45,309862.3500000071,305387.6900000071,4474.659999999974
36559,2022-12-05 12:35:00,836.7,310699.0500000071,305387.6900000071,5311.359999999986
36560,2022-12-05 12:40:00,-362.18,310336.8700000071,305387.6900000071,4949.179999999993
36561,2022-12-05 12:45:00,-656.02,309680.8500000071,305387.6900000071,4293.159999999974
36562,2022-12-05 12:50:00,-1467.4,308213.45000000705,305387.6900000071,2825.759999999951
36563,2022-12-05 12:55:00,867.77,309081.2200000071,305387.6900000071,3693.5299999999697
36564,2022-12-05 13:00:00,1022.15,310103.3700000071,305387.6900000071,4715.679999999993
36565,2022-12-05 13:05:00,-1009.77,309093.6000000071,305387.6900000071,3705.9099999999744
36566,2022-12-05 13:10:00,1643.68,310737.2800000071,305387.6900000071,5349.589999999967
36567,2022-12-05 13:15:00,-611.86,310125.4200000071,305387.6900000071,4737.729999999981
36568,2022-12-05 13:20:00,-434.89,309690.5300000071,305387.6900000071,4302.839999999967
36569,2022-12-05 13:25:00,-1251.62,308438.9100000071,305387.6900000071,3051.219999999972
36570,2022-12-05 13:30:00,-26.53,308412.38000000705,305387.6900000071,3024.689999999944
36571,2022-12-05 13:35:00,573.82,308986.20000000705,305387.6900000071,3598.509999999951
36572,2022-12-05 13:40:00,-1949.96,307036.24000000703,305387.6900000071,1648.5499999999302
36573,2022-12-05 13:45:00,963.04,307999.280000007,305387.6900000071,2611.589999999909
36574,2022-12-05 13:50:00,-408.17,307591.11000000703,305387.6900000071,2203.4199999999255
36575,2022-12-05 13:55:00,1445.13,309036.24000000703,305387.6900000071,3648.54999999993
36576,2022-12-05 14:00:00,-1768.41,307267.83000000706,305387.6900000071,1880.1399999999558
36577,2022-12-05 14:05:00,455.78,307723.6100000071,305387.6900000071,2335.9199999999837
36578,2022-12-05 14:10:00,880.81,308604.4200000071,305387.6900000071,3216.7299999999814
36579,2022-12-05 14:15:00,-1792.16,306812.2600000071,305387.6900000071,1424.570000000007
36580,2022-12-05 14:20:00,-1044.43,305767.8300000071,305387.6900000071,380.14000000001397
36581,2022-12-05 14:25:00,1980.94,307748.7700000071,305387.6900000071,2361.0800000000163
36582,2022-12-05 14:30:00,-1653.05,306095.72000000713,305387.6900000071,708.0300000000279
36583,2022-12-05 14:35:00,-1111.2,304984.5200000071,305387.6900000071,-403.1699999999837
36584,2022-12-05 14:40:00,510.6,305495.1200000071,305387.6900000071,107.42999999999302
36585,2022-12-05 14:45:00,-1726.49,303768.6300000071,305387.6900000071,-1619.0599999999977
36586,2022-12-05 14:50:00,-1390.35,302378.28000000713,305387.6900000071,-3009.4099999999744
36587,2022-12-05 14:55:00,1650.59,304028.87000000715,305387.6900000071,-1358.8199999999488
36588,2022-12-05 15:00:00,505.34,304534.2100000072,305387.6900000071,-853.4799999999232
36589,2022-12-05 15:05:00,-1727.61,302806.6000000072,305387.6900000071,-2581.089999999909
36590,2022-12-05 15:10:00,1504.1,304310.7000000072,305387.6900000071,-1076.9899999999325
36591,2022-12-05 15:15:00,-1560.71,302749.99000000715,305387.6900000071,-2637.6999999999534
36592,2022-12-05 15:20:00,178.2,302928.19000000716,305387.6900000071,-2459.499999999942
36593,2022-12-05 15:25:00,-323.02,302605.17000000714,305387.6900000071,-2782.5199999999604
36594,2022-12-05 15:30:00,589.52,303194.69000000716,305387.6900000071,-2192.999999999942
36595,2022-12-05 15:35:00,-1528.18,301666.51000000717,305387.6900000071,-3721.179999999935
36596,2022-12-05 15:40:00,1109.96,302776.4700000072,305387.6900000071,-2611.219999999914
36597,2022-12-05 15:45:00,-61.81,302714.6600000072,305387.6900000071,-2673.0299999999115
36598,2022-12-05 15:50:00,782.93,303497.5900000072,305387.6900000071,-1890.0999999999185
36599,2022-12-05 15:55:00,-529.52,302968.07000000717,305387.6900000071,-2419.619999999937
36600,2022-12-05 16:00:00,-598.3,302369.7700000072,305387.6900000071,-3017.9199999999255
36601,2022-12-05 16:05:00,132.51,302502.2800000072,305387.6900000071,-2885.409999999916
36602,2022-12-05 16:10:00,1053.31,303555.5900000072,305387.6900000071,-1832.0999999999185
36603,2022-12-05 16:15:00,1917.83,305473.4200000072,305387.6900000071,85.73000000009779
36604,2022-12-05 16:20:00,68.87,305542.2900000072,305387.6900000071,154.60000000009313
36605,2022-12-05 16:25:00,-1762.15,303780.1400000072,305387.6900000071,-1607.5499999999302
36606,2022-12-05 16:30:00,1284.84,305064.9800000072,305387.6900000071,-322.70999999990454
36607,2022-12-05 16:35:00,613.18,305678.1600000072,305387.6900000071,290.4700000000885
36608,2022-12-05 16:40:00,-1280.94,304397.2200000072,305387.6900000071,-990.4699999999139
36609,2022-12-05 16:45:00,351.1,304748.32000000717,305387.6900000071,-639.3699999999371
36610,2022-12-05 16:50:00,-474.39,304273.93000000715,305387.6900000071,-1113.759999999951
36611,2022-12-05 16:55:00,-418.01,303855.92000000714,305387.6900000071,-1531.7699999999604
36612,2022-12-06 08:00:00,1604.79,305460.7100000071,303855.92000000714,1604.789999999979
36613,2022-12-06 08:05:00,297.38,305758.0900000071,303855.92000000714,1902.1699999999837
36614,2022-12-06 08:10:00,-1220.67,304537.42000000714,303855.92000000714,681.5
36615,2022-12-06 08:15:00,-790.09,303747.3300000071,303855.92000000714,-108.59000000002561
36616,2022-12-06 08:20:00,462.93,304210.2600000071,303855.92000000714,354.3399999999674
36617,2022-12-06 08:25:00,-1418.31,302791.9500000071,303855.92000000714,-1063.9700000000303
36618,2022-12-06 08:30:00,-853.93,301938.0200000071,303855.92000000714,-1917.9000000000233
36619,2022-12-06 08:35:00,732.66,302670.6800000071,303855.92000000714,-1185.240000000049
36620,2022-12-06 08:40:00,-1520.89,301149.7900000071,303855.92000000714,-2706.130000000063
36621,2022-12-06 08:45:00,1193.99,302343.7800000071,303855.92000000714,-1512.1400000000722
36622,2022-12-06 08:50:00,1860.0,304203.7800000071,303855.92000000714,347.8599999999278
36623,2022-12-06 08:55:00,717.4,304921.1800000071,303855.92000000714,1065.259999999951
36624,2022-12-06 09:00:00,-99.89,304821.2900000071,303855.92000000714,965.3699999999371
36625,2022-12-06 09:05:00,1164.77,305986.0600000071,303855.92000000714,2130.1399999999558
36626,2022-12-06 09:10:00,219.13,306205.1900000071,303855.92000000714,2349.2699999999604
36627,2022-12-06 09:15:00,1409.27,307614.4600000071,303855.92000000714,3758.539999999979
36628,2022-12-06 09:20:00,1273.48,308887.9400000071,303855.92000000714,5032.01999999996
36629,2022-12-06 09:25:00,-695.17,308192.7700000071,303855.92000000714,4336.849999999977
36630,2022-12-06 09:30:00,-136.42,308056.35000000714,303855.92000000714,4200.429999999993
36631,2022-12-06 09:35:00,1585.32,309641.67000000714,303855.92000000714,5785.75
36632,2022-12-06 09:40:00,1672.45,311314.12000000715,303855.92000000714,7458.200000000012
36633,2022-12-06 09:45:00,1448.11,312762.23000000714,303855.92000000714,8906.309999999998
36634,2022-12-06 09:50:00,-779.37,311982.86000000715,303855.92000000714,8126.940000000002
36635,2022-12-06 09:55:00,-1160.65,310822.2100000071,303855.92000000714,6966.289999999979
36636,2022-12-06 10:00:00,-415.16,310407.05000000715,303855.92000000714,6551.130000000005
36637,2022-12-06 10:05:00,502.74,310909.79000000714,303855.92000000714,7053.869999999995
36638,2022-12-06 10:10:00,-1039.42,309870.37000000715,303855.92000000714,6014.450000000012
36639,2022-12-06 10:15:00,-680.83,309189.54000000714,303855.92000000714,5333.619999999995
36640,2022-12-06 10:20:00,1043.8,310233.3400000071,303855.92000000714,6377.419999999984
36641,2022-12-06 10:25:00,-1306.69,308926.6500000071,303855.92000000714,5070.729999999981
36642,2022-12-06 10:30:00,608.89,309535.54000000714,303855.92000000714,5679.619999999995
36643,2022-12-06 10:35:00,-1223.26,308312.28000000713,303855.92000000714,4456.359999999986
36644,2022-12-06 10:40:00,-630.18,307682.10000000714,303855.92000000714,3826.179999999993
36645,2022-12-06 10:45:00,730.75,308412.85000000714,303855.92000000714,4556.929999999993
36646,2022-12-06 10:50:00,159.0,308571.85000000714,303855.92000000714,4715.929999999993
36647,2022-12-06 10:55:00,-322.48,308249.37000000715,303855.92000000714,4393.450000000012
36648,2022-12-06 11:00:00,1321.99,309571.36000000715,303855.92000000714,5715.440000000002
36649,2022-12-06 11:05:00,676.3,310247.66000000713,303855.92000000714,6391.739999999991
36650,2022-12-06 11:10:00,-1360.33,308887.3300000071,303855.92000000714,5031.409999999974
36651,2022-12-06 11:15:00,-227.82,308659.5100000071,303855.92000000714,4803.589999999967
36652,2022-12-06 11:20:00,-1899.49,306760.0200000071,303855.92000000714,2904.0999999999767
36653,2022-12-06 11:25:00,-1243.5,305516.5200000071,303855.92000000714,1660.5999999999767
36654,2022-12-06 11:30:00,1059.14,306575.66000000713,303855.92000000714,2719.7399999999907
36655,2022-12-06 11:35:00,-1615.01,304960.6500000071,303855.92000000714,1104.7299999999814
36656,2022-12-06 11:40:00,-647.61,304313.04000000714,303855.92000000714,457.11999999999534
36657,2022-12-06 11:45:00,-787.88,303525.16000000713,303855.92000000714,-330.7600000000093
36658,2022-12-06 11:50:00,1735.65,305260.81000000716,303855.92000000714,1404.890000000014
36659,2022-12-06 11:55:00,1703.13,306963.94000000716,303855.92000000714,3108.0200000000186
36660,2022-12-06 12:00:00,611.87,307575.81000000716,303855.92000000714,3719.890000000014
36661,2022-12-06 12:05:00,-1883.6,305692.2100000072,303855.92000000714,1836.2900000000373
36662,2022-12-06 12:10:00,10.91,305703.12000000715,303855.92000000714,1847.2000000000116
36663,2022-12-06 12:15:00,1289.67,306992.79000000714,303855.92000000714,3136.8699999999953
36664,2022-12-06 12:20:00,-704.89,306287.9000000071,303855.92000000714,2431.9799999999814
36665,2022-12-06 12:25:00,-1266.09,305021.8100000071,303855.92000000714,1165.8899999999558
36666,2022-12-06 12:30:00,1229.09,306250.9000000071,303855.92000000714,2394.9799999999814
36667,2022-12-06 12:35:00,-17.23,306233.67000000714,303855.92000000714,2377.75
36668,2022-12-06 12:40:00,-1446.01,304787.66000000713,303855.92000000714,931.7399999999907
36669,2022-12-06 12:45:00,-530.23,304257.43000000715,303855.92000000714,401.5100000000093
36670,2022-12-06 12:50:00,-1072.09,303185.3400000071,303855.92000000714,-670.5800000000163
36671,2022-12-06 12:55:00,1319.83,304505.17000000714,303855.92000000714,649.25
36672,2022-12-06 13:00:00,1187.53,305692.7000000072,303855.92000000714,1836.780000000028
36673,2022-12-06 13:05:00,694.67,306387.37000000715,303855.92000000714,2531.4500000000116
36674,2022-12-06 13:10:00,-652.74,305734.63000000716,303855.92000000714,1878.710000000021
36675,2022-12-06 13:15:00,-335.46,305399.17000000714,303855.92000000714,1543.25
36676,2022-12-06 13:20:00,1979.63,307378.80000000715,303855.92000000714,3522.8800000000047
36677,2022-12-06 13:25:00,-1338.23,306040.57000000717,303855.92000000714,2184.6500000000233
36678,2022-12-06 13:30:00,741.55,306782.12000000715,303855.92000000714,2926.2000000000116
36679,2022-12-06 13:35:00,-1160.26,305621.86000000715,303855.92000000714,1765.9400000000023
36680,2022-12-06 13:40:00,1569.46,307191.32000000717,303855.92000000714,3335.4000000000233
36681,2022-12-06 13:45:00,1825.72,309017.04000000714,303855.92000000714,5161.119999999995
36682,2022-12-06 13:50:00,895.64,309912.68000000715,303855.92000000714,6056.760000000009
36683,2022-12-06 13:55:00,-511.09,309401.5900000071,303855.92000000714,5545.669999999984
36684,2022-12-06 14:00:00,1320.04,310721.6300000071,303855.92000000714,6865.709999999963
36685,2022-12-06 14:05:00,928.07,311649.7000000071,303855.92000000714,7793.77999999997
36686,2022-12-06 14:10:00,-1656.76,309992.9400000071,303855.92000000714,6137.01999999996
36687,2022-12-06 14:15:00,1037.61,311030.5500000071,303855.92000000714,7174.629999999946
36688,2022-12-06 14:20:00,192.94,311223.4900000071,303855.92000000714,7367.569999999949
36689,2022-12-06 14:25:00,-1704.53,309518.96000000706,303855.92000000714,5663.039999999921
36690,2022-12-06 14:30:00,-1420.43,308098.5300000071,303855.92000000714,4242.609999999928
36691,2022-12-06 14:35:00,765.21,308863.7400000071,303855.92000000714,5007.819999999949
36692,2022-12-06 14:40:00,-1078.12,307785.6200000071,303855.92000000714,3929.6999999999534
36693,2022-12-06 14:45:00,-1724.37,306061.2500000071,303855.92000000714,2205.329999999958
36694,2022-12-06 14:50:00,-146.82,305914.4300000071,303855.92000000714,2058.509999999951
36695,2022-12-06 14:55:00,327.31,306241.7400000071,303855.92000000714,2385.819999999949
36696,2022-12-06 15:00:00,989.58,307231.3200000071,303855.92000000714,3375.399999999965
36697,2022-12-06 15:05:00,-295.83,306935.4900000071,303855.92000000714,3079.569999999949
36698,2022-12-06 15:10:00,1525.44,308460.9300000071,303855.92000000714,4605.009999999951
36699,2022-12-06 15:15:00,1221.13,309682.0600000071,303855.92000000714,5826.139999999956
36700,2022-12-06 15:20:00,1231.7,310913.7600000071,303855.92000000714,7057.839999999967
36701,2022-12-06 15:25:00,1458.44,312372.2000000071,303855.92000000714,8516.27999999997
36702,2022-12-06 15:30:00,1565.32,313937.5200000071,303855.92000000714,10081.599999999977
36703,2022-12-06 15:35:00,-168.28,313769.2400000071,303855.92000000714,9913.319999999949
36704,2022-12-06 15:40:00,-1675.08,312094.1600000071,303855.92000000714,8238.239999999932
36705,2022-12-06 15:45:00,-1636.56,310457.6000000071,303855.92000000714,6601.679999999935
36706,2022-12-06 15:50:00,143.72,310601.32000000705,303855.92000000714,6745.399999999907
36707,2022-12-06 15:55:00,1934.37,312535.69000000705,303855.92000000714,8679.769999999902
36708,2022-12-06 16:00:00,-704.62,311831.07000000705,303855.92000000714,7975.149999999907
36709,2022-12-06 16:05:00,-366.13,311464.94000000705,303855.92000000714,7609.019999999902
36710,2022-12-06 16:10:00,1754.78,313219.7200000071,303855.92000000714,9363.79999999993
36711,2022-12-06 16:15:00,1580.07,314799.7900000071,303855.92000000714,10943.869999999937
36712,2022-12-06 16:20:00,444.52,315244.3100000071,303855.92000000714,11388.389999999956
36713,2022-12-06 16:25:00,1749.32,316993.6300000071,303855.92000000714,13137.709999999963
36714,2022-12-06 16:30:00,-1720.27,315273.3600000071,303855.92000000714,11417.439999999944
36715,2022-12-06 16:35:00,-1622.27,313651.09000000707,303855.92000000714,9795.169999999925
36716,2022-12-06 16:40:00,-223.72,313427.3700000071,303855.92000000714,9571.449999999953
36717,2022-12-06 16:45:00,884.76,314312.1300000071,303855.92000000714,10456.209999999963
36718,2022-12-06 16:50:00,-498.05,313814.0800000071,303855.92000000714,9958.159999999974
36719,2022-12-06 16:55:00,-1619.21,312194.8700000071,303855.92000000714,8338.949999999953
36720,2022-12-07 08:00:00,183.01,312377.8800000071,312194.8700000071,183.0100000000093
36721,2022-12-07 08:05:00,-712.15,311665.7300000071,312194.8700000071,-529.140000000014
36722,2022-12-07 08:10:00,571.66,312237.39000000706,312194.8700000071,42.51999999996042
36723,2022-12-07 08:15:00,-1138.48,311098.9100000071,312194.8700000071,-1095.960000000021
36724,2022-12-07 08:20:00,-1359.31,309739.6000000071,312194.8700000071,-2455.2700000000186
36725,2022-12-07 08:25:00,-1329.16,308410.4400000071,312194.8700000071,-3784.429999999993
36726,2022-12-07 08:30:00,124.0,308534.4400000071,312194.8700000071,-3660.429999999993
36727,2022-12-07 08:35:00,1871.22,310405.6600000071,312194.8700000071,-1789.210000000021
36728,2022-12-07 08:40:00,1782.87,312188.5300000071,312194.8700000071,-6.340000000025611
36729,2022-12-07 08:45:00,1992.4,314180.9300000071,312194.8700000071,1986.0599999999977
36730,2022-12-07 08:50:00,-1416.22,312764.7100000071,312194.8700000071,569.8400000000256
36731,2022-12-07 08:55:00,-1176.72,311587.99000000715,312194.8700000071,-606.8799999999464
36732,2022-12-07 09:00:00,-1009.95,310578.04000000714,312194.8700000071,-1616.829999999958
36733,2022-12-07 09:05:00,-1665.96,308912.0800000071,312194.8700000071,-3282.789999999979
36734,2022-12-07 09:10:00,-868.64,308043.4400000071,312194.8700000071,-4151.429999999993
36735,2022-12-07 09:15:00,495.27,308538.7100000071,312194.8700000071,-3656.1599999999744
36736,2022-12-07 09:20:00,403.6,308942.3100000071,312194.8700000071,-3252.5599999999977
36737,2022-12-07 09:25:00,85.6,309027.9100000071,312194.8700000071,-3166.960000000021
36738,2022-12-07 09:30:00,1365.54,310393.45000000705,312194.8700000071,-1801.420000000042
36739,2022-12-07 09:35:00,-1617.29,308776.1600000071,312194.8700000071,-3418.710000000021
36740,2022-12-07 09:40:00,-1326.66,307449.5000000071,312194.8700000071,-4745.369999999995
36741,2022-12-07 09:45:00,1664.41,309113.9100000071,312194.8700000071,-3080.960000000021
36742,2022-12-07 09:50:00,910.22,310024.13000000705,312194.8700000071,-2170.740000000049
36743,2022-12-07 09:55:00,-1892.19,308131.94000000705,312194.8700000071,-4062.930000000051
36744,2022-12-07 10:00:00,1721.59,309853.5300000071,312194.8700000071,-2341.3400000000256
36745,2022-12-07 10:05:00,-796.07,309057.46000000706,312194.8700000071,-3137.4100000000326
36746,2022-12-07 10:10:00,-1421.67,307635.7900000071,312194.8700000071,-4559.080000000016
36747,2022-12-07 10:15:00,-1065.22,306570.5700000071,312194.8700000071,-5624.299999999988
36748,2022-12-07 10:20:00,-1544.03,305026.5400000071,312194.8700000071,-7168.330000000016
36749,2022-12-07 10:25:00,472.8,305499.34000000707,312194.8700000071,-6695.530000000028
36750,2022-12-07 10:30:00,-64.84,305434.50000000704,312194.8700000071,-6760.370000000054
36751,2022-12-07 10:35:00,-1084.69,304349.81000000704,312194.8700000071,-7845.060000000056
36752,2022-12-07 10:40:00,517.5,304867.31000000704,312194.8700000071,-7327.560000000056
36753,2022-12-07 10:45:00,690.31,305557.62000000704,312194.8700000071,-6637.250000000058
36754,2022-12-07 10:50:00,-1617.07,303940.55000000703,312194.8700000071,-8254.320000000065
36755,2022-12-07 10:55:00,965.09,304905.64000000706,312194.8700000071,-7289.23000000004
36756,2022-12-07 11:00:00,-404.32,304501.32000000705,312194.8700000071,-7693.550000000047
36757,2022-12-07 11:05:00,-738.76,303762.56000000704,312194.8700000071,-8432.310000000056
36758,2022-12-07 11:10:00,1580.37,305342.93000000704,312194.8700000071,-6851.9400000000605
36759,2022-12-07 11:15:00,-95.96,305246.970000007,312194.8700000071,-6947.9000000000815
36760,2022-12-07 11:20:00,950.67,306197.640000007,312194.8700000071,-5997.230000000098
36761,2022-12-07 11:25:00,965.98,307163.620000007,312194.8700000071,-5031.250000000116
36762,2022-12-07 11:30:00,-171.05,306992.570000007,312194.8700000071,-5202.300000000105
36763,2022-12-07 11:35:00,-920.07,306072.500000007,312194.8700000071,-6122.370000000112
36764,2022-12-07 11:40:00,-1034.56,305037.940000007,312194.8700000071,-7156.930000000109
36765,2022-12-07 11:45:00,-734.15,304303.79000000696,312194.8700000071,-7891.080000000133
36766,2022-12-07 11:50:00,-1286.41,303017.380000007,312194.8700000071,-9177.490000000107
36767,2022-12-07 11:55:00,-81.81,302935.570000007,312194.8700000071,-9259.300000000105
36768,2022-12-07 12:00:00,-1327.38,301608.190000007,312194.8700000071,-10586.68000000011
36769,2022-12-07 12:05:00,214.24,301822.430000007,312194.8700000071,-10372.440000000119
36770,2022-12-07 12:10:00,1436.2,303258.630000007,312194.8700000071,-8936.240000000107
36771,2022-12-07 12:15:00,301.21,303559.840000007,312194.8700000071,-8635.030000000086
36772,2022-12-07 12:20:00,181.47,303741.310000007,312194.8700000071,-8453.560000000114
36773,2022-12-07 12:25:00,355.94,304097.250000007,312194.8700000071,-8097.620000000112
36774,2022-12-07 12:30:00,1118.4,305215.650000007,312194.8700000071,-6979.2200000000885
36775,2022-12-07 12:35:00,1201.96,306417.61000000703,312194.8700000071,-5777.2600000000675
36776,2022-12-07 12:40:00,-539.99,305877.62000000704,312194.8700000071,-6317.250000000058
36777,2022-12-07 12:45:00,-1827.18,304050.44000000705,312194.8700000071,-8144.430000000051
36778,2022-12-07 12:50:00,-1458.04,302592.40000000707,312194.8700000071,-9602.47000000003
36779,2022-12-07 12:55:00,1363.81,303956.21000000706,312194.8700000071,-8238.660000000033
36780,2022-12-07 13:00:00,-1733.47,302222.7400000071,312194.8700000071,-9972.130000000005
36781,2022-12-07 13:05:00,629.73,302852.4700000071,312194.8700000071,-9342.400000000023
36782,2022-12-07 13:10:00,1859.01,304711.4800000071,312194.8700000071,-7483.390000000014
36783,2022-12-07 13:15:00,984.05,305695.5300000071,312194.8700000071,-6499.340000000026
36784,2022-12-07 13:20:00,-1220.5,304475.0300000071,312194.8700000071,-7719.840000000026
36785,2022-12-07 13:25:00,1050.77,305525.8000000071,312194.8700000071,-6669.070000000007
36786,2022-12-07 13:30:00,363.89,305889.6900000071,312194.8700000071,-6305.179999999993
36787,2022-12-07 13:35:00,36.07,305925.7600000071,312194.8700000071,-6269.109999999986
36788,2022-12-07 13:40:00,-472.25,305453.5100000071,312194.8700000071,-6741.359999999986
36789,2022-12-07 13:45:00,832.55,306286.0600000071,312194.8700000071,-5908.809999999998
36790,2022-12-07 13:50:00,-1162.85,305123.2100000071,312194.8700000071,-7071.659999999974
36791,2022-12-07 13:55:00,820.35,305943.5600000071,312194.8700000071,-6251.309999999998
36792,2022-12-07 14:00:00,-1970.79,303972.7700000071,312194.8700000071,-8222.099999999977
36793,2022-12-07 14:05:00,174.44,304147.2100000071,312194.8700000071,-8047.659999999974
36794,2022-12-07 14:10:00,1533.7,305680.91000000713,312194.8700000071,-6513.959999999963
36795,2022-12-07 14:15:00,583.56,306264.47000000713,312194.8700000071,-5930.399999999965
36796,2022-12-07 14:20:00,-1323.13,304941.3400000071,312194.8700000071,-7253.52999999997
36797,2022-12-07 14:25:00,1096.49,306037.8300000071,312194.8700000071,-6157.039999999979
36798,2022-12-07 14:30:00,-1087.88,304949.9500000071,312194.8700000071,-7244.919999999984
36799,2022-12-07 14:35:00,444.09,305394.04000000714,312194.8700000071,-6800.829999999958
36800,2022-12-07 14:40:00,1725.49,307119.53000000713,312194.8700000071,-5075.339999999967
36801,2022-12-07 14:45:00,-386.02,306733.5100000071,312194.8700000071,-5461.359999999986
36802,2022-12-07 14:50:00,1705.98,308439.4900000071,312194.8700000071,-3755.3800000000047
36803,2022-12-07 14:55:00,-1281.15,307158.34000000707,312194.8700000071,-5036.530000000028
36804,2022-12-07 15:00:00,-1209.23,305949.1100000071,312194.8700000071,-6245.760000000009
36805,2022-12-07 15:05:00,814.78,306763.8900000071,312194.8700000071,-5430.979999999981
36806,2022-12-07 15:10:00,-1580.13,305183.7600000071,312194.8700000071,-7011.109999999986
36807,2022-12-07 15:15:00,1311.01,306494.7700000071,312194.8700000071,-5700.099999999977
36808,2022-12-07 15:20:00,-455.54,306039.23000000714,312194.8700000071,-6155.639999999956
36809,2022-12-07 15:25:00,-662.66,305376.57000000717,312194.8700000071,-6818.29999999993
36810,2022-12-07 15:30:00,-424.67,304951.9000000072,312194.8700000071,-7242.969999999914
36811,2022-12-07 15:35:00,1607.4,306559.3000000072,312194.8700000071,-5635.569999999891
36812,2022-12-07 15:40:00,-498.18,306061.1200000072,312194.8700000071,-6133.749999999884
36813,2022-12-07 15:45:00,1860.08,307921.20000000723,312194.8700000071,-4273.669999999867
36814,2022-12-07 15:50:00,1576.28,309497.48000000726,312194.8700000071,-2697.3899999998393
36815,2022-12-07 15:55:00,1526.98,311024.46000000724,312194.8700000071,-1170.409999999858
36816,2022-12-07 16:00:00,679.28,311703.74000000727,312194.8700000071,-491.12999999983003
36817,2022-12-07 16:05:00,-155.34,311548.40000000724,312194.8700000071,-646.4699999998556
36818,2022-12-07 16:10:00,-1004.0,310544.40000000724,312194.8700000071,-1650.4699999998556
36819,2022-12-07 16:15:00,-1599.56,308944.84000000724,312194.8700000071,-3250.0299999998533
36820,2022-12-07 16:20:00,-301.64,308643.20000000723,312194.8700000071,-3551.6699999998673
36821,2022-12-07 16:25:00,1587.83,310231.03000000725,312194.8700000071,-1963.839999999851
36822,2022-12-07 16:30:00,1858.16,312089.1900000072,312194.8700000071,-105.6799999998766
36823,2022-12-07 16:35:00,-981.5,311107.6900000072,312194.8700000071,-1087.1799999998766
36824,2022-12-07 16:40:00,1443.52,312551.21000000724,312194.8700000071,356.340000000142
36825,2022-12-07 16:45:00,-1200.52,311350.6900000072,312194.8700000071,-844.1799999998766
36826,2022-12-07 16:50:00,-1182.57,310168.1200000072,312194.8700000071,-2026.7499999998836
36827,2022-12-07 16:55:00,-1609.32,308558.8000000072,312194.8700000071,-3636.0699999998906
36828,2022-12-08 08:00:00,-1616.33,306942.4700000072,308558.8000000072,-1616.3300000000163
36829,2022-12-08 08:05:00,910.16,307852.63000000716,308558.8000000072,-706.1700000000419
36830,2022-12-08 08:10:00,718.43,308571.06000000716,308558.8000000072,12.259999999951106
36831,2022-12-08 08:15:00,1300.86,309871.92000000714,308558.8000000072,1313.1199999999371
36832,2022-12-08 08:20:00,1377.27,311249.19000000716,308558.8000000072,2690.3899999999558
36833,2022-12-08 08:25:00,966.65,312215.8400000072,308558.8000000072,3657.039999999979
36834,2022-12-08 08:30:00,-699.08,311516.76000000717,308558.8000000072,2957.9599999999627
36835,2022-12-08 08:35:00,-885.99,310630.7700000072,308558.8000000072,2071.969999999972
36836,2022-12-08 08:40:00,-414.9,310215.87000000715,308558.8000000072,1657.0699999999488
36837,2022-12-08 08:45:00,286.25,310502.12000000715,308558.8000000072,1943.3199999999488
36838,2022-12-08 08:50:00,1954.97,312457.0900000071,308558.8000000072,3898.289999999921
36839,2022-12-08 08:55:00,719.65,313176.74000000715,308558.8000000072,4617.939999999944
36840,2022-12-08 09:00:00,1989.38,315166.12000000715,308558.8000000072,6607.319999999949
36841,2022-12-08 09:05:00,1137.47,316303.5900000071,308558.8000000072,7744.789999999921
36842,2022-12-08 09:10:00,1312.11,317615.7000000071,308558.8000000072,9056.899999999907
36843,2022-12-08 09:15:00,427.57,318043.2700000071,308558.8000000072,9484.469999999914
36844,2022-12-08 09:20:00,1898.45,319941.72000000713,308558.8000000072,11382.919999999925
36845,2022-12-08 09:25:00,-1857.14,318084.5800000071,308558.8000000072,9525.779999999912
36846,2022-12-08 09:30:00,1984.17,320068.7500000071,308558.8000000072,11509.949999999895
36847,2022-12-08 09:35:00,238.05,320306.8000000071,308558.8000000072,11747.999999999884
36848,2022-12-08 09:40:00,1121.67,321428.4700000071,308558.8000000072,12869.669999999867
36849,2022-12-08 09:45:00,-1061.39,320367.08000000706,308558.8000000072,11808.279999999853
36850,2022-12-08 09:50:00,303.23,320670.31000000704,308558.8000000072,12111.509999999835
36851,2022-12-08 09:55:00,1385.31,322055.62000000704,308558.8000000072,13496.819999999832
36852,2022-12-08 10:00:00,1992.72,324048.340000007,308558.8000000072,15489.539999999804
36853,2022-12-08 10:05:00,-1397.3,322651.040000007,308558.8000000072,14092.239999999816
36854,2022-12-08 10:10:00,-582.48,322068.56000000704,308558.8000000072,13509.759999999835
36855,2022-12-08 10:15:00,-754.78,321313.780000007,308558.8000000072,12754.979999999807
36856,2022-12-08 10:20:00,-1053.98,320259.80000000703,308558.8000000072,11700.999999999825
36857,2022-12-08 10:25:00,632.92,320892.720000007,308558.8000000072,12333.919999999809
36858,2022-12-08 10:30:00,-1547.87,319344.850000007,308558.8000000072,10786.049999999814
36859,2022-12-08 10:35:00,1514.73,320859.580000007,308558.8000000072,12300.779999999795
36860,2022-12-08 10:40:00,-1592.24,319267.340000007,308558.8000000072,10708.539999999804
36861,2022-12-08 10:45:00,1876.68,321144.020000007,308558.8000000072,12585.219999999797
36862,2022-12-08 10:50:00,1401.01,322545.030000007,308558.8000000072,13986.229999999807
36863,2022-12-08 10:55:00,-1364.14,321180.890000007,308558.8000000072,12622.089999999793
36864,2022-12-08 11:00:00,615.65,321796.540000007,308558.8000000072,13237.739999999816
36865,2022-12-08 11:05:00,-132.98,321663.56000000704,308558.8000000072,13104.759999999835
36866,2022-12-08 11:10:00,-513.71,321149.850000007,308558.8000000072,12591.049999999814
36867,2022-12-08 11:15:00,-1083.65,320066.200000007,308558.8000000072,11507.39999999979
36868,2022-12-08 11:20:00,1197.58,321263.780000007,308558.8000000072,12704.979999999807
36869,2022-12-08 11:25:00,-1960.36,319303.420000007,308558.8000000072,10744.61999999982
36870,2022-12-08 11:30:00,-749.01,318554.410000007,308558.8000000072,9995.609999999811
36871,2022-12-08 11:35:00,-658.87,317895.540000007,308558.8000000072,9336.739999999816
36872,2022-12-08 11:40:00,1371.41,319266.950000007,308558.8000000072,10708.14999999979
36873,2022-12-08 11:45:00,-1180.0,318086.950000007,308558.8000000072,9528.14999999979
36874,2022-12-08 11:50:00,1764.49,319851.440000007,308558.8000000072,11292.639999999781
36875,2022-12-08 11:55:00,279.42,320130.860000007,308558.8000000072,11572.059999999765
36876,2022-12-08 12:00:00,-803.56,319327.300000007,308558.8000000072,10768.499999999767
36877,2022-12-08 12:05:00,-274.04,319053.260000007,308558.8000000072,10494.459999999788
36878,2022-12-08 12:10:00,-31.47,319021.790000007,308558.8000000072,10462.989999999816
36879,2022-12-08 12:15:00,1866.4,320888.19000000705,308558.8000000072,12329.38999999984
36880,2022-12-08 12:20:00,-1978.55,318909.64000000706,308558.8000000072,10350.839999999851
36881,2022-12-08 12:25:00,-1754.66,317154.9800000071,308558.8000000072,8596.179999999877
36882,2022-12-08 12:30:00,793.39,317948.3700000071,308558.8000000072,9389.56999999989
36883,2022-12-08 12:35:00,-489.61,317458.7600000071,308558.8000000072,8899.959999999905
36884,2022-12-08 12:40:00,929.47,318388.2300000071,308558.8000000072,9829.429999999877
36885,2022-12-08 12:45:00,748.0,319136.2300000071,308558.8000000072,10577.429999999877
36886,2022-12-08 12:50:00,-877.64,318258.59000000707,308558.8000000072,9699.789999999863
36887,2022-12-08 12:55:00,-1040.79,317217.8000000071,308558.8000000072,8658.999999999884
36888,2022-12-08 13:00:00,-1587.42,315630.3800000071,308558.8000000072,7071.5799999999
36889,2022-12-08 13:05:00,212.54,315842.9200000071,308558.8000000072,7284.119999999879
36890,2022-12-08 13:10:00,1344.8,317187.7200000071,308558.8000000072,8628.919999999867
36891,2022-12-08 13:15:00,-1098.31,316089.4100000071,308558.8000000072,7530.60999999987
36892,2022-12-08 13:20:00,-1174.01,314915.40000000707,308558.8000000072,6356.59999999986
36893,2022-12-08 13:25:00,563.74,315479.14000000706,308558.8000000072,6920.339999999851
36894,2022-12-08 13:30:00,-1775.76,313703.38000000705,308558.8000000072,5144.579999999842
36895,2022-12-08 13:35:00,-1333.83,312369.55000000703,308558.8000000072,3810.7499999998254
36896,2022-12-08 13:40:00,1734.04,314103.590000007,308558.8000000072,5544.789999999804
36897,2022-12-08 13:45:00,1784.07,315887.660000007,308558.8000000072,7328.859999999811
36898,2022-12-08 13:50:00,-757.71,315129.950000007,308558.8000000072,6571.14999999979
36899,2022-12-08 13:55:00,-1966.09,313163.860000007,308558.8000000072,4605.059999999765
36900,2022-12-08 14:00:00,-1651.81,311512.050000007,308558.8000000072,2953.249999999767
36901,2022-12-08 14:05:00,1250.85,312762.90000000695,308558.8000000072,4204.099999999744
36902,2022-12-08 14:10:00,-1192.3,311570.60000000696,308558.8000000072,3011.7999999997555
36903,2022-12-08 14:15:00,30.65,311601.250000007,308558.8000000072,3042.449999999779
36904,2022-12-08 14:20:00,-1818.61,309782.640000007,308558.8000000072,1223.8399999997928
36905,2022-12-08 14:25:00,681.7,310464.340000007,308558.8000000072,1905.5399999998044
36906,2022-12-08 14:30:00,1282.79,311747.130000007,308558.8000000072,3188.3299999997835
36907,2022-12-08 14:35:00,-1096.82,310650.310000007,308558.8000000072,2091.5099999997765
36908,2022-12-08 14:40:00,-91.6,310558.710000007,308558.8000000072,1999.9099999997998
36909,2022-12-08 14:45:00,566.71,311125.420000007,308558.8000000072,2566.6199999998207
36910,2022-12-08 14:50:00,520.65,311646.07000000705,308558.8000000072,3087.269999999844
36911,2022-12-08 14:55:00,95.61,311741.68000000704,308558.8000000072,3182.87999999983
36912,2022-12-08 15:00:00,-42.06,311699.62000000704,308558.8000000072,3140.8199999998324
36913,2022-12-08 15:05:00,-1668.19,310031.43000000704,308558.8000000072,1472.62999999983
36914,2022-12-08 15:10:00,31.37,310062.80000000703,308558.8000000072,1503.9999999998254
36915,2022-12-08 15:15:00,127.97,310190.770000007,308558.8000000072,1631.9699999997974
36916,2022-12-08 15:20:00,1051.82,311242.590000007,308558.8000000072,2683.7899999998044
36917,2022-12-08 15:25:00,-1194.12,310048.470000007,308558.8000000072,1489.669999999809
36918,2022-12-08 15:30:00,-1001.96,309046.510000007,308558.8000000072,487.7099999997881
36919,2022-12-08 15:35:00,-1548.33,307498.180000007,308558.8000000072,-1060.6200000002282
36920,2022-12-08 15:40:00,-1290.52,306207.66000000696,308558.8000000072,-2351.140000000247
36921,2022-12-08 15:45:00,-804.25,305403.41000000696,308558.8000000072,-3155.390000000247
36922,2022-12-08 15:50:00,-687.69,304715.72000000696,308558.8000000072,-3843.080000000249
36923,2022-12-08 15:55:00,-708.49,304007.23000000697,308558.8000000072,-4551.57000000024
36924,2022-12-08 16:00:00,-1816.53,302190.70000000694,308558.8000000072,-6368.100000000268
36925,2022-12-08 16:05:00,1545.37,303736.07000000693,308558.8000000072,-4822.730000000272
36926,2022-12-08 16:10:00,1094.02,304830.09000000695,308558.8000000072,-3728.710000000254
36927,2022-12-08 16:15:00,1388.96,306219.050000007,308558.8000000072,-2339.750000000233
36928,2022-12-08 16:20:00,146.98,306366.03000000695,308558.8000000072,-2192.7700000002515
36929,2022-12-08 16:25:00,-256.81,306109.22000000696,308558.8000000072,-2449.580000000249
36930,2022-12-08 16:30:00,1848.35,307957.57000000693,308558.8000000072,-601.2300000002724
36931,2022-12-08 16:35:00,575.79,308533.3600000069,308558.8000000072,-25.440000000293367
36932,2022-12-08 16:40:00,-1254.32,307279.0400000069,308558.8000000072,-1279.7600000003004
36933,2022-12-08 16:45:00,511.82,307790.8600000069,308558.8000000072,-767.9400000002934
36934,2022-12-08 16:50:00,-683.79,307107.07000000693,308558.8000000072,-1451.7300000002724
36935,2022-12-08 16:55:00,1292.12,308399.1900000069,308558.8000000072,-159.61000000027707
36936,2022-12-09 08:00:00,-481.35,307917.84000000695,308399.1900000069,-481.3499999999767
36937,2022-12-09 08:05:00,1849.74,309767.58000000694,308399.1900000069,1368.390000000014
36938,2022-12-09 08:10:00,-1810.65,307956.9300000069,308399.1900000069,-442.2600000000093
36939,2022-12-09 08:15:00,600.17,308557.1000000069,308399.1900000069,157.9099999999744
36940,2022-12-09 08:20:00,-709.54,307847.5600000069,308399.1900000069,-551.6300000000047
36941,2022-12-09 08:25:00,1420.11,309267.6700000069,308399.1900000069,868.4799999999814
36942,2022-12-09 08:30:00,-1648.65,307619.0200000069,308399.1900000069,-780.1700000000419
36943,2022-12-09 08:35:00,-843.68,306775.3400000069,308399.1900000069,-1623.850000000035
36944,2022-12-09 08:40:00,799.24,307574.5800000069,308399.1900000069,-824.6100000000442
36945,2022-12-09 08:45:00,84.67,307659.25000000687,308399.1900000069,-739.9400000000605
36946,2022-12-09 08:50:00,-1892.82,305766.43000000686,308399.1900000069,-2632.7600000000675
36947,2022-12-09 08:55:00,-1216.99,304549.44000000687,308399.1900000069,-3849.750000000058
36948,2022-12-09 09:00:00,1874.76,306424.2000000069,308399.1900000069,-1974.990000000049
36949,2022-12-09 09:05:00,209.1,306633.30000000686,308399.1900000069,-1765.8900000000722
36950,2022-12-09 09:10:00,1933.76,308567.06000000687,308399.1900000069,167.86999999993714
36951,2022-12-09 09:15:00,-568.36,307998.7000000069,308399.1900000069,-400.4900000000489
36952,2022-12-09 09:20:00,-1718.92,306279.7800000069,308399.1900000069,-2119.4100000000326
36953,2022-12-09 09:25:00,-685.2,305594.5800000069,308399.1900000069,-2804.6100000000442
36954,2022-12-09 09:30:00,-290.75,305303.8300000069,308399.1900000069,-3095.3600000000442
36955,2022-12-09 09:35:00,509.06,305812.8900000069,308399.1900000069,-2586.3000000000466
36956,2022-12-09 09:40:00,390.94,306203.8300000069,308399.1900000069,-2195.3600000000442
36957,2022-12-09 09:45:00,-1771.88,304431.9500000069,308399.1900000069,-3967.240000000049
36958,2022-12-09 09:50:00,-1582.61,302849.3400000069,308399.1900000069,-5549.850000000035
36959,2022-12-09 09:55:00,93.55,302942.8900000069,308399.1900000069,-5456.300000000047
36960,2022-12-09 10:00:00,594.73,303537.62000000686,308399.1900000069,-4861.570000000065
36961,2022-12-09 10:05:00,406.58,303944.2000000069,308399.1900000069,-4454.990000000049
36962,2022-12-09 10:10:00,-719.35,303224.8500000069,308399.1900000069,-5174.340000000026
36963,2022-12-09 10:15:00,303.17,303528.0200000069,308399.1900000069,-4871.170000000042
36964,2022-12-09 10:20:00,1728.75,305256.7700000069,308399.1900000069,-3142.420000000042
36965,2022-12-09 10:25:00,-585.87,304670.9000000069,308399.1900000069,-3728.2900000000373
36966,2022-12-09 10:30:00,702.75,305373.6500000069,308399.1900000069,-3025.5400000000373
36967,2022-12-09 10:35:00,-1625.42,303748.2300000069,308399.1900000069,-4650.960000000021
36968,2022-12-09 10:40:00,-315.19,303433.0400000069,308399.1900000069,-4966.150000000023
36969,2022-12-09 10:45:00,-90.88,303342.1600000069,308399.1900000069,-5057.030000000028
36970,2022-12-09 10:50:00,-888.49,302453.6700000069,308399.1900000069,-5945.520000000019
36971,2022-12-09 10:55:00,-658.06,301795.6100000069,308399.1900000069,-6603.580000000016
36972,2022-12-09 11:00:00,181.38,301976.9900000069,308399.1900000069,-6422.200000000012
36973,2022-12-09 11:05:00,-398.19,301578.8000000069,308399.1900000069,-6820.390000000014
36974,2022-12-09 11:10:00,1396.07,302974.8700000069,308399.1900000069,-5424.320000000007
36975,2022-12-09 11:15:00,-238.13,302736.7400000069,308399.1900000069,-5662.450000000012
36976,2022-12-09 11:20:00,-714.76,302021.9800000069,308399.1900000069,-6377.210000000021
36977,2022-12-09 11:25:00,258.69,302280.6700000069,308399.1900000069,-6118.520000000019
36978,2022-12-09 11:30:00,1123.09,303403.76000000694,308399.1900000069,-4995.429999999993
36979,2022-12-09 11:35:00,-1262.91,302140.85000000696,308399.1900000069,-6258.339999999967
36980,2022-12-09 11:40:00,-651.0,301489.85000000696,308399.1900000069,-6909.339999999967
36981,2022-12-09 11:45:00,1522.97,303012.82000000693,308399.1900000069,-5386.369999999995
36982,2022-12-09 11:50:00,-1482.94,301529.88000000693,308399.1900000069,-6869.309999999998
36983,2022-12-09 11:55:00,1651.86,303181.7400000069,308399.1900000069,-5217.450000000012
36984,2022-12-09 12:00:00,-878.55,302303.1900000069,308399.1900000069,-6096.0
36985,2022-12-09 12:05:00,-1735.7,300567.4900000069,308399.1900000069,-7831.700000000012
36986,2022-12-09 12:10:00,1808.84,302376.33000000694,308399.1900000069,-6022.859999999986
36987,2022-12-09 12:15:00,-881.47,301494.860000007,308399.1900000069,-6904.329999999958
36988,2022-12-09 12:20:00,1159.86,302654.72000000696,308399.1900000069,-5744.469999999972
36989,2022-12-09 12:25:00,-1338.31,301316.41000000696,308399.1900000069,-7082.77999999997
36990,2022-12-09 12:30:00,1512.23,302828.64000000694,308399.1900000069,-5570.549999999988
36991,2022-12-09 12:35:00,1334.41,304163.0500000069,308399.1900000069,-4236.140000000014
36992,2022-12-09 12:40:00,-1040.22,303122.83000000694,308399.1900000069,-5276.359999999986
36993,2022-12-09 12:45:00,270.21,303393.04000000696,308399.1900000069,-5006.149999999965
36994,2022-12-09 12:50:00,-1622.61,301770.430000007,308399.1900000069,-6628.759999999951
36995,2022-12-09 12:55:00,-673.24,301097.190000007,308399.1900000069,-7301.999999999942
36996,2022-12-09 13:00:00,-658.72,300438.470000007,308399.1900000069,-7960.719999999914
36997,2022-12-09 13:05:00,1581.84,302020.31000000704,308399.1900000069,-6378.879999999888
36998,2022-12-09 13:10:00,-1565.77,300454.540000007,308399.1900000069,-7944.649999999907
36999,2022-12-09 13:15:00,844.08,301298.62000000704,308399.1900000069,-7100.569999999891
37000,2022-12-09 13:20:00,-1400.73,299897.89000000706,308399.1900000069,-8501.299999999872
37001,2022-12-09 13:25:00,-405.93,299491.96000000706,308399.1900000069,-8907.229999999865
37002,2022-12-09 13:30:00,-764.67,298727.2900000071,308399.1900000069,-9671.899999999849
37003,2022-12-09 13:35:00,-749.1,297978.1900000071,308399.1900000069,-10420.999999999825
37004,2022-12-09 13:40:00,-15.13,297963.0600000071,308399.1900000069,-10436.12999999983
37005,2022-12-09 13:45:00,-1435.09,296527.9700000071,308399.1900000069,-11871.219999999856
37006,2022-12-09 13:50:00,-1835.05,294692.9200000071,308399.1900000069,-13706.269999999844
37007,2022-12-09 13:55:00,1842.08,296535.0000000071,308399.1900000069,-11864.189999999828
37008,2022-12-09 14:00:00,-1003.02,295531.9800000071,308399.1900000069,-12867.209999999846
37009,2022-12-09 14:05:00,770.51,296302.4900000071,308399.1900000069,-12096.699999999837
37010,2022-12-09 14:10:00,-866.13,295436.3600000071,308399.1900000069,-12962.829999999842
37011,2022-12-09 14:15:00,465.18,295901.5400000071,308399.1900000069,-12497.649999999849
37012,2022-12-09 14:20:00,1220.37,297121.9100000071,308399.1900000069,-11277.279999999853
37013,2022-12-09 14:25:00,-1344.62,295777.2900000071,308399.1900000069,-12621.899999999849
37014,2022-12-09 14:30:00,1226.25,297003.5400000071,308399.1900000069,-11395.649999999849
37015,2022-12-09 14:35:00,-1519.15,295484.39000000706,308399.1900000069,-12914.799999999872
37016,2022-12-09 14:40:00,438.36,295922.75000000704,308399.1900000069,-12476.439999999886
37017,2022-12-09 14:45:00,25.42,295948.170000007,308399.1900000069,-12451.019999999902
37018,2022-12-09 14:50:00,1827.17,297775.340000007,308399.1900000069,-10623.849999999919
37019,2022-12-09 14:55:00,-268.17,297507.170000007,308399.1900000069,-10892.019999999902
37020,2022-12-09 15:00:00,-1757.73,295749.44000000705,308399.1900000069,-12649.749999999884
37021,2022-12-09 15:05:00,674.98,296424.420000007,308399.1900000069,-11974.769999999902
37022,2022-12-09 15:10:00,922.39,297346.81000000704,308399.1900000069,-11052.379999999888
37023,2022-12-09 15:15:00,-1683.91,295662.90000000707,308399.1900000069,-12736.289999999863
37024,2022-12-09 15:20:00,245.45,295908.3500000071,308399.1900000069,-12490.839999999851
37025,2022-12-09 15:25:00,-496.4,295411.95000000705,308399.1900000069,-12987.239999999874
37026,2022-12-09 15:30:00,1258.38,296670.33000000706,308399.1900000069,-11728.85999999987
37027,2022-12-09 15:35:00,-942.75,295727.58000000706,308399.1900000069,-12671.60999999987
37028,2022-12-09 15:40:00,480.56,296208.14000000706,308399.1900000069,-12191.049999999872
37029,2022-12-09 15:45:00,-1115.47,295092.6700000071,308399.1900000069,-13306.519999999844
37030,2022-12-09 15:50:00,1361.57,296454.2400000071,308399.1900000069,-11944.949999999837
37031,2022-12-09 15:55:00,-265.29,296188.9500000071,308399.1900000069,-12210.239999999816
37032,2022-12-09 16:00:00,-286.68,295902.2700000071,308399.1900000069,-12496.919999999809
37033,2022-12-09 16:05:00,-1707.51,294194.7600000071,308399.1900000069,-14204.429999999818
37034,2022-12-09 16:10:00,-565.34,293629.4200000071,308399.1900000069,-14769.769999999844
37035,2022-12-09 16:15:00,-1796.33,291833.09000000707,308399.1900000069,-16566.09999999986
37036,2022-12-09 16:20:00,-1833.59,289999.50000000704,308399.1900000069,-18399.689999999886
37037,2022-12-09 16:25:00,460.84,290460.34000000707,308399.1900000069,-17938.84999999986
37038,2022-12-09 16:30:00,209.79,290670.13000000705,308399.1900000069,-17729.05999999988
37039,2022-12-09 16:35:00,-1404.97,289265.1600000071,308399.1900000069,-19134.029999999853
37040,2022-12-09 16:40:00,-439.33,288825.83000000706,308399.1900000069,-19573.35999999987
37041,2022-12-09 16:45:00,1919.04,290744.87000000704,308399.1900000069,-17654.31999999989
37042,2022-12-09 16:50:00,-1050.43,289694.44000000705,308399.1900000069,-18704.749999999884
37043,2022-12-09 16:55:00,1980.93,291675.37000000704,308399.1900000069,-16723.81999999989
37044,2022-12-10 08:00:00,-13.59,291661.780000007,291675.37000000704,-13.590000000025611
37045,2022-12-10 08:05:00,662.89,292324.670000007,291675.37000000704,649.2999999999884
37046,2022-12-10 08:10:00,1704.28,294028.95000000705,291675.37000000704,2353.5800000000163
37047,2022-12-10 08:15:00,-304.4,293724.55000000703,291675.37000000704,2049.179999999993
37048,2022-12-10 08:20:00,538.22,294262.770000007,291675.37000000704,2587.399999999965
37049,2022-12-10 08:25:00,1468.17,295730.940000007,291675.37000000704,4055.569999999949
37050,2022-12-10 08:30:00,1083.65,296814.590000007,291675.37000000704,5139.219999999972
37051,2022-12-10 08:35:00,1689.13,298503.720000007,291675.37000000704,6828.349999999977
37052,2022-12-10 08:40:00,1375.43,299879.150000007,291675.37000000704,8203.77999999997
37053,2022-12-10 08:45:00,1880.47,301759.620000007,291675.37000000704,10084.249999999942
37054,2022-12-10 08:50:00,-1814.7,299944.92000000697,291675.37000000704,8269.54999999993
37055,2022-12-10 08:55:00,-1229.47,298715.450000007,291675.37000000704,7040.079999999958
37056,2022-12-10 09:00:00,293.72,299009.17000000697,291675.37000000704,7333.79999999993
37057,2022-12-10 09:05:00,-597.25,298411.92000000697,291675.37000000704,6736.54999999993
37058,2022-12-10 09:10:00,-1426.4,296985.52000000695,291675.37000000704,5310.149999999907
37059,2022-12-10 09:15:00,-1704.49,295281.03000000695,291675.37000000704,3605.659999999916
37060,2022-12-10 09:20:00,455.0,295736.03000000695,291675.37000000704,4060.659999999916
37061,2022-12-10 09:25:00,-347.66,295388.370000007,291675.37000000704,3712.999999999942
37062,2022-12-10 09:30:00,942.17,296330.54000000696,291675.37000000704,4655.1699999999255
37063,2022-12-10 09:35:00,1673.78,298004.320000007,291675.37000000704,6328.949999999953
37064,2022-12-10 09:40:00,-979.94,297024.380000007,291675.37000000704,5349.009999999951
37065,2022-12-10 09:45:00,-1415.59,295608.79000000696,291675.37000000704,3933.4199999999255
37066,2022-12-10 09:50:00,779.31,296388.10000000696,291675.37000000704,4712.729999999923
37067,2022-12-10 09:55:00,-792.31,295595.79000000696,291675.37000000704,3920.4199999999255
37068,2022-12-10 10:00:00,266.02,295861.810000007,291675.37000000704,4186.439999999944
37069,2022-12-10 10:05:00,-1191.57,294670.240000007,291675.37000000704,2994.869999999937
37070,2022-12-10 10:10:00,630.37,295300.610000007,291675.37000000704,3625.2399999999325
37071,2022-12-10 10:15:00,-169.48,295131.130000007,291675.37000000704,3455.759999999951
37072,2022-12-10 10:20:00,-1684.75,293446.380000007,291675.37000000704,1771.009999999951
37073,2022-12-10 10:25:00,-1510.17,291936.210000007,291675.37000000704,260.8399999999674
37074,2022-12-10 10:30:00,360.0,292296.210000007,291675.37000000704,620.8399999999674
37075,2022-12-10 10:35:00,423.11,292719.320000007,291675.37000000704,1043.9499999999534
37076,2022-12-10 10:40:00,-1641.04,291078.280000007,291675.37000000704,-597.0900000000256
37077,2022-12-10 10:45:00,1096.94,292175.220000007,291675.37000000704,499.8499999999767
37078,2022-12-10 10:50:00,922.34,293097.56000000704,291675.37000000704,1422.1900000000023
37079,2022-12-10 10:55:00,-432.74,292664.82000000705,291675.37000000704,989.4500000000116
37080,2022-12-10 11:00:00,-904.91,291759.9100000071,291675.37000000704,84.54000000003725
37081,2022-12-10 11:05:00,608.68,292368.59000000707,291675.37000000704,693.2200000000303
37082,2022-12-10 11:10:00,1797.33,294165.9200000071,291675.37000000704,2490.5500000000466
37083,2022-12-10 11:15:00,128.11,294294.0300000071,291675.37000000704,2618.6600000000326
37084,2022-12-10 11:20:00,290.34,294584.3700000071,291675.37000000704,2909.000000000058
37085,2022-12-10 11:25:00,627.48,295211.8500000071,291675.37000000704,3536.4800000000396
37086,2022-12-10 11:30:00,-296.01,294915.84000000707,291675.37000000704,3240.4700000000303
37087,2022-12-10 11:35:00,-385.49,294530.3500000071,291675.37000000704,2854.9800000000396
37088,2022-12-10 11:40:00,1674.31,296204.6600000071,291675.37000000704,4529.290000000037
37089,2022-12-10 11:45:00,-1248.33,294956.33000000706,291675.37000000704,3280.960000000021
37090,2022-12-10 11:50:00,-627.52,294328.81000000704,291675.37000000704,2653.4400000000023
37091,2022-12-10 11:55:00,1673.75,296002.56000000704,291675.37000000704,4327.190000000002
37092,2022-12-10 12:00:00,1441.53,297444.09000000707,291675.37000000704,5768.72000000003
37093,2022-12-10 12:05:00,155.82,297599.9100000071,291675.37000000704,5924.540000000037
37094,2022-12-10 12:10:00,790.26,298390.1700000071,291675.37000000704,6714.800000000047
37095,2022-12-10 12:15:00,221.94,298612.1100000071,291675.37000000704,6936.740000000049
37096,2022-12-10 12:20:00,1560.04,300172.15000000707,291675.37000000704,8496.780000000028
37097,2022-12-10 12:25:00,1020.37,301192.52000000706,291675.37000000704,9517.150000000023
37098,2022-12-10 12:30:00,-1950.74,299241.7800000071,291675.37000000704,7566.410000000033
37099,2022-12-10 12:35:00,-1172.31,298069.4700000071,291675.37000000704,6394.100000000035
37100,2022-12-10 12:40:00,281.44,298350.9100000071,291675.37000000704,6675.540000000037
37101,2022-12-10 12:45:00,-745.69,297605.2200000071,291675.37000000704,5929.850000000035
37102,2022-12-10 12:50:00,1617.55,299222.77000000706,291675.37000000704,7547.400000000023
37103,2022-12-10 12:55:00,1947.95,301170.7200000071,291675.37000000704,9495.350000000035
37104,2022-12-10 13:00:00,1477.79,302648.51000000705,291675.37000000704,10973.140000000014
37105,2022-12-10 13:05:00,360.32,303008.83000000706,291675.37000000704,11333.460000000021
37106,2022-12-10 13:10:00,-96.06,302912.77000000706,291675.37000000704,11237.400000000023
37107,2022-12-10 13:15:00,1333.01,304245.7800000071,291675.37000000704,12570.410000000033
37108,2022-12-10 13:20:00,-871.57,303374.21000000706,291675.37000000704,11698.840000000026
37109,2022-12-10 13:25:00,-1828.13,301546.08000000706,291675.37000000704,9870.710000000021
37110,2022-12-10 13:30:00,1128.62,302674.70000000705,291675.37000000704,10999.330000000016
37111,2022-12-10 13:35:00,-1981.18,300693.52000000706,291675.37000000704,9018.150000000023
37112,2022-12-10 13:40:00,-4.56,300688.96000000706,291675.37000000704,9013.590000000026
37113,2022-12-10 13:45:00,-603.27,300085.69000000705,291675.37000000704,8410.320000000007
37114,2022-12-10 13:50:00,1614.74,301700.43000000704,291675.37000000704,10025.059999999998
37115,2022-12-10 13:55:00,-1423.06,300277.37000000704,291675.37000000704,8602.0
37116,2022-12-10 14:00:00,1961.39,302238.76000000705,291675.37000000704,10563.390000000014
37117,2022-12-10 14:05:00,1699.84,303938.6000000071,291675.37000000704,12263.23000000004
37118,2022-12-10 14:10:00,1041.93,304980.5300000071,291675.37000000704,13305.160000000033
37119,2022-12-10 14:15:00,-284.63,304695.90000000707,291675.37000000704,13020.530000000028
37120,2022-12-10 14:20:00,21.75,304717.65000000707,291675.37000000704,13042.280000000028
37121,2022-12-10 14:25:00,318.11,305035.76000000705,291675.37000000704,13360.390000000014
37122,2022-12-10 14:30:00,629.36,305665.12000000704,291675.37000000704,13989.75
37123,2022-12-10 14:35:00,-1580.7,304084.420000007,291675.37000000704,12409.049999999988
37124,2022-12-10 14:40:00,174.21,304258.63000000705,291675.37000000704,12583.26000000001
37125,2022-12-10 14:45:00,-1008.98,303249.65000000707,291675.37000000704,11574.280000000028
37126,2022-12-10 14:50:00,1183.0,304432.65000000707,291675.37000000704,12757.280000000028
37127,2022-12-10 14:55:00,1197.24,305629.89000000706,291675.37000000704,13954.520000000019
37128,2022-12-10 15:00:00,-888.62,304741.27000000706,291675.37000000704,13065.900000000023
37129,2022-12-10 15:05:00,-119.91,304621.3600000071,291675.37000000704,12945.990000000049
37130,2022-12-10 15:10:00,965.41,305586.77000000706,291675.37000000704,13911.400000000023
37131,2022-12-10 15:15:00,37.16,305623.93000000704,291675.37000000704,13948.559999999998
37132,2022-12-10 15:20:00,945.73,306569.660000007,291675.37000000704,14894.289999999979
37133,2022-12-10 15:25:00,-980.83,305588.830000007,291675.37000000704,13913.459999999963
37134,2022-12-10 15:30:00,-1521.84,304066.990000007,291675.37000000704,12391.619999999937
37135,2022-12-10 15:35:00,-1077.09,302989.90000000695,291675.37000000704,11314.529999999912
37136,2022-12-10 15:40:00,-1523.89,301466.01000000694,291675.37000000704,9790.639999999898
37137,2022-12-10 15:45:00,1815.52,303281.53000000695,291675.37000000704,11606.159999999916
37138,2022-12-10 15:50:00,65.53,303347.060000007,291675.37000000704,11671.689999999944
37139,2022-12-10 15:55:00,-149.51,303197.550000007,291675.37000000704,11522.179999999935
37140,2022-12-10 16:00:00,-917.36,302280.190000007,291675.37000000704,10604.819999999949
37141,2022-12-10 16:05:00,-294.23,301985.960000007,291675.37000000704,10310.589999999967
37142,2022-12-10 16:10:00,1411.55,303397.510000007,291675.37000000704,11722.139999999956
37143,2022-12-10 16:15:00,330.73,303728.240000007,291675.37000000704,12052.869999999937
37144,2022-12-10 16:20:00,-280.81,303447.430000007,291675.37000000704,11772.05999999994
37145,2022-12-10 16:25:00,-1890.46,301556.97000000696,291675.37000000704,9881.599999999919
37146,2022-12-10 16:30:00,139.35,301696.32000000693,291675.37000000704,10020.949999999895
37147,2022-12-10 16:35:00,-1349.6,300346.72000000696,291675.37000000704,8671.349999999919
37148,2022-12-10 16:40:00,1771.02,302117.740000007,291675.37000000704,10442.369999999937
37149,2022-12-10 16:45:00,455.09,302572.830000007,291675.37000000704,10897.459999999963
37150,2022-12-10 16:50:00,1111.3,303684.130000007,291675.37000000704,12008.759999999951
37151,2022-12-10 16:55:00,212.55,303896.680000007,291675.37000000704,12221.30999999994
37152,2022-12-11 08:00:00,781.59,304678.270000007,303896.680000007,781.5900000000256
37153,2022-12-11 08:05:00,-1093.5,303584.770000007,303896.680000007,-311.9099999999744
37154,2022-12-11 08:10:00,68.86,303653.630000007,303896.680000007,-243.04999999998836
37155,2022-12-11 08:15:00,-1410.9,302242.73000000697,303896.680000007,-1653.9500000000116
37156,2022-12-11 08:20:00,162.88,302405.610000007,303896.680000007,-1491.070000000007
37157,2022-12-11 08:25:00,-1593.95,300811.66000000696,303896.680000007,-3085.0200000000186
37158,2022-12-11 08:30:00,743.07,301554.73000000697,303896.680000007,-2341.9500000000116
37159,2022-12-11 08:35:00,283.05,301837.78000000695,303896.680000007,-2058.9000000000233
37160,2022-12-11 08:40:00,1010.64,302848.42000000697,303896.680000007,-1048.2600000000093
37161,2022-12-11 08:45:00,1584.51,304432.930000007,303896.680000007,536.25
37162,2022-12-11 08:50:00,-943.26,303489.67000000697,303896.680000007,-407.0100000000093
37163,2022-12-11 08:55:00,-1693.91,301795.760000007,303896.680000007,-2100.9199999999837
37164,2022-12-11 09:00:00,1184.53,302980.290000007,303896.680000007,-916.3899999999558
37165,2022-12-11 09:05:00,-242.2,302738.090000007,303896.680000007,-1158.5899999999674
37166,2022-12-11 09:10:00,-1768.09,300970.000000007,303896.680000007,-2926.679999999993
37167,2022-12-11 09:15:00,-1394.08,299575.92000000697,303896.680000007,-4320.760000000009
37168,2022-12-11 09:20:00,-1320.29,298255.630000007,303896.680000007,-5641.049999999988
37169,2022-12-11 09:25:00,483.76,298739.390000007,303896.680000007,-5157.289999999979
37170,2022-12-11 09:30:00,-750.68,297988.710000007,303896.680000007,-5907.969999999972
37171,2022-12-11 09:35:00,1449.62,299438.330000007,303896.680000007,-4458.349999999977
37172,2022-12-11 09:40:00,1758.96,301197.290000007,303896.680000007,-2699.3899999999558
37173,2022-12-11 09:45:00,-228.75,300968.540000007,303896.680000007,-2928.1399999999558
37174,2022-12-11 09:50:00,-1996.07,298972.470000007,303896.680000007,-4924.209999999963
37175,2022-12-11 09:55:00,-1612.37,297360.100000007,303896.680000007,-6536.579999999958
37176,2022-12-11 10:00:00,-689.87,296670.230000007,303896.680000007,-7226.449999999953
37177,2022-12-11 10:05:00,-557.5,296112.730000007,303896.680000007,-7783.949999999953
37178,2022-12-11 10:10:00,-1617.72,294495.01000000705,303896.680000007,-9401.669999999925
37179,2022-12-11 10:15:00,328.78,294823.7900000071,303896.680000007,-9072.889999999898
37180,2022-12-11 10:20:00,-1756.04,293067.7500000071,303896.680000007,-10828.929999999877
37181,2022-12-11 10:25:00,1372.15,294439.9000000071,303896.680000007,-9456.779999999853
37182,2022-12-11 10:30:00,-13.22,294426.68000000715,303896.680000007,-9469.999999999825
37183,2022-12-11 10:35:00,-470.94,293955.74000000715,303896.680000007,-9940.939999999828
37184,2022-12-11 10:40:00,-313.18,293642.56000000716,303896.680000007,-10254.11999999982
37185,2022-12-11 10:45:00,-688.72,292953.8400000072,303896.680000007,-10942.839999999793
37186,2022-12-11 10:50:00,-476.74,292477.1000000072,303896.680000007,-11419.579999999783
37187,2022-12-11 10:55:00,1083.46,293560.5600000072,303896.680000007,-10336.119999999763
37188,2022-12-11 11:00:00,-1804.88,291755.6800000072,303896.680000007,-12140.999999999767
37189,2022-12-11 11:05:00,1780.35,293536.0300000072,303896.680000007,-10360.64999999979
37190,2022-12-11 11:10:00,289.6,293825.63000000716,303896.680000007,-10071.049999999814
37191,2022-12-11 11:15:00,1324.04,295149.67000000714,303896.680000007,-8747.009999999835
37192,2022-12-11 11:20:00,-918.24,294231.43000000715,303896.680000007,-9665.249999999825
37193,2022-12-11 11:25:00,805.18,295036.61000000715,303896.680000007,-8860.069999999832
37194,2022-12-11 11:30:00,1068.5,296105.11000000715,303896.680000007,-7791.569999999832
37195,2022-12-11 11:35:00,1193.78,297298.8900000072,303896.680000007,-6597.789999999804
37196,2022-12-11 11:40:00,-1989.08,295309.81000000716,303896.680000007,-8586.86999999982
37197,2022-12-11 11:45:00,-1973.33,293336.48000000714,303896.680000007,-10560.199999999837
37198,2022-12-11 11:50:00,1842.4,295178.88000000716,303896.680000007,-8717.799999999814
37199,2022-12-11 11:55:00,-1232.43,293946.4500000072,303896.680000007,-9950.229999999807
37200,2022-12-11 12:00:00,-1715.63,292230.82000000717,303896.680000007,-11665.859999999811
37201,2022-12-11 12:05:00,1674.16,293904.98000000714,303896.680000007,-9991.699999999837
37202,2022-12-11 12:10:00,-1425.94,292479.04000000714,303896.680000007,-11417.63999999984
37203,2022-12-11 12:15:00,-1415.25,291063.79000000714,303896.680000007,-12832.88999999984
37204,2022-12-11 12:20:00,-1951.0,289112.79000000714,303896.680000007,-14783.88999999984
37205,2022-12-11 12:25:00,364.45,289477.24000000715,303896.680000007,-14419.439999999828
37206,2022-12-11 12:30:00,-883.45,288593.79000000714,303896.680000007,-15302.88999999984
37207,2022-12-11 12:35:00,178.28,288772.07000000717,303896.680000007,-15124.609999999811
37208,2022-12-11 12:40:00,-254.29,288517.7800000072,303896.680000007,-15378.89999999979
37209,2022-12-11 12:45:00,-1440.79,287076.9900000072,303896.680000007,-16819.68999999977
37210,2022-12-11 12:50:00,-1169.9,285907.0900000072,303896.680000007,-17989.589999999793
37211,2022-12-11 12:55:00,1346.4,287253.4900000072,303896.680000007,-16643.18999999977
37212,2022-12-11 13:00:00,564.51,287818.0000000072,303896.680000007,-16078.67999999976
37213,2022-12-11 13:05:00,306.34,288124.34000000724,303896.680000007,-15772.339999999735
37214,2022-12-11 13:10:00,-1160.1,286964.24000000727,303896.680000007,-16932.43999999971
37215,2022-12-11 13:15:00,366.82,287331.0600000073,303896.680000007,-16565.619999999704
37216,2022-12-11 13:20:00,-1712.84,285618.22000000725,303896.680000007,-18278.45999999973
37217,2022-12-11 13:25:00,1586.98,287205.20000000723,303896.680000007,-16691.47999999975
37218,2022-12-11 13:30:00,-1028.09,286177.1100000072,303896.680000007,-17719.569999999774
37219,2022-12-11 13:35:00,749.49,286926.6000000072,303896.680000007,-16970.079999999783
37220,2022-12-11 13:40:00,-690.87,286235.7300000072,303896.680000007,-17660.94999999978
37221,2022-12-11 13:45:00,-1855.99,284379.7400000072,303896.680000007,-19516.93999999977
37222,2022-12-11 13:50:00,771.86,285151.6000000072,303896.680000007,-18745.079999999783
37223,2022-12-11 13:55:00,-1607.06,283544.5400000072,303896.680000007,-20352.13999999978
37224,2022-12-11 14:00:00,-1463.2,282081.3400000072,303896.680000007,-21815.339999999793
37225,2022-12-11 14:05:00,-597.28,281484.06000000716,303896.680000007,-22412.61999999982
37226,2022-12-11 14:10:00,-61.65,281422.41000000713,303896.680000007,-22474.269999999844
37227,2022-12-11 14:15:00,-284.0,281138.41000000713,303896.680000007,-22758.269999999844
37228,2022-12-11 14:20:00,-1324.85,279813.56000000716,303896.680000007,-24083.11999999982
37229,2022-12-11 14:25:00,-412.54,279401.0200000072,303896.680000007,-24495.6599999998
37230,2022-12-11 14:30:00,1225.99,280627.01000000717,303896.680000007,-23269.66999999981
37231,2022-12-11 14:35:00,852.97,281479.98000000714,303896.680000007,-22416.699999999837
37232,2022-12-11 14:40:00,-1242.06,280237.92000000714,303896.680000007,-23658.759999999835
37233,2022-12-11 14:45:00,-1904.14,278333.78000000713,303896.680000007,-25562.89999999985
37234,2022-12-11 14:50:00,1457.14,279790.92000000714,303896.680000007,-24105.759999999835
37235,2022-12-11 14:55:00,1669.11,281460.03000000713,303896.680000007,-22436.64999999985
37236,2022-12-11 15:00:00,588.91,282048.9400000071,303896.680000007,-21847.739999999874
37237,2022-12-11 15:05:00,-1932.06,280116.8800000071,303896.680000007,-23779.799999999872
37238,2022-12-11 15:10:00,486.58,280603.4600000071,303896.680000007,-23293.219999999856
37239,2022-12-11 15:15:00,1135.42,281738.8800000071,303896.680000007,-22157.799999999872
37240,2022-12-11 15:20:00,1592.82,283331.7000000071,303896.680000007,-20564.979999999865
37241,2022-12-11 15:25:00,-979.02,282352.6800000071,303896.680000007,-21543.999999999884
37242,2022-12-11 15:30:00,-705.74,281646.9400000071,303896.680000007,-22249.739999999874
37243,2022-12-11 15:35:00,404.57,282051.5100000071,303896.680000007,-21845.169999999867
37244,2022-12-11 15:40:00,-149.99,281901.5200000071,303896.680000007,-21995.159999999858
37245,2022-12-11 15:45:00,303.95,282205.47000000713,303896.680000007,-21691.209999999846
37246,2022-12-11 15:50:00,-1367.82,280837.6500000071,303896.680000007,-23059.029999999853
37247,2022-12-11 15:55:00,-1820.16,279017.49000000715,303896.680000007,-24879.189999999828
37248,2022-12-11 16:00:00,-1398.1,277619.3900000072,303896.680000007,-26277.289999999804
37249,2022-12-11 16:05:00,700.4,278319.7900000072,303896.680000007,-25576.88999999978
37250,2022-12-11 16:10:00,1064.51,279384.3000000072,303896.680000007,-24512.379999999772
37251,2022-12-11 16:15:00,-552.25,278832.0500000072,303896.680000007,-25064.629999999772
37252,2022-12-11 16:20:00,1686.1,280518.1500000072,303896.680000007,-23378.529999999795
37253,2022-12-11 16:25:00,1067.65,281585.8000000072,303896.680000007,-22310.879999999772
37254,2022-12-11 16:30:00,-1395.73,280190.0700000072,303896.680000007,-23706.609999999753
37255,2022-12-11 16:35:00,1622.71,281812.78000000725,303896.680000007,-22083.899999999732
37256,2022-12-11 16:40:00,720.04,282532.8200000072,303896.680000007,-21363.859999999753
37257,2022-12-11 16:45:00,895.8,283428.6200000072,303896.680000007,-20468.059999999765
37258,2022-12-11 16:50:00,1628.69,285057.3100000072,303896.680000007,-18839.369999999763
37259,2022-12-11 16:55:00,-154.07,284903.2400000072,303896.680000007,-18993.43999999977
37260,2022-12-12 08:00:00,1487.66,286390.9000000072,284903.2400000072,1487.6599999999744
37261,2022-12-12 08:05:00,358.92,286749.82000000717,284903.2400000072,1846.579999999958
37262,2022-12-12 08:10:00,697.14,287446.9600000072,284903.2400000072,2543.719999999972
37263,2022-12-12 08:15:00,-582.93,286864.0300000072,284903.2400000072,1960.789999999979
37264,2022-12-12 08:20:00,443.81,287307.8400000072,284903.2400000072,2404.5999999999767
37265,2022-12-12 08:25:00,-437.17,286870.6700000072,284903.2400000072,1967.429999999993
37266,2022-12-12 08:30:00,-424.41,286446.2600000072,284903.2400000072,1543.0200000000186
37267,2022-12-12 08:35:00,1919.67,288365.9300000072,284903.2400000072,3462.6900000000023
37268,2022-12-12 08:40:00,1849.69,290215.6200000072,284903.2400000072,5312.380000000005
37269,2022-12-12 08:45:00,-1142.92,289072.70000000723,284903.2400000072,4169.460000000021
37270,2022-12-12 08:50:00,1581.72,290654.4200000072,284903.2400000072,5751.179999999993
37271,2022-12-12 08:55:00,-49.32,290605.1000000072,284903.2400000072,5701.859999999986
37272,2022-12-12 09:00:00,1748.1,292353.2000000072,284903.2400000072,7449.959999999963
37273,2022-12-12 09:05:00,-1802.17,290551.0300000072,284903.2400000072,5647.789999999979
37274,2022-12-12 09:10:00,-245.49,290305.5400000072,284903.2400000072,5402.299999999988
37275,2022-12-12 09:15:00,-1964.87,288340.6700000072,284903.2400000072,3437.429999999993
37276,2022-12-12 09:20:00,803.15,289143.8200000072,284903.2400000072,4240.580000000016
37277,2022-12-12 09:25:00,-1749.8,287394.02000000724,284903.2400000072,2490.780000000028
37278,2022-12-12 09:30:00,283.78,287677.80000000726,284903.2400000072,2774.560000000056
37279,2022-12-12 09:35:00,-585.43,287092.3700000073,284903.2400000072,2189.130000000063
37280,2022-12-12 09:40:00,-81.79,287010.5800000073,284903.2400000072,2107.340000000084
37281,2022-12-12 09:45:00,-1728.76,285281.8200000073,284903.2400000072,378.5800000000745
37282,2022-12-12 09:50:00,-1450.83,283830.99000000727,284903.2400000072,-1072.2499999999418
37283,2022-12-12 09:55:00,-348.34,283482.65000000724,284903.2400000072,-1420.5899999999674
37284,2022-12-12 10:00:00,1670.62,285153.27000000724,284903.2400000072,250.03000000002794
37285,2022-12-12 10:05:00,1782.56,286935.83000000723,284903.2400000072,2032.5900000000256
37286,2022-12-12 10:10:00,-1361.55,285574.28000000725,284903.2400000072,671.0400000000373
37287,2022-12-12 10:15:00,1834.71,287408.99000000727,284903.2400000072,2505.750000000058
37288,2022-12-12 10:20:00,-108.61,287300.3800000073,284903.2400000072,2397.140000000072
37289,2022-12-12 10:25:00,-1832.24,285468.1400000073,284903.2400000072,564.9000000000815
37290,2022-12-12 10:30:00,317.85,285785.99000000727,284903.2400000072,882.7500000000582
37291,2022-12-12 10:35:00,-1220.48,284565.5100000073,284903.2400000072,-337.72999999992317
37292,2022-12-12 10:40:00,1444.44,286009.9500000073,284903.2400000072,1106.7100000000792
37293,2022-12-12 10:45:00,331.97,286341.92000000726,284903.2400000072,1438.6800000000512
37294,2022-12-12 10:50:00,464.85,286806.77000000724,284903.2400000072,1903.530000000028
37295,2022-12-12 10:55:00,-1581.1,285225.67000000726,284903.2400000072,322.4300000000512
37296,2022-12-12 11:00:00,-1218.17,284007.5000000073,284903.2400000072,-895.7399999999325
37297,2022-12-12 11:05:00,-367.13,283640.3700000073,284903.2400000072,-1262.8699999999371
37298,2022-12-12 11:10:00,-168.32,283472.05000000726,284903.2400000072,-1431.1899999999441
37299,2022-12-12 11:15:00,304.68,283776.73000000726,284903.2400000072,-1126.509999999951
37300,2022-12-12 11:20:00,-183.62,283593.11000000726,284903.2400000072,-1310.1299999999464
37301,2022-12-12 11:25:00,-524.33,283068.78000000725,284903.2400000072,-1834.4599999999627
37302,2022-12-12 11:30:00,1602.22,284671.0000000072,284903.2400000072,-232.2399999999907
37303,2022-12-12 11:35:00,1463.2,286134.20000000723,284903.2400000072,1230.960000000021
37304,2022-12-12 11:40:00,-768.64,285365.5600000072,284903.2400000072,462.320000000007
37305,2022-12-12 11:45:00,-1483.17,283882.39000000723,284903.2400000072,-1020.8499999999767
37306,2022-12-12 11:50:00,-1025.37,282857.02000000724,284903.2400000072,-2046.219999999972
37307,2022-12-12 11:55:00,-1775.88,281081.14000000723,284903.2400000072,-3822.0999999999767
37308,2022-12-12 12:00:00,-1387.01,279694.1300000072,284903.2400000072,-5209.109999999986
37309,2022-12-12 12:05:00,1629.66,281323.7900000072,284903.2400000072,-3579.4500000000116
37310,2022-12-12 12:10:00,988.4,282312.1900000072,284903.2400000072,-2591.0499999999884
37311,2022-12-12 12:15:00,-1665.36,280646.83000000723,284903.2400000072,-4256.409999999974
37312,2022-12-12 12:20:00,-1577.9,279068.9300000072,284903.2400000072,-5834.309999999998
37313,2022-12-12 12:25:00,562.79,279631.7200000072,284903.2400000072,-5271.520000000019
37314,2022-12-12 12:30:00,1571.66,281203.38000000716,284903.2400000072,-3699.8600000000442
37315,2022-12-12 12:35:00,28.06,281231.44000000716,284903.2400000072,-3671.8000000000466
37316,2022-12-12 12:40:00,-825.62,280405.82000000717,284903.2400000072,-4497.420000000042
37317,2022-12-12 12:45:00,-1460.19,278945.63000000716,284903.2400000072,-5957.610000000044
37318,2022-12-12 12:50:00,1687.88,280633.51000000717,284903.2400000072,-4269.73000000004
37319,2022-12-12 12:55:00,-439.27,280194.24000000715,284903.2400000072,-4709.000000000058
37320,2022-12-12 13:00:00,1309.73,281503.97000000713,284903.2400000072,-3399.270000000077
37321,2022-12-12 13:05:00,-1178.22,280325.75000000716,284903.2400000072,-4577.490000000049
37322,2022-12-12 13:10:00,-1813.8,278511.9500000072,284903.2400000072,-6391.290000000037
37323,2022-12-12 13:15:00,494.97,279006.92000000714,284903.2400000072,-5896.320000000065
37324,2022-12-12 13:20:00,-649.83,278357.0900000071,284903.2400000072,-6546.1500000000815
37325,2022-12-12 13:25:00,1464.2,279821.29000000714,284903.2400000072,-5081.95000000007
37326,2022-12-12 13:30:00,-1967.65,277853.6400000071,284903.2400000072,-7049.600000000093
37327,2022-12-12 13:35:00,-239.46,277614.1800000071,284903.2400000072,-7289.060000000114
37328,2022-12-12 13:40:00,-1937.38,275676.8000000071,284903.2400000072,-9226.440000000119
37329,2022-12-12 13:45:00,-1987.43,273689.3700000071,284903.2400000072,-11213.870000000112
37330,2022-12-12 13:50:00,-102.6,273586.7700000071,284903.2400000072,-11316.470000000088
37331,2022-12-12 13:55:00,1186.84,274773.61000000715,284903.2400000072,-10129.630000000063
37332,2022-12-12 14:00:00,-1547.61,273226.00000000716,284903.2400000072,-11677.240000000049
37333,2022-12-12 14:05:00,-1226.38,271999.62000000715,284903.2400000072,-12903.620000000054
37334,2022-12-12 14:10:00,1078.77,273078.3900000072,284903.2400000072,-11824.850000000035
37335,2022-12-12 14:15:00,-1132.31,271946.0800000072,284903.2400000072,-12957.160000000033
37336,2022-12-12 14:20:00,845.8,272791.88000000716,284903.2400000072,-12111.360000000044
37337,2022-12-12 14:25:00,1438.57,274230.4500000072,284903.2400000072,-10672.790000000037
37338,2022-12-12 14:30:00,-1481.6,272748.8500000072,284903.2400000072,-12154.390000000014
37339,2022-12-12 14:35:00,-730.37,272018.4800000072,284903.2400000072,-12884.76000000001
37340,2022-12-12 14:40:00,629.27,272647.7500000072,284903.2400000072,-12255.48999999999
37341,2022-12-12 14:45:00,1304.05,273951.8000000072,284903.2400000072,-10951.440000000002
37342,2022-12-12 14:50:00,-894.22,273057.58000000723,284903.2400000072,-11845.659999999974
37343,2022-12-12 14:55:00,370.31,273427.89000000723,284903.2400000072,-11475.349999999977
37344,2022-12-12 15:00:00,1038.85,274466.7400000072,284903.2400000072,-10436.5
37345,2022-12-12 15:05:00,1392.58,275859.3200000072,284903.2400000072,-9043.919999999984
37346,2022-12-12 15:10:00,-1764.17,274095.15000000724,284903.2400000072,-10808.089999999967
37347,2022-12-12 15:15:00,-1252.22,272842.93000000727,284903.2400000072,-12060.30999999994
37348,2022-12-12 15:20:00,755.84,273598.7700000073,284903.2400000072,-11304.469999999914
37349,2022-12-12 15:25:00,-1975.5,271623.2700000073,284903.2400000072,-13279.969999999914
37350,2022-12-12 15:30:00,-1545.89,270077.3800000073,284903.2400000072,-14825.859999999928
37351,2022-12-12 15:35:00,-1390.91,268686.4700000073,284903.2400000072,-16216.769999999902
37352,2022-12-12 15:40:00,1881.98,270568.4500000073,284903.2400000072,-14334.78999999992
37353,2022-12-12 15:45:00,-1187.88,269380.5700000073,284903.2400000072,-15522.669999999925
37354,2022-12-12 15:50:00,1618.2,270998.7700000073,284903.2400000072,-13904.469999999914
37355,2022-12-12 15:55:00,1822.44,272821.2100000073,284903.2400000072,-12082.029999999912
37356,2022-12-12 16:00:00,1702.21,274523.4200000073,284903.2400000072,-10379.81999999989
37357,2022-12-12 16:05:00,1655.89,276179.31000000733,284903.2400000072,-8723.929999999877
37358,2022-12-12 16:10:00,1536.13,277715.44000000734,284903.2400000072,-7187.799999999872
37359,2022-12-12 16:15:00,-392.26,277323.1800000073,284903.2400000072,-7580.059999999881
37360,2022-12-12 16:20:00,-622.13,276701.0500000073,284903.2400000072,-8202.189999999886
37361,2022-12-12 16:25:00,628.28,277329.33000000735,284903.2400000072,-7573.909999999858
37362,2022-12-12 16:30:00,328.14,277657.47000000736,284903.2400000072,-7245.769999999844
37363,2022-12-12 16:35:00,-1715.14,275942.33000000735,284903.2400000072,-8960.909999999858
37364,2022-12-12 16:40:00,-1869.47,274072.8600000074,284903.2400000072,-10830.37999999983
37365,2022-12-12 16:45:00,-1795.47,272277.3900000074,284903.2400000072,-12625.849999999802
37366,2022-12-12 16:50:00,203.22,272480.6100000074,284903.2400000072,-12422.62999999983
37367,2022-12-12 16:55:00,-1794.83,270685.78000000736,284903.2400000072,-14217.459999999846
37368,2022-12-13 08:00:00,495.47,271181.25000000733,270685.78000000736,495.46999999997206
37369,2022-12-13 08:05:00,-1800.0,269381.25000000733,270685.78000000736,-1304.530000000028
37370,2022-12-13 08:10:00,1733.26,271114.51000000734,270685.78000000736,428.7299999999814
37371,2022-12-13 08:15:00,-1399.39,269715.12000000733,270685.78000000736,-970.6600000000326
37372,2022-12-13 08:20:00,-1643.63,268071.4900000073,270685.78000000736,-2614.2900000000373
37373,2022-12-13 08:25:00,782.04,268853.5300000073,270685.78000000736,-1832.2500000000582
37374,2022-12-13 08:30:00,1804.48,270658.0100000073,270685.78000000736,-27.770000000076834
37375,2022-12-13 08:35:00,375.03,271033.0400000073,270685.78000000736,347.2599999999511
37376,2022-12-13 08:40:00,563.41,271596.4500000073,270685.78000000736,910.6699999999255
37377,2022-12-13 08:45:00,-1474.08,270122.3700000073,270685.78000000736,-563.4100000000908
37378,2022-12-13 08:50:00,53.31,270175.68000000727,270685.78000000736,-510.10000000009313
37379,2022-12-13 08:55:00,-1705.24,268470.4400000073,270685.78000000736,-2215.340000000084
37380,2022-12-13 09:00:00,-1384.07,267086.3700000073,270685.78000000736,-3599.410000000091
37381,2022-12-13 09:05:00,-793.54,266292.8300000073,270685.78000000736,-4392.95000000007
37382,2022-12-13 09:10:00,-1992.88,264299.9500000073,270685.78000000736,-6385.8300000000745
37383,2022-12-13 09:15:00,-1505.41,262794.5400000073,270685.78000000736,-7891.240000000049
37384,2022-12-13 09:20:00,-1676.89,261117.6500000073,270685.78000000736,-9568.130000000063
37385,2022-12-13 09:25:00,850.21,261967.8600000073,270685.78000000736,-8717.920000000071
37386,2022-12-13 09:30:00,-1567.19,260400.6700000073,270685.78000000736,-10285.110000000073
37387,2022-12-13 09:35:00,305.49,260706.16000000728,270685.78000000736,-9979.620000000083
37388,2022-12-13 09:40:00,435.18,261141.34000000727,270685.78000000736,-9544.44000000009
37389,2022-12-13 09:45:00,1803.45,262944.79000000726,270685.78000000736,-7740.990000000107
37390,2022-12-13 09:50:00,730.57,263675.36000000726,270685.78000000736,-7010.4200000001
37391,2022-12-13 09:55:00,-989.94,262685.42000000726,270685.78000000736,-8000.360000000102
37392,2022-12-13 10:00:00,1050.89,263736.3100000073,270685.78000000736,-6949.4700000000885
37393,2022-12-13 10:05:00,-1570.48,262165.8300000073,270685.78000000736,-8519.95000000007
37394,2022-12-13 10:10:00,1983.76,264149.5900000073,270685.78000000736,-6536.1900000000605
37395,2022-12-13 10:15:00,-891.77,263257.8200000073,270685.78000000736,-7427.960000000079
37396,2022-12-13 10:20:00,768.29,264026.11000000726,270685.78000000736,-6659.6700000001
37397,2022-12-13 10:25:00,-644.5,263381.61000000726,270685.78000000736,-7304.1700000001
37398,2022-12-13 10:30:00,-600.24,262781.3700000073,270685.78000000736,-7904.410000000091
37399,2022-12-13 10:35:00,-76.36,262705.0100000073,270685.78000000736,-7980.770000000077
37400,2022-12-13 10:40:00,-1390.08,261314.9300000073,270685.78000000736,-9370.850000000064
37401,2022-12-13 10:45:00,1292.39,262607.3200000073,270685.78000000736,-8078.460000000079
37402,2022-12-13 10:50:00,1888.43,264495.7500000073,270685.78000000736,-6190.030000000086
37403,2022-12-13 10:55:00,1716.99,266212.74000000727,270685.78000000736,-4473.0400000000955
37404,2022-12-13 11:00:00,-1262.08,264950.66000000725,270685.78000000736,-5735.120000000112
37405,2022-12-13 11:05:00,859.79,265810.45000000723,270685.78000000736,-4875.330000000133
37406,2022-12-13 11:10:00,-1127.59,264682.8600000072,270685.78000000736,-6002.920000000158
37407,2022-12-13 11:15:00,818.14,265501.0000000072,270685.78000000736,-5184.780000000144
37408,2022-12-13 11:20:00,1441.24,266942.2400000072,270685.78000000736,-3743.5400000001537
37409,2022-12-13 11:25:00,-787.31,266154.9300000072,270685.78000000736,-4530.850000000151
37410,2022-12-13 11:30:00,-142.7,266012.2300000072,270685.78000000736,-4673.550000000163
37411,2022-12-13 11:35:00,-558.65,265453.5800000072,270685.78000000736,-5232.200000000186
37412,2022-12-13 11:40:00,320.85,265774.43000000715,270685.78000000736,-4911.35000000021
37413,2022-12-13 11:45:00,-525.04,265249.3900000072,270685.78000000736,-5436.390000000189
37414,2022-12-13 11:50:00,-358.8,264890.5900000072,270685.78000000736,-5795.190000000177
37415,2022-12-13 11:55:00,-144.51,264746.0800000072,270685.78000000736,-5939.700000000186
37416,2022-12-13 12:00:00,617.76,265363.8400000072,270685.78000000736,-5321.940000000177
37417,2022-12-13 12:05:00,1886.03,267249.8700000072,270685.78000000736,-3435.910000000149
37418,2022-12-13 12:10:00,988.4,268238.27000000724,270685.78000000736,-2447.5100000001257
37419,2022-12-13 12:15:00,328.61,268566.8800000072,270685.78000000736,-2118.9000000001397
37420,2022-12-13 12:20:00,-1332.69,267234.1900000072,270685.78000000736,-3451.590000000142
37421,2022-12-13 12:25:00,1734.75,268968.9400000072,270685.78000000736,-1716.840000000142
37422,2022-12-13 12:30:00,-179.81,268789.1300000072,270685.78000000736,-1896.6500000001397
37423,2022-12-13 12:35:00,-997.45,267791.6800000072,270685.78000000736,-2894.1000000001513
37424,2022-12-13 12:40:00,1761.87,269553.5500000072,270685.78000000736,-1132.230000000156
37425,2022-12-13 12:45:00,1455.09,271008.64000000723,270685.78000000736,322.8599999998696
37426,2022-12-13 12:50:00,-1136.22,269872.42000000726,270685.78000000736,-813.3600000001024
37427,2022-12-13 12:55:00,-875.43,268996.99000000727,270685.78000000736,-1688.7900000000955
37428,2022-12-13 13:00:00,-588.89,268408.10000000725,270685.78000000736,-2277.6800000001094
37429,2022-12-13 13:05:00,-670.93,267737.17000000726,270685.78000000736,-2948.6100000001024
37430,2022-12-13 13:10:00,-55.36,267681.8100000073,270685.78000000736,-3003.9700000000885
37431,2022-12-13 13:15:00,1451.91,269133.72000000725,270685.78000000736,-1552.060000000114
37432,2022-12-13 13:20:00,-119.48,269014.24000000727,270685.78000000736,-1671.5400000000955
37433,2022-12-13 13:25:00,538.64,269552.8800000073,270685.78000000736,-1132.9000000000815
37434,2022-12-13 13:30:00,1909.77,271462.6500000073,270685.78000000736,776.8699999999371
37435,2022-12-13 13:35:00,591.39,272054.0400000073,270685.78000000736,1368.259999999951
37436,2022-12-13 13:40:00,484.0,272538.0400000073,270685.78000000736,1852.259999999951
37437,2022-12-13 13:45:00,-77.88,272460.1600000073,270685.78000000736,1774.3799999999464
37438,2022-12-13 13:50:00,-1289.17,271170.9900000073,270685.78000000736,485.20999999996275
37439,2022-12-13 13:55:00,-507.9,270663.0900000073,270685.78000000736,-22.690000000060536
37440,2022-12-13 14:00:00,-1498.88,269164.2100000073,270685.78000000736,-1521.5700000000652
37441,2022-12-13 14:05:00,434.31,269598.5200000073,270685.78000000736,-1087.2600000000675
37442,2022-12-13 14:10:00,-505.7,269092.8200000073,270685.78000000736,-1592.9600000000792
37443,2022-12-13 14:15:00,-352.77,268740.05000000726,270685.78000000736,-1945.7300000000978
37444,2022-12-13 14:20:00,-1605.48,267134.5700000073,270685.78000000736,-3551.210000000079
37445,2022-12-13 14:25:00,1586.49,268721.0600000073,270685.78000000736,-1964.7200000000885
37446,2022-12-13 14:30:00,1183.54,269904.60000000725,270685.78000000736,-781.1800000001094
37447,2022-12-13 14:35:00,929.43,270834.03000000725,270685.78000000736,148.24999999988358
37448,2022-12-13 14:40:00,206.31,271040.34000000724,270685.78000000736,354.55999999988126
37449,2022-12-13 14:45:00,1817.47,272857.8100000072,270685.78000000736,2172.0299999998533
37450,2022-12-13 14:50:00,-1943.51,270914.3000000072,270685.78000000736,228.519999999844
37451,2022-12-13 14:55:00,1600.98,272515.2800000072,270685.78000000736,1829.4999999998254
37452,2022-12-13 15:00:00,-371.28,272144.00000000716,270685.78000000736,1458.2199999997974
37453,2022-12-13 15:05:00,-94.84,272049.16000000713,270685.78000000736,1363.3799999997718
37454,2022-12-13 15:10:00,-284.75,271764.41000000713,270685.78000000736,1078.6299999997718
37455,2022-12-13 15:15:00,-425.18,271339.23000000714,270685.78000000736,653.4499999997788
37456,2022-12-13 15:20:00,552.56,271891.79000000714,270685.78000000736,1206.0099999997765
37457,2022-12-13 15:25:00,1224.79,273116.5800000071,270685.78000000736,2430.7999999997555
37458,2022-12-13 15:30:00,-386.1,272730.48000000714,270685.78000000736,2044.6999999997788
37459,2022-12-13 15:35:00,745.57,273476.05000000715,270685.78000000736,2790.269999999786
37460,2022-12-13 15:40:00,-1930.95,271545.10000000714,270685.78000000736,859.3199999997742
37461,2022-12-13 15:45:00,1450.89,272995.99000000715,270685.78000000736,2310.209999999788
37462,2022-12-13 15:50:00,-3.65,272992.3400000071,270685.78000000736,2306.559999999765
37463,2022-12-13 15:55:00,-1290.15,271702.1900000071,270685.78000000736,1016.4099999997416
37464,2022-12-13 16:00:00,331.14,272033.3300000071,270685.78000000736,1347.5499999997555
37465,2022-12-13 16:05:00,414.83,272448.16000000713,270685.78000000736,1762.3799999997718
37466,2022-12-13 16:10:00,175.86,272624.0200000071,270685.78000000736,1938.2399999997579
37467,2022-12-13 16:15:00,1339.86,273963.8800000071,270685.78000000736,3278.099999999744
37468,2022-12-13 16:20:00,244.68,274208.5600000071,270685.78000000736,3522.779999999737
37469,2022-12-13 16:25:00,857.32,275065.8800000071,270685.78000000736,4380.099999999744
37470,2022-12-13 16:30:00,300.92,275366.8000000071,270685.78000000736,4681.019999999728
37471,2022-12-13 16:35:00,1799.91,277166.71000000706,270685.78000000736,6480.929999999702
37472,2022-12-13 16:40:00,-769.84,276396.87000000704,270685.78000000736,5711.089999999676
37473,2022-12-13 16:45:00,1346.88,277743.75000000704,270685.78000000736,7057.969999999681
37474,2022-12-13 16:50:00,1813.92,279557.670000007,270685.78000000736,8871.889999999665
37475,2022-12-13 16:55:00,-1965.09,277592.580000007,270685.78000000736,6906.799999999639
37476,2022-12-14 08:00:00,-1967.38,275625.200000007,277592.580000007,-1967.3800000000047
37477,2022-12-14 08:05:00,867.54,276492.740000007,277592.580000007,-1099.8400000000256
37478,2022-12-14 08:10:00,927.62,277420.360000007,277592.580000007,-172.22000000003027
37479,2022-12-14 08:15:00,-884.17,276536.190000007,277592.580000007,-1056.390000000014
37480,2022-12-14 08:20:00,1813.96,278350.150000007,277592.580000007,757.570000000007
37481,2022-12-14 08:25:00,218.16,278568.310000007,277592.580000007,975.7299999999814
37482,2022-12-14 08:30:00,-515.29,278053.020000007,277592.580000007,460.4400000000023
37483,2022-12-14 08:35:00,1969.69,280022.710000007,277592.580000007,2430.1300000000047
37484,2022-12-14 08:40:00,-1342.9,278679.810000007,277592.580000007,1087.2299999999814
37485,2022-12-14 08:45:00,844.97,279524.78000000695,277592.580000007,1932.1999999999534
37486,2022-12-14 08:50:00,-1927.82,277596.96000000695,277592.580000007,4.379999999946449
37487,2022-12-14 08:55:00,-1703.91,275893.050000007,277592.580000007,-1699.530000000028
37488,2022-12-14 09:00:00,-301.97,275591.080000007,277592.580000007,-2001.5
37489,2022-12-14 09:05:00,1638.8,277229.880000007,277592.580000007,-362.70000000001164
37490,2022-12-14 09:10:00,1886.41,279116.29000000696,277592.580000007,1523.7099999999627
37491,2022-12-14 09:15:00,-518.18,278598.110000007,277592.580000007,1005.5299999999697
37492,2022-12-14 09:20:00,-1318.46,277279.65000000695,277592.580000007,-312.9300000000512
37493,2022-12-14 09:25:00,-1672.39,275607.26000000694,277592.580000007,-1985.3200000000652
37494,2022-12-14 09:30:00,-698.4,274908.8600000069,277592.580000007,-2683.7200000000885
37495,2022-12-14 09:35:00,-1893.68,273015.1800000069,277592.580000007,-4577.4000000000815
37496,2022-12-14 09:40:00,1461.72,274476.9000000069,277592.580000007,-3115.6800000001094
37497,2022-12-14 09:45:00,280.64,274757.5400000069,277592.580000007,-2835.0400000000955
37498,2022-12-14 09:50:00,-1680.65,273076.8900000069,277592.580000007,-4515.690000000119
37499,2022-12-14 09:55:00,443.59,273520.4800000069,277592.580000007,-4072.100000000093
37500,2022-12-14 10:00:00,-1581.18,271939.3000000069,277592.580000007,-5653.280000000086
37501,2022-12-14 10:05:00,-271.45,271667.8500000069,277592.580000007,-5924.730000000098
37502,2022-12-14 10:10:00,-313.49,271354.3600000069,277592.580000007,-6238.2200000000885
37503,2022-12-14 10:15:00,-1430.88,269923.4800000069,277592.580000007,-7669.100000000093
37504,2022-12-14 10:20:00,-1644.14,268279.3400000069,277592.580000007,-9313.240000000107
37505,2022-12-14 10:25:00,1881.67,270161.0100000069,277592.580000007,-7431.570000000123
37506,2022-12-14 10:30:00,-1444.9,268716.11000000685,277592.580000007,-8876.470000000147
37507,2022-12-14 10:35:00,-1529.92,267186.19000000687,277592.580000007,-10406.39000000013
37508,2022-12-14 10:40:00,1037.07,268223.2600000069,277592.580000007,-9369.320000000123
37509,2022-12-14 10:45:00,-1117.25,267106.0100000069,277592.580000007,-10486.570000000123
37510,2022-12-14 10:50:00,1904.12,269010.1300000069,277592.580000007,-8582.450000000128
37511,2022-12-14 10:55:00,-1242.76,267767.37000000686,277592.580000007,-9825.210000000137
37512,2022-12-14 11:00:00,-649.17,267118.2000000069,277592.580000007,-10474.380000000121
37513,2022-12-14 11:05:00,1217.34,268335.5400000069,277592.580000007,-9257.040000000095
37514,2022-12-14 11:10:00,873.8,269209.3400000069,277592.580000007,-8383.240000000107
37515,2022-12-14 11:15:00,794.72,270004.06000000687,277592.580000007,-7588.520000000135
37516,2022-12-14 11:20:00,-998.34,269005.72000000684,277592.580000007,-8586.86000000016
37517,2022-12-14 11:25:00,-1393.51,267612.21000000683,277592.580000007,-9980.37000000017
37518,2022-12-14 11:30:00,-1695.44,265916.7700000068,277592.580000007,-11675.810000000172
37519,2022-12-14 11:35:00,1700.66,267617.4300000068,277592.580000007,-9975.150000000198
37520,2022-12-14 11:40:00,-298.95,267318.4800000068,277592.580000007,-10274.10000000021
37521,2022-12-14 11:45:00,1094.34,268412.8200000068,277592.580000007,-9179.760000000184
37522,2022-12-14 11:50:00,1223.18,269636.0000000068,277592.580000007,-7956.580000000191
37523,2022-12-14 11:55:00,-876.17,268759.8300000068,277592.580000007,-8832.750000000175
37524,2022-12-14 12:00:00,1650.65,270410.48000000685,277592.580000007,-7182.100000000151
37525,2022-12-14 12:05:00,-1051.05,269359.43000000686,277592.580000007,-8233.15000000014
37526,2022-12-14 12:10:00,1866.3,271225.73000000685,277592.580000007,-6366.850000000151
37527,2022-12-14 12:15:00,-1066.05,270159.68000000686,277592.580000007,-7432.90000000014
37528,2022-12-14 12:20:00,-34.46,270125.22000000684,277592.580000007,-7467.360000000161
37529,2022-12-14 12:25:00,1686.9,271812.12000000686,277592.580000007,-5780.460000000137
37530,2022-12-14 12:30:00,160.17,271972.29000000685,277592.580000007,-5620.290000000154
37531,2022-12-14 12:35:00,-1641.92,270330.37000000686,277592.580000007,-7262.210000000137
37532,2022-12-14 12:40:00,1550.42,271880.79000000685,277592.580000007,-5711.790000000154
37533,2022-12-14 12:45:00,959.56,272840.35000000685,277592.580000007,-4752.230000000156
37534,2022-12-14 12:50:00,1809.87,274650.22000000684,277592.580000007,-2942.3600000001607
37535,2022-12-14 12:55:00,135.36,274785.5800000068,277592.580000007,-2807.0000000001746
37536,2022-12-14 13:00:00,1510.45,276296.03000000684,277592.580000007,-1296.550000000163
37537,2022-12-14 13:05:00,-840.86,275455.17000000685,277592.580000007,-2137.410000000149
37538,2022-12-14 13:10:00,669.46,276124.6300000069,277592.580000007,-1467.950000000128
37539,2022-12-14 13:15:00,-674.66,275449.9700000069,277592.580000007,-2142.6100000001024
37540,2022-12-14 13:20:00,749.12,276199.0900000069,277592.580000007,-1393.490000000107
37541,2022-12-14 13:25:00,535.66,276734.75000000687,277592.580000007,-857.8300000001327
37542,2022-12-14 13:30:00,-1475.65,275259.10000000685,277592.580000007,-2333.480000000156
37543,2022-12-14 13:35:00,469.68,275728.78000000684,277592.580000007,-1863.800000000163
37544,2022-12-14 13:40:00,1704.4,277433.18000000686,277592.580000007,-159.4000000001397
37545,2022-12-14 13:45:00,1247.87,278681.05000000686,277592.580000007,1088.4699999998556
37546,2022-12-14 13:50:00,-468.58,278212.47000000684,277592.580000007,619.8899999998393
37547,2022-12-14 13:55:00,561.33,278773.80000000686,277592.580000007,1181.2199999998556
37548,2022-12-14 14:00:00,-1167.8,277606.00000000687,277592.580000007,13.419999999867287
37549,2022-12-14 14:05:00,1921.0,279527.00000000687,277592.580000007,1934.4199999998673
37550,2022-12-14 14:10:00,795.04,280322.04000000685,277592.580000007,2729.4599999998463
37551,2022-12-14 14:15:00,1509.66,281831.7000000068,277592.580000007,4239.119999999821
37552,2022-12-14 14:20:00,245.64,282077.34000000684,277592.580000007,4484.759999999835
37553,2022-12-14 14:25:00,-418.63,281658.71000000683,277592.580000007,4066.12999999983
37554,2022-12-14 14:30:00,1388.32,283047.03000000684,277592.580000007,5454.449999999837
37555,2022-12-14 14:35:00,-822.77,282224.2600000068,277592.580000007,4631.679999999818
37556,2022-12-14 14:40:00,1663.5,283887.7600000068,277592.580000007,6295.179999999818
37557,2022-12-14 14:45:00,1111.77,284999.53000000684,277592.580000007,7406.949999999837
37558,2022-12-14 14:50:00,-814.65,284184.8800000068,277592.580000007,6592.299999999814
37559,2022-12-14 14:55:00,1520.54,285705.4200000068,277592.580000007,8112.839999999793
37560,2022-12-14 15:00:00,1151.82,286857.2400000068,277592.580000007,9264.6599999998
37561,2022-12-14 15:05:00,220.35,287077.5900000068,277592.580000007,9485.009999999776
37562,2022-12-14 15:10:00,-377.52,286700.07000000676,277592.580000007,9107.489999999758
37563,2022-12-14 15:15:00,189.9,286889.9700000068,277592.580000007,9297.389999999781
37564,2022-12-14 15:20:00,111.32,287001.2900000068,277592.580000007,9408.709999999788
37565,2022-12-14 15:25:00,439.77,287441.0600000068,277592.580000007,9848.479999999807
37566,2022-12-14 15:30:00,-1566.78,285874.2800000068,277592.580000007,8281.699999999779
37567,2022-12-14 15:35:00,62.03,285936.3100000068,277592.580000007,8343.729999999807
37568,2022-12-14 15:40:00,835.54,286771.8500000068,277592.580000007,9179.269999999786
37569,2022-12-14 15:45:00,198.81,286970.6600000068,277592.580000007,9378.079999999783
37570,2022-12-14 15:50:00,-920.78,286049.88000000676,277592.580000007,8457.299999999756
37571,2022-12-14 15:55:00,1694.34,287744.2200000068,277592.580000007,10151.639999999781
37572,2022-12-14 16:00:00,358.94,288103.1600000068,277592.580000007,10510.579999999783
37573,2022-12-14 16:05:00,1172.53,289275.6900000068,277592.580000007,11683.109999999811
37574,2022-12-14 16:10:00,-179.17,289096.5200000068,277592.580000007,11503.939999999828
37575,2022-12-14 16:15:00,-1105.3,287991.22000000684,277592.580000007,10398.63999999984
37576,2022-12-14 16:20:00,-937.63,287053.59000000684,277592.580000007,9461.009999999835
37577,2022-12-14 16:25:00,1490.34,288543.93000000686,277592.580000007,10951.34999999986
37578,2022-12-14 16:30:00,157.15,288701.0800000069,277592.580000007,11108.499999999884
37579,2022-12-14 16:35:00,-1804.53,286896.55000000686,277592.580000007,9303.969999999856
37580,2022-12-14 16:40:00,783.5,287680.05000000686,277592.580000007,10087.469999999856
37581,2022-12-14 16:45:00,1189.61,288869.66000000684,277592.580000007,11277.079999999842
37582,2022-12-14 16:50:00,441.95,289311.61000000685,277592.580000007,11719.029999999853
37583,2022-12-14 16:55:00,421.41,289733.0200000068,277592.580000007,12140.439999999828
37584,2022-12-15 08:00:00,-919.04,288813.98000000685,289733.0200000068,-919.039999999979
37585,2022-12-15 08:05:00,1914.19,290728.17000000685,289733.0200000068,995.1500000000233
37586,2022-12-15 08:10:00,1850.34,292578.5100000069,289733.0200000068,2845.490000000049
37587,2022-12-15 08:15:00,-1395.82,291182.69000000687,289733.0200000068,1449.670000000042
37588,2022-12-15 08:20:00,1442.39,292625.0800000069,289733.0200000068,2892.060000000056
37589,2022-12-15 08:25:00,-307.03,292318.05000000686,289733.0200000068,2585.030000000028
37590,2022-12-15 08:30:00,1025.06,293343.11000000685,289733.0200000068,3610.0900000000256
37591,2022-12-15 08:35:00,-1415.26,291927.85000000685,289733.0200000068,2194.8300000000163
37592,2022-12-15 08:40:00,1878.0,293805.85000000685,289733.0200000068,4072.8300000000163
37593,2022-12-15 08:45:00,-1390.79,292415.06000000687,289733.0200000068,2682.0400000000373
37594,2022-12-15 08:50:00,-28.29,292386.7700000069,289733.0200000068,2653.750000000058
37595,2022-12-15 08:55:00,-1902.3,290484.4700000069,289733.0200000068,751.4500000000698
37596,2022-12-15 09:00:00,488.23,290972.7000000069,289733.0200000068,1239.6800000000512
37597,2022-12-15 09:05:00,211.54,291184.24000000686,289733.0200000068,1451.2200000000303
37598,2022-12-15 09:10:00,1909.89,293094.1300000069,289733.0200000068,3361.1100000000442
37599,2022-12-15 09:15:00,-1749.71,291344.42000000685,289733.0200000068,1611.4000000000233
37600,2022-12-15 09:20:00,1695.43,293039.85000000685,289733.0200000068,3306.8300000000163
37601,2022-12-15 09:25:00,1729.54,294769.3900000068,289733.0200000068,5036.369999999995
37602,2022-12-15 09:30:00,1156.03,295925.42000000685,289733.0200000068,6192.400000000023
37603,2022-12-15 09:35:00,-735.23,295190.19000000687,289733.0200000068,5457.170000000042
37604,2022-12-15 09:40:00,1225.32,296415.5100000069,289733.0200000068,6682.490000000049
37605,2022-12-15 09:45:00,1473.21,297888.7200000069,289733.0200000068,8155.70000000007
37606,2022-12-15 09:50:00,-954.07,296934.6500000069,289733.0200000068,7201.630000000063
37607,2022-12-15 09:55:00,-483.31,296451.3400000069,289733.0200000068,6718.320000000065
37608,2022-12-15 10:00:00,-303.71,296147.6300000069,289733.0200000068,6414.610000000044
37609,2022-12-15 10:05:00,753.97,296901.60000000685,289733.0200000068,7168.580000000016
37610,2022-12-15 10:10:00,1801.69,298703.29000000685,289733.0200000068,8970.270000000019
37611,2022-12-15 10:15:00,1235.23,299938.5200000068,289733.0200000068,10205.5
37612,2022-12-15 10:20:00,-1382.21,298556.3100000068,289733.0200000068,8823.289999999979
37613,2022-12-15 10:25:00,-1223.26,297333.0500000068,289733.0200000068,7600.02999999997
37614,2022-12-15 10:30:00,930.95,298264.0000000068,289733.0200000068,8530.979999999981
37615,2022-12-15 10:35:00,1461.36,299725.3600000068,289733.0200000068,9992.339999999967
37616,2022-12-15 10:40:00,1899.95,301625.3100000068,289733.0200000068,11892.289999999979
37617,2022-12-15 10:45:00,-134.22,301491.09000000684,289733.0200000068,11758.070000000007
37618,2022-12-15 10:50:00,696.72,302187.8100000068,289733.0200000068,12454.789999999979
37619,2022-12-15 10:55:00,298.36,302486.1700000068,289733.0200000068,12753.149999999965
37620,2022-12-15 11:00:00,-1936.48,300549.6900000068,289733.0200000068,10816.669999999984
37621,2022-12-15 11:05:00,-644.12,299905.5700000068,289733.0200000068,10172.549999999988
37622,2022-12-15 11:10:00,-1653.06,298252.5100000068,289733.0200000068,8519.48999999999
37623,2022-12-15 11:15:00,759.99,299012.5000000068,289733.0200000068,9279.479999999981
37624,2022-12-15 11:20:00,-1824.09,297188.4100000068,289733.0200000068,7455.389999999956
37625,2022-12-15 11:25:00,1953.09,299141.5000000068,289733.0200000068,9408.479999999981
37626,2022-12-15 11:30:00,1326.69,300468.1900000068,289733.0200000068,10735.169999999984
37627,2022-12-15 11:35:00,-1512.67,298955.5200000068,289733.0200000068,9222.5
37628,2022-12-15 11:40:00,275.25,299230.7700000068,289733.0200000068,9497.75
37629,2022-12-15 11:45:00,-842.58,298388.1900000068,289733.0200000068,8655.169999999984
37630,2022-12-15 11:50:00,-1388.41,296999.78000000684,289733.0200000068,7266.760000000009
37631,2022-12-15 11:55:00,1755.77,298755.55000000686,289733.0200000068,9022.530000000028
37632,2022-12-15 12:00:00,-1060.22,297695.3300000069,289733.0200000068,7962.310000000056
37633,2022-12-15 12:05:00,-73.5,297621.8300000069,289733.0200000068,7888.810000000056
37634,2022-12-15 12:10:00,-393.93,297227.9000000069,289733.0200000068,7494.880000000063
37635,2022-12-15 12:15:00,719.52,297947.4200000069,289733.0200000068,8214.400000000081
37636,2022-12-15 12:20:00,-976.34,296971.0800000069,289733.0200000068,7238.060000000056
37637,2022-12-15 12:25:00,779.88,297750.9600000069,289733.0200000068,8017.9400000000605
37638,2022-12-15 12:30:00,-1174.9,296576.06000000687,289733.0200000068,6843.040000000037
37639,2022-12-15 12:35:00,-868.17,295707.8900000069,289733.0200000068,5974.870000000054
37640,2022-12-15 12:40:00,1331.93,297039.8200000069,289733.0200000068,7306.800000000047
37641,2022-12-15 12:45:00,-740.24,296299.5800000069,289733.0200000068,6566.560000000056
37642,2022-12-15 12:50:00,-945.01,295354.5700000069,289733.0200000068,5621.550000000047
37643,2022-12-15 12:55:00,-981.46,294373.11000000685,289733.0200000068,4640.090000000026
37644,2022-12-15 13:00:00,630.07,295003.18000000686,289733.0200000068,5270.160000000033
37645,2022-12-15 13:05:00,1946.83,296950.0100000069,289733.0200000068,7216.990000000049
37646,2022-12-15 13:10:00,1849.64,298799.6500000069,289733.0200000068,9066.630000000063
37647,2022-12-15 13:15:00,461.58,299261.2300000069,289733.0200000068,9528.21000000008
37648,2022-12-15 13:20:00,1925.51,301186.7400000069,289733.0200000068,11453.720000000088
37649,2022-12-15 13:25:00,1979.84,303166.58000000694,289733.0200000068,13433.560000000114
37650,2022-12-15 13:30:00,-682.93,302483.65000000695,289733.0200000068,12750.630000000121
37651,2022-12-15 13:35:00,1972.74,304456.39000000694,289733.0200000068,14723.370000000112
37652,2022-12-15 13:40:00,648.73,305105.1200000069,289733.0200000068,15372.100000000093
37653,2022-12-15 13:45:00,562.21,305667.33000000694,289733.0200000068,15934.310000000114
37654,2022-12-15 13:50:00,1128.67,306796.0000000069,289733.0200000068,17062.980000000098
37655,2022-12-15 13:55:00,-1480.04,305315.96000000695,289733.0200000068,15582.940000000119
37656,2022-12-15 14:00:00,-1077.33,304238.63000000693,289733.0200000068,14505.610000000102
37657,2022-12-15 14:05:00,-876.35,303362.28000000695,289733.0200000068,13629.260000000126
37658,2022-12-15 14:10:00,-1420.34,301941.9400000069,289733.0200000068,12208.9200000001
37659,2022-12-15 14:15:00,-673.31,301268.63000000693,289733.0200000068,11535.610000000102
37660,2022-12-15 14:20:00,1900.3,303168.9300000069,289733.0200000068,13435.91000000009
37661,2022-12-15 14:25:00,1373.8,304542.7300000069,289733.0200000068,14809.71000000008
37662,2022-12-15 14:30:00,-786.76,303755.9700000069,289733.0200000068,14022.95000000007
37663,2022-12-15 14:35:00,289.46,304045.4300000069,289733.0200000068,14312.41000000009
37664,2022-12-15 14:40:00,-368.63,303676.8000000069,289733.0200000068,13943.780000000086
37665,2022-12-15 14:45:00,-1798.32,301878.4800000069,289733.0200000068,12145.46000000008
37666,2022-12-15 14:50:00,700.88,302579.3600000069,289733.0200000068,12846.340000000084
37667,2022-12-15 14:55:00,-1943.86,300635.5000000069,289733.0200000068,10902.480000000098
37668,2022-12-15 15:00:00,395.35,301030.8500000069,289733.0200000068,11297.830000000075
37669,2022-12-15 15:05:00,-37.66,300993.1900000069,289733.0200000068,11260.1700000001
37670,2022-12-15 15:10:00,-1526.35,299466.84000000695,289733.0200000068,9733.820000000123
37671,2022-12-15 15:15:00,1029.9,300496.740000007,289733.0200000068,10763.720000000147
37672,2022-12-15 15:20:00,222.95,300719.690000007,289733.0200000068,10986.670000000158
37673,2022-12-15 15:25:00,-217.04,300502.650000007,289733.0200000068,10769.63000000018
37674,2022-12-15 15:30:00,1652.92,302155.570000007,289733.0200000068,12422.550000000163
37675,2022-12-15 15:35:00,-706.49,301449.080000007,289733.0200000068,11716.060000000172
37676,2022-12-15 15:40:00,-598.93,300850.150000007,289733.0200000068,11117.13000000018
37677,2022-12-15 15:45:00,-248.55,300601.600000007,289733.0200000068,10868.580000000191
37678,2022-12-15 15:50:00,1804.77,302406.37000000704,289733.0200000068,12673.35000000021
37679,2022-12-15 15:55:00,-484.6,301921.77000000706,289733.0200000068,12188.750000000233
37680,2022-12-15 16:00:00,-266.29,301655.4800000071,289733.0200000068,11922.460000000254
37681,2022-12-15 16:05:00,820.34,302475.8200000071,289733.0200000068,12742.80000000028
37682,2022-12-15 16:10:00,1717.35,304193.1700000071,289733.0200000068,14460.150000000256
37683,2022-12-15 16:15:00,-923.31,303269.8600000071,289733.0200000068,13536.840000000258
37684,2022-12-15 16:20:00,-1014.93,302254.9300000071,289733.0200000068,12521.910000000265
37685,2022-12-15 16:25:00,-986.29,301268.6400000071,289733.0200000068,11535.620000000286
37686,2022-12-15 16:30:00,804.72,302073.3600000071,289733.0200000068,12340.340000000258
37687,2022-12-15 16:35:00,1853.59,303926.9500000071,289733.0200000068,14193.930000000284
37688,2022-12-15 16:40:00,-1992.58,301934.3700000071,289733.0200000068,12201.350000000268
37689,2022-12-15 16:45:00,-1887.74,300046.6300000071,289733.0200000068,10313.610000000277
37690,2022-12-15 16:50:00,-1881.11,298165.5200000071,289733.0200000068,8432.500000000291
37691,2022-12-15 16:55:00,-1566.61,296598.91000000713,289733.0200000068,6865.890000000305
37692,2022-12-16 08:00:00,1044.6,297643.5100000071,296598.91000000713,1044.5999999999767
37693,2022-12-16 08:05:00,1446.2,299089.7100000071,296598.91000000713,2490.7999999999884
37694,2022-12-16 08:10:00,-1083.94,298005.7700000071,296598.91000000713,1406.859999999986
37695,2022-12-16 08:15:00,1579.45,299585.22000000713,296598.91000000713,2986.3099999999977
37696,2022-12-16 08:20:00,-394.99,299190.23000000714,296598.91000000713,2591.320000000007
37697,2022-12-16 08:25:00,995.27,300185.50000000716,296598.91000000713,3586.5900000000256
37698,2022-12-16 08:30:00,668.06,300853.56000000716,296598.91000000713,4254.650000000023
37699,2022-12-16 08:35:00,1866.99,302720.55000000715,296598.91000000713,6121.640000000014
37700,2022-12-16 08:40:00,170.88,302891.43000000715,296598.91000000713,6292.520000000019
37701,2022-12-16 08:45:00,-535.5,302355.93000000715,296598.91000000713,5757.020000000019
37702,2022-12-16 08:50:00,1200.09,303556.0200000072,296598.91000000713,6957.110000000044
37703,2022-12-16 08:55:00,428.04,303984.06000000716,296598.91000000713,7385.150000000023
37704,2022-12-16 09:00:00,1949.38,305933.44000000716,296598.91000000713,9334.530000000028
37705,2022-12-16 09:05:00,-1514.96,304418.48000000714,296598.91000000713,7819.570000000007
37706,2022-12-16 09:10:00,501.54,304920.0200000071,296598.91000000713,8321.109999999986
37707,2022-12-16 09:15:00,1684.03,306604.05000000715,296598.91000000713,10005.140000000014
37708,2022-12-16 09:20:00,-1954.21,304649.8400000071,296598.91000000713,8050.929999999993
37709,2022-12-16 09:25:00,188.49,304838.3300000071,296598.91000000713,8239.419999999984
37710,2022-12-16 09:30:00,989.11,305827.4400000071,296598.91000000713,9228.52999999997
37711,2022-12-16 09:35:00,-840.26,304987.1800000071,296598.91000000713,8388.26999999996
37712,2022-12-16 09:40:00,-1358.83,303628.3500000071,296598.91000000713,7029.439999999944
37713,2022-12-16 09:45:00,861.96,304490.3100000071,296598.91000000713,7891.399999999965
37714,2022-12-16 09:50:00,-1305.0,303185.3100000071,296598.91000000713,6586.399999999965
37715,2022-12-16 09:55:00,-1621.29,301564.0200000071,296598.91000000713,4965.109999999986
37716,2022-12-16 10:00:00,1574.69,303138.7100000071,296598.91000000713,6539.799999999988
37717,2022-12-16 10:05:00,1324.46,304463.17000000714,296598.91000000713,7864.260000000009
37718,2022-12-16 10:10:00,-1187.2,303275.97000000713,296598.91000000713,6677.059999999998
37719,2022-12-16 10:15:00,301.4,303577.37000000715,296598.91000000713,6978.460000000021
37720,2022-12-16 10:20:00,-707.0,302870.37000000715,296598.91000000713,6271.460000000021
37721,2022-12-16 10:25:00,-1324.97,301545.4000000072,296598.91000000713,4946.490000000049
37722,2022-12-16 10:30:00,-1149.21,300396.19000000716,296598.91000000713,3797.280000000028
37723,2022-12-16 10:35:00,-867.29,299528.9000000072,296598.91000000713,2929.990000000049
37724,2022-12-16 10:40:00,537.26,300066.1600000072,296598.91000000713,3467.250000000058
37725,2022-12-16 10:45:00,1304.09,301370.2500000072,296598.91000000713,4771.340000000084
37726,2022-12-16 10:50:00,1268.6,302638.8500000072,296598.91000000713,6039.9400000000605
37727,2022-12-16 10:55:00,331.49,302970.3400000072,296598.91000000713,6371.430000000051
37728,2022-12-16 11:00:00,360.04,303330.38000000716,296598.91000000713,6731.47000000003
37729,2022-12-16 11:05:00,270.46,303600.8400000072,296598.91000000713,7001.930000000051
37730,2022-12-16 11:10:00,465.72,304066.56000000716,296598.91000000713,7467.650000000023
37731,2022-12-16 11:15:00,1787.77,305854.3300000072,296598.91000000713,9255.420000000042
37732,2022-12-16 11:20:00,-692.52,305161.81000000716,296598.91000000713,8562.900000000023
37733,2022-12-16 11:25:00,352.29,305514.10000000714,296598.91000000713,8915.190000000002
37734,2022-12-16 11:30:00,339.76,305853.86000000715,296598.91000000713,9254.950000000012
37735,2022-12-16 11:35:00,709.5,306563.36000000715,296598.91000000713,9964.450000000012
37736,2022-12-16 11:40:00,-1068.48,305494.88000000716,296598.91000000713,8895.97000000003
37737,2022-12-16 11:45:00,844.12,306339.00000000716,296598.91000000713,9740.090000000026
37738,2022-12-16 11:50:00,1459.39,307798.3900000072,296598.91000000713,11199.48000000004
37739,2022-12-16 11:55:00,899.16,308697.55000000715,296598.91000000713,12098.640000000014
37740,2022-12-16 12:00:00,1579.46,310277.01000000717,296598.91000000713,13678.100000000035
37741,2022-12-16 12:05:00,755.96,311032.9700000072,296598.91000000713,14434.060000000056
37742,2022-12-16 12:10:00,1969.27,313002.2400000072,296598.91000000713,16403.330000000075
37743,2022-12-16 12:15:00,284.21,313286.45000000723,296598.91000000713,16687.540000000095
37744,2022-12-16 12:20:00,1661.15,314947.60000000725,296598.91000000713,18348.69000000012
37745,2022-12-16 12:25:00,1782.27,316729.8700000073,296598.91000000713,20130.960000000137
37746,2022-12-16 12:30:00,-1377.66,315352.2100000073,296598.91000000713,18753.300000000163
37747,2022-12-16 12:35:00,-193.37,315158.8400000073,296598.91000000713,18559.930000000168
37748,2022-12-16 12:40:00,-1943.06,313215.7800000073,296598.91000000713,16616.87000000017
37749,2022-12-16 12:45:00,-39.81,313175.9700000073,296598.91000000713,16577.060000000172
37750,2022-12-16 12:50:00,444.06,313620.0300000073,296598.91000000713,17021.12000000017
37751,2022-12-16 12:55:00,-1258.6,312361.4300000073,296598.91000000713,15762.520000000193
37752,2022-12-16 13:00:00,-1974.21,310387.2200000073,296598.91000000713,13788.310000000172
37753,2022-12-16 13:05:00,1816.75,312203.9700000073,296598.91000000713,15605.060000000172
37754,2022-12-16 13:10:00,1588.97,313792.9400000073,296598.91000000713,17194.030000000144
37755,2022-12-16 13:15:00,-1522.04,312270.9000000073,296598.91000000713,15671.990000000165
37756,2022-12-16 13:20:00,-634.0,311636.9000000073,296598.91000000713,15037.990000000165
37757,2022-12-16 13:25:00,1795.68,313432.5800000073,296598.91000000713,16833.67000000016
37758,2022-12-16 13:30:00,1090.46,314523.0400000073,296598.91000000713,17924.13000000018
37759,2022-12-16 13:35:00,-1190.31,313332.7300000073,296598.91000000713,16733.82000000018
37760,2022-12-16 13:40:00,-1740.88,311591.8500000073,296598.91000000713,14992.940000000177
37761,2022-12-16 13:45:00,-322.05,311269.8000000073,296598.91000000713,14670.890000000189
37762,2022-12-16 13:50:00,618.11,311887.9100000073,296598.91000000713,15289.000000000175
37763,2022-12-16 13:55:00,1056.72,312944.6300000073,296598.91000000713,16345.720000000147
37764,2022-12-16 14:00:00,964.5,313909.1300000073,296598.91000000713,17310.220000000147
37765,2022-12-16 14:05:00,1239.87,315149.0000000073,296598.91000000713,18550.090000000142
37766,2022-12-16 14:10:00,1779.75,316928.7500000073,296598.91000000713,20329.840000000142
37767,2022-12-16 14:15:00,805.66,317734.41000000725,296598.91000000713,21135.500000000116
37768,2022-12-16 14:20:00,174.34,317908.7500000073,296598.91000000713,21309.840000000142
37769,2022-12-16 14:25:00,-423.53,317485.22000000725,296598.91000000713,20886.310000000114
37770,2022-12-16 14:30:00,-1083.92,316401.30000000726,296598.91000000713,19802.39000000013
37771,2022-12-16 14:35:00,522.83,316924.1300000073,296598.91000000713,20325.220000000147
37772,2022-12-16 14:40:00,-1312.62,315611.5100000073,296598.91000000713,19012.60000000015
37773,2022-12-16 14:45:00,986.04,316597.55000000726,296598.91000000713,19998.64000000013
37774,2022-12-16 14:50:00,1071.02,317668.5700000073,296598.91000000713,21069.66000000015
37775,2022-12-16 14:55:00,942.57,318611.1400000073,296598.91000000713,22012.230000000156
37776,2022-12-16 15:00:00,314.9,318926.0400000073,296598.91000000713,22327.13000000018
37777,2022-12-16 15:05:00,1849.14,320775.1800000073,296598.91000000713,24176.270000000193
37778,2022-12-16 15:10:00,-1761.51,319013.6700000073,296598.91000000713,22414.760000000184
37779,2022-12-16 15:15:00,1646.92,320660.5900000073,296598.91000000713,24061.680000000168
37780,2022-12-16 15:20:00,596.61,321257.2000000073,296598.91000000713,24658.290000000154
37781,2022-12-16 15:25:00,732.93,321990.1300000073,296598.91000000713,25391.220000000147
37782,2022-12-16 15:30:00,495.76,322485.8900000073,296598.91000000713,25886.980000000156
37783,2022-12-16 15:35:00,1556.25,324042.1400000073,296598.91000000713,27443.230000000156
37784,2022-12-16 15:40:00,1462.73,325504.8700000073,296598.91000000713,28905.960000000137
37785,2022-12-16 15:45:00,153.38,325658.2500000073,296598.91000000713,29059.340000000142
37786,2022-12-16 15:50:00,-442.84,325215.41000000725,296598.91000000713,28616.500000000116
37787,2022-12-16 15:55:00,822.68,326038.09000000724,296598.91000000713,29439.18000000011
37788,2022-12-16 16:00:00,1862.02,327900.11000000726,296598.91000000713,31301.200000000128
37789,2022-12-16 16:05:00,-1530.94,326369.17000000726,296598.91000000713,29770.260000000126
37790,2022-12-16 16:10:00,-132.04,326237.1300000073,296598.91000000713,29638.220000000147
37791,2022-12-16 16:15:00,1818.31,328055.4400000073,296598.91000000713,31456.530000000144
37792,2022-12-16 16:20:00,998.25,329053.6900000073,296598.91000000713,32454.780000000144
37793,2022-12-16 16:25:00,-879.67,328174.0200000073,296598.91000000713,31575.11000000016
37794,2022-12-16 16:30:00,1433.89,329607.9100000073,296598.91000000713,33009.000000000175
37795,2022-12-16 16:35:00,868.37,330476.2800000073,296598.91000000713,33877.37000000017
37796,2022-12-16 16:40:00,-389.38,330086.9000000073,296598.91000000713,33487.990000000165
37797,2022-12-16 16:45:00,-1244.34,328842.5600000073,296598.91000000713,32243.65000000014
37798,2022-12-16 16:50:00,-1380.05,327462.5100000073,296598.91000000713,30863.60000000015
37799,2022-12-16 16:55:00,-1964.29,325498.2200000073,296598.91000000713,28899.310000000172
37800,2022-12-17 08:00:00,1535.28,327033.50000000733,325498.2200000073,1535.280000000028
37801,2022-12-17 08:05:00,1940.6,328974.1000000073,325498.2200000073,3475.8800000000047
37802,2022-12-17 08:10:00,-44.44,328929.6600000073,325498.2200000073,3431.4400000000023
37803,2022-12-17 08:15:00,200.31,329129.9700000073,325498.2200000073,3631.75
37804,2022-12-17 08:20:00,-1405.28,327724.6900000073,325498.2200000073,2226.469999999972
37805,2022-12-17 08:25:00,855.88,328580.5700000073,325498.2200000073,3082.3499999999767
37806,2022-12-17 08:30:00,-273.12,328307.4500000073,325498.2200000073,2809.2299999999814
37807,2022-12-17 08:35:00,-1600.74,326706.7100000073,325498.2200000073,1208.4899999999907
37808,2022-12-17 08:40:00,-389.76,326316.9500000073,325498.2200000073,818.7299999999814
37809,2022-12-17 08:45:00,1009.35,327326.30000000726,325498.2200000073,1828.079999999958
37810,2022-12-17 08:50:00,1913.9,329240.2000000073,325498.2200000073,3741.9799999999814
37811,2022-12-17 08:55:00,-993.09,328247.11000000726,325498.2200000073,2748.8899999999558
37812,2022-12-17 09:00:00,-1352.67,326894.4400000073,325498.2200000073,1396.219999999972
37813,2022-12-17 09:05:00,516.31,327410.7500000073,325498.2200000073,1912.5299999999697
37814,2022-12-17 09:10:00,298.94,327709.6900000073,325498.2200000073,2211.469999999972
37815,2022-12-17 09:15:00,-572.17,327137.5200000073,325498.2200000073,1639.2999999999884
37816,2022-12-17 09:20:00,-690.38,326447.1400000073,325498.2200000073,948.9199999999837
37817,2022-12-17 09:25:00,-931.17,325515.9700000073,325498.2200000073,17.75
37818,2022-12-17 09:30:00,1582.94,327098.9100000073,325498.2200000073,1600.6900000000023
37819,2022-12-17 09:35:00,-1639.25,325459.6600000073,325498.2200000073,-38.55999999999767
37820,2022-12-17 09:40:00,-346.34,325113.3200000073,325498.2200000073,-384.9000000000233
37821,2022-12-17 09:45:00,-1447.72,323665.6000000073,325498.2200000073,-1832.6199999999953
37822,2022-12-17 09:50:00,-1504.58,322161.0200000073,325498.2200000073,-3337.2000000000116
37823,2022-12-17 09:55:00,-1471.62,320689.4000000073,325498.2200000073,-4808.820000000007
37824,2022-12-17 10:00:00,171.3,320860.7000000073,325498.2200000073,-4637.520000000019
37825,2022-12-17 10:05:00,1114.77,321975.4700000073,325498.2200000073,-3522.75
37826,2022-12-17 10:10:00,-1664.42,320311.0500000073,325498.2200000073,-5187.169999999984
37827,2022-12-17 10:15:00,-615.18,319695.87000000733,325498.2200000073,-5802.349999999977
37828,2022-12-17 10:20:00,1347.04,321042.9100000073,325498.2200000073,-4455.309999999998
37829,2022-12-17 10:25:00,598.0,321640.9100000073,325498.2200000073,-3857.3099999999977
37830,2022-12-17 10:30:00,353.28,321994.19000000734,325498.2200000073,-3504.0299999999697
37831,2022-12-17 10:35:00,1776.02,323770.21000000736,325498.2200000073,-1728.009999999951
37832,2022-12-17 10:40:00,1304.25,325074.46000000736,325498.2200000073,-423.7599999999511
37833,2022-12-17 10:45:00,1033.43,326107.89000000735,325498.2200000073,609.6700000000419
37834,2022-12-17 10:50:00,-494.74,325613.15000000736,325498.2200000073,114.93000000005122
37835,2022-12-17 10:55:00,1324.95,326938.10000000737,325498.2200000073,1439.8800000000629
37836,2022-12-17 11:00:00,-1287.53,325650.57000000734,325498.2200000073,152.35000000003492
37837,2022-12-17 11:05:00,-1175.99,324474.58000000735,325498.2200000073,-1023.6399999999558
37838,2022-12-17 11:10:00,1816.77,326291.35000000737,325498.2200000073,793.1300000000629
37839,2022-12-17 11:15:00,-589.08,325702.27000000735,325498.2200000073,204.05000000004657
37840,2022-12-17 11:20:00,-108.84,325593.4300000073,325498.2200000073,95.21000000002095
37841,2022-12-17 11:25:00,-348.16,325245.27000000735,325498.2200000073,-252.94999999995343
37842,2022-12-17 11:30:00,-1600.15,323645.12000000733,325498.2200000073,-1853.0999999999767
37843,2022-12-17 11:35:00,1550.34,325195.46000000736,325498.2200000073,-302.7599999999511
37844,2022-12-17 11:40:00,-1289.76,323905.70000000735,325498.2200000073,-1592.5199999999604
37845,2022-12-17 11:45:00,-969.76,322935.94000000734,325498.2200000073,-2562.2799999999697
37846,2022-12-17 11:50:00,56.98,322992.9200000073,325498.2200000073,-2505.2999999999884
37847,2022-12-17 11:55:00,-96.4,322896.5200000073,325498.2200000073,-2601.7000000000116
37848,2022-12-17 12:00:00,-185.3,322711.2200000073,325498.2200000073,-2787.0
37849,2022-12-17 12:05:00,-1377.06,321334.1600000073,325498.2200000073,-4164.059999999998
37850,2022-12-17 12:10:00,-1911.88,319422.2800000073,325498.2200000073,-6075.940000000002
37851,2022-12-17 12:15:00,-866.16,318556.12000000733,325498.2200000073,-6942.099999999977
37852,2022-12-17 12:20:00,1363.66,319919.7800000073,325498.2200000073,-5578.440000000002
37853,2022-12-17 12:25:00,59.95,319979.7300000073,325498.2200000073,-5518.489999999991
37854,2022-12-17 12:30:00,1897.4,321877.13000000734,325498.2200000073,-3621.0899999999674
37855,2022-12-17 12:35:00,-845.67,321031.46000000736,325498.2200000073,-4466.759999999951
37856,2022-12-17 12:40:00,-1473.08,319558.38000000734,325498.2200000073,-5939.839999999967
37857,2022-12-17 12:45:00,-831.01,318727.37000000733,325498.2200000073,-6770.849999999977
37858,2022-12-17 12:50:00,300.51,319027.88000000734,325498.2200000073,-6470.339999999967
37859,2022-12-17 12:55:00,1430.87,320458.75000000733,325498.2200000073,-5039.469999999972
37860,2022-12-17 13:00:00,1206.91,321665.6600000073,325498.2200000073,-3832.5599999999977
37861,2022-12-17 13:05:00,-276.99,321388.6700000073,325498.2200000073,-4109.549999999988
37862,2022-12-17 13:10:00,-1072.69,320315.9800000073,325498.2200000073,-5182.239999999991
37863,2022-12-17 13:15:00,-609.28,319706.7000000073,325498.2200000073,-5791.520000000019
37864,2022-12-17 13:20:00,1326.14,321032.8400000073,325498.2200000073,-4465.380000000005
37865,2022-12-17 13:25:00,273.09,321305.9300000073,325498.2200000073,-4192.289999999979
37866,2022-12-17 13:30:00,1602.52,322908.45000000735,325498.2200000073,-2589.7699999999604
37867,2022-12-17 13:35:00,709.02,323617.47000000736,325498.2200000073,-1880.7499999999418
37868,2022-12-17 13:40:00,78.65,323696.1200000074,325498.2200000073,-1802.0999999999185
37869,2022-12-17 13:45:00,1441.69,325137.8100000074,325498.2200000073,-360.4099999999162
37870,2022-12-17 13:50:00,-1988.37,323149.4400000074,325498.2200000073,-2348.7799999999115
37871,2022-12-17 13:55:00,-1518.53,321630.91000000737,325498.2200000073,-3867.3099999999395
37872,2022-12-17 14:00:00,102.71,321733.6200000074,325498.2200000073,-3764.5999999999185
37873,2022-12-17 14:05:00,-1760.14,319973.4800000074,325498.2200000073,-5524.7399999999325
37874,2022-12-17 14:10:00,295.38,320268.8600000074,325498.2200000073,-5229.359999999928
37875,2022-12-17 14:15:00,-1162.46,319106.40000000736,325498.2200000073,-6391.819999999949
37876,2022-12-17 14:20:00,1566.56,320672.96000000736,325498.2200000073,-4825.259999999951
37877,2022-12-17 14:25:00,-651.13,320021.83000000735,325498.2200000073,-5476.389999999956
37878,2022-12-17 14:30:00,1498.78,321520.6100000074,325498.2200000073,-3977.609999999928
37879,2022-12-17 14:35:00,465.21,321985.8200000074,325498.2200000073,-3512.399999999907
37880,2022-12-17 14:40:00,466.3,322452.1200000074,325498.2200000073,-3046.0999999999185
37881,2022-12-17 14:45:00,1194.9,323647.0200000074,325498.2200000073,-1851.1999999998952
37882,2022-12-17 14:50:00,1243.35,324890.3700000074,325498.2200000073,-607.8499999999185
37883,2022-12-17 14:55:00,1675.83,326566.2000000074,325498.2200000073,1067.9800000000978
37884,2022-12-17 15:00:00,600.67,327166.8700000074,325498.2200000073,1668.6500000000815
37885,2022-12-17 15:05:00,390.78,327557.6500000074,325498.2200000073,2059.4300000001094
37886,2022-12-17 15:10:00,1322.49,328880.1400000074,325498.2200000073,3381.9200000001
37887,2022-12-17 15:15:00,0.76,328880.9000000074,325498.2200000073,3382.6800000001094
37888,2022-12-17 15:20:00,1097.42,329978.3200000074,325498.2200000073,4480.100000000093
37889,2022-12-17 15:25:00,-821.14,329157.1800000074,325498.2200000073,3658.960000000079
37890,2022-12-17 15:30:00,-1963.92,327193.2600000074,325498.2200000073,1695.0400000000955
37891,2022-12-17 15:35:00,979.62,328172.8800000074,325498.2200000073,2674.660000000091
37892,2022-12-17 15:40:00,-1318.75,326854.1300000074,325498.2200000073,1355.9100000000908
37893,2022-12-17 15:45:00,-1565.91,325288.2200000074,325498.2200000073,-209.99999999988358
37894,2022-12-17 15:50:00,-536.82,324751.4000000074,325498.2200000073,-746.8199999998906
37895,2022-12-17 15:55:00,-756.08,323995.3200000074,325498.2200000073,-1502.8999999999069
37896,2022-12-17 16:00:00,1772.09,325767.4100000074,325498.2200000073,269.19000000011874
37897,2022-12-17 16:05:00,749.64,326517.05000000744,325498.2200000073,1018.8300000001327
37898,2022-12-17 16:10:00,-1495.27,325021.7800000074,325498.2200000073,-476.4399999998859
37899,2022-12-17 16:15:00,885.45,325907.23000000743,325498.2200000073,409.01000000012573
37900,2022-12-17 16:20:00,-1215.88,324691.3500000074,325498.2200000073,-806.8699999998789
37901,2022-12-17 16:25:00,962.42,325653.7700000074,325498.2200000073,155.55000000010477
37902,2022-12-17 16:30:00,138.47,325792.2400000074,325498.2200000073,294.02000000007683
37903,2022-12-17 16:35:00,-762.97,325029.2700000074,325498.2200000073,-468.9499999998952
37904,2022-12-17 16:40:00,-1867.97,323161.30000000744,325498.2200000073,-2336.9199999998673
37905,2022-12-17 16:45:00,-268.31,322892.99000000744,325498.2200000073,-2605.229999999865
37906,2022-12-17 16:50:00,-1674.22,321218.77000000747,325498.2200000073,-4279.449999999837
37907,2022-12-17 16:55:00,-383.12,320835.6500000075,325498.2200000073,-4662.569999999832
37908,2022-12-18 08:00:00,-1664.12,319171.5300000075,320835.6500000075,-1664.1199999999953
37909,2022-12-18 08:05:00,-1741.55,317429.9800000075,320835.6500000075,-3405.6699999999837
37910,2022-12-18 08:10:00,1468.85,318898.83000000747,320835.6500000075,-1936.820000000007
37911,2022-12-18 08:15:00,1403.76,320302.5900000075,320835.6500000075,-533.0599999999977
37912,2022-12-18 08:20:00,-378.32,319924.27000000747,320835.6500000075,-911.3800000000047
37913,2022-12-18 08:25:00,-1457.95,318466.32000000746,320835.6500000075,-2369.3300000000163
37914,2022-12-18 08:30:00,-1745.04,316721.2800000075,320835.6500000075,-4114.369999999995
37915,2022-12-18 08:35:00,321.14,317042.4200000075,320835.6500000075,-3793.2299999999814
37916,2022-12-18 08:40:00,-1145.53,315896.89000000746,320835.6500000075,-4938.760000000009
37917,2022-12-18 08:45:00,-65.85,315831.0400000075,320835.6500000075,-5004.609999999986
37918,2022-12-18 08:50:00,44.54,315875.58000000747,320835.6500000075,-4960.070000000007
37919,2022-12-18 08:55:00,-777.67,315097.9100000075,320835.6500000075,-5737.739999999991
37920,2022-12-18 09:00:00,509.03,315606.9400000075,320835.6500000075,-5228.709999999963
37921,2022-12-18 09:05:00,-957.47,314649.47000000754,320835.6500000075,-6186.179999999935
37922,2022-12-18 09:10:00,1604.12,316253.59000000753,320835.6500000075,-4582.0599999999395
37923,2022-12-18 09:15:00,1795.01,318048.60000000754,320835.6500000075,-2787.04999999993
37924,2022-12-18 09:20:00,912.23,318960.8300000075,320835.6500000075,-1874.8199999999488
37925,2022-12-18 09:25:00,1357.45,320318.28000000754,320835.6500000075,-517.3699999999371
37926,2022-12-18 09:30:00,-1831.43,318486.85000000754,320835.6500000075,-2348.79999999993
37927,2022-12-18 09:35:00,-153.57,318333.28000000754,320835.6500000075,-2502.369999999937
37928,2022-12-18 09:40:00,958.82,319292.10000000754,320835.6500000075,-1543.5499999999302
37929,2022-12-18 09:45:00,153.16,319445.2600000075,320835.6500000075,-1390.3899999999558
37930,2022-12-18 09:50:00,1845.64,321290.90000000753,320835.6500000075,455.2500000000582
37931,2022-12-18 09:55:00,-1488.95,319801.9500000075,320835.6500000075,-1033.6999999999534
37932,2022-12-18 10:00:00,-1268.53,318533.4200000075,320835.6500000075,-2302.2299999999814
37933,2022-12-18 10:05:00,972.12,319505.5400000075,320835.6500000075,-1330.109999999986
37934,2022-12-18 10:10:00,-794.46,318711.08000000747,320835.6500000075,-2124.570000000007
37935,2022-12-18 10:15:00,-1614.21,317096.87000000745,320835.6500000075,-3738.780000000028
37936,2022-12-18 10:20:00,-1204.74,315892.13000000746,320835.6500000075,-4943.520000000019
37937,2022-12-18 10:25:00,1765.95,317658.08000000747,320835.6500000075,-3177.570000000007
37938,2022-12-18 10:30:00,1897.62,319555.70000000746,320835.6500000075,-1279.9500000000116
37939,2022-12-18 10:35:00,-465.3,319090.4000000075,320835.6500000075,-1745.25
37940,2022-12-18 10:40:00,-1519.68,317570.7200000075,320835.6500000075,-3264.929999999993
37941,2022-12-18 10:45:00,-855.02,316715.70000000746,320835.6500000075,-4119.950000000012
37942,2022-12-18 10:50:00,-884.58,315831.12000000745,320835.6500000075,-5004.530000000028
37943,2022-12-18 10:55:00,-1380.8,314450.32000000746,320835.6500000075,-6385.330000000016
37944,2022-12-18 11:00:00,1627.75,316078.07000000746,320835.6500000075,-4757.580000000016
37945,2022-12-18 11:05:00,450.21,316528.2800000075,320835.6500000075,-4307.369999999995
37946,2022-12-18 11:10:00,33.78,316562.0600000075,320835.6500000075,-4273.589999999967
37947,2022-12-18 11:15:00,-1060.15,315501.9100000075,320835.6500000075,-5333.739999999991
37948,2022-12-18 11:20:00,585.38,316087.2900000075,320835.6500000075,-4748.359999999986
37949,2022-12-18 11:25:00,-959.77,315127.52000000747,320835.6500000075,-5708.130000000005
37950,2022-12-18 11:30:00,1193.63,316321.1500000075,320835.6500000075,-4514.5
37951,2022-12-18 11:35:00,811.88,317133.0300000075,320835.6500000075,-3702.6199999999953
37952,2022-12-18 11:40:00,1595.5,318728.5300000075,320835.6500000075,-2107.1199999999953
37953,2022-12-18 11:45:00,1564.71,320293.2400000075,320835.6500000075,-542.4099999999744
37954,2022-12-18 11:50:00,1720.96,322014.2000000075,320835.6500000075,1178.5500000000466
37955,2022-12-18 11:55:00,-1683.0,320331.2000000075,320835.6500000075,-504.44999999995343
37956,2022-12-18 12:00:00,-1706.85,318624.35000000754,320835.6500000075,-2211.29999999993
37957,2022-12-18 12:05:00,-1310.21,317314.1400000075,320835.6500000075,-3521.509999999951
37958,2022-12-18 12:10:00,1218.55,318532.6900000075,320835.6500000075,-2302.9599999999627
37959,2022-12-18 12:15:00,-1218.65,317314.0400000075,320835.6500000075,-3521.609999999986
37960,2022-12-18 12:20:00,-1510.08,315803.9600000075,320835.6500000075,-5031.690000000002
37961,2022-12-18 12:25:00,249.92,316053.88000000746,320835.6500000075,-4781.770000000019
37962,2022-12-18 12:30:00,-1240.0,314813.88000000746,320835.6500000075,-6021.770000000019
37963,2022-12-18 12:35:00,1255.07,316068.95000000746,320835.6500000075,-4766.700000000012
37964,2022-12-18 12:40:00,-1961.65,314107.30000000744,320835.6500000075,-6728.350000000035
37965,2022-12-18 12:45:00,579.9,314687.20000000746,320835.6500000075,-6148.450000000012
37966,2022-12-18 12:50:00,1026.55,315713.75000000745,320835.6500000075,-5121.900000000023
37967,2022-12-18 12:55:00,1585.37,317299.12000000745,320835.6500000075,-3536.530000000028
37968,2022-12-18 13:00:00,1798.0,319097.12000000745,320835.6500000075,-1738.530000000028
37969,2022-12-18 13:05:00,-1925.56,317171.56000000745,320835.6500000075,-3664.0900000000256
37970,2022-12-18 13:10:00,-1358.02,315813.54000000743,320835.6500000075,-5022.110000000044
37971,2022-12-18 13:15:00,-1547.07,314266.4700000074,320835.6500000075,-6569.180000000051
37972,2022-12-18 13:20:00,-592.85,313673.62000000745,320835.6500000075,-7162.030000000028
37973,2022-12-18 13:25:00,-1518.7,312154.92000000743,320835.6500000075,-8680.73000000004
37974,2022-12-18 13:30:00,-154.94,311999.98000000743,320835.6500000075,-8835.670000000042
37975,2022-12-18 13:35:00,-429.82,311570.1600000074,320835.6500000075,-9265.490000000049
37976,2022-12-18 13:40:00,968.47,312538.6300000074,320835.6500000075,-8297.020000000077
37977,2022-12-18 13:45:00,-660.55,311878.0800000074,320835.6500000075,-8957.570000000065
37978,2022-12-18 13:50:00,-1136.25,310741.8300000074,320835.6500000075,-10093.820000000065
37979,2022-12-18 13:55:00,-689.06,310052.7700000074,320835.6500000075,-10782.880000000063
37980,2022-12-18 14:00:00,-966.87,309085.9000000074,320835.6500000075,-11749.750000000058
37981,2022-12-18 14:05:00,-1658.33,307427.5700000074,320835.6500000075,-13408.080000000075
37982,2022-12-18 14:10:00,709.53,308137.1000000074,320835.6500000075,-12698.550000000047
37983,2022-12-18 14:15:00,-305.57,307831.5300000074,320835.6500000075,-13004.120000000054
37984,2022-12-18 14:20:00,694.22,308525.7500000074,320835.6500000075,-12309.900000000081
37985,2022-12-18 14:25:00,871.46,309397.2100000074,320835.6500000075,-11438.44000000006
37986,2022-12-18 14:30:00,2.26,309399.4700000074,320835.6500000075,-11436.180000000051
37987,2022-12-18 14:35:00,1456.49,310855.9600000074,320835.6500000075,-9979.69000000006
37988,2022-12-18 14:40:00,-1774.2,309081.7600000074,320835.6500000075,-11753.890000000072
37989,2022-12-18 14:45:00,-1837.43,307244.3300000074,320835.6500000075,-13591.320000000065
37990,2022-12-18 14:50:00,-1674.19,305570.1400000074,320835.6500000075,-15265.510000000068
37991,2022-12-18 14:55:00,-447.97,305122.17000000743,320835.6500000075,-15713.48000000004
37992,2022-12-18 15:00:00,863.1,305985.2700000074,320835.6500000075,-14850.380000000063
37993,2022-12-18 15:05:00,1155.87,307141.1400000074,320835.6500000075,-13694.510000000068
37994,2022-12-18 15:10:00,-392.29,306748.8500000074,320835.6500000075,-14086.800000000047
37995,2022-12-18 15:15:00,1911.73,308660.5800000074,320835.6500000075,-12175.070000000065
37996,2022-12-18 15:20:00,-1943.68,306716.9000000074,320835.6500000075,-14118.750000000058
37997,2022-12-18 15:25:00,-847.97,305868.93000000744,320835.6500000075,-14966.72000000003
37998,2022-12-18 15:30:00,-1829.47,304039.4600000075,320835.6500000075,-16796.190000000002
37999,2022-12-18 15:35:00,850.86,304890.32000000746,320835.6500000075,-15945.330000000016
38000,2022-12-18 15:40:00,-1070.4,303819.92000000743,320835.6500000075,-17015.73000000004
38001,2022-12-18 15:45:00,1668.44,305488.36000000744,320835.6500000075,-15347.290000000037
38002,2022-12-18 15:50:00,803.8,306292.1600000074,320835.6500000075,-14543.490000000049
38003,2022-12-18 15:55:00,-589.86,305702.30000000744,320835.6500000075,-15133.350000000035
38004,2022-12-18 16:00:00,853.26,306555.56000000745,320835.6500000075,-14280.090000000026
38005,2022-12-18 16:05:00,1008.22,307563.7800000074,320835.6500000075,-13271.870000000054
38006,2022-12-18 16:10:00,-1329.89,306233.8900000074,320835.6500000075,-14601.760000000068
38007,2022-12-18 16:15:00,507.98,306741.8700000074,320835.6500000075,-14093.780000000086
38008,2022-12-18 16:20:00,-1408.59,305333.28000000736,320835.6500000075,-15502.370000000112
38009,2022-12-18 16:25:00,-1898.0,303435.28000000736,320835.6500000075,-17400.37000000011
38010,2022-12-18 16:30:00,319.73,303755.01000000734,320835.6500000075,-17080.64000000013
38011,2022-12-18 16:35:00,212.84,303967.85000000737,320835.6500000075,-16867.800000000105
38012,2022-12-18 16:40:00,1744.89,305712.7400000074,320835.6500000075,-15122.91000000009
38013,2022-12-18 16:45:00,1594.31,307307.0500000074,320835.6500000075,-13528.600000000093
38014,2022-12-18 16:50:00,1479.29,308786.34000000736,320835.6500000075,-12049.310000000114
38015,2022-12-18 16:55:00,-901.42,307884.9200000074,320835.6500000075,-12950.730000000098
38016,2022-12-19 08:00:00,219.5,308104.4200000074,307884.9200000074,219.5
38017,2022-12-19 08:05:00,-986.67,307117.7500000074,307884.9200000074,-767.1699999999837
38018,2022-12-19 08:10:00,519.16,307636.91000000737,307884.9200000074,-248.0100000000093
38019,2022-12-19 08:15:00,1973.27,309610.1800000074,307884.9200000074,1725.2600000000093
38020,2022-12-19 08:20:00,-378.4,309231.78000000736,307884.9200000074,1346.859999999986
38021,2022-12-19 08:25:00,-1637.43,307594.35000000737,307884.9200000074,-290.570000000007
38022,2022-12-19 08:30:00,140.63,307734.9800000074,307884.9200000074,-149.94000000000233
38023,2022-12-19 08:35:00,1630.71,309365.6900000074,307884.9200000074,1480.7700000000186
38024,2022-12-19 08:40:00,297.7,309663.3900000074,307884.9200000074,1778.4700000000303
38025,2022-12-19 08:45:00,221.8,309885.1900000074,307884.9200000074,2000.2700000000186
38026,2022-12-19 08:50:00,1298.03,311183.2200000074,307884.9200000074,3298.3000000000466
38027,2022-12-19 08:55:00,1606.11,312789.3300000074,307884.9200000074,4904.410000000033
38028,2022-12-19 09:00:00,1325.65,314114.98000000743,307884.9200000074,6230.060000000056
38029,2022-12-19 09:05:00,-1717.97,312397.01000000746,307884.9200000074,4512.090000000084
38030,2022-12-19 09:10:00,1527.63,313924.64000000746,307884.9200000074,6039.7200000000885
38031,2022-12-19 09:15:00,463.32,314387.9600000075,307884.9200000074,6503.0400000000955
38032,2022-12-19 09:20:00,-686.47,313701.4900000075,307884.9200000074,5816.570000000123
38033,2022-12-19 09:25:00,1112.44,314813.9300000075,307884.9200000074,6929.010000000126
38034,2022-12-19 09:30:00,345.61,315159.5400000075,307884.9200000074,7274.620000000112
38035,2022-12-19 09:35:00,530.21,315689.7500000075,307884.9200000074,7804.830000000133
38036,2022-12-19 09:40:00,-1669.79,314019.96000000753,307884.9200000074,6135.040000000154
38037,2022-12-19 09:45:00,662.73,314682.6900000075,307884.9200000074,6797.770000000135
38038,2022-12-19 09:50:00,468.68,315151.3700000075,307884.9200000074,7266.450000000128
38039,2022-12-19 09:55:00,-1721.37,313430.0000000075,307884.9200000074,5545.080000000133
38040,2022-12-19 10:00:00,1601.03,315031.03000000754,307884.9200000074,7146.110000000161
38041,2022-12-19 10:05:00,1748.8,316779.8300000075,307884.9200000074,8894.910000000149
38042,2022-12-19 10:10:00,-1255.39,315524.4400000075,307884.9200000074,7639.520000000135
38043,2022-12-19 10:15:00,-1450.64,314073.8000000075,307884.9200000074,6188.880000000121
38044,2022-12-19 10:20:00,1345.99,315419.7900000075,307884.9200000074,7534.870000000112
38045,2022-12-19 10:25:00,-566.92,314852.8700000075,307884.9200000074,6967.950000000128
38046,2022-12-19 10:30:00,1356.85,316209.7200000075,307884.9200000074,8324.800000000105
38047,2022-12-19 10:35:00,-295.11,315914.6100000075,307884.9200000074,8029.690000000119
38048,2022-12-19 10:40:00,-1872.12,314042.4900000075,307884.9200000074,6157.570000000123
38049,2022-12-19 10:45:00,-1175.96,312866.5300000075,307884.9200000074,4981.610000000102
38050,2022-12-19 10:50:00,-1453.34,311413.19000000745,307884.9200000074,3528.270000000077
38051,2022-12-19 10:55:00,1594.09,313007.2800000075,307884.9200000074,5122.360000000102
38052,2022-12-19 11:00:00,712.41,313719.69000000745,307884.9200000074,5834.770000000077
38053,2022-12-19 11:05:00,-1903.32,311816.37000000745,307884.9200000074,3931.45000000007
38054,2022-12-19 11:10:00,1039.23,312855.6000000074,307884.9200000074,4970.680000000051
38055,2022-12-19 11:15:00,-733.57,312122.0300000074,307884.9200000074,4237.110000000044
38056,2022-12-19 11:20:00,1365.14,313487.17000000743,307884.9200000074,5602.250000000058
38057,2022-12-19 11:25:00,-153.67,313333.50000000745,307884.9200000074,5448.5800000000745
38058,2022-12-19 11:30:00,1249.15,314582.6500000075,307884.9200000074,6697.730000000098
38059,2022-12-19 11:35:00,-359.5,314223.1500000075,307884.9200000074,6338.230000000098
38060,2022-12-19 11:40:00,1774.4,315997.5500000075,307884.9200000074,8112.630000000121
38061,2022-12-19 11:45:00,1768.38,317765.9300000075,307884.9200000074,9881.010000000126
38062,2022-12-19 11:50:00,-987.98,316777.9500000075,307884.9200000074,8893.030000000144
38063,2022-12-19 11:55:00,-1677.86,315100.09000000753,307884.9200000074,7215.170000000158
38064,2022-12-19 12:00:00,1583.06,316683.15000000753,307884.9200000074,8798.230000000156
38065,2022-12-19 12:05:00,1986.64,318669.79000000755,307884.9200000074,10784.87000000017
38066,2022-12-19 12:10:00,-851.13,317818.66000000754,307884.9200000074,9933.740000000165
38067,2022-12-19 12:15:00,-1588.79,316229.87000000756,307884.9200000074,8344.950000000186
38068,2022-12-19 12:20:00,-1483.28,314746.59000000753,307884.9200000074,6861.670000000158
38069,2022-12-19 12:25:00,-649.08,314097.5100000075,307884.9200000074,6212.590000000142
38070,2022-12-19 12:30:00,1574.57,315672.0800000075,307884.9200000074,7787.160000000149
38071,2022-12-19 12:35:00,108.45,315780.53000000754,307884.9200000074,7895.610000000161
38072,2022-12-19 12:40:00,-705.77,315074.7600000075,307884.9200000074,7189.840000000142
38073,2022-12-19 12:45:00,1496.94,316571.7000000075,307884.9200000074,8686.780000000144
38074,2022-12-19 12:50:00,-176.61,316395.09000000753,307884.9200000074,8510.170000000158
38075,2022-12-19 12:55:00,765.36,317160.4500000075,307884.9200000074,9275.530000000144
38076,2022-12-19 13:00:00,157.65,317318.10000000754,307884.9200000074,9433.180000000168
38077,2022-12-19 13:05:00,1092.53,318410.6300000076,307884.9200000074,10525.710000000196
38078,2022-12-19 13:10:00,-737.04,317673.5900000076,307884.9200000074,9788.670000000217
38079,2022-12-19 13:15:00,1904.78,319578.3700000076,307884.9200000074,11693.450000000244
38080,2022-12-19 13:20:00,1836.78,321415.15000000765,307884.9200000074,13530.230000000272
38081,2022-12-19 13:25:00,-146.01,321269.14000000764,307884.9200000074,13384.220000000263
38082,2022-12-19 13:30:00,-1137.93,320131.21000000765,307884.9200000074,12246.29000000027
38083,2022-12-19 13:35:00,-1181.36,318949.85000000766,307884.9200000074,11064.930000000284
38084,2022-12-19 13:40:00,-1574.09,317375.76000000763,307884.9200000074,9490.840000000258
38085,2022-12-19 13:45:00,863.35,318239.1100000076,307884.9200000074,10354.190000000235
38086,2022-12-19 13:50:00,1512.65,319751.76000000763,307884.9200000074,11866.840000000258
38087,2022-12-19 13:55:00,575.62,320327.38000000763,307884.9200000074,12442.460000000254
38088,2022-12-19 14:00:00,-1067.26,319260.1200000076,307884.9200000074,11375.200000000244
38089,2022-12-19 14:05:00,1112.94,320373.0600000076,307884.9200000074,12488.140000000247
38090,2022-12-19 14:10:00,-625.8,319747.26000000763,307884.9200000074,11862.340000000258
38091,2022-12-19 14:15:00,-47.31,319699.95000000764,307884.9200000074,11815.03000000026
38092,2022-12-19 14:20:00,416.16,320116.1100000076,307884.9200000074,12231.190000000235
38093,2022-12-19 14:25:00,924.14,321040.2500000076,307884.9200000074,13155.33000000025
38094,2022-12-19 14:30:00,-1374.41,319665.84000000765,307884.9200000074,11780.920000000275
38095,2022-12-19 14:35:00,1458.27,321124.11000000767,307884.9200000074,13239.190000000293
38096,2022-12-19 14:40:00,1116.14,322240.2500000077,307884.9200000074,14355.330000000307
38097,2022-12-19 14:45:00,-314.86,321925.3900000077,307884.9200000074,14040.470000000321
38098,2022-12-19 14:50:00,-860.64,321064.7500000077,307884.9200000074,13179.830000000307
38099,2022-12-19 14:55:00,1818.05,322882.8000000077,307884.9200000074,14997.880000000296
38100,2022-12-19 15:00:00,-143.83,322738.97000000766,307884.9200000074,14854.05000000028
38101,2022-12-19 15:05:00,1790.84,324529.8100000077,307884.9200000074,16644.890000000305
38102,2022-12-19 15:10:00,-796.29,323733.5200000077,307884.9200000074,15848.600000000326
38103,2022-12-19 15:15:00,-1370.76,322362.7600000077,307884.9200000074,14477.840000000317
38104,2022-12-19 15:20:00,1975.98,324338.7400000077,307884.9200000074,16453.820000000298
38105,2022-12-19 15:25:00,1586.23,325924.97000000766,307884.9200000074,18040.05000000028
38106,2022-12-19 15:30:00,-685.92,325239.0500000077,307884.9200000074,17354.130000000296
38107,2022-12-19 15:35:00,949.12,326188.17000000767,307884.9200000074,18303.25000000029
38108,2022-12-19 15:40:00,-1871.25,324316.92000000767,307884.9200000074,16432.00000000029
38109,2022-12-19 15:45:00,792.69,325109.61000000767,307884.9200000074,17224.690000000293
38110,2022-12-19 15:50:00,-1909.42,323200.1900000077,307884.9200000074,15315.27000000031
38111,2022-12-19 15:55:00,195.9,323396.0900000077,307884.9200000074,15511.170000000333
38112,2022-12-19 16:00:00,132.99,323529.0800000077,307884.9200000074,15644.160000000324
38113,2022-12-19 16:05:00,-1531.02,321998.0600000077,307884.9200000074,14113.140000000305
38114,2022-12-19 16:10:00,-305.61,321692.4500000077,307884.9200000074,13807.530000000319
38115,2022-12-19 16:15:00,628.2,322320.6500000077,307884.9200000074,14435.73000000033
38116,2022-12-19 16:20:00,-687.66,321632.99000000773,307884.9200000074,13748.070000000356
38117,2022-12-19 16:25:00,324.33,321957.32000000775,307884.9200000074,14072.400000000373
38118,2022-12-19 16:30:00,1503.86,323461.18000000773,307884.9200000074,15576.260000000359
38119,2022-12-19 16:35:00,-417.5,323043.68000000773,307884.9200000074,15158.760000000359
38120,2022-12-19 16:40:00,814.12,323857.80000000773,307884.9200000074,15972.880000000354
38121,2022-12-19 16:45:00,-1530.87,322326.93000000773,307884.9200000074,14442.010000000359
38122,2022-12-19 16:50:00,-1122.99,321203.94000000774,307884.9200000074,13319.020000000368
38123,2022-12-19 16:55:00,300.38,321504.32000000775,307884.9200000074,13619.400000000373
38124,2022-12-20 08:00:00,160.21,321664.53000000777,321504.32000000775,160.21000000002095
38125,2022-12-20 08:05:00,1656.68,323321.21000000776,321504.32000000775,1816.890000000014
38126,2022-12-20 08:10:00,308.36,323629.57000000775,321504.32000000775,2125.25
38127,2022-12-20 08:15:00,719.2,324348.77000000776,321504.32000000775,2844.4500000000116
38128,2022-12-20 08:20:00,638.17,324986.94000000774,321504.32000000775,3482.6199999999953
38129,2022-12-20 08:25:00,1757.51,326744.45000000775,321504.32000000775,5240.130000000005
38130,2022-12-20 08:30:00,-502.33,326242.12000000774,321504.32000000775,4737.799999999988
38131,2022-12-20 08:35:00,363.3,326605.4200000077,321504.32000000775,5101.099999999977
38132,2022-12-20 08:40:00,-862.28,325743.1400000077,321504.32000000775,4238.819999999949
38133,2022-12-20 08:45:00,-564.76,325178.3800000077,321504.32000000775,3674.0599999999395
38134,2022-12-20 08:50:00,-1663.15,323515.23000000766,321504.32000000775,2010.9099999999162
38135,2022-12-20 08:55:00,-1604.37,321910.86000000767,321504.32000000775,406.53999999992084
38136,2022-12-20 09:00:00,-634.8,321276.0600000077,321504.32000000775,-228.26000000006752
38137,2022-12-20 09:05:00,-1603.39,319672.67000000767,321504.32000000775,-1831.6500000000815
38138,2022-12-20 09:10:00,1736.12,321408.79000000766,321504.32000000775,-95.53000000008615
38139,2022-12-20 09:15:00,197.92,321606.71000000765,321504.32000000775,102.38999999989755
38140,2022-12-20 09:20:00,-1338.37,320268.34000000765,321504.32000000775,-1235.9800000000978
38141,2022-12-20 09:25:00,-442.04,319826.3000000077,321504.32000000775,-1678.0200000000768
38142,2022-12-20 09:30:00,-1472.48,318353.8200000077,321504.32000000775,-3150.500000000058
38143,2022-12-20 09:35:00,-1861.06,316492.7600000077,321504.32000000775,-5011.560000000056
38144,2022-12-20 09:40:00,1627.63,318120.3900000077,321504.32000000775,-3383.930000000051
38145,2022-12-20 09:45:00,466.23,318586.6200000077,321504.32000000775,-2917.70000000007
38146,2022-12-20 09:50:00,800.62,319387.2400000077,321504.32000000775,-2117.0800000000745
38147,2022-12-20 09:55:00,503.33,319890.5700000077,321504.32000000775,-1613.7500000000582
38148,2022-12-20 10:00:00,-1497.78,318392.79000000766,321504.32000000775,-3111.530000000086
38149,2022-12-20 10:05:00,-892.73,317500.0600000077,321504.32000000775,-4004.2600000000675
38150,2022-12-20 10:10:00,1312.46,318812.5200000077,321504.32000000775,-2691.8000000000466
38151,2022-12-20 10:15:00,1030.57,319843.0900000077,321504.32000000775,-1661.2300000000396
38152,2022-12-20 10:20:00,-519.4,319323.6900000077,321504.32000000775,-2180.630000000063
38153,2022-12-20 10:25:00,49.58,319373.2700000077,321504.32000000775,-2131.0500000000466
38154,2022-12-20 10:30:00,405.51,319778.7800000077,321504.32000000775,-1725.5400000000373
38155,2022-12-20 10:35:00,-50.38,319728.4000000077,321504.32000000775,-1775.920000000042
38156,2022-12-20 10:40:00,-49.19,319679.2100000077,321504.32000000775,-1825.1100000000442
38157,2022-12-20 10:45:00,-670.77,319008.4400000077,321504.32000000775,-2495.880000000063
38158,2022-12-20 10:50:00,-772.3,318236.1400000077,321504.32000000775,-3268.180000000051
38159,2022-12-20 10:55:00,1219.72,319455.86000000767,321504.32000000775,-2048.460000000079
38160,2022-12-20 11:00:00,-507.14,318948.72000000766,321504.32000000775,-2555.600000000093
38161,2022-12-20 11:05:00,-63.63,318885.09000000765,321504.32000000775,-2619.230000000098
38162,2022-12-20 11:10:00,-16.15,318868.9400000076,321504.32000000775,-2635.380000000121
38163,2022-12-20 11:15:00,-1796.62,317072.32000000763,321504.32000000775,-4432.000000000116
38164,2022-12-20 11:20:00,1165.15,318237.47000000766,321504.32000000775,-3266.850000000093
38165,2022-12-20 11:25:00,-851.58,317385.89000000764,321504.32000000775,-4118.430000000109
38166,2022-12-20 11:30:00,-592.4,316793.4900000076,321504.32000000775,-4710.830000000133
38167,2022-12-20 11:35:00,907.29,317700.7800000076,321504.32000000775,-3803.5400000001537
38168,2022-12-20 11:40:00,-136.69,317564.0900000076,321504.32000000775,-3940.230000000156
38169,2022-12-20 11:45:00,1341.87,318905.9600000076,321504.32000000775,-2598.3600000001607
38170,2022-12-20 11:50:00,-1373.61,317532.3500000076,321504.32000000775,-3971.9700000001467
38171,2022-12-20 11:55:00,1139.63,318671.9800000076,321504.32000000775,-2832.340000000142
38172,2022-12-20 12:00:00,434.69,319106.6700000076,321504.32000000775,-2397.6500000001397
38173,2022-12-20 12:05:00,-1359.9,317746.7700000076,321504.32000000775,-3757.550000000163
38174,2022-12-20 12:10:00,-1867.55,315879.2200000076,321504.32000000775,-5625.100000000151
38175,2022-12-20 12:15:00,1612.49,317491.7100000076,321504.32000000775,-4012.6100000001607
38176,2022-12-20 12:20:00,1150.23,318641.94000000757,321504.32000000775,-2862.3800000001793
38177,2022-12-20 12:25:00,809.83,319451.7700000076,321504.32000000775,-2052.550000000163
38178,2022-12-20 12:30:00,237.28,319689.0500000076,321504.32000000775,-1815.270000000135
38179,2022-12-20 12:35:00,1493.76,321182.8100000076,321504.32000000775,-321.51000000012573
38180,2022-12-20 12:40:00,1026.55,322209.3600000076,321504.32000000775,705.0399999998626
38181,2022-12-20 12:45:00,31.03,322240.39000000764,321504.32000000775,736.0699999998906
38182,2022-12-20 12:50:00,-1587.37,320653.02000000764,321504.32000000775,-851.3000000001048
38183,2022-12-20 12:55:00,1329.2,321982.22000000766,321504.32000000775,477.89999999990687
38184,2022-12-20 13:00:00,1707.4,323689.6200000077,321504.32000000775,2185.29999999993
38185,2022-12-20 13:05:00,-978.62,322711.0000000077,321504.32000000775,1206.6799999999348
38186,2022-12-20 13:10:00,1876.69,324587.6900000077,321504.32000000775,3083.369999999937
38187,2022-12-20 13:15:00,175.73,324763.42000000767,321504.32000000775,3259.0999999999185
38188,2022-12-20 13:20:00,1548.39,326311.8100000077,321504.32000000775,4807.4899999999325
38189,2022-12-20 13:25:00,-782.61,325529.2000000077,321504.32000000775,4024.8799999999464
38190,2022-12-20 13:30:00,-551.87,324977.3300000077,321504.32000000775,3473.009999999951
38191,2022-12-20 13:35:00,-449.09,324528.2400000077,321504.32000000775,3023.9199999999255
38192,2022-12-20 13:40:00,1162.28,325690.5200000077,321504.32000000775,4186.199999999953
38193,2022-12-20 13:45:00,696.68,326387.2000000077,321504.32000000775,4882.879999999946
38194,2022-12-20 13:50:00,1576.3,327963.5000000077,321504.32000000775,6459.179999999935
38195,2022-12-20 13:55:00,-1233.93,326729.5700000077,321504.32000000775,5225.249999999942
38196,2022-12-20 14:00:00,892.18,327621.7500000077,321504.32000000775,6117.429999999935
38197,2022-12-20 14:05:00,-1833.21,325788.54000000766,321504.32000000775,4284.219999999914
38198,2022-12-20 14:10:00,-1151.89,324636.65000000765,321504.32000000775,3132.3299999999
38199,2022-12-20 14:15:00,1383.01,326019.66000000766,321504.32000000775,4515.339999999909
38200,2022-12-20 14:20:00,-235.72,325783.9400000077,321504.32000000775,4279.619999999937
38201,2022-12-20 14:25:00,411.5,326195.4400000077,321504.32000000775,4691.119999999937
38202,2022-12-20 14:30:00,1406.06,327601.5000000077,321504.32000000775,6097.179999999935
38203,2022-12-20 14:35:00,1409.42,329010.92000000767,321504.32000000775,7506.5999999999185
38204,2022-12-20 14:40:00,-806.07,328204.85000000766,321504.32000000775,6700.5299999999115
38205,2022-12-20 14:45:00,-950.52,327254.33000000764,321504.32000000775,5750.009999999893
38206,2022-12-20 14:50:00,505.17,327759.5000000076,321504.32000000775,6255.179999999877
38207,2022-12-20 14:55:00,153.46,327912.96000000765,321504.32000000775,6408.639999999898
38208,2022-12-20 15:00:00,-1060.31,326852.65000000765,321504.32000000775,5348.3299999999
38209,2022-12-20 15:05:00,-1332.63,325520.02000000764,321504.32000000775,4015.699999999895
38210,2022-12-20 15:10:00,-1005.2,324514.82000000763,321504.32000000775,3010.4999999998836
38211,2022-12-20 15:15:00,964.72,325479.5400000076,321504.32000000775,3975.2199999998556
38212,2022-12-20 15:20:00,-817.99,324661.5500000076,321504.32000000775,3157.229999999865
38213,2022-12-20 15:25:00,-292.15,324369.4000000076,321504.32000000775,2865.0799999998417
38214,2022-12-20 15:30:00,1800.96,326170.3600000076,321504.32000000775,4666.039999999863
38215,2022-12-20 15:35:00,809.17,326979.5300000076,321504.32000000775,5475.209999999846
38216,2022-12-20 15:40:00,1864.16,328843.69000000757,321504.32000000775,7339.369999999821
38217,2022-12-20 15:45:00,1594.05,330437.74000000756,321504.32000000775,8933.419999999809
38218,2022-12-20 15:50:00,1707.03,332144.7700000076,321504.32000000775,10640.449999999837
38219,2022-12-20 15:55:00,-843.27,331301.50000000757,321504.32000000775,9797.179999999818
38220,2022-12-20 16:00:00,-381.93,330919.5700000076,321504.32000000775,9415.249999999825
38221,2022-12-20 16:05:00,-1511.58,329407.99000000756,321504.32000000775,7903.669999999809
38222,2022-12-20 16:10:00,81.41,329489.40000000753,321504.32000000775,7985.0799999997835
38223,2022-12-20 16:15:00,-679.05,328810.35000000754,321504.32000000775,7306.029999999795
38224,2022-12-20 16:20:00,289.02,329099.37000000756,321504.32000000775,7595.049999999814
38225,2022-12-20 16:25:00,1878.65,330978.0200000076,321504.32000000775,9473.699999999837
38226,2022-12-20 16:30:00,683.2,331661.2200000076,321504.32000000775,10156.899999999849
38227,2022-12-20 16:35:00,1063.52,332724.7400000076,321504.32000000775,11220.419999999867
38228,2022-12-20 16:40:00,35.04,332759.7800000076,321504.32000000775,11255.459999999846
38229,2022-12-20 16:45:00,1379.56,334139.3400000076,321504.32000000775,12635.019999999844
38230,2022-12-20 16:50:00,1028.27,335167.6100000076,321504.32000000775,13663.289999999863
38231,2022-12-20 16:55:00,-1982.53,333185.0800000076,321504.32000000775,11680.759999999835
38232,2022-12-21 08:00:00,-1986.08,331199.00000000757,333185.0800000076,-1986.0800000000163
38233,2022-12-21 08:05:00,1849.23,333048.23000000755,333185.0800000076,-136.85000000003492
38234,2022-12-21 08:10:00,-1258.28,331789.9500000075,333185.0800000076,-1395.1300000000629
38235,2022-12-21 08:15:00,1090.73,332880.6800000075,333185.0800000076,-304.4000000000815
38236,2022-12-21 08:20:00,-1627.67,331253.0100000075,333185.0800000076,-1932.0700000000652
38237,2022-12-21 08:25:00,1689.51,332942.5200000075,333185.0800000076,-242.56000000005588
38238,2022-12-21 08:30:00,-1965.78,330976.7400000075,333185.0800000076,-2208.340000000084
38239,2022-12-21 08:35:00,-1243.22,329733.5200000075,333185.0800000076,-3451.560000000056
38240,2022-12-21 08:40:00,-1795.34,327938.1800000075,333185.0800000076,-5246.9000000000815
38241,2022-12-21 08:45:00,-1515.65,326422.5300000075,333185.0800000076,-6762.550000000105
38242,2022-12-21 08:50:00,1915.91,328338.44000000745,333185.0800000076,-4846.64000000013
38243,2022-12-21 08:55:00,-1762.06,326576.38000000746,333185.0800000076,-6608.700000000128
38244,2022-12-21 09:00:00,-1398.27,325178.11000000744,333185.0800000076,-8006.970000000147
38245,2022-12-21 09:05:00,644.16,325822.2700000074,333185.0800000076,-7362.810000000172
38246,2022-12-21 09:10:00,187.41,326009.6800000074,333185.0800000076,-7175.400000000198
38247,2022-12-21 09:15:00,-520.5,325489.1800000074,333185.0800000076,-7695.900000000198
38248,2022-12-21 09:20:00,-1036.2,324452.9800000074,333185.0800000076,-8732.10000000021
38249,2022-12-21 09:25:00,1148.9,325601.8800000074,333185.0800000076,-7583.200000000186
38250,2022-12-21 09:30:00,934.91,326536.7900000074,333185.0800000076,-6648.290000000212
38251,2022-12-21 09:35:00,-1043.44,325493.35000000737,333185.0800000076,-7691.730000000214
38252,2022-12-21 09:40:00,-1102.36,324390.9900000074,333185.0800000076,-8794.0900000002
38253,2022-12-21 09:45:00,879.28,325270.2700000074,333185.0800000076,-7914.810000000172
38254,2022-12-21 09:50:00,1713.04,326983.3100000074,333185.0800000076,-6201.770000000193
38255,2022-12-21 09:55:00,1992.6,328975.91000000737,333185.0800000076,-4209.1700000002165
38256,2022-12-21 10:00:00,-617.01,328358.90000000736,333185.0800000076,-4826.180000000226
38257,2022-12-21 10:05:00,1504.55,329863.45000000735,333185.0800000076,-3321.6300000002375
38258,2022-12-21 10:10:00,1786.09,331649.5400000074,333185.0800000076,-1535.5400000002119
38259,2022-12-21 10:15:00,-35.11,331614.4300000074,333185.0800000076,-1570.650000000198
38260,2022-12-21 10:20:00,-814.16,330800.2700000074,333185.0800000076,-2384.8100000001723
38261,2022-12-21 10:25:00,1191.77,331992.04000000743,333185.0800000076,-1193.0400000001537
38262,2022-12-21 10:30:00,1348.33,333340.37000000745,333185.0800000076,155.28999999986263
38263,2022-12-21 10:35:00,-1552.49,331787.88000000746,333185.0800000076,-1397.200000000128
38264,2022-12-21 10:40:00,-1931.93,329855.95000000746,333185.0800000076,-3329.130000000121
38265,2022-12-21 10:45:00,1535.98,331391.93000000744,333185.0800000076,-1793.1500000001397
38266,2022-12-21 10:50:00,-881.55,330510.38000000746,333185.0800000076,-2674.700000000128
38267,2022-12-21 10:55:00,-366.71,330143.67000000743,333185.0800000076,-3041.410000000149
38268,2022-12-21 11:00:00,885.7,331029.37000000745,333185.0800000076,-2155.7100000001374
38269,2022-12-21 11:05:00,-646.81,330382.56000000745,333185.0800000076,-2802.520000000135
38270,2022-12-21 11:10:00,-314.14,330068.42000000743,333185.0800000076,-3116.660000000149
38271,2022-12-21 11:15:00,-780.88,329287.54000000743,333185.0800000076,-3897.5400000001537
38272,2022-12-21 11:20:00,-16.46,329271.0800000074,333185.0800000076,-3914.0000000001746
38273,2022-12-21 11:25:00,164.25,329435.3300000074,333185.0800000076,-3749.7500000001746
38274,2022-12-21 11:30:00,219.82,329655.1500000074,333185.0800000076,-3529.9300000001676
38275,2022-12-21 11:35:00,1863.63,331518.7800000074,333185.0800000076,-1666.300000000163
38276,2022-12-21 11:40:00,781.68,332300.4600000074,333185.0800000076,-884.62000000017
38277,2022-12-21 11:45:00,-726.35,331574.11000000744,333185.0800000076,-1610.9700000001467
38278,2022-12-21 11:50:00,-1480.72,330093.39000000746,333185.0800000076,-3091.6900000001187
38279,2022-12-21 11:55:00,71.75,330165.14000000746,333185.0800000076,-3019.9400000001187
38280,2022-12-21 12:00:00,-1364.75,328800.39000000746,333185.0800000076,-4384.690000000119
38281,2022-12-21 12:05:00,484.57,329284.9600000075,333185.0800000076,-3900.1200000001118
38282,2022-12-21 12:10:00,408.9,329693.8600000075,333185.0800000076,-3491.2200000000885
38283,2022-12-21 12:15:00,1927.32,331621.1800000075,333185.0800000076,-1563.9000000000815
38284,2022-12-21 12:20:00,579.81,332200.9900000075,333185.0800000076,-984.0900000000838
38285,2022-12-21 12:25:00,-441.56,331759.4300000075,333185.0800000076,-1425.6500000000815
38286,2022-12-21 12:30:00,1444.51,333203.9400000075,333185.0800000076,18.859999999927823
38287,2022-12-21 12:35:00,-174.64,333029.3000000075,333185.0800000076,-155.78000000008615
38288,2022-12-21 12:40:00,389.89,333419.1900000075,333185.0800000076,234.10999999992782
38289,2022-12-21 12:45:00,321.58,333740.7700000075,333185.0800000076,555.6899999999441
38290,2022-12-21 12:50:00,713.04,334453.8100000075,333185.0800000076,1268.7299999999232
38291,2022-12-21 12:55:00,-1216.63,333237.1800000075,333185.0800000076,52.09999999991851
38292,2022-12-21 13:00:00,-896.86,332340.3200000075,333185.0800000076,-844.7600000000675
38293,2022-12-21 13:05:00,914.0,333254.3200000075,333185.0800000076,69.23999999993248
38294,2022-12-21 13:10:00,1289.42,334543.7400000075,333185.0800000076,1358.6599999999162
38295,2022-12-21 13:15:00,-1483.44,333060.3000000075,333185.0800000076,-124.78000000008615
38296,2022-12-21 13:20:00,1661.69,334721.9900000075,333185.0800000076,1536.9099999999162
38297,2022-12-21 13:25:00,1516.07,336238.0600000075,333185.0800000076,3052.979999999923
38298,2022-12-21 13:30:00,-1392.36,334845.7000000075,333185.0800000076,1660.6199999999371
38299,2022-12-21 13:35:00,-1400.6,333445.10000000754,333185.0800000076,260.0199999999604
38300,2022-12-21 13:40:00,-330.16,333114.94000000757,333185.0800000076,-70.14000000001397
38301,2022-12-21 13:45:00,1918.77,335033.7100000076,333185.0800000076,1848.6300000000047
38302,2022-12-21 13:50:00,-1819.12,333214.5900000076,333185.0800000076,29.510000000009313
38303,2022-12-21 13:55:00,-1347.54,331867.0500000076,333185.0800000076,-1318.0299999999697
38304,2022-12-21 14:00:00,1393.27,333260.32000000763,333185.0800000076,75.2400000000489
38305,2022-12-21 14:05:00,1642.39,334902.71000000765,333185.0800000076,1717.6300000000629
38306,2022-12-21 14:10:00,-1392.4,333510.3100000076,333185.0800000076,325.2300000000396
38307,2022-12-21 14:15:00,1687.1,335197.4100000076,333185.0800000076,2012.3300000000163
38308,2022-12-21 14:20:00,1903.37,337100.7800000076,333185.0800000076,3915.7000000000116
38309,2022-12-21 14:25:00,1648.06,338748.8400000076,333185.0800000076,5563.760000000009
38310,2022-12-21 14:30:00,631.55,339380.3900000076,333185.0800000076,6195.309999999998
38311,2022-12-21 14:35:00,398.94,339779.3300000076,333185.0800000076,6594.25
38312,2022-12-21 14:40:00,-1629.91,338149.4200000076,333185.0800000076,4964.340000000026
38313,2022-12-21 14:45:00,-1866.04,336283.38000000763,333185.0800000076,3098.3000000000466
38314,2022-12-21 14:50:00,-497.95,335785.4300000076,333185.0800000076,2600.350000000035
38315,2022-12-21 14:55:00,570.66,336356.0900000076,333185.0800000076,3171.0100000000093
38316,2022-12-21 15:00:00,-739.17,335616.9200000076,333185.0800000076,2431.8400000000256
38317,2022-12-21 15:05:00,-1649.47,333967.45000000764,333185.0800000076,782.3700000000536
38318,2022-12-21 15:10:00,461.34,334428.79000000766,333185.0800000076,1243.7100000000792
38319,2022-12-21 15:15:00,-1717.3,332711.4900000077,333185.0800000076,-473.5899999999092
38320,2022-12-21 15:20:00,-244.0,332467.4900000077,333185.0800000076,-717.5899999999092
38321,2022-12-21 15:25:00,924.76,333392.2500000077,333185.0800000076,207.17000000010012
38322,2022-12-21 15:30:00,-1653.83,331738.42000000767,333185.0800000076,-1446.6599999999162
38323,2022-12-21 15:35:00,-1337.71,330400.71000000765,333185.0800000076,-2784.369999999937
38324,2022-12-21 15:40:00,-1574.72,328825.9900000077,333185.0800000076,-4359.089999999909
38325,2022-12-21 15:45:00,-87.14,328738.85000000766,333185.0800000076,-4446.229999999923
38326,2022-12-21 15:50:00,-265.19,328473.66000000766,333185.0800000076,-4711.4199999999255
38327,2022-12-21 15:55:00,-357.33,328116.33000000764,333185.0800000076,-5068.749999999942
38328,2022-12-21 16:00:00,-1693.96,326422.3700000076,333185.0800000076,-6762.709999999963
38329,2022-12-21 16:05:00,1932.11,328354.4800000076,333185.0800000076,-4830.599999999977
38330,2022-12-21 16:10:00,984.19,329338.6700000076,333185.0800000076,-3846.4099999999744
38331,2022-12-21 16:15:00,-10.31,329328.3600000076,333185.0800000076,-3856.719999999972
38332,2022-12-21 16:20:00,-1245.47,328082.89000000764,333185.0800000076,-5102.189999999944
38333,2022-12-21 16:25:00,-559.16,327523.73000000766,333185.0800000076,-5661.3499999999185
38334,2022-12-21 16:30:00,189.77,327713.5000000077,333185.0800000076,-5471.5799999999
38335,2022-12-21 16:35:00,-350.81,327362.6900000077,333185.0800000076,-5822.389999999898
38336,2022-12-21 16:40:00,1873.55,329236.2400000077,333185.0800000076,-3948.839999999909
38337,2022-12-21 16:45:00,-1487.45,327748.79000000766,333185.0800000076,-5436.289999999921
38338,2022-12-21 16:50:00,-1439.84,326308.95000000764,333185.0800000076,-6876.129999999946
38339,2022-12-21 16:55:00,-692.09,325616.8600000076,333185.0800000076,-7568.219999999972
38340,2022-12-22 08:00:00,-518.6,325098.26000000763,325616.8600000076,-518.5999999999767
38341,2022-12-22 08:05:00,1526.12,326624.38000000763,325616.8600000076,1007.5200000000186
38342,2022-12-22 08:10:00,-1978.26,324646.1200000076,325616.8600000076,-970.7399999999907
38343,2022-12-22 08:15:00,-1665.35,322980.77000000764,325616.8600000076,-2636.0899999999674
38344,2022-12-22 08:20:00,16.21,322996.98000000766,325616.8600000076,-2619.8799999999464
38345,2022-12-22 08:25:00,1245.03,324242.0100000077,325616.8600000076,-1374.8499999999185
38346,2022-12-22 08:30:00,-1106.06,323135.9500000077,325616.8600000076,-2480.909999999916
38347,2022-12-22 08:35:00,1291.0,324426.9500000077,325616.8600000076,-1189.9099999999162
38348,2022-12-22 08:40:00,-783.83,323643.1200000077,325616.8600000076,-1973.7399999999325
38349,2022-12-22 08:45:00,-1071.45,322571.67000000767,325616.8600000076,-3045.189999999944
38350,2022-12-22 08:50:00,-1618.11,320953.5600000077,325616.8600000076,-4663.29999999993
38351,2022-12-22 08:55:00,-380.53,320573.03000000765,325616.8600000076,-5043.829999999958
38352,2022-12-22 09:00:00,181.74,320754.77000000764,325616.8600000076,-4862.089999999967
38353,2022-12-22 09:05:00,-1603.05,319151.72000000766,325616.8600000076,-6465.139999999956
38354,2022-12-22 09:10:00,1510.03,320661.7500000077,325616.8600000076,-4955.109999999928
38355,2022-12-22 09:15:00,480.34,321142.0900000077,325616.8600000076,-4474.769999999902
38356,2022-12-22 09:20:00,853.76,321995.8500000077,325616.8600000076,-3621.009999999893
38357,2022-12-22 09:25:00,932.61,322928.4600000077,325616.8600000076,-2688.399999999907
38358,2022-12-22 09:30:00,546.7,323475.1600000077,325616.8600000076,-2141.699999999895
38359,2022-12-22 09:35:00,855.77,324330.93000000773,325616.8600000076,-1285.9299999998766
38360,2022-12-22 09:40:00,808.84,325139.77000000776,325616.8600000076,-477.089999999851
38361,2022-12-22 09:45:00,811.39,325951.1600000078,325616.8600000076,334.300000000163
38362,2022-12-22 09:50:00,-58.81,325892.3500000078,325616.8600000076,275.4900000001653
38363,2022-12-22 09:55:00,1146.69,327039.0400000078,325616.8600000076,1422.1800000001676
38364,2022-12-22 10:00:00,-179.9,326859.14000000776,325616.8600000076,1242.2800000001444
38365,2022-12-22 10:05:00,1476.64,328335.78000000777,325616.8600000076,2718.9200000001583
38366,2022-12-22 10:10:00,-909.79,327425.9900000078,325616.8600000076,1809.1300000001793
38367,2022-12-22 10:15:00,-1404.46,326021.53000000777,325616.8600000076,404.6700000001583
38368,2022-12-22 10:20:00,-1795.51,324226.02000000776,325616.8600000076,-1390.839999999851
38369,2022-12-22 10:25:00,1597.95,325823.9700000078,325616.8600000076,207.11000000016065
38370,2022-12-22 10:30:00,763.77,326587.7400000078,325616.8600000076,970.8800000001793
38371,2022-12-22 10:35:00,566.64,327154.3800000078,325616.8600000076,1537.5200000001932
38372,2022-12-22 10:40:00,319.62,327474.0000000078,325616.8600000076,1857.1400000001886
38373,2022-12-22 10:45:00,-1386.03,326087.9700000078,325616.8600000076,471.11000000016065
38374,2022-12-22 10:50:00,-1957.16,324130.8100000078,325616.8600000076,-1486.0499999998137
38375,2022-12-22 10:55:00,1278.32,325409.1300000078,325616.8600000076,-207.72999999980675
38376,2022-12-22 11:00:00,-1.81,325407.3200000078,325616.8600000076,-209.53999999980442
38377,2022-12-22 11:05:00,1460.32,326867.6400000078,325616.8600000076,1250.7800000002026
38378,2022-12-22 11:10:00,-1466.38,325401.2600000078,325616.8600000076,-215.5999999998021
38379,2022-12-22 11:15:00,267.89,325669.1500000078,325616.8600000076,52.290000000211876
38380,2022-12-22 11:20:00,-1105.39,324563.7600000078,325616.8600000076,-1053.099999999802
38381,2022-12-22 11:25:00,-1492.22,323071.54000000784,325616.8600000076,-2545.319999999774
38382,2022-12-22 11:30:00,-1037.36,322034.18000000785,325616.8600000076,-3582.67999999976
38383,2022-12-22 11:35:00,-1657.42,320376.76000000787,325616.8600000076,-5240.099999999744
38384,2022-12-22 11:40:00,1765.46,322142.2200000079,325616.8600000076,-3474.639999999723
38385,2022-12-22 11:45:00,-1574.73,320567.4900000079,325616.8600000076,-5049.369999999704
38386,2022-12-22 11:50:00,-584.41,319983.08000000793,325616.8600000076,-5633.779999999679
38387,2022-12-22 11:55:00,-1827.36,318155.72000000795,325616.8600000076,-7461.139999999665
38388,2022-12-22 12:00:00,-1418.23,316737.49000000797,325616.8600000076,-8879.369999999646
38389,2022-12-22 12:05:00,-1944.77,314792.72000000795,325616.8600000076,-10824.139999999665
38390,2022-12-22 12:10:00,-1930.18,312862.54000000795,325616.8600000076,-12754.319999999658
38391,2022-12-22 12:15:00,-273.62,312588.92000000796,325616.8600000076,-13027.939999999653
38392,2022-12-22 12:20:00,702.72,313291.64000000793,325616.8600000076,-12325.219999999681
38393,2022-12-22 12:25:00,-1969.96,311321.6800000079,325616.8600000076,-14295.179999999702
38394,2022-12-22 12:30:00,-1792.2,309529.4800000079,325616.8600000076,-16087.379999999714
38395,2022-12-22 12:35:00,-1965.8,307563.6800000079,325616.8600000076,-18053.179999999702
38396,2022-12-22 12:40:00,-531.39,307032.2900000079,325616.8600000076,-18584.569999999716
38397,2022-12-22 12:45:00,-1185.14,305847.1500000079,325616.8600000076,-19769.70999999973
38398,2022-12-22 12:50:00,-1111.71,304735.44000000786,325616.8600000076,-20881.41999999975
38399,2022-12-22 12:55:00,-1695.9,303039.54000000784,325616.8600000076,-22577.319999999774
38400,2022-12-22 13:00:00,1514.48,304554.0200000078,325616.8600000076,-21062.839999999793
38401,2022-12-22 13:05:00,-499.88,304054.1400000078,325616.8600000076,-21562.719999999797
38402,2022-12-22 13:10:00,492.44,304546.5800000078,325616.8600000076,-21070.279999999795
38403,2022-12-22 13:15:00,-1481.05,303065.5300000078,325616.8600000076,-22551.329999999783
38404,2022-12-22 13:20:00,1315.1,304380.6300000078,325616.8600000076,-21236.229999999807
38405,2022-12-22 13:25:00,1774.73,306155.3600000078,325616.8600000076,-19461.499999999825
38406,2022-12-22 13:30:00,13.61,306168.9700000078,325616.8600000076,-19447.88999999984
38407,2022-12-22 13:35:00,536.84,306705.8100000078,325616.8600000076,-18911.049999999814
38408,2022-12-22 13:40:00,715.44,307421.2500000078,325616.8600000076,-18195.60999999981
38409,2022-12-22 13:45:00,1533.68,308954.9300000078,325616.8600000076,-16661.92999999982
38410,2022-12-22 13:50:00,-1729.59,307225.34000000777,325616.8600000076,-18391.519999999844
38411,2022-12-22 13:55:00,1809.41,309034.75000000774,325616.8600000076,-16582.10999999987
38412,2022-12-22 14:00:00,-1842.43,307192.32000000775,325616.8600000076,-18424.539999999863
38413,2022-12-22 14:05:00,-1345.54,305846.78000000777,325616.8600000076,-19770.07999999984
38414,2022-12-22 14:10:00,-577.25,305269.53000000777,325616.8600000076,-20347.32999999984
38415,2022-12-22 14:15:00,-1165.2,304104.33000000776,325616.8600000076,-21512.529999999853
38416,2022-12-22 14:20:00,148.05,304252.38000000775,325616.8600000076,-21364.479999999865
38417,2022-12-22 14:25:00,-112.56,304139.82000000775,325616.8600000076,-21477.039999999863
38418,2022-12-22 14:30:00,287.71,304427.53000000777,325616.8600000076,-21189.32999999984
38419,2022-12-22 14:35:00,-694.66,303732.8700000078,325616.8600000076,-21883.989999999816
38420,2022-12-22 14:40:00,-331.72,303401.1500000078,325616.8600000076,-22215.709999999788
38421,2022-12-22 14:45:00,1766.76,305167.91000000783,325616.8600000076,-20448.94999999978
38422,2022-12-22 14:50:00,-145.5,305022.41000000783,325616.8600000076,-20594.44999999978
38423,2022-12-22 14:55:00,147.51,305169.92000000784,325616.8600000076,-20446.93999999977
38424,2022-12-22 15:00:00,-1911.25,303258.67000000784,325616.8600000076,-22358.18999999977
38425,2022-12-22 15:05:00,366.07,303624.74000000785,325616.8600000076,-21992.119999999763
38426,2022-12-22 15:10:00,207.53,303832.2700000079,325616.8600000076,-21784.589999999735
38427,2022-12-22 15:15:00,469.08,304301.3500000079,325616.8600000076,-21315.50999999972
38428,2022-12-22 15:20:00,-1102.09,303199.26000000787,325616.8600000076,-22417.599999999744
38429,2022-12-22 15:25:00,1481.57,304680.8300000079,325616.8600000076,-20936.029999999737
38430,2022-12-22 15:30:00,-565.78,304115.05000000785,325616.8600000076,-21501.809999999765
38431,2022-12-22 15:35:00,-855.09,303259.9600000078,325616.8600000076,-22356.89999999979
38432,2022-12-22 15:40:00,-1120.66,302139.30000000785,325616.8600000076,-23477.559999999765
38433,2022-12-22 15:45:00,-1722.31,300416.99000000785,325616.8600000076,-25199.869999999763
38434,2022-12-22 15:50:00,-1470.78,298946.2100000078,325616.8600000076,-26670.64999999979
38435,2022-12-22 15:55:00,-392.2,298554.0100000078,325616.8600000076,-27062.849999999802
38436,2022-12-22 16:00:00,-1693.48,296860.5300000078,325616.8600000076,-28756.329999999783
38437,2022-12-22 16:05:00,1010.55,297871.0800000078,325616.8600000076,-27745.779999999795
38438,2022-12-22 16:10:00,1569.84,299440.92000000784,325616.8600000076,-26175.93999999977
38439,2022-12-22 16:15:00,1973.11,301414.0300000078,325616.8600000076,-24202.829999999783
38440,2022-12-22 16:20:00,1201.08,302615.11000000784,325616.8600000076,-23001.749999999767
38441,2022-12-22 16:25:00,1478.28,304093.3900000079,325616.8600000076,-21523.46999999974
38442,2022-12-22 16:30:00,1307.04,305400.43000000785,325616.8600000076,-20216.42999999976
38443,2022-12-22 16:35:00,-1405.13,303995.30000000785,325616.8600000076,-21621.559999999765
38444,2022-12-22 16:40:00,291.98,304287.2800000078,325616.8600000076,-21329.579999999783
38445,2022-12-22 16:45:00,-1847.84,302439.4400000078,325616.8600000076,-23177.41999999981
38446,2022-12-22 16:50:00,639.33,303078.7700000078,325616.8600000076,-22538.089999999793
38447,2022-12-22 16:55:00,920.31,303999.0800000078,325616.8600000076,-21617.779999999795
38448,2022-12-23 08:00:00,406.55,304405.6300000078,303999.0800000078,406.54999999998836
38449,2022-12-23 08:05:00,211.21,304616.8400000078,303999.0800000078,617.7600000000093
38450,2022-12-23 08:10:00,-106.89,304509.9500000078,303999.0800000078,510.86999999999534
38451,2022-12-23 08:15:00,1330.8,305840.7500000078,303999.0800000078,1841.6699999999837
38452,2022-12-23 08:20:00,-1292.42,304548.3300000078,303999.0800000078,549.25
38453,2022-12-23 08:25:00,-1329.25,303219.0800000078,303999.0800000078,-780.0
38454,2022-12-23 08:30:00,1273.3,304492.3800000078,303999.0800000078,493.29999999998836
38455,2022-12-23 08:35:00,-74.96,304417.4200000078,303999.0800000078,418.3399999999674
38456,2022-12-23 08:40:00,-515.9,303901.52000000776,303999.0800000078,-97.56000000005588
38457,2022-12-23 08:45:00,241.24,304142.76000000775,303999.0800000078,143.6799999999348
38458,2022-12-23 08:50:00,-708.4,303434.3600000077,303999.0800000078,-564.7200000000885
38459,2022-12-23 08:55:00,965.84,304400.20000000775,303999.0800000078,401.11999999993714
38460,2022-12-23 09:00:00,-1607.56,302792.64000000776,303999.0800000078,-1206.4400000000605
38461,2022-12-23 09:05:00,974.34,303766.9800000078,303999.0800000078,-232.10000000003492
38462,2022-12-23 09:10:00,-957.04,302809.9400000078,303999.0800000078,-1189.140000000014
38463,2022-12-23 09:15:00,170.57,302980.5100000078,303999.0800000078,-1018.570000000007
38464,2022-12-23 09:20:00,-599.93,302380.5800000078,303999.0800000078,-1618.5
38465,2022-12-23 09:25:00,-717.09,301663.4900000078,303999.0800000078,-2335.5900000000256
38466,2022-12-23 09:30:00,-829.14,300834.3500000078,303999.0800000078,-3164.7300000000396
38467,2022-12-23 09:35:00,-1950.69,298883.6600000078,303999.0800000078,-5115.420000000042
38468,2022-12-23 09:40:00,1723.98,300607.64000000776,303999.0800000078,-3391.4400000000605
38469,2022-12-23 09:45:00,1186.54,301794.18000000773,303999.0800000078,-2204.9000000000815
38470,2022-12-23 09:50:00,-653.32,301140.8600000077,303999.0800000078,-2858.2200000000885
38471,2022-12-23 09:55:00,1909.02,303049.88000000775,303999.0800000078,-949.2000000000698
38472,2022-12-23 10:00:00,1985.83,305035.71000000776,303999.0800000078,1036.6299999999464
38473,2022-12-23 10:05:00,1268.0,306303.71000000776,303999.0800000078,2304.6299999999464
38474,2022-12-23 10:10:00,1307.99,307611.70000000775,303999.0800000078,3612.619999999937
38475,2022-12-23 10:15:00,1712.01,309323.71000000776,303999.0800000078,5324.629999999946
38476,2022-12-23 10:20:00,705.9,310029.6100000078,303999.0800000078,6030.52999999997
38477,2022-12-23 10:25:00,627.13,310656.7400000078,303999.0800000078,6657.659999999974
38478,2022-12-23 10:30:00,-1711.87,308944.8700000078,303999.0800000078,4945.789999999979
38479,2022-12-23 10:35:00,-1163.67,307781.2000000078,303999.0800000078,3782.1199999999953
38480,2022-12-23 10:40:00,-1321.89,306459.3100000078,303999.0800000078,2460.2299999999814
38481,2022-12-23 10:45:00,-222.99,306236.3200000078,303999.0800000078,2237.2399999999907
38482,2022-12-23 10:50:00,227.66,306463.9800000078,303999.0800000078,2464.899999999965
38483,2022-12-23 10:55:00,-1628.2,304835.78000000777,303999.0800000078,836.6999999999534
38484,2022-12-23 11:00:00,-882.09,303953.69000000774,303999.0800000078,-45.39000000007218
38485,2022-12-23 11:05:00,467.38,304421.07000000775,303999.0800000078,421.9899999999325
38486,2022-12-23 11:10:00,371.27,304792.34000000777,303999.0800000078,793.2599999999511
38487,2022-12-23 11:15:00,-1019.48,303772.8600000078,303999.0800000078,-226.22000000003027
38488,2022-12-23 11:20:00,-201.63,303571.2300000078,303999.0800000078,-427.8500000000349
38489,2022-12-23 11:25:00,-1669.25,301901.9800000078,303999.0800000078,-2097.100000000035
38490,2022-12-23 11:30:00,1987.06,303889.0400000078,303999.0800000078,-110.04000000003725
38491,2022-12-23 11:35:00,-503.41,303385.6300000078,303999.0800000078,-613.4500000000116
38492,2022-12-23 11:40:00,-542.43,302843.2000000078,303999.0800000078,-1155.8800000000047
38493,2022-12-23 11:45:00,-1758.99,301084.2100000078,303999.0800000078,-2914.8699999999953
38494,2022-12-23 11:50:00,-1483.62,299600.5900000078,303999.0800000078,-4398.489999999991
38495,2022-12-23 11:55:00,-362.14,299238.4500000078,303999.0800000078,-4760.630000000005
38496,2022-12-23 12:00:00,-362.81,298875.6400000078,303999.0800000078,-5123.440000000002
38497,2022-12-23 12:05:00,739.73,299615.3700000078,303999.0800000078,-4383.710000000021
38498,2022-12-23 12:10:00,-420.7,299194.6700000078,303999.0800000078,-4804.410000000033
38499,2022-12-23 12:15:00,1997.17,301191.84000000777,303999.0800000078,-2807.240000000049
38500,2022-12-23 12:20:00,1667.45,302859.2900000078,303999.0800000078,-1139.7900000000373
38501,2022-12-23 12:25:00,530.77,303390.0600000078,303999.0800000078,-609.0200000000186
38502,2022-12-23 12:30:00,-1762.46,301627.6000000078,303999.0800000078,-2371.4800000000396
38503,2022-12-23 12:35:00,-198.37,301429.2300000078,303999.0800000078,-2569.850000000035
38504,2022-12-23 12:40:00,-310.83,301118.40000000776,303999.0800000078,-2880.680000000051
38505,2022-12-23 12:45:00,-1398.63,299719.77000000776,303999.0800000078,-4279.310000000056
38506,2022-12-23 12:50:00,-1910.03,297809.74000000773,303999.0800000078,-6189.340000000084
38507,2022-12-23 12:55:00,1136.29,298946.0300000077,303999.0800000078,-5053.050000000105
38508,2022-12-23 13:00:00,-148.67,298797.3600000077,303999.0800000078,-5201.7200000000885
38509,2022-12-23 13:05:00,-1470.66,297326.70000000775,303999.0800000078,-6672.380000000063
38510,2022-12-23 13:10:00,-995.04,296331.6600000078,303999.0800000078,-7667.420000000042
38511,2022-12-23 13:15:00,269.27,296600.9300000078,303999.0800000078,-7398.150000000023
38512,2022-12-23 13:20:00,-1129.07,295471.8600000078,303999.0800000078,-8527.22000000003
38513,2022-12-23 13:25:00,-1288.33,294183.53000000777,303999.0800000078,-9815.550000000047
38514,2022-12-23 13:30:00,-874.76,293308.77000000776,303999.0800000078,-10690.310000000056
38515,2022-12-23 13:35:00,1561.58,294870.3500000078,303999.0800000078,-9128.73000000004
38516,2022-12-23 13:40:00,-893.23,293977.1200000078,303999.0800000078,-10021.960000000021
38517,2022-12-23 13:45:00,-1688.51,292288.6100000078,303999.0800000078,-11710.47000000003
38518,2022-12-23 13:50:00,1097.98,293386.59000000777,303999.0800000078,-10612.490000000049
38519,2022-12-23 13:55:00,1225.18,294611.77000000776,303999.0800000078,-9387.310000000056
38520,2022-12-23 14:00:00,323.18,294934.95000000775,303999.0800000078,-9064.130000000063
38521,2022-12-23 14:05:00,1450.52,296385.4700000078,303999.0800000078,-7613.610000000044
38522,2022-12-23 14:10:00,1386.51,297771.9800000078,303999.0800000078,-6227.100000000035
38523,2022-12-23 14:15:00,-1162.39,296609.59000000777,303999.0800000078,-7389.490000000049
38524,2022-12-23 14:20:00,-1888.43,294721.1600000078,303999.0800000078,-9277.920000000042
38525,2022-12-23 14:25:00,-275.37,294445.7900000078,303999.0800000078,-9553.290000000037
38526,2022-12-23 14:30:00,-736.09,293709.70000000775,303999.0800000078,-10289.380000000063
38527,2022-12-23 14:35:00,-1451.52,292258.18000000773,303999.0800000078,-11740.900000000081
38528,2022-12-23 14:40:00,-1671.17,290587.01000000775,303999.0800000078,-13412.070000000065
38529,2022-12-23 14:45:00,-948.37,289638.64000000776,303999.0800000078,-14360.44000000006
38530,2022-12-23 14:50:00,-1180.52,288458.12000000774,303999.0800000078,-15540.96000000008
38531,2022-12-23 14:55:00,-1522.55,286935.57000000775,303999.0800000078,-17063.510000000068
38532,2022-12-23 15:00:00,-163.46,286772.1100000077,303999.0800000078,-17226.97000000009
38533,2022-12-23 15:05:00,842.42,287614.5300000077,303999.0800000078,-16384.550000000105
38534,2022-12-23 15:10:00,-855.45,286759.0800000077,303999.0800000078,-17240.000000000116
38535,2022-12-23 15:15:00,615.8,287374.8800000077,303999.0800000078,-16624.200000000128
38536,2022-12-23 15:20:00,1720.32,289095.2000000077,303999.0800000078,-14903.880000000121
38537,2022-12-23 15:25:00,-1397.19,287698.0100000077,303999.0800000078,-16301.070000000123
38538,2022-12-23 15:30:00,1425.85,289123.86000000767,303999.0800000078,-14875.220000000147
38539,2022-12-23 15:35:00,-285.93,288837.9300000077,303999.0800000078,-15161.15000000014
38540,2022-12-23 15:40:00,1212.4,290050.3300000077,303999.0800000078,-13948.750000000116
38541,2022-12-23 15:45:00,-1780.33,288270.0000000077,303999.0800000078,-15729.080000000133
38542,2022-12-23 15:50:00,751.57,289021.5700000077,303999.0800000078,-14977.510000000126
38543,2022-12-23 15:55:00,669.03,289690.6000000077,303999.0800000078,-14308.480000000098
38544,2022-12-23 16:00:00,-1700.25,287990.3500000077,303999.0800000078,-16008.730000000098
38545,2022-12-23 16:05:00,-592.55,287397.80000000773,303999.0800000078,-16601.280000000086
38546,2022-12-23 16:10:00,-900.24,286497.56000000774,303999.0800000078,-17501.520000000077
38547,2022-12-23 16:15:00,1264.97,287762.5300000077,303999.0800000078,-16236.550000000105
38548,2022-12-23 16:20:00,1983.44,289745.9700000077,303999.0800000078,-14253.110000000102
38549,2022-12-23 16:25:00,-750.49,288995.4800000077,303999.0800000078,-15003.600000000093
38550,2022-12-23 16:30:00,-1956.41,287039.07000000775,303999.0800000078,-16960.010000000068
38551,2022-12-23 16:35:00,1168.66,288207.7300000077,303999.0800000078,-15791.350000000093
38552,2022-12-23 16:40:00,-1043.07,287164.6600000077,303999.0800000078,-16834.4200000001
38553,2022-12-23 16:45:00,-1503.27,285661.3900000077,303999.0800000078,-18337.69000000012
38554,2022-12-23 16:50:00,748.98,286410.3700000077,303999.0800000078,-17588.710000000137
38555,2022-12-23 16:55:00,-1889.97,284520.4000000077,303999.0800000078,-19478.68000000011
38556,2022-12-24 08:00:00,1397.59,285917.99000000773,284520.4000000077,1397.5900000000256
38557,2022-12-24 08:05:00,-122.8,285795.19000000774,284520.4000000077,1274.7900000000373
38558,2022-12-24 08:10:00,-514.03,285281.1600000077,284520.4000000077,760.7600000000093
38559,2022-12-24 08:15:00,1116.63,286397.7900000077,284520.4000000077,1877.390000000014
38560,2022-12-24 08:20:00,-1014.61,285383.18000000773,284520.4000000077,862.7800000000279
38561,2022-12-24 08:25:00,-514.5,284868.68000000773,284520.4000000077,348.28000000002794
38562,2022-12-24 08:30:00,-1752.79,283115.89000000776,284520.4000000077,-1404.509999999951
38563,2022-12-24 08:35:00,171.07,283286.96000000776,284520.4000000077,-1233.4399999999441
38564,2022-12-24 08:40:00,110.76,283397.7200000078,284520.4000000077,-1122.6799999999348
38565,2022-12-24 08:45:00,-1223.66,282174.0600000078,284520.4000000077,-2346.339999999909
38566,2022-12-24 08:50:00,-320.28,281853.78000000777,284520.4000000077,-2666.619999999937
38567,2022-12-24 08:55:00,149.71,282003.4900000078,284520.4000000077,-2516.909999999916
38568,2022-12-24 09:00:00,-114.07,281889.4200000078,284520.4000000077,-2630.979999999923
38569,2022-12-24 09:05:00,-1528.1,280361.3200000078,284520.4000000077,-4159.0799999999
38570,2022-12-24 09:10:00,973.22,281334.5400000078,284520.4000000077,-3185.859999999928
38571,2022-12-24 09:15:00,1163.56,282498.1000000078,284520.4000000077,-2022.2999999999302
38572,2022-12-24 09:20:00,-1030.87,281467.2300000078,284520.4000000077,-3053.1699999999255
38573,2022-12-24 09:25:00,-1589.34,279877.89000000776,284520.4000000077,-4642.509999999951
38574,2022-12-24 09:30:00,-618.63,279259.26000000775,284520.4000000077,-5261.139999999956
38575,2022-12-24 09:35:00,-762.75,278496.51000000775,284520.4000000077,-6023.889999999956
38576,2022-12-24 09:40:00,1380.77,279877.28000000777,284520.4000000077,-4643.119999999937
38577,2022-12-24 09:45:00,462.96,280340.2400000078,284520.4000000077,-4180.159999999916
38578,2022-12-24 09:50:00,-910.72,279429.5200000078,284520.4000000077,-5090.879999999888
38579,2022-12-24 09:55:00,-1067.13,278362.3900000078,284520.4000000077,-6158.009999999893
38580,2022-12-24 10:00:00,-1879.71,276482.6800000078,284520.4000000077,-8037.719999999914
38581,2022-12-24 10:05:00,1551.72,278034.40000000776,284520.4000000077,-6485.999999999942
38582,2022-12-24 10:10:00,1168.89,279203.2900000078,284520.4000000077,-5317.109999999928
38583,2022-12-24 10:15:00,550.18,279753.4700000078,284520.4000000077,-4766.929999999935
38584,2022-12-24 10:20:00,105.16,279858.63000000775,284520.4000000077,-4661.76999999996
38585,2022-12-24 10:25:00,677.37,280536.00000000774,284520.4000000077,-3984.399999999965
38586,2022-12-24 10:30:00,-1577.96,278958.0400000077,284520.4000000077,-5562.359999999986
38587,2022-12-24 10:35:00,-192.57,278765.4700000077,284520.4000000077,-5754.929999999993
38588,2022-12-24 10:40:00,442.46,279207.93000000773,284520.4000000077,-5312.469999999972
38589,2022-12-24 10:45:00,846.52,280054.45000000775,284520.4000000077,-4465.949999999953
38590,2022-12-24 10:50:00,-1488.86,278565.59000000777,284520.4000000077,-5954.8099999999395
38591,2022-12-24 10:55:00,-1534.48,277031.1100000078,284520.4000000077,-7489.289999999921
38592,2022-12-24 11:00:00,1789.09,278820.2000000078,284520.4000000077,-5700.199999999895
38593,2022-12-24 11:05:00,1777.5,280597.7000000078,284520.4000000077,-3922.699999999895
38594,2022-12-24 11:10:00,1418.82,282016.5200000078,284520.4000000077,-2503.8799999998882
38595,2022-12-24 11:15:00,-182.58,281833.9400000078,284520.4000000077,-2686.4599999999045
38596,2022-12-24 11:20:00,6.62,281840.5600000078,284520.4000000077,-2679.839999999909
38597,2022-12-24 11:25:00,131.93,281972.4900000078,284520.4000000077,-2547.909999999916
38598,2022-12-24 11:30:00,263.71,282236.2000000078,284520.4000000077,-2284.199999999895
38599,2022-12-24 11:35:00,477.51,282713.7100000078,284520.4000000077,-1806.689999999886
38600,2022-12-24 11:40:00,1171.44,283885.1500000078,284520.4000000077,-635.2499999998836
38601,2022-12-24 11:45:00,1604.15,285489.30000000785,284520.4000000077,968.9000000001397
38602,2022-12-24 11:50:00,1390.63,286879.93000000785,284520.4000000077,2359.5300000001444
38603,2022-12-24 11:55:00,179.15,287059.0800000079,284520.4000000077,2538.6800000001676
38604,2022-12-24 12:00:00,1685.26,288744.3400000079,284520.4000000077,4223.940000000177
38605,2022-12-24 12:05:00,279.66,289024.00000000786,284520.4000000077,4503.600000000151
38606,2022-12-24 12:10:00,1439.49,290463.49000000785,284520.4000000077,5943.090000000142
38607,2022-12-24 12:15:00,891.17,291354.66000000783,284520.4000000077,6834.260000000126
38608,2022-12-24 12:20:00,-1103.63,290251.0300000078,284520.4000000077,5730.630000000121
38609,2022-12-24 12:25:00,36.42,290287.4500000078,284520.4000000077,5767.050000000105
38610,2022-12-24 12:30:00,1716.76,292004.2100000078,284520.4000000077,7483.810000000114
38611,2022-12-24 12:35:00,-424.48,291579.73000000784,284520.4000000077,7059.330000000133
38612,2022-12-24 12:40:00,-1128.78,290450.9500000078,284520.4000000077,5930.550000000105
38613,2022-12-24 12:45:00,1807.91,292258.8600000078,284520.4000000077,7738.460000000079
38614,2022-12-24 12:50:00,926.5,293185.3600000078,284520.4000000077,8664.96000000008
38615,2022-12-24 12:55:00,-1372.34,291813.02000000776,284520.4000000077,7292.620000000054
38616,2022-12-24 13:00:00,1147.25,292960.27000000776,284520.4000000077,8439.870000000054
38617,2022-12-24 13:05:00,1661.78,294622.0500000078,284520.4000000077,10101.650000000081
38618,2022-12-24 13:10:00,-175.42,294446.6300000078,284520.4000000077,9926.230000000098
38619,2022-12-24 13:15:00,20.62,294467.2500000078,284520.4000000077,9946.850000000093
38620,2022-12-24 13:20:00,1369.03,295836.2800000078,284520.4000000077,11315.880000000121
38621,2022-12-24 13:25:00,-876.11,294960.17000000784,284520.4000000077,10439.770000000135
38622,2022-12-24 13:30:00,-1046.37,293913.80000000785,284520.4000000077,9393.40000000014
38623,2022-12-24 13:35:00,153.12,294066.92000000784,284520.4000000077,9546.520000000135
38624,2022-12-24 13:40:00,-807.32,293259.60000000783,284520.4000000077,8739.200000000128
38625,2022-12-24 13:45:00,-790.87,292468.73000000784,284520.4000000077,7948.330000000133
38626,2022-12-24 13:50:00,-1629.35,290839.38000000786,284520.4000000077,6318.980000000156
38627,2022-12-24 13:55:00,435.26,291274.6400000079,284520.4000000077,6754.240000000165
38628,2022-12-24 14:00:00,1394.23,292668.87000000785,284520.4000000077,8148.470000000147
38629,2022-12-24 14:05:00,1990.34,294659.2100000079,284520.4000000077,10138.810000000172
38630,2022-12-24 14:10:00,-905.52,293753.69000000786,284520.4000000077,9233.290000000154
38631,2022-12-24 14:15:00,175.11,293928.80000000785,284520.4000000077,9408.40000000014
38632,2022-12-24 14:20:00,127.24,294056.04000000784,284520.4000000077,9535.64000000013
38633,2022-12-24 14:25:00,-1192.43,292863.61000000784,284520.4000000077,8343.210000000137
38634,2022-12-24 14:30:00,-56.21,292807.4000000078,284520.4000000077,8287.000000000116
38635,2022-12-24 14:35:00,-1702.59,291104.8100000078,284520.4000000077,6584.410000000091
38636,2022-12-24 14:40:00,925.55,292030.3600000078,284520.4000000077,7509.960000000079
38637,2022-12-24 14:45:00,1362.56,293392.9200000078,284520.4000000077,8872.520000000077
38638,2022-12-24 14:50:00,-52.55,293340.3700000078,284520.4000000077,8819.970000000088
38639,2022-12-24 14:55:00,1320.22,294660.59000000777,284520.4000000077,10140.19000000006
38640,2022-12-24 15:00:00,625.96,295286.5500000078,284520.4000000077,10766.150000000081
38641,2022-12-24 15:05:00,844.08,296130.6300000078,284520.4000000077,11610.230000000098
38642,2022-12-24 15:10:00,729.74,296860.3700000078,284520.4000000077,12339.970000000088
38643,2022-12-24 15:15:00,-998.64,295861.7300000078,284520.4000000077,11341.330000000075
38644,2022-12-24 15:20:00,1950.1,297811.83000000776,284520.4000000077,13291.430000000051
38645,2022-12-24 15:25:00,-620.95,297190.88000000775,284520.4000000077,12670.48000000004
38646,2022-12-24 15:30:00,-744.11,296446.77000000776,284520.4000000077,11926.370000000054
38647,2022-12-24 15:35:00,537.21,296983.9800000078,284520.4000000077,12463.580000000075
38648,2022-12-24 15:40:00,-892.73,296091.2500000078,284520.4000000077,11570.850000000093
38649,2022-12-24 15:45:00,1261.19,297352.4400000078,284520.4000000077,12832.040000000095
38650,2022-12-24 15:50:00,-503.61,296848.8300000078,284520.4000000077,12328.43000000011
38651,2022-12-24 15:55:00,789.2,297638.0300000078,284520.4000000077,13117.630000000121
38652,2022-12-24 16:00:00,-437.68,297200.35000000783,284520.4000000077,12679.950000000128
38653,2022-12-24 16:05:00,-1031.28,296169.0700000078,284520.4000000077,11648.6700000001
38654,2022-12-24 16:10:00,-1123.94,295045.1300000078,284520.4000000077,10524.730000000098
38655,2022-12-24 16:15:00,-880.02,294165.1100000078,284520.4000000077,9644.71000000008
38656,2022-12-24 16:20:00,477.19,294642.3000000078,284520.4000000077,10121.900000000081
38657,2022-12-24 16:25:00,1514.28,296156.5800000078,284520.4000000077,11636.18000000011
38658,2022-12-24 16:30:00,544.66,296701.2400000078,284520.4000000077,12180.840000000084
38659,2022-12-24 16:35:00,-931.07,295770.1700000078,284520.4000000077,11249.770000000077
38660,2022-12-24 16:40:00,-1080.48,294689.6900000078,284520.4000000077,10169.290000000095
38661,2022-12-24 16:45:00,-514.74,294174.9500000078,284520.4000000077,9654.550000000105
38662,2022-12-24 16:50:00,-56.85,294118.10000000783,284520.4000000077,9597.700000000128
38663,2022-12-24 16:55:00,-1449.38,292668.72000000783,284520.4000000077,8148.320000000123
38664,2022-12-25 08:00:00,-598.07,292070.6500000078,292668.72000000783,-598.070000000007
38665,2022-12-25 08:05:00,-1977.6,290093.05000000785,292668.72000000783,-2575.6699999999837
38666,2022-12-25 08:10:00,-1068.97,289024.0800000079,292668.72000000783,-3644.6399999999558
38667,2022-12-25 08:15:00,-955.04,288069.0400000079,292668.72000000783,-4599.679999999935
38668,2022-12-25 08:20:00,1870.9,289939.9400000079,292668.72000000783,-2728.7799999999115
38669,2022-12-25 08:25:00,1411.7,291351.64000000793,292668.72000000783,-1317.0799999998999
38670,2022-12-25 08:30:00,1234.53,292586.17000000796,292668.72000000783,-82.54999999987194
38671,2022-12-25 08:35:00,626.71,293212.880000008,292668.72000000783,544.160000000149
38672,2022-12-25 08:40:00,-1015.53,292197.35000000795,292668.72000000783,-471.3699999998789
38673,2022-12-25 08:45:00,402.51,292599.86000000796,292668.72000000783,-68.85999999986961
38674,2022-12-25 08:50:00,483.69,293083.55000000796,292668.72000000783,414.8300000001327
38675,2022-12-25 08:55:00,-37.08,293046.47000000795,292668.72000000783,377.7500000001164
38676,2022-12-25 09:00:00,-697.04,292349.43000000797,292668.72000000783,-319.28999999986263
38677,2022-12-25 09:05:00,758.16,293107.59000000794,292668.72000000783,438.87000000011176
38678,2022-12-25 09:10:00,-1940.85,291166.74000000797,292668.72000000783,-1501.979999999865
38679,2022-12-25 09:15:00,-1532.43,289634.310000008,292668.72000000783,-3034.409999999858
38680,2022-12-25 09:20:00,-851.43,288782.880000008,292668.72000000783,-3885.839999999851
38681,2022-12-25 09:25:00,413.93,289196.810000008,292668.72000000783,-3471.909999999858
38682,2022-12-25 09:30:00,-1252.94,287943.87000000797,292668.72000000783,-4724.84999999986
38683,2022-12-25 09:35:00,119.5,288063.37000000797,292668.72000000783,-4605.34999999986
38684,2022-12-25 09:40:00,1091.59,289154.960000008,292668.72000000783,-3513.7599999998347
38685,2022-12-25 09:45:00,-1903.19,287251.770000008,292668.72000000783,-5416.949999999837
38686,2022-12-25 09:50:00,-1261.71,285990.060000008,292668.72000000783,-6678.659999999858
38687,2022-12-25 09:55:00,571.34,286561.400000008,292668.72000000783,-6107.319999999832
38688,2022-12-25 10:00:00,-1304.88,285256.520000008,292668.72000000783,-7412.199999999837
38689,2022-12-25 10:05:00,1319.49,286576.010000008,292668.72000000783,-6092.709999999846
38690,2022-12-25 10:10:00,575.71,287151.720000008,292668.72000000783,-5516.999999999825
38691,2022-12-25 10:15:00,-382.7,286769.020000008,292668.72000000783,-5899.699999999837
38692,2022-12-25 10:20:00,1841.55,288610.570000008,292668.72000000783,-4058.1499999998487
38693,2022-12-25 10:25:00,-400.68,288209.890000008,292668.72000000783,-4458.829999999842
38694,2022-12-25 10:30:00,-94.21,288115.68000000797,292668.72000000783,-4553.039999999863
38695,2022-12-25 10:35:00,-1886.85,286228.830000008,292668.72000000783,-6439.889999999839
38696,2022-12-25 10:40:00,864.12,287092.950000008,292668.72000000783,-5575.769999999844
38697,2022-12-25 10:45:00,1891.43,288984.380000008,292668.72000000783,-3684.339999999851
38698,2022-12-25 10:50:00,1888.72,290873.10000000795,292668.72000000783,-1795.619999999879
38699,2022-12-25 10:55:00,129.79,291002.89000000793,292668.72000000783,-1665.8299999998999
38700,2022-12-25 11:00:00,846.88,291849.77000000793,292668.72000000783,-818.9499999998952
38701,2022-12-25 11:05:00,-507.67,291342.10000000795,292668.72000000783,-1326.619999999879
38702,2022-12-25 11:10:00,-769.7,290572.40000000794,292668.72000000783,-2096.3199999998906
38703,2022-12-25 11:15:00,1199.99,291772.39000000793,292668.72000000783,-896.3299999998999
38704,2022-12-25 11:20:00,1550.34,293322.73000000796,292668.72000000783,654.0100000001257
38705,2022-12-25 11:25:00,997.05,294319.78000000794,292668.72000000783,1651.060000000114
38706,2022-12-25 11:30:00,-968.57,293351.21000000794,292668.72000000783,682.4900000001071
38707,2022-12-25 11:35:00,-1806.31,291544.90000000794,292668.72000000783,-1123.8199999998906
38708,2022-12-25 11:40:00,-88.62,291456.28000000794,292668.72000000783,-1212.439999999886
38709,2022-12-25 11:45:00,1420.93,292877.21000000794,292668.72000000783,208.4900000001071
38710,2022-12-25 11:50:00,-1097.03,291780.1800000079,292668.72000000783,-888.5399999999208
38711,2022-12-25 11:55:00,783.88,292564.0600000079,292668.72000000783,-104.65999999991618
38712,2022-12-25 12:00:00,1388.18,293952.2400000079,292668.72000000783,1283.5200000000768
38713,2022-12-25 12:05:00,-994.6,292957.64000000793,292668.72000000783,288.9200000001001
38714,2022-12-25 12:10:00,1296.73,294254.3700000079,292668.72000000783,1585.6500000000815
38715,2022-12-25 12:15:00,1632.7,295887.0700000079,292668.72000000783,3218.350000000093
38716,2022-12-25 12:20:00,-279.39,295607.6800000079,292668.72000000783,2938.960000000079
38717,2022-12-25 12:25:00,-1653.91,293953.77000000793,292668.72000000783,1285.0500000001048
38718,2022-12-25 12:30:00,1895.33,295849.10000000795,292668.72000000783,3180.380000000121
38719,2022-12-25 12:35:00,-440.48,295408.62000000797,292668.72000000783,2739.9000000001397
38720,2022-12-25 12:40:00,1029.8,296438.42000000796,292668.72000000783,3769.700000000128
38721,2022-12-25 12:45:00,-1597.42,294841.000000008,292668.72000000783,2172.2800000001444
38722,2022-12-25 12:50:00,1251.7,296092.700000008,292668.72000000783,3423.980000000156
38723,2022-12-25 12:55:00,-376.17,295716.530000008,292668.72000000783,3047.8100000001723
38724,2022-12-25 13:00:00,-92.75,295623.780000008,292668.72000000783,2955.0600000001723
38725,2022-12-25 13:05:00,-59.67,295564.110000008,292668.72000000783,2895.3900000001886
38726,2022-12-25 13:10:00,-395.38,295168.730000008,292668.72000000783,2500.010000000184
38727,2022-12-25 13:15:00,-562.37,294606.360000008,292668.72000000783,1937.6400000001886
38728,2022-12-25 13:20:00,-427.4,294178.960000008,292668.72000000783,1510.2400000001653
38729,2022-12-25 13:25:00,1438.2,295617.160000008,292668.72000000783,2948.440000000177
38730,2022-12-25 13:30:00,1965.33,297582.490000008,292668.72000000783,4913.770000000193
38731,2022-12-25 13:35:00,142.74,297725.230000008,292668.72000000783,5056.510000000184
38732,2022-12-25 13:40:00,124.34,297849.57000000804,292668.72000000783,5180.85000000021
38733,2022-12-25 13:45:00,955.53,298805.10000000807,292668.72000000783,6136.3800000002375
38734,2022-12-25 13:50:00,-61.1,298744.0000000081,292668.72000000783,6075.280000000261
38735,2022-12-25 13:55:00,423.2,299167.2000000081,292668.72000000783,6498.480000000272
38736,2022-12-25 14:00:00,861.41,300028.6100000081,292668.72000000783,7359.890000000247
38737,2022-12-25 14:05:00,468.32,300496.9300000081,292668.72000000783,7828.210000000254
38738,2022-12-25 14:10:00,1630.18,302127.1100000081,292668.72000000783,9458.390000000247
38739,2022-12-25 14:15:00,209.22,302336.33000000805,292668.72000000783,9667.610000000219
38740,2022-12-25 14:20:00,-1966.42,300369.91000000807,292668.72000000783,7701.190000000235
38741,2022-12-25 14:25:00,-639.55,299730.3600000081,292668.72000000783,7061.640000000247
38742,2022-12-25 14:30:00,651.88,300382.2400000081,292668.72000000783,7713.5200000002515
38743,2022-12-25 14:35:00,-680.17,299702.0700000081,292668.72000000783,7033.350000000268
38744,2022-12-25 14:40:00,-1144.63,298557.4400000081,292668.72000000783,5888.720000000263
38745,2022-12-25 14:45:00,1822.74,300380.1800000081,292668.72000000783,7711.460000000254
38746,2022-12-25 14:50:00,50.62,300430.8000000081,292668.72000000783,7762.080000000249
38747,2022-12-25 14:55:00,1746.46,302177.2600000081,292668.72000000783,9508.54000000027
38748,2022-12-25 15:00:00,744.23,302921.4900000081,292668.72000000783,10252.770000000251
38749,2022-12-25 15:05:00,-556.48,302365.0100000081,292668.72000000783,9696.29000000027
38750,2022-12-25 15:10:00,-35.62,302329.3900000081,292668.72000000783,9660.670000000275
38751,2022-12-25 15:15:00,340.89,302670.2800000081,292668.72000000783,10001.560000000289
38752,2022-12-25 15:20:00,-259.33,302410.9500000081,292668.72000000783,9742.230000000272
38753,2022-12-25 15:25:00,1561.93,303972.8800000081,292668.72000000783,11304.160000000265
38754,2022-12-25 15:30:00,-226.25,303746.6300000081,292668.72000000783,11077.910000000265
38755,2022-12-25 15:35:00,-807.01,302939.6200000081,292668.72000000783,10270.900000000256
38756,2022-12-25 15:40:00,105.32,303044.9400000081,292668.72000000783,10376.220000000263
38757,2022-12-25 15:45:00,1545.39,304590.3300000081,292668.72000000783,11921.610000000277
38758,2022-12-25 15:50:00,-406.86,304183.4700000081,292668.72000000783,11514.750000000291
38759,2022-12-25 15:55:00,-1060.64,303122.8300000081,292668.72000000783,10454.110000000277
38760,2022-12-25 16:00:00,879.44,304002.2700000081,292668.72000000783,11333.55000000028
38761,2022-12-25 16:05:00,854.49,304856.7600000081,292668.72000000783,12188.04000000027
38762,2022-12-25 16:10:00,1291.9,306148.6600000081,292668.72000000783,13479.940000000293
38763,2022-12-25 16:15:00,-1713.39,304435.2700000081,292668.72000000783,11766.55000000028
38764,2022-12-25 16:20:00,1229.08,305664.3500000081,292668.72000000783,12995.630000000296
38765,2022-12-25 16:25:00,-1948.65,303715.7000000081,292668.72000000783,11046.980000000272
38766,2022-12-25 16:30:00,1404.31,305120.0100000081,292668.72000000783,12451.29000000027
38767,2022-12-25 16:35:00,634.27,305754.2800000081,292668.72000000783,13085.560000000289
38768,2022-12-25 16:40:00,-572.42,305181.86000000814,292668.72000000783,12513.140000000305
38769,2022-12-25 16:45:00,1214.74,306396.6000000081,292668.72000000783,13727.880000000296
38770,2022-12-25 16:50:00,-880.5,305516.1000000081,292668.72000000783,12847.380000000296
38771,2022-12-25 16:55:00,552.2,306068.30000000814,292668.72000000783,13399.580000000307
38772,2022-12-26 08:00:00,-101.59,305966.7100000081,306068.30000000814,-101.59000000002561
38773,2022-12-26 08:05:00,1272.38,307239.0900000081,306068.30000000814,1170.789999999979
38774,2022-12-26 08:10:00,773.02,308012.11000000814,306068.30000000814,1943.8099999999977
38775,2022-12-26 08:15:00,272.07,308284.18000000814,306068.30000000814,2215.8800000000047
38776,2022-12-26 08:20:00,1718.14,310002.32000000816,306068.30000000814,3934.0200000000186
38777,2022-12-26 08:25:00,-203.7,309798.62000000814,306068.30000000814,3730.320000000007
38778,2022-12-26 08:30:00,914.9,310713.52000000817,306068.30000000814,4645.22000000003
38779,2022-12-26 08:35:00,249.84,310963.3600000082,306068.30000000814,4895.060000000056
38780,2022-12-26 08:40:00,140.15,311103.5100000082,306068.30000000814,5035.210000000079
38781,2022-12-26 08:45:00,520.78,311624.29000000824,306068.30000000814,5555.990000000107
38782,2022-12-26 08:50:00,1489.9,313114.19000000827,306068.30000000814,7045.89000000013
38783,2022-12-26 08:55:00,1496.86,314611.05000000825,306068.30000000814,8542.750000000116
38784,2022-12-26 09:00:00,-532.43,314078.62000000826,306068.30000000814,8010.320000000123
38785,2022-12-26 09:05:00,1714.51,315793.13000000827,306068.30000000814,9724.830000000133
38786,2022-12-26 09:10:00,654.94,316448.0700000083,306068.30000000814,10379.770000000135
38787,2022-12-26 09:15:00,-1281.11,315166.9600000083,306068.30000000814,9098.660000000149
38788,2022-12-26 09:20:00,-1558.97,313607.9900000083,306068.30000000814,7539.690000000177
38789,2022-12-26 09:25:00,-1553.86,312054.1300000083,306068.30000000814,5985.830000000191
38790,2022-12-26 09:30:00,1935.97,313990.1000000083,306068.30000000814,7921.800000000163
38791,2022-12-26 09:35:00,185.48,314175.5800000083,306068.30000000814,8107.280000000144
38792,2022-12-26 09:40:00,1365.42,315541.00000000827,306068.30000000814,9472.700000000128
38793,2022-12-26 09:45:00,1997.96,317538.9600000083,306068.30000000814,11470.660000000149
38794,2022-12-26 09:50:00,-1161.16,316377.8000000083,306068.30000000814,10309.500000000175
38795,2022-12-26 09:55:00,-478.83,315898.9700000083,306068.30000000814,9830.670000000158
38796,2022-12-26 10:00:00,-1924.19,313974.7800000083,306068.30000000814,7906.480000000156
38797,2022-12-26 10:05:00,1738.52,315713.3000000083,306068.30000000814,9645.000000000175
38798,2022-12-26 10:10:00,378.49,316091.7900000083,306068.30000000814,10023.490000000165
38799,2022-12-26 10:15:00,-1657.55,314434.2400000083,306068.30000000814,8365.940000000177
38800,2022-12-26 10:20:00,-1279.39,313154.8500000083,306068.30000000814,7086.550000000163
38801,2022-12-26 10:25:00,827.66,313982.5100000083,306068.30000000814,7914.210000000137
38802,2022-12-26 10:30:00,790.47,314772.98000000825,306068.30000000814,8704.68000000011
38803,2022-12-26 10:35:00,1988.46,316761.44000000827,306068.30000000814,10693.14000000013
38804,2022-12-26 10:40:00,1586.84,318348.2800000083,306068.30000000814,12279.980000000156
38805,2022-12-26 10:45:00,648.84,318997.1200000083,306068.30000000814,12928.820000000182
38806,2022-12-26 10:50:00,-233.11,318764.01000000833,306068.30000000814,12695.710000000196
38807,2022-12-26 10:55:00,-1418.43,317345.58000000834,306068.30000000814,11277.280000000203
38808,2022-12-26 11:00:00,-1071.41,316274.17000000837,306068.30000000814,10205.870000000228
38809,2022-12-26 11:05:00,-795.37,315478.80000000837,306068.30000000814,9410.500000000233
38810,2022-12-26 11:10:00,-76.44,315402.36000000837,306068.30000000814,9334.06000000023
38811,2022-12-26 11:15:00,-1668.9,313733.46000000834,306068.30000000814,7665.160000000207
38812,2022-12-26 11:20:00,1742.7,315476.16000000836,306068.30000000814,9407.860000000219
38813,2022-12-26 11:25:00,-1797.79,313678.3700000084,306068.30000000814,7610.07000000024
38814,2022-12-26 11:30:00,-343.14,313335.23000000836,306068.30000000814,7266.930000000226
38815,2022-12-26 11:35:00,1063.23,314398.46000000834,306068.30000000814,8330.160000000207
38816,2022-12-26 11:40:00,-1834.09,312564.3700000083,306068.30000000814,6496.070000000182
38817,2022-12-26 11:45:00,-760.33,311804.0400000083,306068.30000000814,5735.740000000165
38818,2022-12-26 11:50:00,587.58,312391.6200000083,306068.30000000814,6323.320000000182
38819,2022-12-26 11:55:00,-1511.26,310880.3600000083,306068.30000000814,4812.060000000172
38820,2022-12-26 12:00:00,-1718.89,309161.4700000083,306068.30000000814,3093.1700000001583
38821,2022-12-26 12:05:00,-1114.09,308047.38000000827,306068.30000000814,1979.0800000001327
38822,2022-12-26 12:10:00,-535.76,307511.62000000826,306068.30000000814,1443.3200000001234
38823,2022-12-26 12:15:00,667.66,308179.28000000824,306068.30000000814,2110.980000000098
38824,2022-12-26 12:20:00,-252.1,307927.18000000826,306068.30000000814,1858.880000000121
38825,2022-12-26 12:25:00,-1568.84,306358.34000000823,306068.30000000814,290.04000000009546
38826,2022-12-26 12:30:00,-588.12,305770.22000000824,306068.30000000814,-298.0799999998999
38827,2022-12-26 12:35:00,-1461.92,304308.30000000825,306068.30000000814,-1759.9999999998836
38828,2022-12-26 12:40:00,-908.26,303400.04000000824,306068.30000000814,-2668.259999999893
38829,2022-12-26 12:45:00,-362.03,303038.0100000082,306068.30000000814,-3030.289999999921
38830,2022-12-26 12:50:00,-740.86,302297.15000000823,306068.30000000814,-3771.149999999907
38831,2022-12-26 12:55:00,973.24,303270.3900000082,306068.30000000814,-2797.909999999916
38832,2022-12-26 13:00:00,-412.34,302858.0500000082,306068.30000000814,-3210.249999999942
38833,2022-12-26 13:05:00,1246.48,304104.5300000082,306068.30000000814,-1963.7699999999604
38834,2022-12-26 13:10:00,292.02,304396.5500000082,306068.30000000814,-1671.7499999999418
38835,2022-12-26 13:15:00,-1803.61,302592.9400000082,306068.30000000814,-3475.359999999928
38836,2022-12-26 13:20:00,1764.47,304357.4100000082,306068.30000000814,-1710.8899999999558
38837,2022-12-26 13:25:00,723.08,305080.4900000082,306068.30000000814,-987.8099999999395
38838,2022-12-26 13:30:00,262.51,305343.0000000082,306068.30000000814,-725.2999999999302
38839,2022-12-26 13:35:00,-1534.85,303808.15000000823,306068.30000000814,-2260.149999999907
38840,2022-12-26 13:40:00,-780.93,303027.22000000824,306068.30000000814,-3041.0799999999
38841,2022-12-26 13:45:00,-432.49,302594.73000000825,306068.30000000814,-3473.5699999998906
38842,2022-12-26 13:50:00,396.84,302991.5700000083,306068.30000000814,-3076.729999999865
38843,2022-12-26 13:55:00,980.14,303971.7100000083,306068.30000000814,-2096.589999999851
38844,2022-12-26 14:00:00,-1707.01,302264.7000000083,306068.30000000814,-3803.5999999998603
38845,2022-12-26 14:05:00,-814.71,301449.99000000826,306068.30000000814,-4618.309999999881
38846,2022-12-26 14:10:00,-220.71,301229.28000000824,306068.30000000814,-4839.019999999902
38847,2022-12-26 14:15:00,744.53,301973.81000000826,306068.30000000814,-4094.4899999998743
38848,2022-12-26 14:20:00,-364.34,301609.47000000824,306068.30000000814,-4458.8299999999
38849,2022-12-26 14:25:00,115.19,301724.66000000824,306068.30000000814,-4343.639999999898
38850,2022-12-26 14:30:00,-1330.53,300394.1300000082,306068.30000000814,-5674.1699999999255
38851,2022-12-26 14:35:00,-1399.66,298994.47000000824,306068.30000000814,-7073.8299999999
38852,2022-12-26 14:40:00,1252.49,300246.9600000082,306068.30000000814,-5821.339999999909
38853,2022-12-26 14:45:00,1174.96,301421.92000000825,306068.30000000814,-4646.379999999888
38854,2022-12-26 14:50:00,1151.31,302573.23000000825,306068.30000000814,-3495.0699999998906
38855,2022-12-26 14:55:00,-1091.41,301481.8200000083,306068.30000000814,-4586.479999999865
38856,2022-12-26 15:00:00,-297.61,301184.2100000083,306068.30000000814,-4884.089999999851
38857,2022-12-26 15:05:00,-573.28,300610.93000000826,306068.30000000814,-5457.369999999879
38858,2022-12-26 15:10:00,-1327.66,299283.2700000083,306068.30000000814,-6785.029999999853
38859,2022-12-26 15:15:00,267.79,299551.06000000826,306068.30000000814,-6517.239999999874
38860,2022-12-26 15:20:00,-568.52,298982.54000000824,306068.30000000814,-7085.759999999893
38861,2022-12-26 15:25:00,-1682.43,297300.11000000825,306068.30000000814,-8768.189999999886
38862,2022-12-26 15:30:00,-651.99,296648.12000000826,306068.30000000814,-9420.179999999877
38863,2022-12-26 15:35:00,1231.13,297879.25000000827,306068.30000000814,-8189.049999999872
38864,2022-12-26 15:40:00,-1054.57,296824.68000000826,306068.30000000814,-9243.619999999879
38865,2022-12-26 15:45:00,1576.22,298400.90000000823,306068.30000000814,-7667.399999999907
38866,2022-12-26 15:50:00,438.88,298839.78000000824,306068.30000000814,-7228.519999999902
38867,2022-12-26 15:55:00,-27.28,298812.5000000082,306068.30000000814,-7255.79999999993
38868,2022-12-26 16:00:00,1540.69,300353.1900000082,306068.30000000814,-5715.109999999928
38869,2022-12-26 16:05:00,-1363.25,298989.9400000082,306068.30000000814,-7078.359999999928
38870,2022-12-26 16:10:00,805.53,299795.47000000824,306068.30000000814,-6272.8299999999
38871,2022-12-26 16:15:00,-745.62,299049.85000000824,306068.30000000814,-7018.449999999895
38872,2022-12-26 16:20:00,830.42,299880.2700000082,306068.30000000814,-6188.0299999999115
38873,2022-12-26 16:25:00,348.56,300228.8300000082,306068.30000000814,-5839.469999999914
38874,2022-12-26 16:30:00,1350.68,301579.5100000082,306068.30000000814,-4488.789999999921
38875,2022-12-26 16:35:00,1273.28,302852.79000000824,306068.30000000814,-3215.509999999893
38876,2022-12-26 16:40:00,-987.86,301864.93000000826,306068.30000000814,-4203.369999999879
38877,2022-12-26 16:45:00,-1431.79,300433.1400000083,306068.30000000814,-5635.159999999858
38878,2022-12-26 16:50:00,475.33,300908.4700000083,306068.30000000814,-5159.829999999842
38879,2022-12-26 16:55:00,1236.84,302145.3100000083,306068.30000000814,-3922.989999999816
38880,2022-12-27 08:00:00,545.21,302690.52000000834,302145.3100000083,545.210000000021
38881,2022-12-27 08:05:00,-1423.06,301267.46000000834,302145.3100000083,-877.8499999999767
38882,2022-12-27 08:10:00,-1262.16,300005.30000000837,302145.3100000083,-2140.009999999951
38883,2022-12-27 08:15:00,-1093.63,298911.67000000837,302145.3100000083,-3233.6399999999558
38884,2022-12-27 08:20:00,1214.6,300126.27000000834,302145.3100000083,-2019.039999999979
38885,2022-12-27 08:25:00,1181.75,301308.02000000834,302145.3100000083,-837.289999999979
38886,2022-12-27 08:30:00,1733.26,303041.28000000835,302145.3100000083,895.9700000000303
38887,2022-12-27 08:35:00,-310.68,302730.60000000836,302145.3100000083,585.2900000000373
38888,2022-12-27 08:40:00,-759.52,301971.08000000834,302145.3100000083,-174.22999999998137
38889,2022-12-27 08:45:00,-415.34,301555.7400000083,302145.3100000083,-589.570000000007
38890,2022-12-27 08:50:00,370.09,301925.83000000834,302145.3100000083,-219.47999999998137
38891,2022-12-27 08:55:00,515.46,302441.29000000836,302145.3100000083,295.9800000000396
38892,2022-12-27 09:00:00,-1240.07,301201.22000000835,302145.3100000083,-944.0899999999674
38893,2022-12-27 09:05:00,-875.79,300325.4300000084,302145.3100000083,-1819.8799999999464
38894,2022-12-27 09:10:00,1242.95,301568.3800000084,302145.3100000083,-576.9299999999348
38895,2022-12-27 09:15:00,-174.49,301393.8900000084,302145.3100000083,-751.4199999999255
38896,2022-12-27 09:20:00,981.78,302375.6700000084,302145.3100000083,230.36000000010245
38897,2022-12-27 09:25:00,1600.42,303976.0900000084,302145.3100000083,1830.7800000000861
38898,2022-12-27 09:30:00,-461.3,303514.7900000084,302145.3100000083,1369.4800000000978
38899,2022-12-27 09:35:00,827.7,304342.49000000843,302145.3100000083,2197.1800000001094
38900,2022-12-27 09:40:00,-778.63,303563.8600000084,302145.3100000083,1418.5500000001048
38901,2022-12-27 09:45:00,-1569.27,301994.5900000084,302145.3100000083,-150.71999999991385
38902,2022-12-27 09:50:00,1628.01,303622.6000000084,302145.3100000083,1477.2900000000955
38903,2022-12-27 09:55:00,1664.2,305286.8000000084,302145.3100000083,3141.490000000107
38904,2022-12-27 10:00:00,1204.88,306491.68000000843,302145.3100000083,4346.370000000112
38905,2022-12-27 10:05:00,-309.14,306182.5400000084,302145.3100000083,4037.230000000098
38906,2022-12-27 10:10:00,553.6,306736.1400000084,302145.3100000083,4590.8300000000745
38907,2022-12-27 10:15:00,-1610.85,305125.2900000084,302145.3100000083,2979.980000000098
38908,2022-12-27 10:20:00,85.54,305210.8300000084,302145.3100000083,3065.520000000077
38909,2022-12-27 10:25:00,-391.95,304818.8800000084,302145.3100000083,2673.570000000065
38910,2022-12-27 10:30:00,-273.37,304545.5100000084,302145.3100000083,2400.20000000007
38911,2022-12-27 10:35:00,944.96,305490.4700000084,302145.3100000083,3345.160000000091
38912,2022-12-27 10:40:00,416.44,305906.9100000084,302145.3100000083,3761.600000000093
38913,2022-12-27 10:45:00,-1328.33,304578.5800000084,302145.3100000083,2433.270000000077
38914,2022-12-27 10:50:00,100.33,304678.9100000084,302145.3100000083,2533.600000000093
38915,2022-12-27 10:55:00,-707.92,303970.99000000843,302145.3100000083,1825.6800000001094
38916,2022-12-27 11:00:00,1175.93,305146.9200000084,302145.3100000083,3001.6100000001024
38917,2022-12-27 11:05:00,-1124.18,304022.74000000843,302145.3100000083,1877.4300000001094
38918,2022-12-27 11:10:00,621.67,304644.4100000084,302145.3100000083,2499.100000000093
38919,2022-12-27 11:15:00,-1145.7,303498.7100000084,302145.3100000083,1353.4000000000815
38920,2022-12-27 11:20:00,649.57,304148.2800000084,302145.3100000083,2002.9700000000885
38921,2022-12-27 11:25:00,1919.07,306067.3500000084,302145.3100000083,3922.0400000000955
38922,2022-12-27 11:30:00,-607.88,305459.4700000084,302145.3100000083,3314.160000000091
38923,2022-12-27 11:35:00,-38.54,305420.93000000843,302145.3100000083,3275.6200000001118
38924,2022-12-27 11:40:00,-694.25,304726.68000000843,302145.3100000083,2581.3700000001118
38925,2022-12-27 11:45:00,962.54,305689.2200000084,302145.3100000083,3543.910000000091
38926,2022-12-27 11:50:00,114.88,305804.1000000084,302145.3100000083,3658.7900000000955
38927,2022-12-27 11:55:00,875.85,306679.9500000084,302145.3100000083,4534.640000000072
38928,2022-12-27 12:00:00,397.78,307077.7300000084,302145.3100000083,4932.4200000001
38929,2022-12-27 12:05:00,567.16,307644.8900000084,302145.3100000083,5499.5800000000745
38930,2022-12-27 12:10:00,224.15,307869.0400000084,302145.3100000083,5723.730000000098
38931,2022-12-27 12:15:00,1647.29,309516.3300000084,302145.3100000083,7371.020000000077
38932,2022-12-27 12:20:00,-1534.07,307982.2600000084,302145.3100000083,5836.95000000007
38933,2022-12-27 12:25:00,-688.08,307294.1800000084,302145.3100000083,5148.870000000054
38934,2022-12-27 12:30:00,513.5,307807.6800000084,302145.3100000083,5662.370000000054
38935,2022-12-27 12:35:00,881.39,308689.0700000084,302145.3100000083,6543.7600000000675
38936,2022-12-27 12:40:00,-1161.51,307527.5600000084,302145.3100000083,5382.250000000058
38937,2022-12-27 12:45:00,1865.36,309392.92000000837,302145.3100000083,7247.610000000044
38938,2022-12-27 12:50:00,1177.46,310570.3800000084,302145.3100000083,8425.070000000065
38939,2022-12-27 12:55:00,1705.32,312275.7000000084,302145.3100000083,10130.390000000072
38940,2022-12-27 13:00:00,479.3,312755.0000000084,302145.3100000083,10609.69000000006
38941,2022-12-27 13:05:00,472.5,313227.5000000084,302145.3100000083,11082.19000000006
38942,2022-12-27 13:10:00,-1767.97,311459.5300000084,302145.3100000083,9314.220000000088
38943,2022-12-27 13:15:00,767.55,312227.0800000084,302145.3100000083,10081.770000000077
38944,2022-12-27 13:20:00,-247.46,311979.6200000084,302145.3100000083,9834.310000000056
38945,2022-12-27 13:25:00,-1220.59,310759.03000000835,302145.3100000083,8613.72000000003
38946,2022-12-27 13:30:00,812.37,311571.40000000835,302145.3100000083,9426.090000000026
38947,2022-12-27 13:35:00,-1374.24,310197.16000000836,302145.3100000083,8051.850000000035
38948,2022-12-27 13:40:00,-55.45,310141.71000000834,302145.3100000083,7996.400000000023
38949,2022-12-27 13:45:00,-95.78,310045.9300000083,302145.3100000083,7900.619999999995
38950,2022-12-27 13:50:00,59.5,310105.4300000083,302145.3100000083,7960.119999999995
38951,2022-12-27 13:55:00,1021.55,311126.9800000083,302145.3100000083,8981.669999999984
38952,2022-12-27 14:00:00,891.84,312018.82000000833,302145.3100000083,9873.51000000001
38953,2022-12-27 14:05:00,-1098.66,310920.16000000836,302145.3100000083,8774.850000000035
38954,2022-12-27 14:10:00,1551.19,312471.35000000836,302145.3100000083,10326.040000000037
38955,2022-12-27 14:15:00,678.08,313149.4300000084,302145.3100000083,11004.120000000054
38956,2022-12-27 14:20:00,9.61,313159.04000000836,302145.3100000083,11013.73000000004
38957,2022-12-27 14:25:00,1291.81,314450.85000000836,302145.3100000083,12305.540000000037
38958,2022-12-27 14:30:00,955.14,315405.9900000084,302145.3100000083,13260.680000000051
38959,2022-12-27 14:35:00,-836.77,314569.22000000835,302145.3100000083,12423.910000000033
38960,2022-12-27 14:40:00,-668.4,313900.82000000833,302145.3100000083,11755.51000000001
38961,2022-12-27 14:45:00,-506.32,313394.5000000083,302145.3100000083,11249.190000000002
38962,2022-12-27 14:50:00,1161.87,314556.3700000083,302145.3100000083,12411.059999999998
38963,2022-12-27 14:55:00,1153.99,315710.3600000083,302145.3100000083,13565.049999999988
38964,2022-12-27 15:00:00,-1588.58,314121.7800000083,302145.3100000083,11976.469999999972
38965,2022-12-27 15:05:00,-487.07,313634.7100000083,302145.3100000083,11489.399999999965
38966,2022-12-27 15:10:00,327.64,313962.3500000083,302145.3100000083,11817.039999999979
38967,2022-12-27 15:15:00,811.44,314773.7900000083,302145.3100000083,12628.479999999981
38968,2022-12-27 15:20:00,-1291.69,313482.1000000083,302145.3100000083,11336.789999999979
38969,2022-12-27 15:25:00,914.63,314396.7300000083,302145.3100000083,12251.419999999984
38970,2022-12-27 15:30:00,-1606.38,312790.3500000083,302145.3100000083,10645.039999999979
38971,2022-12-27 15:35:00,-1073.01,311717.3400000083,302145.3100000083,9572.02999999997
38972,2022-12-27 15:40:00,-781.77,310935.5700000083,302145.3100000083,8790.259999999951
38973,2022-12-27 15:45:00,865.2,311800.7700000083,302145.3100000083,9655.459999999963
38974,2022-12-27 15:50:00,1078.66,312879.43000000826,302145.3100000083,10734.119999999937
38975,2022-12-27 15:55:00,-175.18,312704.25000000827,302145.3100000083,10558.939999999944
38976,2022-12-27 16:00:00,-1991.76,310712.49000000826,302145.3100000083,8567.179999999935
38977,2022-12-27 16:05:00,-1867.63,308844.86000000825,302145.3100000083,6699.54999999993
38978,2022-12-27 16:10:00,608.25,309453.11000000825,302145.3100000083,7307.79999999993
38979,2022-12-27 16:15:00,-110.67,309342.44000000827,302145.3100000083,7197.129999999946
38980,2022-12-27 16:20:00,-888.08,308454.36000000825,302145.3100000083,6309.04999999993
38981,2022-12-27 16:25:00,-1277.94,307176.42000000825,302145.3100000083,5031.109999999928
38982,2022-12-27 16:30:00,-1881.12,305295.30000000825,302145.3100000083,3149.9899999999325
38983,2022-12-27 16:35:00,835.46,306130.7600000083,302145.3100000083,3985.4499999999534
38984,2022-12-27 16:40:00,-353.18,305777.5800000083,302145.3100000083,3632.2699999999604
38985,2022-12-27 16:45:00,1413.87,307191.4500000083,302145.3100000083,5046.139999999956
38986,2022-12-27 16:50:00,1996.88,309188.3300000083,302145.3100000083,7043.01999999996
38987,2022-12-27 16:55:00,-171.91,309016.4200000083,302145.3100000083,6871.109999999986
38988,2022-12-28 08:00:00,-1084.48,307931.9400000083,309016.4200000083,-1084.4799999999814
38989,2022-12-28 08:05:00,752.54,308684.4800000083,309016.4200000083,-331.9400000000023
38990,2022-12-28 08:10:00,-32.26,308652.2200000083,309016.4200000083,-364.20000000001164
38991,2022-12-28 08:15:00,-1894.22,306758.0000000083,309016.4200000083,-2258.4199999999837
38992,2022-12-28 08:20:00,-504.22,306253.78000000835,309016.4200000083,-2762.6399999999558
38993,2022-12-28 08:25:00,1581.12,307834.90000000835,309016.4200000083,-1181.5199999999604
38994,2022-12-28 08:30:00,-1884.01,305950.89000000834,309016.4200000083,-3065.5299999999697
38995,2022-12-28 08:35:00,-948.41,305002.48000000836,309016.4200000083,-4013.939999999944
38996,2022-12-28 08:40:00,331.63,305334.11000000837,309016.4200000083,-3682.3099999999395
38997,2022-12-28 08:45:00,1402.48,306736.59000000835,309016.4200000083,-2279.829999999958
38998,2022-12-28 08:50:00,862.06,307598.65000000835,309016.4200000083,-1417.7699999999604
38999,2022-12-28 08:55:00,-148.68,307449.97000000835,309016.4200000083,-1566.4499999999534
39000,2022-12-28 09:00:00,922.73,308372.70000000834,309016.4200000083,-643.7199999999721
39001,2022-12-28 09:05:00,-345.63,308027.07000000833,309016.4200000083,-989.3499999999767
39002,2022-12-28 09:10:00,1270.48,309297.5500000083,309016.4200000083,281.13000000000466
39003,2022-12-28 09:15:00,-170.19,309127.3600000083,309016.4200000083,110.94000000000233
39004,2022-12-28 09:20:00,861.83,309989.1900000083,309016.4200000083,972.7700000000186
39005,2022-12-28 09:25:00,-541.59,309447.6000000083,309016.4200000083,431.179999999993
39006,2022-12-28 09:30:00,-218.3,309229.3000000083,309016.4200000083,212.88000000000466
39007,2022-12-28 09:35:00,-423.37,308805.9300000083,309016.4200000083,-210.4899999999907
39008,2022-12-28 09:40:00,-1836.61,306969.32000000833,309016.4200000083,-2047.0999999999767
39009,2022-12-28 09:45:00,1858.13,308827.45000000834,309016.4200000083,-188.96999999997206
39010,2022-12-28 09:50:00,-240.39,308587.0600000083,309016.4200000083,-429.35999999998603
39011,2022-12-28 09:55:00,-134.79,308452.27000000834,309016.4200000083,-564.1499999999651
39012,2022-12-28 10:00:00,-530.3,307921.97000000835,309016.4200000083,-1094.4499999999534
39013,2022-12-28 10:05:00,1764.02,309685.9900000084,309016.4200000083,669.5700000000652
39014,2022-12-28 10:10:00,-1504.22,308181.7700000084,309016.4200000083,-834.6499999999069
39015,2022-12-28 10:15:00,-75.44,308106.3300000084,309016.4200000083,-910.0899999999092
39016,2022-12-28 10:20:00,-285.07,307821.2600000084,309016.4200000083,-1195.1599999999162
39017,2022-12-28 10:25:00,1266.96,309088.2200000084,309016.4200000083,71.80000000010477
39018,2022-12-28 10:30:00,671.6,309759.8200000084,309016.4200000083,743.4000000000815
39019,2022-12-28 10:35:00,1949.22,311709.04000000836,309016.4200000083,2692.6200000000536
39020,2022-12-28 10:40:00,1494.58,313203.6200000084,309016.4200000083,4187.20000000007
39021,2022-12-28 10:45:00,-1193.82,312009.80000000837,309016.4200000083,2993.380000000063
39022,2022-12-28 10:50:00,1754.03,313763.8300000084,309016.4200000083,4747.410000000091
39023,2022-12-28 10:55:00,321.34,314085.1700000084,309016.4200000083,5068.750000000116
39024,2022-12-28 11:00:00,-1073.64,313011.5300000084,309016.4200000083,3995.1100000001024
39025,2022-12-28 11:05:00,1364.84,314376.37000000844,309016.4200000083,5359.950000000128
39026,2022-12-28 11:10:00,-1704.74,312671.63000000844,309016.4200000083,3655.2100000001374
39027,2022-12-28 11:15:00,1309.02,313980.65000000846,309016.4200000083,4964.230000000156
39028,2022-12-28 11:20:00,1534.89,315515.5400000085,309016.4200000083,6499.12000000017
39029,2022-12-28 11:25:00,-108.36,315407.1800000085,309016.4200000083,6390.760000000184
39030,2022-12-28 11:30:00,-842.48,314564.7000000085,309016.4200000083,5548.280000000203
39031,2022-12-28 11:35:00,-52.7,314512.0000000085,309016.4200000083,5495.580000000191
39032,2022-12-28 11:40:00,-45.53,314466.47000000847,309016.4200000083,5450.050000000163
39033,2022-12-28 11:45:00,-721.42,313745.0500000085,309016.4200000083,4728.630000000179
39034,2022-12-28 11:50:00,1088.01,314833.0600000085,309016.4200000083,5816.640000000189
39035,2022-12-28 11:55:00,979.76,315812.8200000085,309016.4200000083,6796.400000000198
39036,2022-12-28 12:00:00,-548.93,315263.8900000085,309016.4200000083,6247.470000000205
39037,2022-12-28 12:05:00,1334.33,316598.2200000085,309016.4200000083,7581.800000000221
39038,2022-12-28 12:10:00,-1739.3,314858.92000000854,309016.4200000083,5842.500000000233
39039,2022-12-28 12:15:00,-1309.35,313549.57000000856,309016.4200000083,4533.150000000256
39040,2022-12-28 12:20:00,940.07,314489.64000000857,309016.4200000083,5473.220000000263
39041,2022-12-28 12:25:00,1259.03,315748.6700000086,309016.4200000083,6732.250000000291
39042,2022-12-28 12:30:00,1581.34,317330.0100000086,309016.4200000083,8313.590000000317
39043,2022-12-28 12:35:00,1593.48,318923.4900000086,309016.4200000083,9907.070000000298
39044,2022-12-28 12:40:00,-1743.62,317179.8700000086,309016.4200000083,8163.450000000303
39045,2022-12-28 12:45:00,-910.59,316269.2800000086,309016.4200000083,7252.860000000277
39046,2022-12-28 12:50:00,192.34,316461.6200000086,309016.4200000083,7445.200000000303
39047,2022-12-28 12:55:00,1162.18,317623.8000000086,309016.4200000083,8607.380000000296
39048,2022-12-28 13:00:00,1675.38,319299.1800000086,309016.4200000083,10282.7600000003
39049,2022-12-28 13:05:00,-1358.98,317940.2000000086,309016.4200000083,8923.780000000319
39050,2022-12-28 13:10:00,811.92,318752.1200000086,309016.4200000083,9735.700000000303
39051,2022-12-28 13:15:00,1935.74,320687.8600000086,309016.4200000083,11671.440000000293
39052,2022-12-28 13:20:00,1044.74,321732.6000000086,309016.4200000083,12716.180000000284
39053,2022-12-28 13:25:00,619.0,322351.6000000086,309016.4200000083,13335.180000000284
39054,2022-12-28 13:30:00,-228.66,322122.9400000086,309016.4200000083,13106.52000000031
39055,2022-12-28 13:35:00,-204.45,321918.4900000086,309016.4200000083,12902.070000000298
39056,2022-12-28 13:40:00,327.01,322245.5000000086,309016.4200000083,13229.080000000307
39057,2022-12-28 13:45:00,105.52,322351.02000000863,309016.4200000083,13334.600000000326
39058,2022-12-28 13:50:00,-945.92,321405.10000000865,309016.4200000083,12388.680000000342
39059,2022-12-28 13:55:00,412.57,321817.67000000866,309016.4200000083,12801.25000000035
39060,2022-12-28 14:00:00,436.06,322253.73000000865,309016.4200000083,13237.310000000347
39061,2022-12-28 14:05:00,1938.22,324191.9500000086,309016.4200000083,15175.530000000319
39062,2022-12-28 14:10:00,272.06,324464.0100000086,309016.4200000083,15447.590000000317
39063,2022-12-28 14:15:00,339.4,324803.41000000865,309016.4200000083,15786.99000000034
39064,2022-12-28 14:20:00,595.61,325399.02000000863,309016.4200000083,16382.600000000326
39065,2022-12-28 14:25:00,-398.77,325000.2500000086,309016.4200000083,15983.830000000307
39066,2022-12-28 14:30:00,-115.11,324885.1400000086,309016.4200000083,15868.720000000321
39067,2022-12-28 14:35:00,539.71,325424.85000000865,309016.4200000083,16408.430000000342
39068,2022-12-28 14:40:00,-956.04,324468.81000000867,309016.4200000083,15452.390000000363
39069,2022-12-28 14:45:00,-138.09,324330.72000000865,309016.4200000083,15314.300000000338
39070,2022-12-28 14:50:00,52.17,324382.8900000086,309016.4200000083,15366.470000000321
39071,2022-12-28 14:55:00,-1106.33,323276.5600000086,309016.4200000083,14260.140000000305
39072,2022-12-28 15:00:00,-1683.23,321593.33000000863,309016.4200000083,12576.910000000324
39073,2022-12-28 15:05:00,1616.32,323209.65000000864,309016.4200000083,14193.23000000033
39074,2022-12-28 15:10:00,1369.0,324578.65000000864,309016.4200000083,15562.23000000033
39075,2022-12-28 15:15:00,-18.82,324559.83000000863,309016.4200000083,15543.410000000324
39076,2022-12-28 15:20:00,-246.23,324313.60000000865,309016.4200000083,15297.180000000342
39077,2022-12-28 15:25:00,121.26,324434.86000000866,309016.4200000083,15418.440000000352
39078,2022-12-28 15:30:00,1130.79,325565.65000000864,309016.4200000083,16549.23000000033
39079,2022-12-28 15:35:00,-607.07,324958.58000000863,309016.4200000083,15942.160000000324
39080,2022-12-28 15:40:00,732.05,325690.6300000086,309016.4200000083,16674.210000000312
39081,2022-12-28 15:45:00,-519.85,325170.78000000864,309016.4200000083,16154.360000000335
39082,2022-12-28 15:50:00,849.54,326020.3200000086,309016.4200000083,17003.900000000314
39083,2022-12-28 15:55:00,1349.82,327370.1400000086,309016.4200000083,18353.72000000032
39084,2022-12-28 16:00:00,866.78,328236.92000000866,309016.4200000083,19220.50000000035
39085,2022-12-28 16:05:00,1411.98,329648.90000000864,309016.4200000083,20632.48000000033
39086,2022-12-28 16:10:00,97.7,329746.60000000865,309016.4200000083,20730.180000000342
39087,2022-12-28 16:15:00,1998.98,331745.58000000863,309016.4200000083,22729.160000000324
39088,2022-12-28 16:20:00,-984.63,330760.9500000086,309016.4200000083,21744.53000000032
39089,2022-12-28 16:25:00,-331.76,330429.1900000086,309016.4200000083,21412.77000000031
39090,2022-12-28 16:30:00,-290.84,330138.3500000086,309016.4200000083,21121.930000000284
39091,2022-12-28 16:35:00,-1329.99,328808.3600000086,309016.4200000083,19791.940000000293
39092,2022-12-28 16:40:00,-947.88,327860.4800000086,309016.4200000083,18844.06000000029
39093,2022-12-28 16:45:00,-470.32,327390.1600000086,309016.4200000083,18373.74000000028
39094,2022-12-28 16:50:00,1600.33,328990.4900000086,309016.4200000083,19974.070000000298
39095,2022-12-28 16:55:00,-1509.05,327481.4400000086,309016.4200000083,18465.02000000031
39096,2022-12-29 08:00:00,1648.37,329129.8100000086,327481.4400000086,1648.3699999999953
39097,2022-12-29 08:05:00,703.8,329833.6100000086,327481.4400000086,2352.1699999999837
39098,2022-12-29 08:10:00,-766.95,329066.6600000086,327481.4400000086,1585.219999999972
39099,2022-12-29 08:15:00,-1562.39,327504.2700000086,327481.4400000086,22.82999999995809
39100,2022-12-29 08:20:00,-899.04,326605.2300000086,327481.4400000086,-876.210000000021
39101,2022-12-29 08:25:00,1258.03,327863.2600000086,327481.4400000086,381.820000000007
39102,2022-12-29 08:30:00,-1741.34,326121.9200000086,327481.4400000086,-1359.5200000000186
39103,2022-12-29 08:35:00,-246.77,325875.1500000086,327481.4400000086,-1606.2900000000373
39104,2022-12-29 08:40:00,-926.16,324948.9900000086,327481.4400000086,-2532.4500000000116
39105,2022-12-29 08:45:00,1153.68,326102.6700000086,327481.4400000086,-1378.7700000000186
39106,2022-12-29 08:50:00,-1385.45,324717.2200000086,327481.4400000086,-2764.2200000000303
39107,2022-12-29 08:55:00,259.59,324976.8100000086,327481.4400000086,-2504.6300000000047
39108,2022-12-29 09:00:00,356.97,325333.7800000086,327481.4400000086,-2147.6600000000326
39109,2022-12-29 09:05:00,121.67,325455.45000000857,327481.4400000086,-2025.990000000049
39110,2022-12-29 09:10:00,1579.37,327034.82000000856,327481.4400000086,-446.62000000005355
39111,2022-12-29 09:15:00,1848.54,328883.36000000854,327481.4400000086,1401.9199999999255
39112,2022-12-29 09:20:00,-1086.0,327797.36000000854,327481.4400000086,315.9199999999255
39113,2022-12-29 09:25:00,1891.59,329688.95000000857,327481.4400000086,2207.509999999951
39114,2022-12-29 09:30:00,-893.74,328795.2100000086,327481.4400000086,1313.7699999999604
39115,2022-12-29 09:35:00,1676.52,330471.7300000086,327481.4400000086,2990.289999999979
39116,2022-12-29 09:40:00,467.97,330939.70000000857,327481.4400000086,3458.259999999951
39117,2022-12-29 09:45:00,-1612.49,329327.2100000086,327481.4400000086,1845.7699999999604
39118,2022-12-29 09:50:00,769.8,330097.01000000857,327481.4400000086,2615.569999999949
39119,2022-12-29 09:55:00,1045.04,331142.05000000854,327481.4400000086,3660.609999999928
39120,2022-12-29 10:00:00,1547.07,332689.12000000855,327481.4400000086,5207.679999999935
39121,2022-12-29 10:05:00,-1290.69,331398.43000000855,327481.4400000086,3916.9899999999325
39122,2022-12-29 10:10:00,606.08,332004.51000000857,327481.4400000086,4523.069999999949
39123,2022-12-29 10:15:00,132.03,332136.5400000086,327481.4400000086,4655.099999999977
39124,2022-12-29 10:20:00,-1202.1,330934.4400000086,327481.4400000086,3453.0
39125,2022-12-29 10:25:00,-394.14,330540.3000000086,327481.4400000086,3058.859999999986
39126,2022-12-29 10:30:00,286.31,330826.6100000086,327481.4400000086,3345.1699999999837
39127,2022-12-29 10:35:00,-875.06,329951.5500000086,327481.4400000086,2470.109999999986
39128,2022-12-29 10:40:00,1695.3,331646.8500000086,327481.4400000086,4165.409999999974
39129,2022-12-29 10:45:00,-429.51,331217.3400000086,327481.4400000086,3735.899999999965
39130,2022-12-29 10:50:00,193.64,331410.9800000086,327481.4400000086,3929.539999999979
39131,2022-12-29 10:55:00,706.29,332117.2700000086,327481.4400000086,4635.829999999958
39132,2022-12-29 11:00:00,-1999.55,330117.7200000086,327481.4400000086,2636.2799999999697
39133,2022-12-29 11:05:00,-1370.37,328747.3500000086,327481.4400000086,1265.9099999999744
39134,2022-12-29 11:10:00,-1295.97,327451.3800000086,327481.4400000086,-30.05999999999767
39135,2022-12-29 11:15:00,1446.73,328898.1100000086,327481.4400000086,1416.6699999999837
39136,2022-12-29 11:20:00,1707.79,330605.9000000086,327481.4400000086,3124.4599999999627
39137,2022-12-29 11:25:00,320.18,330926.0800000086,327481.4400000086,3444.6399999999558
39138,2022-12-29 11:30:00,-1923.14,329002.94000000856,327481.4400000086,1521.4999999999418
39139,2022-12-29 11:35:00,17.37,329020.31000000855,327481.4400000086,1538.8699999999371
39140,2022-12-29 11:40:00,585.32,329605.63000000856,327481.4400000086,2124.189999999944
39141,2022-12-29 11:45:00,1120.95,330726.5800000086,327481.4400000086,3245.1399999999558
39142,2022-12-29 11:50:00,1831.83,332558.4100000086,327481.4400000086,5076.969999999972
39143,2022-12-29 11:55:00,-1367.3,331191.1100000086,327481.4400000086,3709.6699999999837
39144,2022-12-29 12:00:00,-782.08,330409.0300000086,327481.4400000086,2927.5899999999674
39145,2022-12-29 12:05:00,-86.93,330322.1000000086,327481.4400000086,2840.6599999999744
39146,2022-12-29 12:10:00,1574.61,331896.7100000086,327481.4400000086,4415.26999999996
39147,2022-12-29 12:15:00,1860.23,333756.94000000856,327481.4400000086,6275.499999999942
39148,2022-12-29 12:20:00,1562.86,335319.80000000854,327481.4400000086,7838.359999999928
39149,2022-12-29 12:25:00,-780.36,334539.44000000856,327481.4400000086,7057.999999999942
39150,2022-12-29 12:30:00,1357.97,335897.41000000853,327481.4400000086,8415.969999999914
39151,2022-12-29 12:35:00,1018.32,336915.73000000854,327481.4400000086,9434.28999999992
39152,2022-12-29 12:40:00,1467.54,338383.2700000085,327481.4400000086,10901.8299999999
39153,2022-12-29 12:45:00,37.94,338421.2100000085,327481.4400000086,10939.769999999902
39154,2022-12-29 12:50:00,1797.88,340219.0900000085,327481.4400000086,12737.649999999907
39155,2022-12-29 12:55:00,835.76,341054.85000000853,327481.4400000086,13573.409999999916
39156,2022-12-29 13:00:00,-1253.97,339800.88000000856,327481.4400000086,12319.439999999944
39157,2022-12-29 13:05:00,-776.58,339024.30000000854,327481.4400000086,11542.859999999928
39158,2022-12-29 13:10:00,836.36,339860.66000000853,327481.4400000086,12379.219999999914
39159,2022-12-29 13:15:00,-1228.41,338632.25000000856,327481.4400000086,11150.80999999994
39160,2022-12-29 13:20:00,-884.34,337747.91000000853,327481.4400000086,10266.469999999914
39161,2022-12-29 13:25:00,-770.81,336977.10000000853,327481.4400000086,9495.659999999916
39162,2022-12-29 13:30:00,490.48,337467.5800000085,327481.4400000086,9986.139999999898
39163,2022-12-29 13:35:00,1317.97,338785.5500000085,327481.4400000086,11304.10999999987
39164,2022-12-29 13:40:00,-1219.32,337566.2300000085,327481.4400000086,10084.789999999863
39165,2022-12-29 13:45:00,1273.91,338840.14000000845,327481.4400000086,11358.699999999837
39166,2022-12-29 13:50:00,193.55,339033.69000000844,327481.4400000086,11552.249999999825
39167,2022-12-29 13:55:00,746.59,339780.28000000847,327481.4400000086,12298.839999999851
39168,2022-12-29 14:00:00,-1890.61,337889.6700000085,327481.4400000086,10408.229999999865
39169,2022-12-29 14:05:00,-1381.1,336508.5700000085,327481.4400000086,9027.129999999888
39170,2022-12-29 14:10:00,402.75,336911.3200000085,327481.4400000086,9429.879999999888
39171,2022-12-29 14:15:00,-1650.04,335261.2800000085,327481.4400000086,7779.839999999909
39172,2022-12-29 14:20:00,1379.13,336640.41000000853,327481.4400000086,9158.969999999914
39173,2022-12-29 14:25:00,1335.68,337976.0900000085,327481.4400000086,10494.649999999907
39174,2022-12-29 14:30:00,-1522.89,336453.2000000085,327481.4400000086,8971.759999999893
39175,2022-12-29 14:35:00,414.41,336867.6100000085,327481.4400000086,9386.169999999867
39176,2022-12-29 14:40:00,-1283.95,335583.6600000085,327481.4400000086,8102.219999999856
39177,2022-12-29 14:45:00,296.17,335879.83000000846,327481.4400000086,8398.38999999984
39178,2022-12-29 14:50:00,-1152.71,334727.12000000844,327481.4400000086,7245.679999999818
39179,2022-12-29 14:55:00,484.16,335211.2800000084,327481.4400000086,7729.839999999793
39180,2022-12-29 15:00:00,-1786.15,333425.1300000084,327481.4400000086,5943.6899999997695
39181,2022-12-29 15:05:00,-1066.08,332359.05000000837,327481.4400000086,4877.609999999753
39182,2022-12-29 15:10:00,-1381.1,330977.9500000084,327481.4400000086,3496.5099999997765
39183,2022-12-29 15:15:00,-601.75,330376.2000000084,327481.4400000086,2894.7599999997765
39184,2022-12-29 15:20:00,-1023.94,329352.2600000084,327481.4400000086,1870.8199999997742
39185,2022-12-29 15:25:00,1144.19,330496.4500000084,327481.4400000086,3015.0099999997765
39186,2022-12-29 15:30:00,-1565.72,328930.7300000084,327481.4400000086,1449.2899999998044
39187,2022-12-29 15:35:00,1484.47,330415.2000000084,327481.4400000086,2933.7599999997765
39188,2022-12-29 15:40:00,1223.65,331638.8500000084,327481.4400000086,4157.4099999998
39189,2022-12-29 15:45:00,-347.16,331291.69000000844,327481.4400000086,3810.2499999998254
39190,2022-12-29 15:50:00,1545.98,332837.6700000084,327481.4400000086,5356.229999999807
39191,2022-12-29 15:55:00,-787.15,332050.5200000084,327481.4400000086,4569.0799999997835
39192,2022-12-29 16:00:00,-145.65,331904.8700000084,327481.4400000086,4423.42999999976
39193,2022-12-29 16:05:00,-1802.94,330101.9300000084,327481.4400000086,2620.489999999758
39194,2022-12-29 16:10:00,1381.31,331483.2400000084,327481.4400000086,4001.7999999997555
39195,2022-12-29 16:15:00,-38.71,331444.53000000835,327481.4400000086,3963.0899999997346
39196,2022-12-29 16:20:00,-1193.03,330251.5000000083,327481.4400000086,2770.0599999997066
39197,2022-12-29 16:25:00,-478.26,329773.2400000083,327481.4400000086,2291.7999999996973
39198,2022-12-29 16:30:00,439.35,330212.5900000083,327481.4400000086,2731.149999999674
39199,2022-12-29 16:35:00,1030.66,331243.25000000827,327481.4400000086,3761.8099999996484
39200,2022-12-29 16:40:00,97.97,331341.22000000824,327481.4400000086,3859.7799999996205
39201,2022-12-29 16:45:00,399.0,331740.22000000824,327481.4400000086,4258.7799999996205
39202,2022-12-29 16:50:00,1608.49,333348.7100000082,327481.4400000086,5867.269999999611
39203,2022-12-29 16:55:00,1407.67,334756.3800000082,327481.4400000086,7274.939999999595
39204,2022-12-30 08:00:00,1901.97,336658.3500000082,334756.3800000082,1901.969999999972
39205,2022-12-30 08:05:00,-688.98,335969.3700000082,334756.3800000082,1212.9899999999907
39206,2022-12-30 08:10:00,-1953.83,334015.5400000082,334756.3800000082,-740.8400000000256
39207,2022-12-30 08:15:00,15.12,334030.6600000082,334756.3800000082,-725.7200000000303
39208,2022-12-30 08:20:00,540.76,334571.4200000082,334756.3800000082,-184.96000000002095
39209,2022-12-30 08:25:00,488.04,335059.46000000817,334756.3800000082,303.0799999999581
39210,2022-12-30 08:30:00,-1211.47,333847.9900000082,334756.3800000082,-908.390000000014
39211,2022-12-30 08:35:00,-668.79,333179.2000000082,334756.3800000082,-1577.179999999993
39212,2022-12-30 08:40:00,310.36,333489.5600000082,334756.3800000082,-1266.820000000007
39213,2022-12-30 08:45:00,-1186.05,332303.5100000082,334756.3800000082,-2452.8699999999953
39214,2022-12-30 08:50:00,-472.48,331831.03000000824,334756.3800000082,-2925.3499999999767
39215,2022-12-30 08:55:00,434.32,332265.35000000824,334756.3800000082,-2491.0299999999697
39216,2022-12-30 09:00:00,-827.71,331437.6400000082,334756.3800000082,-3318.7399999999907
39217,2022-12-30 09:05:00,1576.11,333013.7500000082,334756.3800000082,-1742.6300000000047
39218,2022-12-30 09:10:00,823.26,333837.0100000082,334756.3800000082,-919.3699999999953
39219,2022-12-30 09:15:00,686.74,334523.7500000082,334756.3800000082,-232.63000000000466
39220,2022-12-30 09:20:00,-1307.51,333216.2400000082,334756.3800000082,-1540.140000000014
39221,2022-12-30 09:25:00,1201.39,334417.6300000082,334756.3800000082,-338.75
39222,2022-12-30 09:30:00,-1916.05,332501.5800000082,334756.3800000082,-2254.7999999999884
39223,2022-12-30 09:35:00,456.93,332958.5100000082,334756.3800000082,-1797.8699999999953
39224,2022-12-30 09:40:00,1400.51,334359.0200000082,334756.3800000082,-397.35999999998603
39225,2022-12-30 09:45:00,-1558.08,332800.9400000082,334756.3800000082,-1955.4400000000023
39226,2022-12-30 09:50:00,714.19,333515.1300000082,334756.3800000082,-1241.25
39227,2022-12-30 09:55:00,-960.27,332554.8600000082,334756.3800000082,-2201.5200000000186
39228,2022-12-30 10:00:00,1801.06,334355.9200000082,334756.3800000082,-400.46000000002095
39229,2022-12-30 10:05:00,-1513.58,332842.3400000082,334756.3800000082,-1914.0400000000373
39230,2022-12-30 10:10:00,370.94,333213.2800000082,334756.3800000082,-1543.100000000035
39231,2022-12-30 10:15:00,-1657.29,331555.9900000082,334756.3800000082,-3200.390000000014
39232,2022-12-30 10:20:00,-1565.71,329990.2800000082,334756.3800000082,-4766.100000000035
39233,2022-12-30 10:25:00,-799.06,329191.2200000082,334756.3800000082,-5565.160000000033
39234,2022-12-30 10:30:00,1676.88,330868.1000000082,334756.3800000082,-3888.280000000028
39235,2022-12-30 10:35:00,1882.94,332751.0400000082,334756.3800000082,-2005.3400000000256
39236,2022-12-30 10:40:00,1470.7,334221.7400000082,334756.3800000082,-534.640000000014
39237,2022-12-30 10:45:00,1130.15,335351.8900000082,334756.3800000082,595.5100000000093
39238,2022-12-30 10:50:00,1962.42,337314.3100000082,334756.3800000082,2557.929999999993
39239,2022-12-30 10:55:00,-1846.14,335468.1700000082,334756.3800000082,711.789999999979
39240,2022-12-30 11:00:00,-1264.6,334203.5700000082,334756.3800000082,-552.8099999999977
39241,2022-12-30 11:05:00,1613.32,335816.8900000082,334756.3800000082,1060.5100000000093
39242,2022-12-30 11:10:00,-1415.81,334401.0800000082,334756.3800000082,-355.29999999998836
39243,2022-12-30 11:15:00,-1439.93,332961.15000000823,334756.3800000082,-1795.2299999999814
39244,2022-12-30 11:20:00,1785.13,334746.28000000824,334756.3800000082,-10.099999999976717
39245,2022-12-30 11:25:00,-1079.27,333667.0100000082,334756.3800000082,-1089.3699999999953
39246,2022-12-30 11:30:00,-1774.71,331892.3000000082,334756.3800000082,-2864.0800000000163
39247,2022-12-30 11:35:00,746.91,332639.21000000817,334756.3800000082,-2117.170000000042
39248,2022-12-30 11:40:00,-418.17,332221.0400000082,334756.3800000082,-2535.3400000000256
39249,2022-12-30 11:45:00,-1448.23,330772.8100000082,334756.3800000082,-3983.570000000007
39250,2022-12-30 11:50:00,-1750.04,329022.7700000082,334756.3800000082,-5733.609999999986
39251,2022-12-30 11:55:00,-1821.3,327201.47000000824,334756.3800000082,-7554.909999999974
39252,2022-12-30 12:00:00,-971.0,326230.47000000824,334756.3800000082,-8525.909999999974
39253,2022-12-30 12:05:00,-1957.06,324273.41000000824,334756.3800000082,-10482.969999999972
39254,2022-12-30 12:10:00,-1940.36,322333.05000000825,334756.3800000082,-12423.329999999958
39255,2022-12-30 12:15:00,-1046.45,321286.60000000824,334756.3800000082,-13469.77999999997
39256,2022-12-30 12:20:00,-540.14,320746.4600000082,334756.3800000082,-14009.919999999984
39257,2022-12-30 12:25:00,-54.12,320692.34000000823,334756.3800000082,-14064.039999999979
39258,2022-12-30 12:30:00,-731.4,319960.9400000082,334756.3800000082,-14795.440000000002
39259,2022-12-30 12:35:00,1527.6,321488.5400000082,334756.3800000082,-13267.840000000026
39260,2022-12-30 12:40:00,1869.02,323357.5600000082,334756.3800000082,-11398.820000000007
39261,2022-12-30 12:45:00,-957.11,322400.4500000082,334756.3800000082,-12355.929999999993
39262,2022-12-30 12:50:00,-826.17,321574.28000000824,334756.3800000082,-13182.099999999977
39263,2022-12-30 12:55:00,-291.09,321283.1900000082,334756.3800000082,-13473.190000000002
39264,2022-12-30 13:00:00,-209.67,321073.5200000082,334756.3800000082,-13682.859999999986
39265,2022-12-30 13:05:00,-1564.92,319508.60000000824,334756.3800000082,-15247.77999999997
39266,2022-12-30 13:10:00,-1271.49,318237.11000000825,334756.3800000082,-16519.26999999996
39267,2022-12-30 13:15:00,483.77,318720.88000000827,334756.3800000082,-16035.499999999942
39268,2022-12-30 13:20:00,218.84,318939.7200000083,334756.3800000082,-15816.659999999916
39269,2022-12-30 13:25:00,1368.3,320308.0200000083,334756.3800000082,-14448.359999999928
39270,2022-12-30 13:30:00,944.39,321252.4100000083,334756.3800000082,-13503.969999999914
39271,2022-12-30 13:35:00,-850.06,320402.3500000083,334756.3800000082,-14354.029999999912
39272,2022-12-30 13:40:00,718.84,321121.1900000083,334756.3800000082,-13635.189999999886
39273,2022-12-30 13:45:00,-1214.44,319906.7500000083,334756.3800000082,-14849.629999999888
39274,2022-12-30 13:50:00,1781.14,321687.89000000834,334756.3800000082,-13068.489999999874
39275,2022-12-30 13:55:00,-1513.84,320174.0500000083,334756.3800000082,-14582.3299999999
39276,2022-12-30 14:00:00,-1022.86,319151.1900000083,334756.3800000082,-15605.189999999886
39277,2022-12-30 14:05:00,-1673.62,317477.57000000833,334756.3800000082,-17278.80999999988
39278,2022-12-30 14:10:00,669.62,318147.1900000083,334756.3800000082,-16609.189999999886
39279,2022-12-30 14:15:00,-1962.34,316184.8500000083,334756.3800000082,-18571.52999999991
39280,2022-12-30 14:20:00,1167.62,317352.4700000083,334756.3800000082,-17403.909999999916
39281,2022-12-30 14:25:00,-618.26,316734.2100000083,334756.3800000082,-18022.169999999925
39282,2022-12-30 14:30:00,1620.77,318354.9800000083,334756.3800000082,-16401.399999999907
39283,2022-12-30 14:35:00,-1048.32,317306.6600000083,334756.3800000082,-17449.719999999914
39284,2022-12-30 14:40:00,387.0,317693.6600000083,334756.3800000082,-17062.719999999914
39285,2022-12-30 14:45:00,906.27,318599.9300000083,334756.3800000082,-16156.449999999895
39286,2022-12-30 14:50:00,190.46,318790.39000000834,334756.3800000082,-15965.989999999874
39287,2022-12-30 14:55:00,1482.3,320272.6900000083,334756.3800000082,-14483.689999999886
39288,2022-12-30 15:00:00,473.74,320746.4300000083,334756.3800000082,-14009.949999999895
39289,2022-12-30 15:05:00,-1380.94,319365.4900000083,334756.3800000082,-15390.889999999898
39290,2022-12-30 15:10:00,-433.59,318931.9000000083,334756.3800000082,-15824.479999999923
39291,2022-12-30 15:15:00,-1585.03,317346.87000000826,334756.3800000082,-17409.50999999995
39292,2022-12-30 15:20:00,-647.73,316699.1400000083,334756.3800000082,-18057.239999999932
39293,2022-12-30 15:25:00,-195.01,316504.13000000827,334756.3800000082,-18252.24999999994
39294,2022-12-30 15:30:00,-658.69,315845.44000000827,334756.3800000082,-18910.939999999944
39295,2022-12-30 15:35:00,-1200.22,314645.2200000083,334756.3800000082,-20111.159999999916
39296,2022-12-30 15:40:00,-1931.49,312713.7300000083,334756.3800000082,-22042.649999999907
39297,2022-12-30 15:45:00,1899.07,314612.8000000083,334756.3800000082,-20143.5799999999
39298,2022-12-30 15:50:00,-1201.82,313410.9800000083,334756.3800000082,-21345.399999999907
39299,2022-12-30 15:55:00,-1528.17,311882.8100000083,334756.3800000082,-22873.56999999989
39300,2022-12-30 16:00:00,251.91,312134.7200000083,334756.3800000082,-22621.659999999916
39301,2022-12-30 16:05:00,-611.11,311523.6100000083,334756.3800000082,-23232.769999999902
39302,2022-12-30 16:10:00,-1379.13,310144.4800000083,334756.3800000082,-24611.899999999907
39303,2022-12-30 16:15:00,94.41,310238.8900000083,334756.3800000082,-24517.489999999932
39304,2022-12-30 16:20:00,-1413.37,308825.5200000083,334756.3800000082,-25930.859999999928
39305,2022-12-30 16:25:00,-424.38,308401.1400000083,334756.3800000082,-26355.239999999932
39306,2022-12-30 16:30:00,1168.12,309569.2600000083,334756.3800000082,-25187.119999999937
39307,2022-12-30 16:35:00,-1156.53,308412.73000000825,334756.3800000082,-26343.649999999965
39308,2022-12-30 16:40:00,-313.64,308099.09000000823,334756.3800000082,-26657.28999999998
39309,2022-12-30 16:45:00,1566.13,309665.22000000824,334756.3800000082,-25091.159999999974
39310,2022-12-30 16:50:00,-337.39,309327.8300000082,334756.3800000082,-25428.54999999999
39311,2022-12-30 16:55:00,216.3,309544.1300000082,334756.3800000082,-25212.25
39312,2022-12-31 08:00:00,189.96,309734.09000000823,309544.1300000082,189.96000000002095
39313,2022-12-31 08:05:00,-347.88,309386.2100000082,309544.1300000082,-157.9199999999837
39314,2022-12-31 08:10:00,-1980.47,307405.74000000826,309544.1300000082,-2138.3899999999558
39315,2022-12-31 08:15:00,-652.68,306753.06000000826,309544.1300000082,-2791.069999999949
39316,2022-12-31 08:20:00,-1088.95,305664.11000000825,309544.1300000082,-3880.0199999999604
39317,2022-12-31 08:25:00,-1085.36,304578.75000000827,309544.1300000082,-4965.379999999946
39318,2022-12-31 08:30:00,-1175.9,303402.85000000824,309544.1300000082,-6141.27999999997
39319,2022-12-31 08:35:00,310.74,303713.59000000823,309544.1300000082,-5830.539999999979
39320,2022-12-31 08:40:00,-1262.78,302450.8100000082,309544.1300000082,-7093.320000000007
39321,2022-12-31 08:45:00,-1398.17,301052.6400000082,309544.1300000082,-8491.48999999999
39322,2022-12-31 08:50:00,-921.94,300130.7000000082,309544.1300000082,-9413.429999999993
39323,2022-12-31 08:55:00,1683.74,301814.4400000082,309544.1300000082,-7729.690000000002
39324,2022-12-31 09:00:00,197.12,302011.5600000082,309544.1300000082,-7532.570000000007
39325,2022-12-31 09:05:00,-757.28,301254.2800000082,309544.1300000082,-8289.850000000035
39326,2022-12-31 09:10:00,-786.96,300467.32000000816,309544.1300000082,-9076.810000000056
39327,2022-12-31 09:15:00,1967.06,302434.38000000815,309544.1300000082,-7109.750000000058
39328,2022-12-31 09:20:00,-1533.92,300900.46000000817,309544.1300000082,-8643.670000000042
39329,2022-12-31 09:25:00,1090.17,301990.63000000815,309544.1300000082,-7553.500000000058
39330,2022-12-31 09:30:00,-142.08,301848.55000000814,309544.1300000082,-7695.5800000000745
39331,2022-12-31 09:35:00,565.01,302413.56000000815,309544.1300000082,-7130.570000000065
39332,2022-12-31 09:40:00,-1502.28,300911.2800000081,309544.1300000082,-8632.850000000093
39333,2022-12-31 09:45:00,-1642.45,299268.8300000081,309544.1300000082,-10275.300000000105
39334,2022-12-31 09:50:00,-1302.59,297966.2400000081,309544.1300000082,-11577.89000000013
39335,2022-12-31 09:55:00,-1733.58,296232.66000000807,309544.1300000082,-13311.470000000147
39336,2022-12-31 10:00:00,1671.28,297903.9400000081,309544.1300000082,-11640.190000000119
39337,2022-12-31 10:05:00,-1446.96,296456.9800000081,309544.1300000082,-13087.15000000014
39338,2022-12-31 10:10:00,938.51,297395.4900000081,309544.1300000082,-12148.64000000013
39339,2022-12-31 10:15:00,291.13,297686.6200000081,309544.1300000082,-11857.510000000126
39340,2022-12-31 10:20:00,-309.3,297377.3200000081,309544.1300000082,-12166.810000000114
39341,2022-12-31 10:25:00,-397.53,296979.79000000807,309544.1300000082,-12564.340000000142
39342,2022-12-31 10:30:00,1693.9,298673.6900000081,309544.1300000082,-10870.440000000119
39343,2022-12-31 10:35:00,1118.4,299792.0900000081,309544.1300000082,-9752.040000000095
39344,2022-12-31 10:40:00,-665.8,299126.2900000081,309544.1300000082,-10417.840000000084
39345,2022-12-31 10:45:00,-395.77,298730.5200000081,309544.1300000082,-10813.610000000102
39346,2022-12-31 10:50:00,-1277.3,297453.2200000081,309544.1300000082,-12090.91000000009
39347,2022-12-31 10:55:00,109.87,297563.0900000081,309544.1300000082,-11981.040000000095
39348,2022-12-31 11:00:00,1790.59,299353.68000000814,309544.1300000082,-10190.45000000007
39349,2022-12-31 11:05:00,-1371.37,297982.31000000815,309544.1300000082,-11561.820000000065
39350,2022-12-31 11:10:00,-1874.28,296108.0300000081,309544.1300000082,-13436.100000000093
39351,2022-12-31 11:15:00,-1203.38,294904.6500000081,309544.1300000082,-14639.480000000098
39352,2022-12-31 11:20:00,-775.34,294129.3100000081,309544.1300000082,-15414.820000000123
39353,2022-12-31 11:25:00,630.19,294759.5000000081,309544.1300000082,-14784.630000000121
39354,2022-12-31 11:30:00,-790.71,293968.79000000807,309544.1300000082,-15575.340000000142
39355,2022-12-31 11:35:00,-1766.71,292202.08000000805,309544.1300000082,-17342.050000000163
39356,2022-12-31 11:40:00,-1982.2,290219.88000000804,309544.1300000082,-19324.250000000175
39357,2022-12-31 11:45:00,808.04,291027.920000008,309544.1300000082,-18516.210000000196
39358,2022-12-31 11:50:00,-315.43,290712.490000008,309544.1300000082,-18831.64000000019
39359,2022-12-31 11:55:00,216.61,290929.100000008,309544.1300000082,-18615.030000000203
39360,2022-12-31 12:00:00,-773.39,290155.710000008,309544.1300000082,-19388.420000000217
39361,2022-12-31 12:05:00,1296.98,291452.690000008,309544.1300000082,-18091.440000000235
39362,2022-12-31 12:10:00,-107.1,291345.590000008,309544.1300000082,-18198.540000000212
39363,2022-12-31 12:15:00,-1103.89,290241.700000008,309544.1300000082,-19302.430000000226
39364,2022-12-31 12:20:00,836.13,291077.830000008,309544.1300000082,-18466.30000000022
39365,2022-12-31 12:25:00,1705.45,292783.280000008,309544.1300000082,-16760.85000000021
39366,2022-12-31 12:30:00,491.32,293274.600000008,309544.1300000082,-16269.530000000203
39367,2022-12-31 12:35:00,-1194.52,292080.080000008,309544.1300000082,-17464.05000000022
39368,2022-12-31 12:40:00,-1462.93,290617.150000008,309544.1300000082,-18926.980000000214
39369,2022-12-31 12:45:00,-1932.57,288684.580000008,309544.1300000082,-20859.55000000022
39370,2022-12-31 12:50:00,800.5,289485.080000008,309544.1300000082,-20059.05000000022
39371,2022-12-31 12:55:00,-545.3,288939.780000008,309544.1300000082,-20604.35000000021
39372,2022-12-31 13:00:00,-731.69,288208.090000008,309544.1300000082,-21336.040000000212
39373,2022-12-31 13:05:00,-1565.81,286642.280000008,309544.1300000082,-22901.85000000021
39374,2022-12-31 13:10:00,-920.39,285721.890000008,309544.1300000082,-23822.240000000224
39375,2022-12-31 13:15:00,509.68,286231.570000008,309544.1300000082,-23312.56000000023
39376,2022-12-31 13:20:00,-1280.09,284951.48000000796,309544.1300000082,-24592.650000000256
39377,2022-12-31 13:25:00,118.33,285069.810000008,309544.1300000082,-24474.32000000024
39378,2022-12-31 13:30:00,-444.31,284625.500000008,309544.1300000082,-24918.630000000237
39379,2022-12-31 13:35:00,-1306.68,283318.820000008,309544.1300000082,-26225.31000000023
39380,2022-12-31 13:40:00,-922.84,282395.98000000796,309544.1300000082,-27148.150000000256
39381,2022-12-31 13:45:00,-1525.31,280870.67000000796,309544.1300000082,-28673.460000000254
39382,2022-12-31 13:50:00,-1173.49,279697.18000000797,309544.1300000082,-29846.950000000244
39383,2022-12-31 13:55:00,1970.22,281667.40000000794,309544.1300000082,-27876.730000000272
39384,2022-12-31 14:00:00,875.48,282542.8800000079,309544.1300000082,-27001.25000000029
39385,2022-12-31 14:05:00,784.59,283327.47000000795,309544.1300000082,-26216.660000000265
39386,2022-12-31 14:10:00,1935.75,285263.22000000795,309544.1300000082,-24280.910000000265
39387,2022-12-31 14:15:00,-899.83,284363.39000000793,309544.1300000082,-25180.74000000028
39388,2022-12-31 14:20:00,1072.57,285435.96000000794,309544.1300000082,-24108.170000000275
39389,2022-12-31 14:25:00,1478.78,286914.74000000797,309544.1300000082,-22629.390000000247
39390,2022-12-31 14:30:00,-1030.91,285883.830000008,309544.1300000082,-23660.30000000022
39391,2022-12-31 14:35:00,-1029.46,284854.37000000797,309544.1300000082,-24689.760000000242
39392,2022-12-31 14:40:00,394.96,285249.330000008,309544.1300000082,-24294.80000000022
39393,2022-12-31 14:45:00,189.21,285438.540000008,309544.1300000082,-24105.5900000002
39394,2022-12-31 14:50:00,-334.18,285104.360000008,309544.1300000082,-24439.770000000193
39395,2022-12-31 14:55:00,214.42,285318.780000008,309544.1300000082,-24225.35000000021
39396,2022-12-31 15:00:00,1103.79,286422.570000008,309544.1300000082,-23121.56000000023
39397,2022-12-31 15:05:00,1319.66,287742.23000000796,309544.1300000082,-21801.900000000256
39398,2022-12-31 15:10:00,309.39,288051.62000000797,309544.1300000082,-21492.510000000242
39399,2022-12-31 15:15:00,-675.09,287376.53000000794,309544.1300000082,-22167.600000000268
39400,2022-12-31 15:20:00,-959.13,286417.40000000794,309544.1300000082,-23126.730000000272
39401,2022-12-31 15:25:00,-247.51,286169.89000000793,309544.1300000082,-23374.24000000028
39402,2022-12-31 15:30:00,-1280.73,284889.16000000795,309544.1300000082,-24654.970000000263
39403,2022-12-31 15:35:00,-1808.84,283080.3200000079,309544.1300000082,-26463.81000000029
39404,2022-12-31 15:40:00,884.31,283964.6300000079,309544.1300000082,-25579.50000000029
39405,2022-12-31 15:45:00,842.08,284806.71000000794,309544.1300000082,-24737.420000000275
39406,2022-12-31 15:50:00,-267.84,284538.8700000079,309544.1300000082,-25005.2600000003
39407,2022-12-31 15:55:00,640.41,285179.2800000079,309544.1300000082,-24364.850000000326
39408,2022-12-31 16:00:00,-963.16,284216.1200000079,309544.1300000082,-25328.0100000003
39409,2022-12-31 16:05:00,-1546.78,282669.3400000079,309544.1300000082,-26874.79000000033
39410,2022-12-31 16:10:00,1847.34,284516.6800000079,309544.1300000082,-25027.450000000303
39411,2022-12-31 16:15:00,-1380.69,283135.9900000079,309544.1300000082,-26408.140000000305
39412,2022-12-31 16:20:00,1129.31,284265.3000000079,309544.1300000082,-25278.830000000307
39413,2022-12-31 16:25:00,184.21,284449.5100000079,309544.1300000082,-25094.620000000286
39414,2022-12-31 16:30:00,-1956.28,282493.2300000079,309544.1300000082,-27050.900000000314
39415,2022-12-31 16:35:00,-1069.05,281424.1800000079,309544.1300000082,-28119.950000000303
39416,2022-12-31 16:40:00,-753.33,280670.8500000079,309544.1300000082,-28873.28000000032
39417,2022-12-31 16:45:00,-279.35,280391.5000000079,309544.1300000082,-29152.630000000296
39418,2022-12-31 16:50:00,1567.12,281958.6200000079,309544.1300000082,-27585.5100000003
39419,2022-12-31 16:55:00,-1178.89,280779.7300000079,309544.1300000082,-28764.400000000314
